,일시,지점명,강수량(mm),사망자수,경상자수,부상신고자수,중상자수,총 피해자수
0,2018-01-01,강남구,0.0,0,2,2,1,5
1,2018-01-01,강동구,0.0,0,2,0,1,3
2,2018-01-01,강북구,0.0,0,4,0,1,5
3,2018-01-01,강서구,0.0,0,1,0,0,1
4,2018-01-01,관악구,0.0,0,7,1,1,9
5,2018-01-01,광진구,0.0,0,0,0,2,2
6,2018-01-01,구로구,0.0,0,1,0,2,3
7,2018-01-01,금천구,0.0,0,1,0,0,1
8,2018-01-01,노원구,0.0,0,2,0,0,2
9,2018-01-01,도봉구,0.0,0,0,0,0,0
10,2018-01-01,동대문구,0.0,0,1,1,0,2
11,2018-01-01,동작구,0.0,0,1,1,1,3
12,2018-01-01,마포구,0.0,0,4,0,2,6
13,2018-01-01,서대문구,0.0,0,0,2,0,2
14,2018-01-01,서초구,0.0,0,3,0,1,4
15,2018-01-01,성동구,0.0,0,0,0,0,0
16,2018-01-01,성북구,0.0,0,2,0,4,6
17,2018-01-01,송파구,0.0,0,7,0,6,13
18,2018-01-01,양천구,0.0,0,3,0,0,3
19,2018-01-01,영등포구,0.0,0,5,0,4,9
20,2018-01-01,용산구,0.0,0,4,0,0,4
21,2018-01-01,은평구,0.0,1,2,0,1,4
22,2018-01-01,종로구,0.0,0,2,0,1,3
23,2018-01-01,중구,0.0,0,1,0,1,2
24,2018-01-01,중랑구,0.0,0,6,0,3,9
25,2018-01-02,강남구,0.0,0,3,0,2,5
26,2018-01-02,강동구,0.0,0,3,1,0,4
27,2018-01-02,강북구,0.0,0,4,0,0,4
28,2018-01-02,강서구,0.0,0,2,0,0,2
29,2018-01-02,관악구,0.0,0,2,0,1,3
30,2018-01-02,광진구,0.0,0,0,0,2,2
31,2018-01-02,구로구,0.0,0,2,0,2,4
32,2018-01-02,금천구,0.0,0,3,0,0,3
33,2018-01-02,노원구,0.0,0,0,0,1,1
34,2018-01-02,도봉구,0.0,0,1,0,1,2
35,2018-01-02,동대문구,0.0,0,1,0,2,3
36,2018-01-02,동작구,0.0,0,0,0,0,0
37,2018-01-02,마포구,0.0,0,3,0,2,5
38,2018-01-02,서대문구,0.0,0,1,0,1,2
39,2018-01-02,서초구,0.0,0,2,0,2,4
40,2018-01-02,성동구,0.0,0,1,0,0,1
41,2018-01-02,성북구,0.0,0,3,0,0,3
42,2018-01-02,송파구,0.0,0,6,2,2,10
43,2018-01-02,양천구,0.0,0,3,0,2,5
44,2018-01-02,영등포구,0.0,0,3,0,1,4
45,2018-01-02,용산구,0.0,0,3,0,1,4
46,2018-01-02,은평구,0.0,0,3,0,3,6
47,2018-01-02,종로구,0.0,0,0,0,0,0
48,2018-01-02,중구,0.0,0,4,0,4,8
49,2018-01-02,중랑구,0.0,0,5,1,0,6
50,2018-01-03,강남구,0.0,0,8,1,4,13
51,2018-01-03,강동구,0.0,0,1,1,2,4
52,2018-01-03,강북구,0.0,0,1,0,1,2
53,2018-01-03,강서구,0.0,0,5,3,1,9
54,2018-01-03,관악구,0.0,0,1,0,1,2
55,2018-01-03,광진구,0.0,0,1,1,1,3
56,2018-01-03,구로구,0.0,0,4,1,1,6
57,2018-01-03,금천구,0.0,0,0,0,0,0
58,2018-01-03,노원구,0.0,0,3,0,1,4
59,2018-01-03,도봉구,0.0,0,3,0,0,3
60,2018-01-03,동대문구,0.0,0,2,1,3,6
61,2018-01-03,동작구,0.0,0,1,0,0,1
62,2018-01-03,마포구,0.0,0,3,0,2,5
63,2018-01-03,서대문구,0.0,0,3,0,0,3
64,2018-01-03,서초구,0.0,0,2,0,0,2
65,2018-01-03,성동구,0.0,0,1,0,1,2
66,2018-01-03,성북구,0.0,0,1,0,3,4
67,2018-01-03,송파구,0.0,0,3,2,0,5
68,2018-01-03,양천구,0.0,0,2,0,2,4
69,2018-01-03,영등포구,0.0,0,1,1,2,4
70,2018-01-03,용산구,0.0,2,3,0,1,6
71,2018-01-03,은평구,0.0,0,2,0,0,2
72,2018-01-03,종로구,0.0,0,3,0,1,4
73,2018-01-03,중구,0.0,0,3,0,1,4
74,2018-01-03,중랑구,0.0,0,2,0,0,2
75,2018-01-04,강남구,0.0,0,6,1,3,10
76,2018-01-04,강동구,0.0,0,1,0,2,3
77,2018-01-04,강북구,0.0,0,3,0,1,4
78,2018-01-04,강서구,0.0,0,3,0,0,3
79,2018-01-04,관악구,0.0,0,0,0,0,0
80,2018-01-04,광진구,0.0,0,1,0,0,1
81,2018-01-04,구로구,0.0,0,2,0,1,3
82,2018-01-04,금천구,0.0,0,3,0,1,4
83,2018-01-04,노원구,0.0,0,5,0,0,5
84,2018-01-04,도봉구,0.0,0,0,0,0,0
85,2018-01-04,동대문구,0.0,0,0,0,2,2
86,2018-01-04,동작구,0.0,1,3,0,1,5
87,2018-01-04,마포구,0.0,0,2,0,1,3
88,2018-01-04,서대문구,0.0,0,2,0,0,2
89,2018-01-04,서초구,0.0,1,5,1,1,8
90,2018-01-04,성동구,0.0,0,5,1,1,7
91,2018-01-04,성북구,0.0,0,2,0,0,2
92,2018-01-04,송파구,0.0,0,9,1,0,10
93,2018-01-04,양천구,0.0,0,0,0,1,1
94,2018-01-04,영등포구,0.0,0,4,0,2,6
95,2018-01-04,용산구,0.0,0,3,0,2,5
96,2018-01-04,은평구,0.0,0,1,0,2,3
97,2018-01-04,종로구,0.0,0,3,0,3,6
98,2018-01-04,중구,0.0,0,1,0,1,2
99,2018-01-04,중랑구,0.0,1,1,0,2,4
100,2018-01-05,강남구,0.0,0,12,1,5,18
101,2018-01-05,강동구,0.0,0,1,1,1,3
102,2018-01-05,강북구,0.0,0,0,2,0,2
103,2018-01-05,강서구,0.0,1,4,0,3,8
104,2018-01-05,관악구,0.0,0,1,0,1,2
105,2018-01-05,광진구,0.0,0,5,0,0,5
106,2018-01-05,구로구,0.0,0,1,0,0,1
107,2018-01-05,금천구,0.0,0,4,2,2,8
108,2018-01-05,노원구,0.0,0,2,0,1,3
109,2018-01-05,도봉구,0.0,0,2,0,3,5
110,2018-01-05,동대문구,0.0,0,5,1,1,7
111,2018-01-05,동작구,0.0,0,1,0,1,2
112,2018-01-05,마포구,0.0,0,7,1,2,10
113,2018-01-05,서대문구,0.0,0,7,0,3,10
114,2018-01-05,서초구,0.0,0,1,3,0,4
115,2018-01-05,성동구,0.0,0,4,0,1,5
116,2018-01-05,성북구,0.0,0,5,0,1,6
117,2018-01-05,송파구,0.0,0,3,0,0,3
118,2018-01-05,양천구,0.0,0,4,0,1,5
119,2018-01-05,영등포구,0.0,0,4,3,4,11
120,2018-01-05,용산구,0.0,0,2,0,2,4
121,2018-01-05,은평구,0.0,0,1,0,0,1
122,2018-01-05,종로구,0.0,0,4,1,1,6
123,2018-01-05,중구,0.0,0,1,1,1,3
124,2018-01-05,중랑구,0.0,0,1,0,1,2
125,2018-01-06,강남구,0.0,0,9,0,0,9
126,2018-01-06,강동구,0.0,0,1,0,2,3
127,2018-01-06,강북구,0.0,0,1,0,0,1
128,2018-01-06,강서구,0.0,1,7,0,2,10
129,2018-01-06,관악구,0.0,0,0,0,0,0
130,2018-01-06,광진구,0.0,0,2,0,1,3
131,2018-01-06,구로구,0.0,0,2,0,2,4
132,2018-01-06,금천구,0.0,0,5,1,1,7
133,2018-01-06,노원구,0.0,0,7,0,3,10
134,2018-01-06,도봉구,0.0,0,2,0,2,4
135,2018-01-06,동대문구,0.0,0,8,1,3,12
136,2018-01-06,동작구,0.0,0,1,1,1,3
137,2018-01-06,마포구,0.0,0,6,0,1,7
138,2018-01-06,서대문구,0.0,0,0,1,0,1
139,2018-01-06,서초구,0.0,0,3,0,3,6
140,2018-01-06,성동구,0.0,0,4,0,1,5
141,2018-01-06,성북구,0.0,0,2,0,0,2
142,2018-01-06,송파구,0.0,0,9,3,3,15
143,2018-01-06,양천구,0.0,0,4,0,1,5
144,2018-01-06,영등포구,0.0,0,13,2,1,16
145,2018-01-06,용산구,0.0,1,7,0,2,10
146,2018-01-06,은평구,0.0,0,1,0,1,2
147,2018-01-06,종로구,0.0,0,10,1,0,11
148,2018-01-06,중구,0.0,0,4,0,0,4
149,2018-01-06,중랑구,0.0,0,5,0,1,6
150,2018-01-07,강남구,0.0,0,4,0,1,5
151,2018-01-07,강동구,0.0,0,1,0,0,1
152,2018-01-07,강북구,0.0,0,1,0,0,1
153,2018-01-07,강서구,0.0,0,3,0,0,3
154,2018-01-07,관악구,0.0,0,0,0,0,0
155,2018-01-07,광진구,0.0,0,5,0,2,7
156,2018-01-07,구로구,0.0,0,2,1,0,3
157,2018-01-07,금천구,0.0,0,1,0,1,2
158,2018-01-07,노원구,0.0,0,1,1,3,5
159,2018-01-07,도봉구,0.0,0,3,0,0,3
160,2018-01-07,동대문구,0.0,0,0,0,0,0
161,2018-01-07,동작구,0.0,0,4,0,0,4
162,2018-01-07,마포구,0.0,0,0,1,0,1
163,2018-01-07,서대문구,0.0,0,1,0,2,3
164,2018-01-07,서초구,0.0,0,1,0,0,1
165,2018-01-07,성동구,0.0,0,1,0,0,1
166,2018-01-07,성북구,0.0,0,0,0,2,2
167,2018-01-07,송파구,0.0,0,2,1,0,3
168,2018-01-07,양천구,0.0,0,0,0,1,1
169,2018-01-07,영등포구,0.0,1,3,1,1,6
170,2018-01-07,용산구,0.0,0,3,0,0,3
171,2018-01-07,은평구,0.0,0,0,0,0,0
172,2018-01-07,종로구,0.0,0,4,1,0,5
173,2018-01-07,중구,0.0,0,0,0,0,0
174,2018-01-07,중랑구,0.0,0,14,0,1,15
175,2018-01-08,강남구,0.5,1,11,2,2,16
176,2018-01-08,강동구,0.5,0,4,1,1,6
177,2018-01-08,강북구,0.5,0,5,0,2,7
178,2018-01-08,강서구,0.5,0,3,2,3,8
179,2018-01-08,관악구,0.5,0,4,0,1,5
180,2018-01-08,광진구,0.0,0,0,0,0,0
181,2018-01-08,구로구,0.5,0,3,0,0,3
182,2018-01-08,금천구,0.5,0,3,0,2,5
183,2018-01-08,노원구,0.0,0,0,0,2,2
184,2018-01-08,도봉구,0.0,0,1,1,1,3
185,2018-01-08,동대문구,0.0,0,4,0,4,8
186,2018-01-08,동작구,0.5,0,3,0,0,3
187,2018-01-08,마포구,0.0,0,3,0,0,3
188,2018-01-08,서대문구,0.5,0,0,1,0,1
189,2018-01-08,서초구,0.5,0,5,2,2,9
190,2018-01-08,성동구,0.5,0,2,0,1,3
191,2018-01-08,성북구,0.5,0,4,1,1,6
192,2018-01-08,송파구,0.5,1,0,0,0,1
193,2018-01-08,양천구,0.5,0,1,1,0,2
194,2018-01-08,영등포구,0.0,0,12,0,2,14
195,2018-01-08,용산구,0.0,0,2,0,0,2
196,2018-01-08,은평구,0.0,0,1,0,1,2
197,2018-01-08,종로구,0.9,0,1,1,1,3
198,2018-01-08,중구,0.5,0,4,0,0,4
199,2018-01-08,중랑구,1.0,0,2,0,1,3
200,2018-01-09,강남구,0.0,0,7,0,1,8
201,2018-01-09,강동구,0.0,0,1,0,1,2
202,2018-01-09,강북구,0.0,0,3,0,0,3
203,2018-01-09,강서구,0.0,0,10,0,5,15
204,2018-01-09,관악구,0.0,0,2,0,0,2
205,2018-01-09,광진구,0.5,0,1,0,0,1
206,2018-01-09,구로구,0.0,0,5,1,1,7
207,2018-01-09,금천구,0.0,0,7,0,3,10
208,2018-01-09,노원구,0.0,0,8,0,3,11
209,2018-01-09,도봉구,0.0,0,2,0,0,2
210,2018-01-09,동대문구,0.0,0,2,0,0,2
211,2018-01-09,동작구,0.0,0,1,0,1,2
212,2018-01-09,마포구,0.0,0,2,1,1,4
213,2018-01-09,서대문구,0.0,0,0,0,1,1
214,2018-01-09,서초구,0.0,0,4,0,3,7
215,2018-01-09,성동구,0.0,1,0,0,0,1
216,2018-01-09,성북구,0.0,0,3,0,0,3
217,2018-01-09,송파구,0.0,0,2,2,0,4
218,2018-01-09,양천구,0.0,0,3,0,0,3
219,2018-01-09,영등포구,0.0,0,6,1,1,8
220,2018-01-09,용산구,0.0,0,1,1,2,4
221,2018-01-09,은평구,0.0,0,11,1,3,15
222,2018-01-09,종로구,0.5,0,4,1,0,5
223,2018-01-09,중구,0.0,0,5,2,4,11
224,2018-01-09,중랑구,0.0,0,8,0,0,8
225,2018-01-10,강남구,0.0,0,17,1,4,22
226,2018-01-10,강동구,0.5,0,1,0,1,2
227,2018-01-10,강북구,0.0,0,2,0,2,4
228,2018-01-10,강서구,0.0,0,6,0,0,6
229,2018-01-10,관악구,0.25,0,2,1,0,3
230,2018-01-10,광진구,0.0,0,5,0,2,7
231,2018-01-10,구로구,0.0,1,3,0,1,5
232,2018-01-10,금천구,0.0,0,6,0,0,6
233,2018-01-10,노원구,0.0,0,9,0,0,9
234,2018-01-10,도봉구,0.0,0,5,0,1,6
235,2018-01-10,동대문구,0.0,0,8,0,6,14
236,2018-01-10,동작구,0.0,0,3,0,0,3
237,2018-01-10,마포구,0.0,0,4,0,2,6
238,2018-01-10,서대문구,0.0,0,6,0,1,7
239,2018-01-10,서초구,0.0,0,7,0,0,7
240,2018-01-10,성동구,0.0,0,10,4,0,14
241,2018-01-10,성북구,0.0,0,10,1,1,12
242,2018-01-10,송파구,0.0,0,11,3,2,16
243,2018-01-10,양천구,0.0,0,5,0,2,7
244,2018-01-10,영등포구,0.0,0,4,0,3,7
245,2018-01-10,용산구,0.0,0,11,0,3,14
246,2018-01-10,은평구,0.0,0,4,0,1,5
247,2018-01-10,종로구,0.3,0,5,0,2,7
248,2018-01-10,중구,0.0,1,3,2,1,7
249,2018-01-10,중랑구,0.0,0,3,0,1,4
250,2018-01-11,강남구,0.0,0,18,1,12,31
251,2018-01-11,강동구,0.0,0,0,0,1,1
252,2018-01-11,강북구,0.0,0,2,0,0,2
253,2018-01-11,강서구,0.0,0,4,0,1,5
254,2018-01-11,관악구,0.0,0,5,0,0,5
255,2018-01-11,광진구,0.0,0,5,0,2,7
256,2018-01-11,구로구,0.0,0,9,0,2,11
257,2018-01-11,금천구,0.0,0,3,0,0,3
258,2018-01-11,노원구,0.0,0,10,3,0,13
259,2018-01-11,도봉구,0.0,0,1,0,2,3
260,2018-01-11,동대문구,0.0,0,6,0,3,9
261,2018-01-11,동작구,0.0,0,6,0,2,8
262,2018-01-11,마포구,0.0,0,5,0,2,7
263,2018-01-11,서대문구,0.0,0,1,1,0,2
264,2018-01-11,서초구,0.0,0,12,1,5,18
265,2018-01-11,성동구,0.0,0,1,0,1,2
266,2018-01-11,성북구,0.0,0,7,0,2,9
267,2018-01-11,송파구,0.0,0,10,0,4,14
268,2018-01-11,양천구,0.0,0,4,0,1,5
269,2018-01-11,영등포구,0.0,0,5,1,2,8
270,2018-01-11,용산구,0.0,0,4,0,1,5
271,2018-01-11,은평구,0.0,0,1,0,0,1
272,2018-01-11,종로구,0.0,0,3,0,2,5
273,2018-01-11,중구,0.0,0,1,2,2,5
274,2018-01-11,중랑구,0.0,0,2,0,1,3
275,2018-01-12,강남구,0.0,0,17,5,4,26
276,2018-01-12,강동구,0.0,0,2,0,1,3
277,2018-01-12,강북구,0.0,0,8,1,1,10
278,2018-01-12,강서구,0.0,1,3,1,2,7
279,2018-01-12,관악구,0.0,0,6,0,1,7
280,2018-01-12,광진구,0.0,0,4,0,1,5
281,2018-01-12,구로구,0.0,0,9,4,7,20
282,2018-01-12,금천구,0.0,0,7,0,2,9
283,2018-01-12,노원구,0.0,0,3,0,2,5
284,2018-01-12,도봉구,0.0,0,6,2,0,8
285,2018-01-12,동대문구,0.0,0,1,0,1,2
286,2018-01-12,동작구,0.0,0,3,1,0,4
287,2018-01-12,마포구,0.0,0,11,3,2,16
288,2018-01-12,서대문구,0.0,0,2,0,0,2
289,2018-01-12,서초구,0.0,0,12,1,3,16
290,2018-01-12,성동구,0.0,0,1,0,3,4
291,2018-01-12,성북구,0.0,0,5,0,3,8
292,2018-01-12,송파구,0.0,0,9,2,0,11
293,2018-01-12,양천구,0.0,0,11,1,1,13
294,2018-01-12,영등포구,0.0,0,6,0,3,9
295,2018-01-12,용산구,0.0,0,3,1,3,7
296,2018-01-12,은평구,0.0,0,2,0,0,2
297,2018-01-12,종로구,0.0,0,5,1,1,7
298,2018-01-12,중구,0.0,0,14,1,5,20
299,2018-01-12,중랑구,0.0,0,6,0,0,6
300,2018-01-13,강남구,0.0,0,11,4,6,21
301,2018-01-13,강동구,0.0,0,2,0,0,2
302,2018-01-13,강북구,0.0,0,7,0,0,7
303,2018-01-13,강서구,0.0,0,5,0,0,5
304,2018-01-13,관악구,0.0,0,10,0,0,10
305,2018-01-13,광진구,0.0,0,4,1,3,8
306,2018-01-13,구로구,0.0,0,3,0,1,4
307,2018-01-13,금천구,0.0,0,7,1,0,8
308,2018-01-13,노원구,0.0,0,5,0,2,7
309,2018-01-13,도봉구,0.0,0,1,0,1,2
310,2018-01-13,동대문구,0.0,0,4,0,5,9
311,2018-01-13,동작구,0.0,0,2,1,1,4
312,2018-01-13,마포구,0.0,0,10,0,2,12
313,2018-01-13,서대문구,0.0,0,6,5,2,13
314,2018-01-13,서초구,0.0,0,10,2,2,14
315,2018-01-13,성동구,0.0,0,3,0,1,4
316,2018-01-13,성북구,0.0,0,6,0,3,9
317,2018-01-13,송파구,0.0,0,7,6,1,14
318,2018-01-13,양천구,0.0,0,2,2,2,6
319,2018-01-13,영등포구,0.0,1,17,1,0,19
320,2018-01-13,용산구,0.0,0,16,0,0,16
321,2018-01-13,은평구,0.0,0,2,0,0,2
322,2018-01-13,종로구,0.4,0,1,0,0,1
323,2018-01-13,중구,0.0,0,1,0,0,1
324,2018-01-13,중랑구,0.0,0,7,0,4,11
325,2018-01-14,강남구,0.0,0,13,2,2,17
326,2018-01-14,강동구,0.0,0,0,0,1,1
327,2018-01-14,강북구,0.0,0,0,0,0,0
328,2018-01-14,강서구,0.0,0,7,0,2,9
329,2018-01-14,관악구,0.0,0,3,0,1,4
330,2018-01-14,광진구,0.0,0,4,0,1,5
331,2018-01-14,구로구,0.0,0,4,0,1,5
332,2018-01-14,금천구,0.0,0,5,0,1,6
333,2018-01-14,노원구,0.0,0,5,1,2,8
334,2018-01-14,도봉구,0.0,0,3,0,4,7
335,2018-01-14,동대문구,0.0,0,2,0,0,2
336,2018-01-14,동작구,0.0,0,1,0,1,2
337,2018-01-14,마포구,0.0,0,4,1,0,5
338,2018-01-14,서대문구,0.0,0,2,0,1,3
339,2018-01-14,서초구,0.0,0,18,0,4,22
340,2018-01-14,성동구,0.0,0,2,0,2,4
341,2018-01-14,성북구,0.0,0,6,1,2,9
342,2018-01-14,송파구,0.0,0,1,2,1,4
343,2018-01-14,양천구,0.0,0,3,1,1,5
344,2018-01-14,영등포구,0.0,0,4,1,0,5
345,2018-01-14,용산구,0.0,0,9,0,0,9
346,2018-01-14,은평구,0.0,0,4,0,0,4
347,2018-01-14,종로구,0.0,0,2,0,0,2
348,2018-01-14,중구,0.0,0,0,0,1,1
349,2018-01-14,중랑구,0.0,0,2,2,3,7
350,2018-01-15,강남구,0.0,0,13,1,2,16
351,2018-01-15,강동구,0.0,0,6,1,5,12
352,2018-01-15,강북구,0.0,0,2,0,1,3
353,2018-01-15,강서구,0.0,0,4,1,0,5
354,2018-01-15,관악구,0.0,0,8,1,2,11
355,2018-01-15,광진구,0.0,0,2,0,0,2
356,2018-01-15,구로구,0.0,0,4,0,1,5
357,2018-01-15,금천구,0.0,0,4,0,0,4
358,2018-01-15,노원구,0.0,0,7,2,2,11
359,2018-01-15,도봉구,0.0,0,1,0,0,1
360,2018-01-15,동대문구,0.0,0,5,1,3,9
361,2018-01-15,동작구,0.0,0,1,0,2,3
362,2018-01-15,마포구,0.0,0,10,0,0,10
363,2018-01-15,서대문구,0.0,0,0,1,2,3
364,2018-01-15,서초구,0.0,0,6,0,2,8
365,2018-01-15,성동구,0.0,1,0,0,0,1
366,2018-01-15,성북구,0.0,0,2,2,0,4
367,2018-01-15,송파구,0.0,0,7,1,2,10
368,2018-01-15,양천구,0.0,0,2,0,0,2
369,2018-01-15,영등포구,0.0,0,11,0,3,14
370,2018-01-15,용산구,0.0,0,1,1,1,3
371,2018-01-15,은평구,0.0,0,2,0,0,2
372,2018-01-15,종로구,0.2,0,3,3,2,8
373,2018-01-15,중구,0.0,0,3,1,1,5
374,2018-01-15,중랑구,0.0,0,4,0,0,4
375,2018-01-16,강남구,0.0,0,15,2,2,19
376,2018-01-16,강동구,0.0,0,2,0,0,2
377,2018-01-16,강북구,0.0,0,3,1,1,5
378,2018-01-16,강서구,0.0,0,6,0,0,6
379,2018-01-16,관악구,0.0,0,1,2,0,3
380,2018-01-16,광진구,0.0,0,3,0,0,3
381,2018-01-16,구로구,0.0,0,7,0,3,10
382,2018-01-16,금천구,0.0,0,4,0,0,4
383,2018-01-16,노원구,0.0,0,2,0,3,5
384,2018-01-16,도봉구,0.0,0,1,0,1,2
385,2018-01-16,동대문구,0.0,0,3,0,1,4
386,2018-01-16,동작구,0.0,0,1,2,0,3
387,2018-01-16,마포구,0.0,0,4,0,1,5
388,2018-01-16,서대문구,0.0,0,3,1,0,4
389,2018-01-16,서초구,0.0,0,15,3,6,24
390,2018-01-16,성동구,0.0,0,3,0,1,4
391,2018-01-16,성북구,0.0,0,3,0,2,5
392,2018-01-16,송파구,0.0,0,5,0,2,7
393,2018-01-16,양천구,0.0,0,7,0,2,9
394,2018-01-16,영등포구,0.0,0,3,1,0,4
395,2018-01-16,용산구,0.0,0,1,0,0,1
396,2018-01-16,은평구,0.0,0,3,0,0,3
397,2018-01-16,종로구,0.0,0,2,0,0,2
398,2018-01-16,중구,0.0,0,3,1,0,4
399,2018-01-16,중랑구,0.0,0,1,0,3,4
400,2018-01-17,강남구,0.0,0,15,4,4,23
401,2018-01-17,강동구,0.0,0,0,0,0,0
402,2018-01-17,강북구,0.0,0,1,1,3,5
403,2018-01-17,강서구,0.0,0,4,0,4,8
404,2018-01-17,관악구,0.0,0,0,0,0,0
405,2018-01-17,광진구,0.0,0,1,1,0,2
406,2018-01-17,구로구,0.0,0,1,1,1,3
407,2018-01-17,금천구,0.0,0,3,1,1,5
408,2018-01-17,노원구,0.0,0,9,2,5,16
409,2018-01-17,도봉구,0.0,0,4,0,0,4
410,2018-01-17,동대문구,0.0,0,7,0,2,9
411,2018-01-17,동작구,0.0,0,1,1,0,2
412,2018-01-17,마포구,0.0,0,9,0,6,15
413,2018-01-17,서대문구,0.0,0,4,1,1,6
414,2018-01-17,서초구,0.0,0,7,1,0,8
415,2018-01-17,성동구,0.0,0,5,0,0,5
416,2018-01-17,성북구,0.0,0,9,0,3,12
417,2018-01-17,송파구,0.0,0,11,1,0,12
418,2018-01-17,양천구,0.0,0,9,0,0,9
419,2018-01-17,영등포구,0.0,0,12,1,1,14
420,2018-01-17,용산구,0.0,0,1,1,0,2
421,2018-01-17,은평구,0.0,0,3,0,2,5
422,2018-01-17,종로구,0.0,0,3,1,1,5
423,2018-01-17,중구,0.0,0,0,0,0,0
424,2018-01-17,중랑구,0.0,0,16,0,1,17
425,2018-01-18,강남구,0.0,0,21,1,8,30
426,2018-01-18,강동구,0.0,0,3,1,0,4
427,2018-01-18,강북구,0.0,0,1,0,0,1
428,2018-01-18,강서구,0.0,0,6,0,1,7
429,2018-01-18,관악구,0.0,0,1,0,0,1
430,2018-01-18,광진구,0.0,0,3,0,0,3
431,2018-01-18,구로구,0.0,0,4,0,1,5
432,2018-01-18,금천구,0.0,0,1,0,0,1
433,2018-01-18,노원구,0.0,0,0,1,0,1
434,2018-01-18,도봉구,0.0,0,0,0,1,1
435,2018-01-18,동대문구,0.0,0,2,0,1,3
436,2018-01-18,동작구,0.0,0,3,0,2,5
437,2018-01-18,마포구,0.0,0,4,0,2,6
438,2018-01-18,서대문구,0.0,0,0,0,1,1
439,2018-01-18,서초구,0.0,0,4,0,0,4
440,2018-01-18,성동구,0.0,1,0,0,0,1
441,2018-01-18,성북구,0.0,0,7,0,3,10
442,2018-01-18,송파구,0.0,0,11,2,3,16
443,2018-01-18,양천구,0.0,0,1,0,0,1
444,2018-01-18,영등포구,0.0,0,6,2,1,9
445,2018-01-18,용산구,0.0,0,1,0,0,1
446,2018-01-18,은평구,0.0,0,3,1,1,5
447,2018-01-18,종로구,0.0,0,6,2,2,10
448,2018-01-18,중구,0.0,0,3,0,2,5
449,2018-01-18,중랑구,0.0,0,2,0,0,2
450,2018-01-19,강남구,0.0,0,12,4,6,22
451,2018-01-19,강동구,0.0,0,2,0,1,3
452,2018-01-19,강북구,0.0,0,8,0,1,9
453,2018-01-19,강서구,0.0,0,11,3,1,15
454,2018-01-19,관악구,0.0,0,5,0,1,6
455,2018-01-19,광진구,0.0,0,3,1,0,4
456,2018-01-19,구로구,0.0,0,0,0,1,1
457,2018-01-19,금천구,0.0,1,2,0,0,3
458,2018-01-19,노원구,0.0,0,0,0,0,0
459,2018-01-19,도봉구,0.0,0,0,0,0,0
460,2018-01-19,동대문구,0.0,0,7,1,1,9
461,2018-01-19,동작구,0.0,0,2,0,2,4
462,2018-01-19,마포구,0.0,0,3,0,4,7
463,2018-01-19,서대문구,0.0,0,1,0,2,3
464,2018-01-19,서초구,0.0,0,4,0,0,4
465,2018-01-19,성동구,0.0,0,0,0,1,1
466,2018-01-19,성북구,0.0,0,9,0,1,10
467,2018-01-19,송파구,0.0,1,14,3,6,24
468,2018-01-19,양천구,0.0,0,8,1,1,10
469,2018-01-19,영등포구,0.0,0,14,0,2,16
470,2018-01-19,용산구,0.0,0,2,0,2,4
471,2018-01-19,은평구,0.0,0,1,0,3,4
472,2018-01-19,종로구,0.0,0,1,2,1,4
473,2018-01-19,중구,0.0,0,3,0,2,5
474,2018-01-19,중랑구,0.0,0,1,0,2,3
475,2018-01-20,강남구,0.0,0,14,0,2,16
476,2018-01-20,강동구,0.0,0,0,1,1,2
477,2018-01-20,강북구,0.0,0,1,0,1,2
478,2018-01-20,강서구,0.0,0,2,0,1,3
479,2018-01-20,관악구,0.0,1,1,1,2,5
480,2018-01-20,광진구,0.0,0,3,0,2,5
481,2018-01-20,구로구,0.0,0,1,0,1,2
482,2018-01-20,금천구,0.0,0,4,0,0,4
483,2018-01-20,노원구,0.0,0,4,0,0,4
484,2018-01-20,도봉구,0.0,0,1,0,0,1
485,2018-01-20,동대문구,0.0,0,4,0,3,7
486,2018-01-20,동작구,0.0,0,5,0,2,7
487,2018-01-20,마포구,0.0,0,9,0,1,10
488,2018-01-20,서대문구,0.0,0,1,0,1,2
489,2018-01-20,서초구,0.0,0,6,1,2,9
490,2018-01-20,성동구,0.0,0,3,1,2,6
491,2018-01-20,성북구,0.0,0,7,0,3,10
492,2018-01-20,송파구,0.0,0,10,1,2,13
493,2018-01-20,양천구,0.0,0,2,0,1,3
494,2018-01-20,영등포구,0.0,0,14,3,5,22
495,2018-01-20,용산구,0.0,0,4,0,3,7
496,2018-01-20,은평구,0.0,0,5,0,0,5
497,2018-01-20,종로구,0.0,0,1,0,1,2
498,2018-01-20,중구,0.0,0,8,0,1,9
499,2018-01-20,중랑구,0.0,0,2,0,1,3
500,2018-01-21,강남구,0.0,0,8,0,1,9
501,2018-01-21,강동구,0.0,0,0,0,2,2
502,2018-01-21,강북구,0.0,0,1,0,1,2
503,2018-01-21,강서구,0.0,0,3,0,0,3
504,2018-01-21,관악구,0.0,0,3,2,1,6
505,2018-01-21,광진구,0.0,0,0,0,0,0
506,2018-01-21,구로구,0.0,0,3,0,1,4
507,2018-01-21,금천구,0.0,0,4,0,1,5
508,2018-01-21,노원구,0.0,0,10,0,0,10
509,2018-01-21,도봉구,0.0,0,0,0,0,0
510,2018-01-21,동대문구,0.0,0,5,0,1,6
511,2018-01-21,동작구,0.0,0,1,0,2,3
512,2018-01-21,마포구,0.0,0,6,2,0,8
513,2018-01-21,서대문구,0.0,0,0,0,1,1
514,2018-01-21,서초구,0.0,0,7,0,2,9
515,2018-01-21,성동구,0.0,0,1,0,0,1
516,2018-01-21,성북구,0.0,0,0,1,1,2
517,2018-01-21,송파구,0.0,0,3,1,1,5
518,2018-01-21,양천구,0.0,0,3,2,1,6
519,2018-01-21,영등포구,0.0,0,6,1,2,9
520,2018-01-21,용산구,0.0,0,7,0,1,8
521,2018-01-21,은평구,0.0,0,0,0,0,0
522,2018-01-21,종로구,0.0,0,3,0,1,4
523,2018-01-21,중구,0.0,0,3,2,0,5
524,2018-01-21,중랑구,0.0,0,5,1,1,7
525,2018-01-22,강남구,4.5,0,4,3,0,7
526,2018-01-22,강동구,4.0,1,2,0,2,5
527,2018-01-22,강북구,3.5,0,6,1,1,8
528,2018-01-22,강서구,3.0,0,3,2,2,7
529,2018-01-22,관악구,3.75,0,2,0,1,3
530,2018-01-22,광진구,4.5,0,1,0,1,2
531,2018-01-22,구로구,2.5,0,6,0,0,6
532,2018-01-22,금천구,3.0,0,0,1,0,1
533,2018-01-22,노원구,4.0,1,1,0,1,3
534,2018-01-22,도봉구,1.0,0,3,0,2,5
535,2018-01-22,동대문구,3.5,0,2,0,0,2
536,2018-01-22,동작구,3.5,0,1,0,1,2
537,2018-01-22,마포구,3.5,0,7,0,0,7
538,2018-01-22,서대문구,3.5,0,1,1,0,2
539,2018-01-22,서초구,4.0,0,13,2,4,19
540,2018-01-22,성동구,4.0,0,3,0,0,3
541,2018-01-22,성북구,3.5,0,2,0,1,3
542,2018-01-22,송파구,3.0,1,6,0,5,12
543,2018-01-22,양천구,3.5,0,1,0,0,1
544,2018-01-22,영등포구,3.75,0,4,0,1,5
545,2018-01-22,용산구,3.0,0,3,0,0,3
546,2018-01-22,은평구,2.5,0,8,1,0,9
547,2018-01-22,종로구,3.3,0,1,1,0,2
548,2018-01-22,중구,3.5,0,3,0,3,6
549,2018-01-22,중랑구,4.5,0,1,0,0,1
550,2018-01-23,강남구,0.0,0,8,0,4,12
551,2018-01-23,강동구,0.0,0,6,0,0,6
552,2018-01-23,강북구,0.0,0,1,0,0,1
553,2018-01-23,강서구,0.0,0,1,0,1,2
554,2018-01-23,관악구,0.0,0,1,0,1,2
555,2018-01-23,광진구,0.0,0,3,0,0,3
556,2018-01-23,구로구,0.0,0,2,0,1,3
557,2018-01-23,금천구,0.0,0,1,2,1,4
558,2018-01-23,노원구,0.0,0,2,0,0,2
559,2018-01-23,도봉구,0.0,0,1,0,1,2
560,2018-01-23,동대문구,0.0,0,9,0,4,13
561,2018-01-23,동작구,0.0,0,2,0,2,4
562,2018-01-23,마포구,0.0,0,5,0,0,5
563,2018-01-23,서대문구,0.0,0,0,0,1,1
564,2018-01-23,서초구,0.0,0,12,1,4,17
565,2018-01-23,성동구,0.0,0,4,1,0,5
566,2018-01-23,성북구,0.0,0,5,0,0,5
567,2018-01-23,송파구,0.0,0,18,3,3,24
568,2018-01-23,양천구,0.0,0,2,1,0,3
569,2018-01-23,영등포구,0.0,0,4,2,3,9
570,2018-01-23,용산구,0.0,0,3,0,1,4
571,2018-01-23,은평구,0.0,0,1,1,1,3
572,2018-01-23,종로구,0.0,0,4,0,1,5
573,2018-01-23,중구,0.0,0,1,1,0,2
574,2018-01-23,중랑구,0.0,0,4,1,2,7
575,2018-01-24,강남구,0.0,0,7,0,1,8
576,2018-01-24,강동구,0.0,0,0,0,1,1
577,2018-01-24,강북구,0.0,0,7,0,3,10
578,2018-01-24,강서구,0.0,0,4,1,2,7
579,2018-01-24,관악구,0.0,0,6,1,5,12
580,2018-01-24,광진구,0.0,0,2,0,0,2
581,2018-01-24,구로구,0.0,0,3,0,0,3
582,2018-01-24,금천구,0.0,0,2,0,1,3
583,2018-01-24,노원구,0.0,0,1,0,0,1
584,2018-01-24,도봉구,0.0,0,1,0,3,4
585,2018-01-24,동대문구,0.0,0,2,0,1,3
586,2018-01-24,동작구,0.0,0,3,0,1,4
587,2018-01-24,마포구,0.0,0,7,0,3,10
588,2018-01-24,서대문구,0.0,0,10,2,2,14
589,2018-01-24,서초구,0.0,0,13,2,7,22
590,2018-01-24,성동구,0.0,0,1,0,0,1
591,2018-01-24,성북구,0.0,0,6,0,1,7
592,2018-01-24,송파구,0.0,0,4,0,2,6
593,2018-01-24,양천구,0.0,0,6,1,2,9
594,2018-01-24,영등포구,0.0,0,5,1,4,10
595,2018-01-24,용산구,0.0,0,0,1,1,2
596,2018-01-24,은평구,0.0,0,1,0,0,1
597,2018-01-24,종로구,0.0,0,1,0,0,1
598,2018-01-24,중구,0.0,0,1,1,1,3
599,2018-01-24,중랑구,0.0,0,3,0,1,4
600,2018-01-25,강남구,0.0,0,10,0,3,13
601,2018-01-25,강동구,0.0,0,2,0,1,3
602,2018-01-25,강북구,0.0,0,32,0,7,39
603,2018-01-25,강서구,0.0,0,5,1,2,8
604,2018-01-25,관악구,0.0,0,3,1,1,5
605,2018-01-25,광진구,0.0,0,0,0,3,3
606,2018-01-25,구로구,0.0,0,1,0,0,1
607,2018-01-25,금천구,0.0,0,0,0,1,1
608,2018-01-25,노원구,0.0,0,2,0,0,2
609,2018-01-25,도봉구,0.0,0,2,1,0,3
610,2018-01-25,동대문구,0.0,0,3,0,0,3
611,2018-01-25,동작구,0.0,0,1,0,2,3
612,2018-01-25,마포구,0.0,0,1,0,2,3
613,2018-01-25,서대문구,0.0,0,1,0,0,1
614,2018-01-25,서초구,0.0,0,13,0,1,14
615,2018-01-25,성동구,0.0,0,1,0,0,1
616,2018-01-25,성북구,0.0,0,5,0,2,7
617,2018-01-25,송파구,0.0,0,5,0,2,7
618,2018-01-25,양천구,0.0,0,7,2,1,10
619,2018-01-25,영등포구,0.0,0,4,1,1,6
620,2018-01-25,용산구,0.0,0,0,0,0,0
621,2018-01-25,은평구,0.0,0,2,0,1,3
622,2018-01-25,종로구,0.0,0,0,0,1,1
623,2018-01-25,중구,0.0,0,4,0,2,6
624,2018-01-25,중랑구,0.0,0,5,0,0,5
625,2018-01-26,강남구,0.0,0,6,1,4,11
626,2018-01-26,강동구,0.0,0,5,0,3,8
627,2018-01-26,강북구,0.0,0,1,0,1,2
628,2018-01-26,강서구,0.0,0,3,0,2,5
629,2018-01-26,관악구,0.0,0,2,0,0,2
630,2018-01-26,광진구,0.0,0,6,0,0,6
631,2018-01-26,구로구,0.0,2,4,2,1,9
632,2018-01-26,금천구,0.0,0,1,0,0,1
633,2018-01-26,노원구,0.0,1,1,0,3,5
634,2018-01-26,도봉구,0.0,0,4,1,0,5
635,2018-01-26,동대문구,0.0,0,4,0,0,4
636,2018-01-26,동작구,0.0,0,5,0,0,5
637,2018-01-26,마포구,0.0,0,14,0,3,17
638,2018-01-26,서대문구,0.0,0,4,0,1,5
639,2018-01-26,서초구,0.0,0,16,1,3,20
640,2018-01-26,성동구,0.0,0,1,0,1,2
641,2018-01-26,성북구,0.0,0,3,0,1,4
642,2018-01-26,송파구,0.0,0,6,0,2,8
643,2018-01-26,양천구,0.0,0,0,0,2,2
644,2018-01-26,영등포구,0.0,0,12,1,4,17
645,2018-01-26,용산구,0.0,0,2,0,1,3
646,2018-01-26,은평구,0.0,0,2,2,1,5
647,2018-01-26,종로구,0.0,0,2,2,0,4
648,2018-01-26,중구,0.0,0,1,0,2,3
649,2018-01-26,중랑구,0.0,0,2,2,1,5
650,2018-01-27,강남구,0.0,0,9,0,2,11
651,2018-01-27,강동구,0.0,0,1,0,0,1
652,2018-01-27,강북구,0.0,0,3,0,0,3
653,2018-01-27,강서구,0.0,0,3,0,0,3
654,2018-01-27,관악구,0.0,0,2,0,1,3
655,2018-01-27,광진구,0.0,0,2,0,2,4
656,2018-01-27,구로구,0.0,0,14,0,1,15
657,2018-01-27,금천구,0.0,0,0,0,0,0
658,2018-01-27,노원구,0.0,0,1,1,2,4
659,2018-01-27,도봉구,0.0,0,2,0,0,2
660,2018-01-27,동대문구,0.0,0,10,0,1,11
661,2018-01-27,동작구,0.0,0,1,1,1,3
662,2018-01-27,마포구,0.0,0,3,0,5,8
663,2018-01-27,서대문구,0.0,0,0,0,0,0
664,2018-01-27,서초구,0.0,0,3,2,0,5
665,2018-01-27,성동구,0.0,0,4,0,0,4
666,2018-01-27,성북구,0.0,0,5,1,2,8
667,2018-01-27,송파구,0.0,1,12,0,3,16
668,2018-01-27,양천구,0.0,0,3,0,0,3
669,2018-01-27,영등포구,0.0,0,8,2,1,11
670,2018-01-27,용산구,0.0,0,0,0,0,0
671,2018-01-27,은평구,0.0,0,0,0,1,1
672,2018-01-27,종로구,0.0,0,1,0,0,1
673,2018-01-27,중구,0.0,0,0,0,1,1
674,2018-01-27,중랑구,0.0,0,3,0,2,5
675,2018-01-28,강남구,0.0,0,6,0,1,7
676,2018-01-28,강동구,0.0,0,2,1,1,4
677,2018-01-28,강북구,0.0,0,0,0,1,1
678,2018-01-28,강서구,0.0,0,1,1,2,4
679,2018-01-28,관악구,0.0,0,6,1,1,8
680,2018-01-28,광진구,0.0,0,0,0,0,0
681,2018-01-28,구로구,0.0,0,7,1,0,8
682,2018-01-28,금천구,0.0,0,3,0,0,3
683,2018-01-28,노원구,0.0,0,7,2,4,13
684,2018-01-28,도봉구,0.0,0,0,0,0,0
685,2018-01-28,동대문구,0.0,0,1,1,0,2
686,2018-01-28,동작구,0.0,0,3,1,0,4
687,2018-01-28,마포구,0.0,0,9,0,0,9
688,2018-01-28,서대문구,0.0,0,1,0,1,2
689,2018-01-28,서초구,0.0,0,4,0,2,6
690,2018-01-28,성동구,0.0,0,1,0,1,2
691,2018-01-28,성북구,0.0,0,4,0,1,5
692,2018-01-28,송파구,0.0,0,4,0,3,7
693,2018-01-28,양천구,0.0,0,1,0,0,1
694,2018-01-28,영등포구,0.0,0,12,0,0,12
695,2018-01-28,용산구,0.0,0,3,0,0,3
696,2018-01-28,은평구,0.0,0,0,0,1,1
697,2018-01-28,종로구,0.0,0,2,0,0,2
698,2018-01-28,중구,0.0,0,2,0,1,3
699,2018-01-28,중랑구,0.0,0,4,0,0,4
700,2018-01-29,강남구,0.0,0,19,1,1,21
701,2018-01-29,강동구,0.0,0,5,0,0,5
702,2018-01-29,강북구,0.0,0,0,1,1,2
703,2018-01-29,강서구,0.0,0,6,2,0,8
704,2018-01-29,관악구,0.0,0,1,0,1,2
705,2018-01-29,광진구,0.0,1,3,0,0,4
706,2018-01-29,구로구,0.0,0,2,0,2,4
707,2018-01-29,금천구,0.0,0,2,0,1,3
708,2018-01-29,노원구,0.0,0,2,1,1,4
709,2018-01-29,도봉구,0.0,0,1,0,1,2
710,2018-01-29,동대문구,0.0,0,6,0,1,7
711,2018-01-29,동작구,0.0,0,4,1,0,5
712,2018-01-29,마포구,0.0,0,3,0,1,4
713,2018-01-29,서대문구,0.0,0,1,1,1,3
714,2018-01-29,서초구,0.0,0,10,0,0,10
715,2018-01-29,성동구,0.0,0,5,0,1,6
716,2018-01-29,성북구,0.0,0,1,0,2,3
717,2018-01-29,송파구,0.0,0,14,0,0,14
718,2018-01-29,양천구,0.0,0,1,0,1,2
719,2018-01-29,영등포구,0.0,0,8,1,5,14
720,2018-01-29,용산구,0.0,0,3,1,2,6
721,2018-01-29,은평구,0.0,0,2,0,2,4
722,2018-01-29,종로구,0.0,0,3,0,0,3
723,2018-01-29,중구,0.0,0,0,1,1,2
724,2018-01-29,중랑구,0.0,0,3,0,1,4
725,2018-01-30,강남구,0.0,0,14,0,3,17
726,2018-01-30,강동구,0.5,0,4,0,1,5
727,2018-01-30,강북구,0.5,0,4,0,0,4
728,2018-01-30,강서구,1.0,0,24,0,3,27
729,2018-01-30,관악구,0.0,0,3,1,2,6
730,2018-01-30,광진구,0.0,0,5,0,1,6
731,2018-01-30,구로구,0.0,0,1,0,1,2
732,2018-01-30,금천구,0.0,0,0,1,0,1
733,2018-01-30,노원구,1.0,0,8,0,1,9
734,2018-01-30,도봉구,0.0,0,0,0,0,0
735,2018-01-30,동대문구,0.0,0,3,0,0,3
736,2018-01-30,동작구,0.0,0,7,0,0,7
737,2018-01-30,마포구,0.5,0,8,0,2,10
738,2018-01-30,서대문구,1.0,0,1,1,1,3
739,2018-01-30,서초구,0.0,0,5,1,2,8
740,2018-01-30,성동구,1.0,0,3,0,1,4
741,2018-01-30,성북구,1.0,0,7,2,1,10
742,2018-01-30,송파구,0.0,0,4,1,4,9
743,2018-01-30,양천구,0.0,0,27,6,5,38
744,2018-01-30,영등포구,0.25,0,5,0,5,10
745,2018-01-30,용산구,0.0,0,0,0,2,2
746,2018-01-30,은평구,0.0,0,3,1,1,5
747,2018-01-30,종로구,2.9,0,1,1,0,2
748,2018-01-30,중구,1.0,0,7,2,0,9
749,2018-01-30,중랑구,1.0,0,14,0,2,16
750,2018-01-31,강남구,0.0,0,7,1,1,9
751,2018-01-31,강동구,0.0,0,1,0,0,1
752,2018-01-31,강북구,0.0,0,6,0,5,11
753,2018-01-31,강서구,0.0,0,2,0,2,4
754,2018-01-31,관악구,0.0,0,3,0,1,4
755,2018-01-31,광진구,0.0,0,13,0,2,15
756,2018-01-31,구로구,0.0,0,5,0,0,5
757,2018-01-31,금천구,0.0,0,2,1,1,4
758,2018-01-31,노원구,0.0,0,1,1,1,3
759,2018-01-31,도봉구,0.0,0,3,0,1,4
760,2018-01-31,동대문구,0.0,0,8,1,3,12
761,2018-01-31,동작구,0.0,0,0,0,2,2
762,2018-01-31,마포구,0.0,0,4,0,1,5
763,2018-01-31,서대문구,0.0,0,3,0,0,3
764,2018-01-31,서초구,0.0,0,12,0,1,13
765,2018-01-31,성동구,0.0,0,11,1,1,13
766,2018-01-31,성북구,0.0,0,5,0,3,8
767,2018-01-31,송파구,0.0,0,8,2,1,11
768,2018-01-31,양천구,0.0,0,4,0,1,5
769,2018-01-31,영등포구,0.0,0,6,1,3,10
770,2018-01-31,용산구,0.0,0,1,0,0,1
771,2018-01-31,은평구,0.0,0,1,0,1,2
772,2018-01-31,종로구,0.0,0,9,2,1,12
773,2018-01-31,중구,0.0,0,4,0,0,4
774,2018-01-31,중랑구,0.0,0,7,0,0,7
775,2018-02-01,강남구,0.0,0,16,1,3,20
776,2018-02-01,강동구,0.0,0,4,2,2,8
777,2018-02-01,강북구,0.0,0,5,0,4,9
778,2018-02-01,강서구,0.0,0,9,0,1,10
779,2018-02-01,관악구,0.0,0,2,0,2,4
780,2018-02-01,광진구,0.0,0,1,0,0,1
781,2018-02-01,구로구,0.0,0,13,2,1,16
782,2018-02-01,금천구,0.0,0,2,0,0,2
783,2018-02-01,노원구,0.0,0,5,2,3,10
784,2018-02-01,도봉구,0.0,0,4,0,0,4
785,2018-02-01,동대문구,0.0,0,4,1,5,10
786,2018-02-01,동작구,0.0,0,2,0,3,5
787,2018-02-01,마포구,0.0,0,4,0,4,8
788,2018-02-01,서대문구,0.0,0,0,0,1,1
789,2018-02-01,서초구,0.0,0,11,1,5,17
790,2018-02-01,성동구,0.0,0,0,1,2,3
791,2018-02-01,성북구,0.0,0,9,0,5,14
792,2018-02-01,송파구,0.0,0,3,0,5,8
793,2018-02-01,양천구,0.0,0,2,0,2,4
794,2018-02-01,영등포구,0.0,0,10,0,2,12
795,2018-02-01,용산구,0.0,0,5,1,1,7
796,2018-02-01,은평구,0.0,0,4,1,2,7
797,2018-02-01,종로구,0.0,0,1,1,1,3
798,2018-02-01,중구,0.0,0,2,1,1,4
799,2018-02-01,중랑구,0.0,0,1,0,0,1
800,2018-02-02,강남구,0.0,0,14,2,3,19
801,2018-02-02,강동구,0.0,0,3,0,1,4
802,2018-02-02,강북구,0.0,0,6,1,0,7
803,2018-02-02,강서구,0.0,0,3,0,2,5
804,2018-02-02,관악구,0.0,0,2,0,0,2
805,2018-02-02,광진구,0.0,0,1,0,0,1
806,2018-02-02,구로구,0.0,0,2,1,1,4
807,2018-02-02,금천구,0.0,0,2,0,0,2
808,2018-02-02,노원구,0.0,0,8,2,2,12
809,2018-02-02,도봉구,0.0,0,10,1,3,14
810,2018-02-02,동대문구,0.0,0,8,1,2,11
811,2018-02-02,동작구,0.0,0,3,0,0,3
812,2018-02-02,마포구,0.0,0,3,0,2,5
813,2018-02-02,서대문구,0.0,0,1,2,1,4
814,2018-02-02,서초구,0.0,0,7,3,2,12
815,2018-02-02,성동구,0.0,0,5,0,2,7
816,2018-02-02,성북구,0.0,0,7,7,4,18
817,2018-02-02,송파구,0.0,0,8,3,2,13
818,2018-02-02,양천구,0.0,0,13,1,4,18
819,2018-02-02,영등포구,0.0,0,4,0,0,4
820,2018-02-02,용산구,0.0,0,4,0,2,6
821,2018-02-02,은평구,0.0,0,2,0,0,2
822,2018-02-02,종로구,0.0,0,5,1,0,6
823,2018-02-02,중구,0.0,0,4,0,1,5
824,2018-02-02,중랑구,0.0,0,5,0,2,7
825,2018-02-03,강남구,0.0,0,22,1,4,27
826,2018-02-03,강동구,0.0,0,6,0,4,10
827,2018-02-03,강북구,0.0,0,5,0,0,5
828,2018-02-03,강서구,0.0,0,8,2,3,13
829,2018-02-03,관악구,0.0,0,2,1,2,5
830,2018-02-03,광진구,0.0,0,4,1,0,5
831,2018-02-03,구로구,0.0,0,13,0,4,17
832,2018-02-03,금천구,0.0,0,0,0,0,0
833,2018-02-03,노원구,0.0,0,5,3,1,9
834,2018-02-03,도봉구,0.0,0,2,0,0,2
835,2018-02-03,동대문구,0.0,0,2,0,2,4
836,2018-02-03,동작구,0.0,0,10,6,5,21
837,2018-02-03,마포구,0.0,0,6,1,0,7
838,2018-02-03,서대문구,0.0,0,6,2,0,8
839,2018-02-03,서초구,0.0,0,10,3,3,16
840,2018-02-03,성동구,0.0,0,8,0,1,9
841,2018-02-03,성북구,0.0,0,9,1,4,14
842,2018-02-03,송파구,0.0,0,4,2,5,11
843,2018-02-03,양천구,0.0,0,2,0,0,2
844,2018-02-03,영등포구,0.0,0,7,1,6,14
845,2018-02-03,용산구,0.0,0,7,6,1,14
846,2018-02-03,은평구,0.0,0,5,2,1,8
847,2018-02-03,종로구,0.5,0,15,1,0,16
848,2018-02-03,중구,0.0,0,3,0,2,5
849,2018-02-03,중랑구,0.0,0,3,1,1,5
850,2018-02-04,강남구,0.0,0,12,4,2,18
851,2018-02-04,강동구,0.0,0,2,1,0,3
852,2018-02-04,강북구,0.0,0,3,0,2,5
853,2018-02-04,강서구,0.0,0,7,2,2,11
854,2018-02-04,관악구,0.0,0,5,3,2,10
855,2018-02-04,광진구,0.0,0,0,0,1,1
856,2018-02-04,구로구,0.0,0,5,0,2,7
857,2018-02-04,금천구,0.0,0,2,0,1,3
858,2018-02-04,노원구,0.0,0,2,2,0,4
859,2018-02-04,도봉구,0.0,0,4,1,0,5
860,2018-02-04,동대문구,0.0,0,1,0,2,3
861,2018-02-04,동작구,0.0,0,3,0,3,6
862,2018-02-04,마포구,0.0,1,8,1,0,10
863,2018-02-04,서대문구,0.0,0,8,1,0,9
864,2018-02-04,서초구,0.0,0,9,0,3,12
865,2018-02-04,성동구,0.0,0,4,1,1,6
866,2018-02-04,성북구,0.0,1,5,0,1,7
867,2018-02-04,송파구,0.0,0,8,1,2,11
868,2018-02-04,양천구,0.0,0,4,0,0,4
869,2018-02-04,영등포구,0.0,2,12,1,2,17
870,2018-02-04,용산구,0.0,0,7,0,3,10
871,2018-02-04,은평구,0.0,0,1,0,0,1
872,2018-02-04,종로구,0.0,0,1,0,3,4
873,2018-02-04,중구,0.0,1,6,1,0,8
874,2018-02-04,중랑구,0.0,0,11,0,1,12
875,2018-02-05,강남구,0.0,0,5,0,0,5
876,2018-02-05,강동구,0.0,0,1,0,1,2
877,2018-02-05,강북구,0.0,0,6,0,3,9
878,2018-02-05,강서구,0.0,0,4,0,1,5
879,2018-02-05,관악구,0.0,0,7,1,0,8
880,2018-02-05,광진구,0.0,0,9,0,1,10
881,2018-02-05,구로구,0.0,0,4,1,1,6
882,2018-02-05,금천구,0.0,0,3,0,0,3
883,2018-02-05,노원구,0.0,0,2,0,1,3
884,2018-02-05,도봉구,0.0,0,3,0,0,3
885,2018-02-05,동대문구,0.0,0,1,0,1,2
886,2018-02-05,동작구,0.0,0,6,1,5,12
887,2018-02-05,마포구,0.0,0,1,0,3,4
888,2018-02-05,서대문구,0.0,0,1,2,3,6
889,2018-02-05,서초구,0.0,0,14,0,4,18
890,2018-02-05,성동구,0.0,0,4,0,1,5
891,2018-02-05,성북구,0.0,0,3,0,0,3
892,2018-02-05,송파구,0.0,0,10,2,3,15
893,2018-02-05,양천구,0.0,0,1,0,1,2
894,2018-02-05,영등포구,0.0,0,5,0,3,8
895,2018-02-05,용산구,0.0,0,3,0,1,4
896,2018-02-05,은평구,0.0,0,3,1,1,5
897,2018-02-05,종로구,0.0,0,3,0,2,5
898,2018-02-05,중구,0.0,0,4,0,2,6
899,2018-02-05,중랑구,0.0,0,5,0,1,6
900,2018-02-06,강남구,0.0,0,11,0,4,15
901,2018-02-06,강동구,0.0,0,1,0,1,2
902,2018-02-06,강북구,0.0,0,3,0,1,4
903,2018-02-06,강서구,0.0,0,2,0,4,6
904,2018-02-06,관악구,0.0,0,4,1,1,6
905,2018-02-06,광진구,0.0,0,3,0,0,3
906,2018-02-06,구로구,0.0,0,5,0,1,6
907,2018-02-06,금천구,0.0,0,2,0,1,3
908,2018-02-06,노원구,0.0,0,1,0,0,1
909,2018-02-06,도봉구,0.0,0,3,0,0,3
910,2018-02-06,동대문구,0.0,0,2,0,1,3
911,2018-02-06,동작구,0.0,1,3,1,1,6
912,2018-02-06,마포구,0.0,0,20,2,8,30
913,2018-02-06,서대문구,0.0,0,2,0,0,2
914,2018-02-06,서초구,0.0,0,6,0,3,9
915,2018-02-06,성동구,0.0,0,3,2,0,5
916,2018-02-06,성북구,0.0,0,9,0,5,14
917,2018-02-06,송파구,0.0,0,0,0,2,2
918,2018-02-06,양천구,0.0,0,8,0,1,9
919,2018-02-06,영등포구,0.0,0,12,2,2,16
920,2018-02-06,용산구,0.0,0,7,0,0,7
921,2018-02-06,은평구,0.0,1,3,0,1,5
922,2018-02-06,종로구,0.0,0,6,0,3,9
923,2018-02-06,중구,0.0,0,0,0,1,1
924,2018-02-06,중랑구,0.0,0,12,0,5,17
925,2018-02-07,강남구,0.0,0,12,2,2,16
926,2018-02-07,강동구,0.0,1,4,2,0,7
927,2018-02-07,강북구,0.0,0,3,0,2,5
928,2018-02-07,강서구,0.0,0,11,1,0,12
929,2018-02-07,관악구,0.0,0,3,0,1,4
930,2018-02-07,광진구,0.0,0,0,0,1,1
931,2018-02-07,구로구,0.0,0,6,0,1,7
932,2018-02-07,금천구,0.0,0,4,0,0,4
933,2018-02-07,노원구,0.0,0,3,1,1,5
934,2018-02-07,도봉구,0.0,1,0,0,1,2
935,2018-02-07,동대문구,0.0,0,13,2,1,16
936,2018-02-07,동작구,0.0,0,4,1,3,8
937,2018-02-07,마포구,0.0,0,4,0,2,6
938,2018-02-07,서대문구,0.0,0,5,0,0,5
939,2018-02-07,서초구,0.0,0,17,1,1,19
940,2018-02-07,성동구,0.0,0,5,1,1,7
941,2018-02-07,성북구,0.0,0,8,0,3,11
942,2018-02-07,송파구,0.0,0,8,0,2,10
943,2018-02-07,양천구,0.0,0,8,0,2,10
944,2018-02-07,영등포구,0.0,0,8,1,1,10
945,2018-02-07,용산구,0.0,0,2,0,0,2
946,2018-02-07,은평구,0.0,0,2,0,0,2
947,2018-02-07,종로구,0.0,1,7,2,0,10
948,2018-02-07,중구,0.0,0,4,0,2,6
949,2018-02-07,중랑구,0.0,0,5,1,2,8
950,2018-02-08,강남구,0.0,0,4,2,3,9
951,2018-02-08,강동구,0.0,0,9,0,1,10
952,2018-02-08,강북구,0.0,0,3,0,2,5
953,2018-02-08,강서구,0.0,0,3,0,3,6
954,2018-02-08,관악구,0.0,0,1,1,2,4
955,2018-02-08,광진구,0.0,0,9,0,5,14
956,2018-02-08,구로구,0.0,0,2,0,2,4
957,2018-02-08,금천구,0.0,0,4,0,1,5
958,2018-02-08,노원구,0.0,0,15,0,4,19
959,2018-02-08,도봉구,0.0,0,4,0,5,9
960,2018-02-08,동대문구,0.0,0,7,0,3,10
961,2018-02-08,동작구,0.0,0,3,3,1,7
962,2018-02-08,마포구,0.0,0,11,1,1,13
963,2018-02-08,서대문구,0.0,0,1,0,1,2
964,2018-02-08,서초구,0.0,0,5,2,2,9
965,2018-02-08,성동구,0.0,0,10,1,0,11
966,2018-02-08,성북구,0.0,0,4,0,0,4
967,2018-02-08,송파구,0.0,0,9,1,5,15
968,2018-02-08,양천구,0.0,0,6,0,5,11
969,2018-02-08,영등포구,0.0,0,8,1,5,14
970,2018-02-08,용산구,0.0,0,1,0,2,3
971,2018-02-08,은평구,0.0,0,7,0,1,8
972,2018-02-08,종로구,0.0,0,2,3,1,6
973,2018-02-08,중구,0.0,0,3,1,1,5
974,2018-02-08,중랑구,0.0,0,5,0,1,6
975,2018-02-09,강남구,0.0,0,19,2,1,22
976,2018-02-09,강동구,0.0,0,2,0,6,8
977,2018-02-09,강북구,0.0,0,3,1,0,4
978,2018-02-09,강서구,0.0,0,4,0,2,6
979,2018-02-09,관악구,0.0,0,7,0,2,9
980,2018-02-09,광진구,0.0,0,6,0,2,8
981,2018-02-09,구로구,0.0,0,6,1,4,11
982,2018-02-09,금천구,0.0,0,5,0,2,7
983,2018-02-09,노원구,0.0,0,1,1,1,3
984,2018-02-09,도봉구,0.0,0,2,0,2,4
985,2018-02-09,동대문구,0.0,0,2,0,2,4
986,2018-02-09,동작구,0.0,0,4,0,2,6
987,2018-02-09,마포구,0.0,0,9,1,3,13
988,2018-02-09,서대문구,0.0,0,5,0,3,8
989,2018-02-09,서초구,0.0,0,9,2,2,13
990,2018-02-09,성동구,0.0,0,3,0,3,6
991,2018-02-09,성북구,0.0,0,8,0,0,8
992,2018-02-09,송파구,0.0,0,9,4,3,16
993,2018-02-09,양천구,0.0,0,4,0,3,7
994,2018-02-09,영등포구,0.0,0,3,1,4,8
995,2018-02-09,용산구,0.0,1,2,0,3,6
996,2018-02-09,은평구,0.0,0,2,0,1,3
997,2018-02-09,종로구,0.0,0,2,1,0,3
998,2018-02-09,중구,0.0,0,2,0,1,3
999,2018-02-09,중랑구,0.0,0,13,0,0,13
1000,2018-02-10,강남구,0.0,0,9,1,7,17
1001,2018-02-10,강동구,0.0,0,6,0,2,8
1002,2018-02-10,강북구,0.0,0,1,0,3,4
1003,2018-02-10,강서구,0.0,0,1,0,3,4
1004,2018-02-10,관악구,0.0,0,3,1,0,4
1005,2018-02-10,광진구,0.0,0,7,1,0,8
1006,2018-02-10,구로구,0.0,0,3,0,0,3
1007,2018-02-10,금천구,0.0,0,3,1,1,5
1008,2018-02-10,노원구,0.0,0,1,1,0,2
1009,2018-02-10,도봉구,0.0,0,0,1,0,1
1010,2018-02-10,동대문구,0.0,0,5,0,0,5
1011,2018-02-10,동작구,0.0,0,7,0,2,9
1012,2018-02-10,마포구,0.0,0,2,0,0,2
1013,2018-02-10,서대문구,0.0,0,1,0,1,2
1014,2018-02-10,서초구,0.0,0,6,2,0,8
1015,2018-02-10,성동구,0.0,0,1,0,0,1
1016,2018-02-10,성북구,0.0,0,2,0,0,2
1017,2018-02-10,송파구,0.0,0,8,1,1,10
1018,2018-02-10,양천구,0.0,0,5,0,1,6
1019,2018-02-10,영등포구,0.0,0,3,2,1,6
1020,2018-02-10,용산구,0.0,0,4,0,1,5
1021,2018-02-10,은평구,0.0,0,10,0,1,11
1022,2018-02-10,종로구,0.0,0,4,0,0,4
1023,2018-02-10,중구,0.0,0,0,1,0,1
1024,2018-02-10,중랑구,0.0,0,3,0,1,4
1025,2018-02-11,강남구,0.0,0,2,0,1,3
1026,2018-02-11,강동구,0.0,0,1,0,1,2
1027,2018-02-11,강북구,0.0,0,2,1,0,3
1028,2018-02-11,강서구,0.0,0,4,1,2,7
1029,2018-02-11,관악구,0.0,0,4,0,0,4
1030,2018-02-11,광진구,0.0,0,4,0,2,6
1031,2018-02-11,구로구,0.0,0,3,0,1,4
1032,2018-02-11,금천구,0.0,0,1,0,1,2
1033,2018-02-11,노원구,0.0,0,5,0,1,6
1034,2018-02-11,도봉구,0.0,0,0,2,0,2
1035,2018-02-11,동대문구,0.0,0,1,0,2,3
1036,2018-02-11,동작구,0.0,0,1,0,1,2
1037,2018-02-11,마포구,0.0,0,1,0,1,2
1038,2018-02-11,서대문구,0.0,0,1,0,0,1
1039,2018-02-11,서초구,0.0,0,8,9,1,18
1040,2018-02-11,성동구,0.0,0,8,0,3,11
1041,2018-02-11,성북구,0.0,0,1,1,0,2
1042,2018-02-11,송파구,0.0,0,2,0,1,3
1043,2018-02-11,양천구,0.0,0,1,0,2,3
1044,2018-02-11,영등포구,0.0,0,3,0,1,4
1045,2018-02-11,용산구,0.0,0,5,0,0,5
1046,2018-02-11,은평구,0.0,0,11,0,1,12
1047,2018-02-11,종로구,0.0,0,1,0,0,1
1048,2018-02-11,중구,0.0,0,3,0,0,3
1049,2018-02-11,중랑구,0.0,0,5,0,1,6
1050,2018-02-12,강남구,0.0,0,24,0,5,29
1051,2018-02-12,강동구,0.0,0,4,0,1,5
1052,2018-02-12,강북구,0.0,0,1,0,0,1
1053,2018-02-12,강서구,0.0,0,4,0,4,8
1054,2018-02-12,관악구,0.0,0,4,0,3,7
1055,2018-02-12,광진구,0.0,0,2,0,1,3
1056,2018-02-12,구로구,0.0,0,10,0,1,11
1057,2018-02-12,금천구,0.0,0,3,0,1,4
1058,2018-02-12,노원구,0.0,0,6,0,2,8
1059,2018-02-12,도봉구,0.0,0,0,0,0,0
1060,2018-02-12,동대문구,0.0,0,6,0,2,8
1061,2018-02-12,동작구,0.0,0,4,0,0,4
1062,2018-02-12,마포구,0.0,0,6,0,3,9
1063,2018-02-12,서대문구,0.0,0,0,0,0,0
1064,2018-02-12,서초구,0.0,1,10,5,3,19
1065,2018-02-12,성동구,0.0,0,5,0,3,8
1066,2018-02-12,성북구,0.0,0,6,0,2,8
1067,2018-02-12,송파구,0.0,0,1,3,3,7
1068,2018-02-12,양천구,0.0,0,7,0,1,8
1069,2018-02-12,영등포구,0.0,0,8,3,0,11
1070,2018-02-12,용산구,0.0,0,2,0,0,2
1071,2018-02-12,은평구,0.0,0,1,1,0,2
1072,2018-02-12,종로구,0.0,0,3,1,0,4
1073,2018-02-12,중구,0.0,0,2,1,1,4
1074,2018-02-12,중랑구,0.0,0,4,0,1,5
1075,2018-02-13,강남구,0.0,0,13,0,6,19
1076,2018-02-13,강동구,0.0,0,2,0,2,4
1077,2018-02-13,강북구,0.0,0,6,0,2,8
1078,2018-02-13,강서구,0.0,0,8,0,3,11
1079,2018-02-13,관악구,0.0,0,3,0,2,5
1080,2018-02-13,광진구,0.0,0,0,0,1,1
1081,2018-02-13,구로구,0.0,0,5,0,2,7
1082,2018-02-13,금천구,0.0,0,4,0,1,5
1083,2018-02-13,노원구,0.0,0,5,0,2,7
1084,2018-02-13,도봉구,0.0,0,1,0,1,2
1085,2018-02-13,동대문구,0.0,0,10,2,1,13
1086,2018-02-13,동작구,0.0,0,4,1,4,9
1087,2018-02-13,마포구,0.0,0,6,0,2,8
1088,2018-02-13,서대문구,0.0,0,2,1,3,6
1089,2018-02-13,서초구,0.0,0,10,0,1,11
1090,2018-02-13,성동구,0.0,0,2,0,1,3
1091,2018-02-13,성북구,0.0,1,6,1,0,8
1092,2018-02-13,송파구,0.0,0,7,0,4,11
1093,2018-02-13,양천구,0.0,0,8,1,0,9
1094,2018-02-13,영등포구,0.0,0,11,3,4,18
1095,2018-02-13,용산구,0.0,0,4,0,2,6
1096,2018-02-13,은평구,0.0,0,4,1,2,7
1097,2018-02-13,종로구,0.0,0,2,0,0,2
1098,2018-02-13,중구,0.0,0,1,2,1,4
1099,2018-02-13,중랑구,0.0,0,7,1,1,9
1100,2018-02-14,강남구,0.0,0,13,0,4,17
1101,2018-02-14,강동구,0.0,0,3,0,3,6
1102,2018-02-14,강북구,0.0,0,7,1,0,8
1103,2018-02-14,강서구,0.0,0,4,0,1,5
1104,2018-02-14,관악구,0.0,0,5,2,0,7
1105,2018-02-14,광진구,0.0,0,5,1,1,7
1106,2018-02-14,구로구,0.0,0,8,0,3,11
1107,2018-02-14,금천구,0.0,0,2,0,3,5
1108,2018-02-14,노원구,0.0,0,10,0,2,12
1109,2018-02-14,도봉구,0.0,0,3,0,0,3
1110,2018-02-14,동대문구,0.0,0,2,1,3,6
1111,2018-02-14,동작구,0.0,0,9,1,2,12
1112,2018-02-14,마포구,0.0,0,3,0,1,4
1113,2018-02-14,서대문구,0.0,1,5,0,3,9
1114,2018-02-14,서초구,0.0,0,3,0,4,7
1115,2018-02-14,성동구,0.0,0,3,0,0,3
1116,2018-02-14,성북구,0.0,0,2,0,2,4
1117,2018-02-14,송파구,0.0,0,6,0,2,8
1118,2018-02-14,양천구,0.0,0,4,0,1,5
1119,2018-02-14,영등포구,0.0,0,12,0,2,14
1120,2018-02-14,용산구,0.0,0,13,0,2,15
1121,2018-02-14,은평구,0.0,0,4,0,1,5
1122,2018-02-14,종로구,0.0,0,6,2,1,9
1123,2018-02-14,중구,0.0,0,4,0,2,6
1124,2018-02-14,중랑구,0.0,0,7,0,0,7
1125,2018-02-15,강남구,0.0,0,2,0,1,3
1126,2018-02-15,강동구,0.0,0,0,0,2,2
1127,2018-02-15,강북구,0.0,0,5,0,2,7
1128,2018-02-15,강서구,0.0,0,6,0,0,6
1129,2018-02-15,관악구,0.0,0,3,0,1,4
1130,2018-02-15,광진구,0.0,0,0,0,0,0
1131,2018-02-15,구로구,0.0,0,1,0,1,2
1132,2018-02-15,금천구,0.0,0,0,1,2,3
1133,2018-02-15,노원구,0.0,0,4,0,0,4
1134,2018-02-15,도봉구,0.0,0,1,2,0,3
1135,2018-02-15,동대문구,0.0,0,6,0,5,11
1136,2018-02-15,동작구,0.0,0,1,0,1,2
1137,2018-02-15,마포구,0.0,0,7,0,2,9
1138,2018-02-15,서대문구,0.0,0,6,1,0,7
1139,2018-02-15,서초구,0.0,0,9,0,1,10
1140,2018-02-15,성동구,0.0,0,2,0,1,3
1141,2018-02-15,성북구,0.0,0,1,0,2,3
1142,2018-02-15,송파구,0.0,0,4,0,3,7
1143,2018-02-15,양천구,0.0,0,3,0,1,4
1144,2018-02-15,영등포구,0.0,0,4,0,1,5
1145,2018-02-15,용산구,0.0,0,3,0,0,3
1146,2018-02-15,은평구,0.0,0,1,0,1,2
1147,2018-02-15,종로구,0.0,0,0,0,0,0
1148,2018-02-15,중구,0.0,1,4,0,0,5
1149,2018-02-15,중랑구,0.0,0,5,0,2,7
1150,2018-02-16,강남구,0.0,0,7,0,0,7
1151,2018-02-16,강동구,0.0,0,9,0,1,10
1152,2018-02-16,강북구,0.0,0,3,1,2,6
1153,2018-02-16,강서구,0.0,0,2,0,2,4
1154,2018-02-16,관악구,0.0,0,1,0,0,1
1155,2018-02-16,광진구,0.0,0,2,0,0,2
1156,2018-02-16,구로구,0.0,0,1,0,0,1
1157,2018-02-16,금천구,0.0,0,14,1,2,17
1158,2018-02-16,노원구,0.0,0,4,0,1,5
1159,2018-02-16,도봉구,0.0,0,0,0,0,0
1160,2018-02-16,동대문구,0.0,0,0,0,1,1
1161,2018-02-16,동작구,0.0,0,0,0,0,0
1162,2018-02-16,마포구,0.0,0,4,0,0,4
1163,2018-02-16,서대문구,0.0,0,1,0,3,4
1164,2018-02-16,서초구,0.0,0,9,1,0,10
1165,2018-02-16,성동구,0.0,0,0,1,0,1
1166,2018-02-16,성북구,0.0,0,2,0,1,3
1167,2018-02-16,송파구,0.0,0,0,1,1,2
1168,2018-02-16,양천구,0.0,0,1,0,0,1
1169,2018-02-16,영등포구,0.0,0,9,0,1,10
1170,2018-02-16,용산구,0.0,0,2,0,1,3
1171,2018-02-16,은평구,0.0,0,2,0,0,2
1172,2018-02-16,종로구,0.0,0,0,0,0,0
1173,2018-02-16,중구,0.0,0,1,0,0,1
1174,2018-02-16,중랑구,0.0,0,3,0,0,3
1175,2018-02-17,강남구,0.0,0,1,0,0,1
1176,2018-02-17,강동구,0.0,0,1,0,1,2
1177,2018-02-17,강북구,0.0,0,5,0,0,5
1178,2018-02-17,강서구,0.0,0,2,0,0,2
1179,2018-02-17,관악구,0.0,0,3,0,0,3
1180,2018-02-17,광진구,0.0,0,4,0,3,7
1181,2018-02-17,구로구,0.0,1,4,0,0,5
1182,2018-02-17,금천구,0.0,0,0,0,0,0
1183,2018-02-17,노원구,0.0,0,0,1,0,1
1184,2018-02-17,도봉구,0.0,0,0,0,0,0
1185,2018-02-17,동대문구,0.0,0,1,0,0,1
1186,2018-02-17,동작구,0.0,0,0,0,1,1
1187,2018-02-17,마포구,0.0,0,5,1,0,6
1188,2018-02-17,서대문구,0.0,0,0,1,0,1
1189,2018-02-17,서초구,0.0,0,0,0,2,2
1190,2018-02-17,성동구,0.0,0,0,0,0,0
1191,2018-02-17,성북구,0.0,0,0,0,1,1
1192,2018-02-17,송파구,0.0,1,6,0,3,10
1193,2018-02-17,양천구,0.0,0,1,0,0,1
1194,2018-02-17,영등포구,0.0,0,2,0,2,4
1195,2018-02-17,용산구,0.0,0,0,0,1,1
1196,2018-02-17,은평구,0.0,0,1,0,0,1
1197,2018-02-17,종로구,0.0,0,0,0,0,0
1198,2018-02-17,중구,0.0,0,0,0,0,0
1199,2018-02-17,중랑구,0.0,0,0,0,0,0
1200,2018-02-18,강남구,0.0,0,1,1,1,3
1201,2018-02-18,강동구,0.0,0,1,1,1,3
1202,2018-02-18,강북구,0.0,0,1,0,0,1
1203,2018-02-18,강서구,0.0,0,3,0,0,3
1204,2018-02-18,관악구,0.0,0,0,0,1,1
1205,2018-02-18,광진구,0.0,0,2,0,0,2
1206,2018-02-18,구로구,0.0,0,3,0,0,3
1207,2018-02-18,금천구,0.0,0,2,0,1,3
1208,2018-02-18,노원구,0.0,0,0,0,1,1
1209,2018-02-18,도봉구,0.0,0,1,0,0,1
1210,2018-02-18,동대문구,0.0,0,0,0,1,1
1211,2018-02-18,동작구,0.0,0,0,0,0,0
1212,2018-02-18,마포구,0.0,0,5,3,1,9
1213,2018-02-18,서대문구,0.0,0,1,0,1,2
1214,2018-02-18,서초구,0.0,0,2,0,0,2
1215,2018-02-18,성동구,0.0,0,0,0,0,0
1216,2018-02-18,성북구,0.0,0,0,0,0,0
1217,2018-02-18,송파구,0.0,0,6,0,1,7
1218,2018-02-18,양천구,0.0,0,1,0,1,2
1219,2018-02-18,영등포구,0.0,0,0,0,1,1
1220,2018-02-18,용산구,0.0,0,4,0,0,4
1221,2018-02-18,은평구,0.0,0,4,1,2,7
1222,2018-02-18,종로구,0.0,0,0,0,1,1
1223,2018-02-18,중구,0.0,0,1,1,0,2
1224,2018-02-18,중랑구,0.0,0,1,0,3,4
1225,2018-02-19,강남구,0.0,0,14,2,4,20
1226,2018-02-19,강동구,0.0,0,4,1,0,5
1227,2018-02-19,강북구,0.0,0,3,0,1,4
1228,2018-02-19,강서구,0.0,0,6,0,4,10
1229,2018-02-19,관악구,0.0,0,0,0,1,1
1230,2018-02-19,광진구,0.0,0,4,0,1,5
1231,2018-02-19,구로구,0.0,0,0,0,0,0
1232,2018-02-19,금천구,0.0,0,4,0,0,4
1233,2018-02-19,노원구,0.0,0,8,2,0,10
1234,2018-02-19,도봉구,0.0,0,0,0,1,1
1235,2018-02-19,동대문구,0.0,0,4,0,2,6
1236,2018-02-19,동작구,0.0,0,2,0,0,2
1237,2018-02-19,마포구,0.0,0,1,1,0,2
1238,2018-02-19,서대문구,0.0,0,2,2,2,6
1239,2018-02-19,서초구,0.0,0,1,0,3,4
1240,2018-02-19,성동구,0.0,0,5,3,0,8
1241,2018-02-19,성북구,0.0,0,2,0,2,4
1242,2018-02-19,송파구,0.0,0,6,1,0,7
1243,2018-02-19,양천구,0.0,0,2,0,3,5
1244,2018-02-19,영등포구,0.0,1,3,0,2,6
1245,2018-02-19,용산구,0.0,0,0,0,0,0
1246,2018-02-19,은평구,0.0,0,1,1,0,2
1247,2018-02-19,종로구,0.0,0,2,1,3,6
1248,2018-02-19,중구,0.0,0,2,1,0,3
1249,2018-02-19,중랑구,0.0,0,3,0,1,4
1250,2018-02-20,강남구,0.0,0,11,0,2,13
1251,2018-02-20,강동구,0.0,0,1,0,1,2
1252,2018-02-20,강북구,0.0,0,3,0,0,3
1253,2018-02-20,강서구,0.0,0,4,0,1,5
1254,2018-02-20,관악구,0.0,0,4,0,1,5
1255,2018-02-20,광진구,0.0,0,6,0,0,6
1256,2018-02-20,구로구,0.0,0,1,0,0,1
1257,2018-02-20,금천구,0.0,0,0,0,0,0
1258,2018-02-20,노원구,0.0,0,13,0,2,15
1259,2018-02-20,도봉구,0.0,0,1,0,0,1
1260,2018-02-20,동대문구,0.0,0,2,0,2,4
1261,2018-02-20,동작구,0.0,0,1,1,0,2
1262,2018-02-20,마포구,0.0,0,6,0,0,6
1263,2018-02-20,서대문구,0.0,0,1,0,0,1
1264,2018-02-20,서초구,0.0,0,11,1,2,14
1265,2018-02-20,성동구,0.0,0,0,0,0,0
1266,2018-02-20,성북구,0.0,0,7,1,0,8
1267,2018-02-20,송파구,0.0,0,7,2,3,12
1268,2018-02-20,양천구,0.0,0,3,0,2,5
1269,2018-02-20,영등포구,0.0,0,4,0,2,6
1270,2018-02-20,용산구,0.0,0,1,0,1,2
1271,2018-02-20,은평구,0.0,0,9,14,1,24
1272,2018-02-20,종로구,0.0,0,1,0,0,1
1273,2018-02-20,중구,0.0,0,0,1,0,1
1274,2018-02-20,중랑구,0.0,0,3,1,0,4
1275,2018-02-21,강남구,0.0,0,4,1,5,10
1276,2018-02-21,강동구,0.0,0,3,0,1,4
1277,2018-02-21,강북구,0.0,0,4,0,3,7
1278,2018-02-21,강서구,0.0,0,8,0,0,8
1279,2018-02-21,관악구,0.0,0,2,0,0,2
1280,2018-02-21,광진구,0.0,0,0,1,0,1
1281,2018-02-21,구로구,0.0,0,2,0,0,2
1282,2018-02-21,금천구,0.0,0,1,1,2,4
1283,2018-02-21,노원구,0.0,0,1,0,0,1
1284,2018-02-21,도봉구,0.0,0,0,0,0,0
1285,2018-02-21,동대문구,0.0,0,3,0,2,5
1286,2018-02-21,동작구,0.0,0,5,0,0,5
1287,2018-02-21,마포구,0.0,0,8,0,2,10
1288,2018-02-21,서대문구,0.0,0,1,1,2,4
1289,2018-02-21,서초구,0.0,0,6,0,2,8
1290,2018-02-21,성동구,0.0,0,2,0,0,2
1291,2018-02-21,성북구,0.0,0,4,0,0,4
1292,2018-02-21,송파구,0.0,1,4,1,2,8
1293,2018-02-21,양천구,0.0,0,1,0,1,2
1294,2018-02-21,영등포구,0.0,0,4,1,0,5
1295,2018-02-21,용산구,0.0,0,2,1,3,6
1296,2018-02-21,은평구,0.0,0,3,0,2,5
1297,2018-02-21,종로구,0.0,0,0,0,0,0
1298,2018-02-21,중구,0.0,0,5,0,1,6
1299,2018-02-21,중랑구,0.0,0,2,0,0,2
1300,2018-02-22,강남구,0.0,0,9,1,1,11
1301,2018-02-22,강동구,0.0,0,3,0,0,3
1302,2018-02-22,강북구,0.0,0,1,0,3,4
1303,2018-02-22,강서구,0.5,0,3,0,1,4
1304,2018-02-22,관악구,0.0,0,1,0,2,3
1305,2018-02-22,광진구,0.0,0,2,1,1,4
1306,2018-02-22,구로구,0.0,0,1,0,0,1
1307,2018-02-22,금천구,0.0,0,3,0,0,3
1308,2018-02-22,노원구,0.0,0,3,0,0,3
1309,2018-02-22,도봉구,0.0,0,1,1,1,3
1310,2018-02-22,동대문구,0.0,0,5,0,0,5
1311,2018-02-22,동작구,0.0,0,1,2,1,4
1312,2018-02-22,마포구,0.0,0,5,0,0,5
1313,2018-02-22,서대문구,0.0,0,2,0,2,4
1314,2018-02-22,서초구,0.0,0,5,1,1,7
1315,2018-02-22,성동구,0.0,0,3,0,1,4
1316,2018-02-22,성북구,0.0,0,4,0,1,5
1317,2018-02-22,송파구,0.0,0,2,1,1,4
1318,2018-02-22,양천구,0.0,0,1,0,0,1
1319,2018-02-22,영등포구,0.0,0,13,1,1,15
1320,2018-02-22,용산구,0.0,0,5,0,1,6
1321,2018-02-22,은평구,0.0,0,3,1,0,4
1322,2018-02-22,종로구,0.4,0,2,0,1,3
1323,2018-02-22,중구,0.0,0,3,0,4,7
1324,2018-02-22,중랑구,0.0,0,5,0,0,5
1325,2018-02-23,강남구,4.0,0,14,0,5,19
1326,2018-02-23,강동구,4.5,0,2,0,1,3
1327,2018-02-23,강북구,5.0,1,8,0,1,10
1328,2018-02-23,강서구,4.5,0,2,0,1,3
1329,2018-02-23,관악구,4.25,0,2,2,2,6
1330,2018-02-23,광진구,0.0,0,1,2,1,4
1331,2018-02-23,구로구,3.5,0,10,0,1,11
1332,2018-02-23,금천구,4.5,0,6,0,1,7
1333,2018-02-23,노원구,6.0,0,4,0,1,5
1334,2018-02-23,도봉구,0.0,0,6,0,0,6
1335,2018-02-23,동대문구,0.0,0,5,0,1,6
1336,2018-02-23,동작구,3.25,0,1,0,0,1
1337,2018-02-23,마포구,4.5,0,5,0,2,7
1338,2018-02-23,서대문구,5.0,0,5,0,1,6
1339,2018-02-23,서초구,4.5,0,6,3,2,11
1340,2018-02-23,성동구,3.5,0,1,1,1,3
1341,2018-02-23,성북구,5.0,0,1,0,1,2
1342,2018-02-23,송파구,3.5,0,11,1,3,15
1343,2018-02-23,양천구,3.5,1,4,1,0,6
1344,2018-02-23,영등포구,1.75,0,5,1,1,7
1345,2018-02-23,용산구,3.0,0,12,0,1,13
1346,2018-02-23,은평구,0.0,0,3,0,1,4
1347,2018-02-23,종로구,3.7,0,2,0,2,4
1348,2018-02-23,중구,4.5,0,4,2,3,9
1349,2018-02-23,중랑구,4.5,0,4,1,2,7
1350,2018-02-24,강남구,0.0,0,8,0,2,10
1351,2018-02-24,강동구,0.0,0,1,0,0,1
1352,2018-02-24,강북구,0.0,0,3,0,0,3
1353,2018-02-24,강서구,0.0,0,4,0,2,6
1354,2018-02-24,관악구,0.0,0,3,1,1,5
1355,2018-02-24,광진구,0.0,0,3,0,0,3
1356,2018-02-24,구로구,0.0,0,3,1,1,5
1357,2018-02-24,금천구,0.0,0,0,0,0,0
1358,2018-02-24,노원구,0.0,0,2,1,0,3
1359,2018-02-24,도봉구,0.0,0,0,0,0,0
1360,2018-02-24,동대문구,0.0,1,1,2,2,6
1361,2018-02-24,동작구,0.0,0,4,0,2,6
1362,2018-02-24,마포구,0.0,0,7,0,2,9
1363,2018-02-24,서대문구,0.0,0,2,0,0,2
1364,2018-02-24,서초구,0.0,0,8,3,0,11
1365,2018-02-24,성동구,0.0,0,3,0,0,3
1366,2018-02-24,성북구,0.0,0,5,1,0,6
1367,2018-02-24,송파구,0.0,0,0,1,2,3
1368,2018-02-24,양천구,0.0,0,2,0,1,3
1369,2018-02-24,영등포구,0.0,0,7,1,2,10
1370,2018-02-24,용산구,0.0,0,2,0,0,2
1371,2018-02-24,은평구,0.0,0,3,0,1,4
1372,2018-02-24,종로구,0.0,0,0,0,0,0
1373,2018-02-24,중구,0.0,0,5,0,0,5
1374,2018-02-24,중랑구,0.0,0,4,0,2,6
1375,2018-02-25,강남구,0.0,0,3,0,2,5
1376,2018-02-25,강동구,0.0,0,4,1,1,6
1377,2018-02-25,강북구,0.0,1,3,0,3,7
1378,2018-02-25,강서구,0.0,0,5,0,0,5
1379,2018-02-25,관악구,0.0,0,4,0,2,6
1380,2018-02-25,광진구,0.0,0,0,0,0,0
1381,2018-02-25,구로구,0.0,0,9,1,0,10
1382,2018-02-25,금천구,0.0,0,2,1,0,3
1383,2018-02-25,노원구,0.0,0,3,0,1,4
1384,2018-02-25,도봉구,0.0,0,2,0,0,2
1385,2018-02-25,동대문구,0.0,0,5,0,2,7
1386,2018-02-25,동작구,0.0,0,4,2,2,8
1387,2018-02-25,마포구,0.0,0,3,0,3,6
1388,2018-02-25,서대문구,0.0,0,1,0,1,2
1389,2018-02-25,서초구,0.0,0,5,0,0,5
1390,2018-02-25,성동구,0.0,0,0,0,1,1
1391,2018-02-25,성북구,0.0,0,2,0,0,2
1392,2018-02-25,송파구,0.0,0,3,0,0,3
1393,2018-02-25,양천구,0.0,0,1,0,0,1
1394,2018-02-25,영등포구,0.0,0,16,0,0,16
1395,2018-02-25,용산구,0.0,0,2,0,1,3
1396,2018-02-25,은평구,0.0,0,0,0,0,0
1397,2018-02-25,종로구,0.0,0,2,0,1,3
1398,2018-02-25,중구,0.0,0,0,0,0,0
1399,2018-02-25,중랑구,0.0,1,3,0,1,5
1400,2018-02-26,강남구,0.0,0,5,1,3,9
1401,2018-02-26,강동구,0.0,0,3,1,1,5
1402,2018-02-26,강북구,0.0,0,3,0,1,4
1403,2018-02-26,강서구,0.0,0,0,0,0,0
1404,2018-02-26,관악구,0.0,0,7,1,1,9
1405,2018-02-26,광진구,0.0,0,1,0,1,2
1406,2018-02-26,구로구,0.0,0,8,0,0,8
1407,2018-02-26,금천구,0.0,0,4,0,0,4
1408,2018-02-26,노원구,0.0,0,1,0,0,1
1409,2018-02-26,도봉구,0.0,0,0,0,0,0
1410,2018-02-26,동대문구,0.0,0,3,0,1,4
1411,2018-02-26,동작구,0.0,1,6,0,0,7
1412,2018-02-26,마포구,0.0,0,9,1,5,15
1413,2018-02-26,서대문구,0.0,0,1,0,2,3
1414,2018-02-26,서초구,0.0,0,8,1,2,11
1415,2018-02-26,성동구,0.0,0,4,0,1,5
1416,2018-02-26,성북구,0.0,0,0,0,0,0
1417,2018-02-26,송파구,0.0,0,8,1,1,10
1418,2018-02-26,양천구,0.0,0,4,0,2,6
1419,2018-02-26,영등포구,0.0,0,7,1,2,10
1420,2018-02-26,용산구,0.0,0,3,0,1,4
1421,2018-02-26,은평구,0.0,0,4,0,3,7
1422,2018-02-26,종로구,0.0,0,3,0,0,3
1423,2018-02-26,중구,0.0,0,2,0,2,4
1424,2018-02-26,중랑구,0.0,0,3,0,0,3
1425,2018-02-27,강남구,0.0,1,9,0,0,10
1426,2018-02-27,강동구,0.0,0,2,1,0,3
1427,2018-02-27,강북구,0.0,0,0,0,1,1
1428,2018-02-27,강서구,0.0,0,6,0,1,7
1429,2018-02-27,관악구,0.0,0,3,0,0,3
1430,2018-02-27,광진구,0.0,0,3,0,1,4
1431,2018-02-27,구로구,0.0,0,2,0,1,3
1432,2018-02-27,금천구,0.0,0,2,0,3,5
1433,2018-02-27,노원구,0.0,1,6,1,1,9
1434,2018-02-27,도봉구,0.0,0,4,0,0,4
1435,2018-02-27,동대문구,0.0,0,2,2,1,5
1436,2018-02-27,동작구,0.0,0,1,0,1,2
1437,2018-02-27,마포구,0.0,0,4,0,0,4
1438,2018-02-27,서대문구,0.0,0,2,0,2,4
1439,2018-02-27,서초구,0.0,1,3,1,1,6
1440,2018-02-27,성동구,0.0,0,2,0,1,3
1441,2018-02-27,성북구,0.0,0,1,0,2,3
1442,2018-02-27,송파구,0.0,0,9,1,4,14
1443,2018-02-27,양천구,0.0,0,5,0,0,5
1444,2018-02-27,영등포구,0.0,0,3,0,1,4
1445,2018-02-27,용산구,0.0,0,2,0,1,3
1446,2018-02-27,은평구,0.0,0,2,0,1,3
1447,2018-02-27,종로구,0.0,0,3,0,0,3
1448,2018-02-27,중구,0.0,0,3,1,2,6
1449,2018-02-27,중랑구,0.0,0,2,0,5,7
1450,2018-02-28,강남구,17.0,0,10,0,3,13
1451,2018-02-28,강동구,16.0,0,7,1,1,9
1452,2018-02-28,강북구,20.5,0,2,0,0,2
1453,2018-02-28,강서구,20.0,0,2,0,3,5
1454,2018-02-28,관악구,30.5,0,10,0,0,10
1455,2018-02-28,광진구,19.5,0,1,0,1,2
1456,2018-02-28,구로구,25.0,0,14,0,3,17
1457,2018-02-28,금천구,26.0,0,1,0,0,1
1458,2018-02-28,노원구,17.5,0,2,0,0,2
1459,2018-02-28,도봉구,26.5,0,2,0,0,2
1460,2018-02-28,동대문구,26.5,0,1,1,1,3
1461,2018-02-28,동작구,24.25,0,0,0,0,0
1462,2018-02-28,마포구,25.0,0,4,1,0,5
1463,2018-02-28,서대문구,25.0,0,1,0,1,2
1464,2018-02-28,서초구,24.0,0,5,3,2,10
1465,2018-02-28,성동구,18.5,0,4,0,0,4
1466,2018-02-28,성북구,24.0,0,8,0,4,12
1467,2018-02-28,송파구,15.5,0,13,7,6,26
1468,2018-02-28,양천구,24.0,0,1,0,0,1
1469,2018-02-28,영등포구,19.5,0,6,1,2,9
1470,2018-02-28,용산구,23.5,0,4,0,4,8
1471,2018-02-28,은평구,54.0,0,1,1,2,4
1472,2018-02-28,종로구,25.0,0,4,1,1,6
1473,2018-02-28,중구,9.0,0,6,0,2,8
1474,2018-02-28,중랑구,23.5,0,3,3,1,7
1475,2018-03-01,강남구,1.0,0,10,1,4,15
1476,2018-03-01,강동구,1.0,0,2,0,1,3
1477,2018-03-01,강북구,1.0,0,3,0,3,6
1478,2018-03-01,강서구,0.5,0,3,1,2,6
1479,2018-03-01,관악구,2.5,0,9,1,1,11
1480,2018-03-01,광진구,1.0,0,1,1,0,2
1481,2018-03-01,구로구,1.0,0,1,0,5,6
1482,2018-03-01,금천구,1.0,0,1,0,1,2
1483,2018-03-01,노원구,1.0,0,5,0,2,7
1484,2018-03-01,도봉구,1.5,0,4,0,1,5
1485,2018-03-01,동대문구,1.5,0,4,0,2,6
1486,2018-03-01,동작구,1.5,0,1,0,0,1
1487,2018-03-01,마포구,1.0,0,1,0,1,2
1488,2018-03-01,서대문구,1.0,0,11,1,5,17
1489,2018-03-01,서초구,1.5,0,10,1,1,12
1490,2018-03-01,성동구,1.5,0,2,0,2,4
1491,2018-03-01,성북구,1.0,0,7,0,0,7
1492,2018-03-01,송파구,0.5,0,10,0,3,13
1493,2018-03-01,양천구,1.0,0,5,1,0,6
1494,2018-03-01,영등포구,1.5,0,2,0,1,3
1495,2018-03-01,용산구,0.5,0,2,0,1,3
1496,2018-03-01,은평구,1.5,0,4,0,2,6
1497,2018-03-01,종로구,0.5,0,3,1,0,4
1498,2018-03-01,중구,0.5,0,2,1,0,3
1499,2018-03-01,중랑구,0.5,0,2,0,0,2
1500,2018-03-02,강남구,0.0,0,10,0,2,12
1501,2018-03-02,강동구,0.0,0,2,0,2,4
1502,2018-03-02,강북구,0.0,0,2,1,1,4
1503,2018-03-02,강서구,0.0,0,2,2,0,4
1504,2018-03-02,관악구,0.0,0,9,3,2,14
1505,2018-03-02,광진구,0.0,0,2,0,0,2
1506,2018-03-02,구로구,0.0,0,1,1,0,2
1507,2018-03-02,금천구,0.0,0,1,0,2,3
1508,2018-03-02,노원구,0.0,0,3,1,2,6
1509,2018-03-02,도봉구,0.0,0,2,1,1,4
1510,2018-03-02,동대문구,0.0,0,4,0,1,5
1511,2018-03-02,동작구,0.0,0,2,0,0,2
1512,2018-03-02,마포구,0.0,0,1,0,3,4
1513,2018-03-02,서대문구,0.0,0,2,1,2,5
1514,2018-03-02,서초구,0.0,0,7,4,4,15
1515,2018-03-02,성동구,0.0,0,4,2,0,6
1516,2018-03-02,성북구,0.0,0,7,1,1,9
1517,2018-03-02,송파구,0.0,0,4,0,2,6
1518,2018-03-02,양천구,0.0,0,4,0,0,4
1519,2018-03-02,영등포구,0.0,0,14,1,1,16
1520,2018-03-02,용산구,0.0,0,0,0,0,0
1521,2018-03-02,은평구,0.0,0,3,0,2,5
1522,2018-03-02,종로구,0.0,0,7,0,2,9
1523,2018-03-02,중구,0.0,0,4,0,1,5
1524,2018-03-02,중랑구,0.0,0,4,1,3,8
1525,2018-03-03,강남구,0.0,0,6,0,3,9
1526,2018-03-03,강동구,0.0,0,7,0,0,7
1527,2018-03-03,강북구,0.0,0,0,0,0,0
1528,2018-03-03,강서구,0.0,0,7,1,1,9
1529,2018-03-03,관악구,0.0,0,2,1,1,4
1530,2018-03-03,광진구,0.0,1,0,0,0,1
1531,2018-03-03,구로구,0.0,0,1,0,1,2
1532,2018-03-03,금천구,0.0,0,0,0,1,1
1533,2018-03-03,노원구,0.0,0,8,1,0,9
1534,2018-03-03,도봉구,0.0,0,0,0,0,0
1535,2018-03-03,동대문구,0.0,0,6,0,2,8
1536,2018-03-03,동작구,0.0,0,2,1,1,4
1537,2018-03-03,마포구,0.0,0,10,0,0,10
1538,2018-03-03,서대문구,0.0,0,0,0,0,0
1539,2018-03-03,서초구,0.0,0,7,3,4,14
1540,2018-03-03,성동구,0.0,0,3,0,1,4
1541,2018-03-03,성북구,0.0,0,4,0,0,4
1542,2018-03-03,송파구,0.0,0,15,1,1,17
1543,2018-03-03,양천구,0.0,0,6,0,0,6
1544,2018-03-03,영등포구,0.0,0,8,1,1,10
1545,2018-03-03,용산구,0.0,0,3,0,1,4
1546,2018-03-03,은평구,0.0,0,2,0,0,2
1547,2018-03-03,종로구,0.0,0,0,0,1,1
1548,2018-03-03,중구,0.0,0,5,0,2,7
1549,2018-03-03,중랑구,0.0,1,3,0,0,4
1550,2018-03-04,강남구,14.0,0,7,0,2,9
1551,2018-03-04,강동구,11.5,0,3,1,2,6
1552,2018-03-04,강북구,11.0,0,6,0,1,7
1553,2018-03-04,강서구,14.0,0,12,1,2,15
1554,2018-03-04,관악구,16.25,0,4,0,0,4
1555,2018-03-04,광진구,12.5,0,4,1,1,6
1556,2018-03-04,구로구,16.5,0,2,0,1,3
1557,2018-03-04,금천구,16.0,0,7,0,2,9
1558,2018-03-04,노원구,9.5,0,9,0,2,11
1559,2018-03-04,도봉구,12.5,0,2,0,1,3
1560,2018-03-04,동대문구,13.0,0,5,0,0,5
1561,2018-03-04,동작구,15.0,0,7,0,1,8
1562,2018-03-04,마포구,14.5,0,3,0,0,3
1563,2018-03-04,서대문구,14.5,0,2,0,0,2
1564,2018-03-04,서초구,14.5,0,10,4,9,23
1565,2018-03-04,성동구,13.0,0,2,0,0,2
1566,2018-03-04,성북구,11.5,0,8,0,3,11
1567,2018-03-04,송파구,12.0,1,2,0,2,5
1568,2018-03-04,양천구,16.5,0,8,1,3,12
1569,2018-03-04,영등포구,14.75,0,2,0,1,3
1570,2018-03-04,용산구,13.5,0,4,0,1,5
1571,2018-03-04,은평구,12.5,0,3,0,0,3
1572,2018-03-04,종로구,11.5,0,1,0,0,1
1573,2018-03-04,중구,2.5,0,3,1,2,6
1574,2018-03-04,중랑구,12.5,0,1,0,0,1
1575,2018-03-05,강남구,6.0,0,9,1,5,15
1576,2018-03-05,강동구,5.0,0,9,0,4,13
1577,2018-03-05,강북구,4.0,0,3,0,0,3
1578,2018-03-05,강서구,4.0,0,2,0,2,4
1579,2018-03-05,관악구,6.75,0,3,0,0,3
1580,2018-03-05,광진구,6.0,0,2,0,1,3
1581,2018-03-05,구로구,6.0,0,4,0,1,5
1582,2018-03-05,금천구,6.5,0,2,0,0,2
1583,2018-03-05,노원구,4.0,0,0,1,0,1
1584,2018-03-05,도봉구,6.0,0,1,2,0,3
1585,2018-03-05,동대문구,6.0,0,3,1,1,5
1586,2018-03-05,동작구,6.0,0,2,0,2,4
1587,2018-03-05,마포구,4.5,0,7,0,2,9
1588,2018-03-05,서대문구,4.5,0,2,0,2,4
1589,2018-03-05,서초구,6.0,0,7,2,0,9
1590,2018-03-05,성동구,6.5,0,2,0,3,5
1591,2018-03-05,성북구,4.5,0,2,1,2,5
1592,2018-03-05,송파구,4.0,0,4,0,6,10
1593,2018-03-05,양천구,4.5,0,8,2,1,11
1594,2018-03-05,영등포구,4.25,0,6,0,5,11
1595,2018-03-05,용산구,5.5,0,0,1,3,4
1596,2018-03-05,은평구,5.5,0,1,1,0,2
1597,2018-03-05,종로구,3.5,0,2,1,3,6
1598,2018-03-05,중구,0.5,0,0,0,1,1
1599,2018-03-05,중랑구,6.5,0,0,0,1,1
1600,2018-03-06,강남구,0.0,0,10,0,3,13
1601,2018-03-06,강동구,0.0,0,8,0,0,8
1602,2018-03-06,강북구,0.0,0,0,0,1,1
1603,2018-03-06,강서구,0.0,0,5,0,3,8
1604,2018-03-06,관악구,0.0,0,5,0,0,5
1605,2018-03-06,광진구,0.0,0,2,0,2,4
1606,2018-03-06,구로구,0.0,0,4,0,1,5
1607,2018-03-06,금천구,0.0,0,2,1,0,3
1608,2018-03-06,노원구,0.0,0,5,1,1,7
1609,2018-03-06,도봉구,0.0,0,0,0,0,0
1610,2018-03-06,동대문구,0.0,0,4,0,0,4
1611,2018-03-06,동작구,0.0,0,5,1,1,7
1612,2018-03-06,마포구,0.0,0,3,0,3,6
1613,2018-03-06,서대문구,0.0,0,1,0,0,1
1614,2018-03-06,서초구,0.0,0,4,0,2,6
1615,2018-03-06,성동구,0.0,0,3,0,0,3
1616,2018-03-06,성북구,0.0,0,3,0,1,4
1617,2018-03-06,송파구,0.0,0,6,0,0,6
1618,2018-03-06,양천구,0.0,0,5,1,2,8
1619,2018-03-06,영등포구,0.0,0,4,1,0,5
1620,2018-03-06,용산구,0.0,0,6,0,0,6
1621,2018-03-06,은평구,0.0,0,0,0,3,3
1622,2018-03-06,종로구,0.0,0,1,0,1,2
1623,2018-03-06,중구,0.0,0,2,0,3,5
1624,2018-03-06,중랑구,0.0,0,8,0,0,8
1625,2018-03-07,강남구,0.5,0,9,1,1,11
1626,2018-03-07,강동구,0.5,0,5,1,1,7
1627,2018-03-07,강북구,0.0,0,6,0,1,7
1628,2018-03-07,강서구,2.5,0,2,0,1,3
1629,2018-03-07,관악구,0.75,1,6,0,0,7
1630,2018-03-07,광진구,0.5,0,5,0,0,5
1631,2018-03-07,구로구,1.5,0,3,0,0,3
1632,2018-03-07,금천구,1.0,0,3,0,2,5
1633,2018-03-07,노원구,0.0,0,9,0,0,9
1634,2018-03-07,도봉구,1.0,0,1,0,0,1
1635,2018-03-07,동대문구,0.5,2,6,0,3,11
1636,2018-03-07,동작구,0.5,0,2,0,0,2
1637,2018-03-07,마포구,0.5,0,3,1,1,5
1638,2018-03-07,서대문구,0.5,0,6,3,0,9
1639,2018-03-07,서초구,0.5,0,5,2,4,11
1640,2018-03-07,성동구,0.5,0,5,0,0,5
1641,2018-03-07,성북구,0.5,0,4,0,1,5
1642,2018-03-07,송파구,0.0,0,4,1,4,9
1643,2018-03-07,양천구,1.5,0,0,0,1,1
1644,2018-03-07,영등포구,0.5,0,6,1,3,10
1645,2018-03-07,용산구,0.5,0,3,0,0,3
1646,2018-03-07,은평구,0.5,0,2,0,0,2
1647,2018-03-07,종로구,0.5,0,2,1,0,3
1648,2018-03-07,중구,0.5,0,1,0,2,3
1649,2018-03-07,중랑구,0.0,0,1,0,0,1
1650,2018-03-08,강남구,6.5,0,17,1,3,21
1651,2018-03-08,강동구,4.5,0,2,1,0,3
1652,2018-03-08,강북구,3.5,0,5,0,1,6
1653,2018-03-08,강서구,7.5,0,0,2,1,3
1654,2018-03-08,관악구,6.5,0,1,0,2,3
1655,2018-03-08,광진구,6.5,0,1,0,1,2
1656,2018-03-08,구로구,7.0,0,4,0,1,5
1657,2018-03-08,금천구,5.5,0,0,1,1,2
1658,2018-03-08,노원구,4.0,0,5,0,2,7
1659,2018-03-08,도봉구,6.0,0,0,0,0,0
1660,2018-03-08,동대문구,6.5,0,2,0,1,3
1661,2018-03-08,동작구,5.75,0,3,0,1,4
1662,2018-03-08,마포구,4.5,0,2,0,1,3
1663,2018-03-08,서대문구,6.0,0,3,0,0,3
1664,2018-03-08,서초구,6.5,0,4,0,2,6
1665,2018-03-08,성동구,6.5,0,2,0,1,3
1666,2018-03-08,성북구,4.0,0,2,0,0,2
1667,2018-03-08,송파구,5.0,0,4,2,1,7
1668,2018-03-08,양천구,5.0,0,2,1,1,4
1669,2018-03-08,영등포구,5.25,0,9,0,3,12
1670,2018-03-08,용산구,6.0,0,2,0,2,4
1671,2018-03-08,은평구,6.5,0,2,0,1,3
1672,2018-03-08,종로구,4.0,0,4,1,0,5
1673,2018-03-08,중구,4.0,0,2,0,1,3
1674,2018-03-08,중랑구,5.0,1,3,1,0,5
1675,2018-03-09,강남구,0.0,0,12,2,1,15
1676,2018-03-09,강동구,0.0,0,3,0,1,4
1677,2018-03-09,강북구,0.0,0,1,0,2,3
1678,2018-03-09,강서구,0.0,0,1,0,0,1
1679,2018-03-09,관악구,0.0,0,2,0,3,5
1680,2018-03-09,광진구,0.0,0,2,0,1,3
1681,2018-03-09,구로구,0.0,0,9,0,1,10
1682,2018-03-09,금천구,0.0,0,2,0,0,2
1683,2018-03-09,노원구,0.0,0,4,1,0,5
1684,2018-03-09,도봉구,0.0,0,1,0,0,1
1685,2018-03-09,동대문구,0.0,0,2,0,2,4
1686,2018-03-09,동작구,0.0,0,3,2,0,5
1687,2018-03-09,마포구,0.0,1,0,0,0,1
1688,2018-03-09,서대문구,0.0,0,2,0,0,2
1689,2018-03-09,서초구,0.0,0,7,2,1,10
1690,2018-03-09,성동구,0.0,0,1,0,0,1
1691,2018-03-09,성북구,0.0,0,4,0,3,7
1692,2018-03-09,송파구,0.0,0,4,0,0,4
1693,2018-03-09,양천구,0.0,0,2,0,2,4
1694,2018-03-09,영등포구,0.0,0,10,0,1,11
1695,2018-03-09,용산구,0.0,0,5,3,0,8
1696,2018-03-09,은평구,0.0,0,2,0,0,2
1697,2018-03-09,종로구,0.0,0,0,0,3,3
1698,2018-03-09,중구,0.0,0,4,1,1,6
1699,2018-03-09,중랑구,0.0,0,2,0,0,2
1700,2018-03-10,강남구,0.0,0,9,0,3,12
1701,2018-03-10,강동구,0.0,0,12,0,3,15
1702,2018-03-10,강북구,0.0,0,11,0,2,13
1703,2018-03-10,강서구,0.0,0,3,1,0,4
1704,2018-03-10,관악구,0.0,1,3,0,0,4
1705,2018-03-10,광진구,0.0,0,2,0,0,2
1706,2018-03-10,구로구,0.0,0,1,0,0,1
1707,2018-03-10,금천구,0.0,0,0,0,1,1
1708,2018-03-10,노원구,0.0,0,6,1,1,8
1709,2018-03-10,도봉구,0.0,0,2,0,0,2
1710,2018-03-10,동대문구,0.0,0,5,0,4,9
1711,2018-03-10,동작구,0.0,0,9,0,3,12
1712,2018-03-10,마포구,0.0,0,13,0,2,15
1713,2018-03-10,서대문구,0.0,0,1,0,2,3
1714,2018-03-10,서초구,0.0,0,6,2,2,10
1715,2018-03-10,성동구,0.0,0,1,0,0,1
1716,2018-03-10,성북구,0.0,1,3,0,0,4
1717,2018-03-10,송파구,0.0,1,9,3,3,16
1718,2018-03-10,양천구,0.0,0,2,0,3,5
1719,2018-03-10,영등포구,0.0,0,11,0,0,11
1720,2018-03-10,용산구,0.0,0,4,2,0,6
1721,2018-03-10,은평구,0.0,0,3,2,1,6
1722,2018-03-10,종로구,0.0,0,2,0,1,3
1723,2018-03-10,중구,0.0,0,6,0,1,7
1724,2018-03-10,중랑구,0.0,0,8,1,0,9
1725,2018-03-11,강남구,0.0,0,5,3,8,16
1726,2018-03-11,강동구,0.0,0,0,0,0,0
1727,2018-03-11,강북구,0.0,0,3,0,0,3
1728,2018-03-11,강서구,0.0,0,7,2,0,9
1729,2018-03-11,관악구,0.0,0,3,1,0,4
1730,2018-03-11,광진구,0.0,0,1,0,0,1
1731,2018-03-11,구로구,0.0,0,4,0,0,4
1732,2018-03-11,금천구,0.0,0,0,0,2,2
1733,2018-03-11,노원구,0.0,1,5,1,0,7
1734,2018-03-11,도봉구,0.0,0,0,0,0,0
1735,2018-03-11,동대문구,0.0,0,3,0,3,6
1736,2018-03-11,동작구,0.0,0,1,0,0,1
1737,2018-03-11,마포구,0.0,0,2,0,0,2
1738,2018-03-11,서대문구,0.0,0,0,1,0,1
1739,2018-03-11,서초구,0.0,0,5,1,1,7
1740,2018-03-11,성동구,0.0,1,3,0,0,4
1741,2018-03-11,성북구,0.0,0,1,0,0,1
1742,2018-03-11,송파구,0.0,0,4,0,2,6
1743,2018-03-11,양천구,0.0,0,3,0,1,4
1744,2018-03-11,영등포구,0.0,0,4,0,3,7
1745,2018-03-11,용산구,0.0,0,2,0,0,2
1746,2018-03-11,은평구,0.0,0,1,0,2,3
1747,2018-03-11,종로구,0.0,0,5,0,2,7
1748,2018-03-11,중구,0.0,0,0,0,2,2
1749,2018-03-11,중랑구,0.0,0,2,0,1,3
1750,2018-03-12,강남구,0.0,0,7,2,1,10
1751,2018-03-12,강동구,0.0,0,0,0,1,1
1752,2018-03-12,강북구,0.0,1,4,0,0,5
1753,2018-03-12,강서구,0.0,0,3,0,0,3
1754,2018-03-12,관악구,0.0,0,1,1,1,3
1755,2018-03-12,광진구,0.0,0,1,1,0,2
1756,2018-03-12,구로구,0.0,0,0,0,1,1
1757,2018-03-12,금천구,0.0,0,0,1,2,3
1758,2018-03-12,노원구,0.0,0,0,1,0,1
1759,2018-03-12,도봉구,0.0,0,1,0,0,1
1760,2018-03-12,동대문구,0.0,0,5,0,1,6
1761,2018-03-12,동작구,0.0,0,9,0,1,10
1762,2018-03-12,마포구,0.0,0,5,0,0,5
1763,2018-03-12,서대문구,0.0,0,2,2,1,5
1764,2018-03-12,서초구,0.0,0,9,1,1,11
1765,2018-03-12,성동구,0.0,0,6,0,1,7
1766,2018-03-12,성북구,0.0,0,3,2,1,6
1767,2018-03-12,송파구,0.0,0,8,1,1,10
1768,2018-03-12,양천구,0.0,0,6,0,0,6
1769,2018-03-12,영등포구,0.0,0,5,0,1,6
1770,2018-03-12,용산구,0.0,0,2,0,2,4
1771,2018-03-12,은평구,0.0,0,1,0,2,3
1772,2018-03-12,종로구,0.0,0,0,0,0,0
1773,2018-03-12,중구,0.0,0,0,0,1,1
1774,2018-03-12,중랑구,0.0,0,5,2,0,7
1775,2018-03-13,강남구,0.0,0,13,0,0,13
1776,2018-03-13,강동구,0.0,0,3,0,0,3
1777,2018-03-13,강북구,0.0,0,5,0,2,7
1778,2018-03-13,강서구,0.0,0,1,1,6,8
1779,2018-03-13,관악구,0.0,0,1,0,1,2
1780,2018-03-13,광진구,0.0,0,1,0,0,1
1781,2018-03-13,구로구,0.0,0,8,0,0,8
1782,2018-03-13,금천구,0.0,0,2,0,0,2
1783,2018-03-13,노원구,0.0,0,5,0,4,9
1784,2018-03-13,도봉구,0.0,0,1,0,0,1
1785,2018-03-13,동대문구,0.0,0,2,0,2,4
1786,2018-03-13,동작구,0.0,0,0,0,1,1
1787,2018-03-13,마포구,0.0,0,1,1,0,2
1788,2018-03-13,서대문구,0.0,0,0,0,1,1
1789,2018-03-13,서초구,0.0,0,3,0,0,3
1790,2018-03-13,성동구,0.0,0,2,0,0,2
1791,2018-03-13,성북구,0.0,0,1,0,1,2
1792,2018-03-13,송파구,0.0,0,10,0,1,11
1793,2018-03-13,양천구,0.0,0,6,0,1,7
1794,2018-03-13,영등포구,0.0,0,5,1,1,7
1795,2018-03-13,용산구,0.0,0,4,1,0,5
1796,2018-03-13,은평구,0.0,1,2,0,1,4
1797,2018-03-13,종로구,0.0,0,1,0,1,2
1798,2018-03-13,중구,0.0,0,5,1,0,6
1799,2018-03-13,중랑구,0.0,0,2,1,2,5
1800,2018-03-14,강남구,0.0,0,8,0,4,12
1801,2018-03-14,강동구,0.0,0,4,0,0,4
1802,2018-03-14,강북구,0.0,0,1,2,1,4
1803,2018-03-14,강서구,0.0,0,2,0,1,3
1804,2018-03-14,관악구,0.0,0,2,0,2,4
1805,2018-03-14,광진구,0.0,0,0,0,0,0
1806,2018-03-14,구로구,0.0,0,4,0,2,6
1807,2018-03-14,금천구,0.0,0,6,0,0,6
1808,2018-03-14,노원구,0.0,0,6,0,0,6
1809,2018-03-14,도봉구,0.0,0,0,0,2,2
1810,2018-03-14,동대문구,0.0,0,6,1,0,7
1811,2018-03-14,동작구,0.0,0,1,0,0,1
1812,2018-03-14,마포구,0.0,0,1,0,2,3
1813,2018-03-14,서대문구,0.0,0,0,0,1,1
1814,2018-03-14,서초구,0.0,0,3,0,1,4
1815,2018-03-14,성동구,0.0,0,0,0,0,0
1816,2018-03-14,성북구,0.0,0,2,0,2,4
1817,2018-03-14,송파구,0.0,0,2,0,0,2
1818,2018-03-14,양천구,0.0,0,1,1,0,2
1819,2018-03-14,영등포구,0.0,0,4,0,0,4
1820,2018-03-14,용산구,0.0,0,1,0,0,1
1821,2018-03-14,은평구,0.0,0,3,0,0,3
1822,2018-03-14,종로구,0.0,0,2,0,0,2
1823,2018-03-14,중구,0.0,0,0,0,4,4
1824,2018-03-14,중랑구,0.0,0,6,0,1,7
1825,2018-03-15,강남구,30.5,0,8,0,0,8
1826,2018-03-15,강동구,28.5,0,3,1,0,4
1827,2018-03-15,강북구,19.0,0,4,0,1,5
1828,2018-03-15,강서구,23.0,0,4,0,2,6
1829,2018-03-15,관악구,39.75,0,4,2,2,8
1830,2018-03-15,광진구,32.0,0,4,0,2,6
1831,2018-03-15,구로구,35.0,0,7,0,2,9
1832,2018-03-15,금천구,36.0,0,3,1,1,5
1833,2018-03-15,노원구,25.5,0,6,0,2,8
1834,2018-03-15,도봉구,16.5,0,1,0,0,1
1835,2018-03-15,동대문구,29.0,0,3,0,0,3
1836,2018-03-15,동작구,31.25,0,1,0,1,2
1837,2018-03-15,마포구,4.0,0,3,1,2,6
1838,2018-03-15,서대문구,27.5,0,1,0,1,2
1839,2018-03-15,서초구,34.0,0,8,1,0,9
1840,2018-03-15,성동구,29.5,0,5,0,2,7
1841,2018-03-15,성북구,25.5,0,3,0,2,5
1842,2018-03-15,송파구,28.5,0,4,1,0,5
1843,2018-03-15,양천구,28.5,0,1,0,1,2
1844,2018-03-15,영등포구,31.0,1,7,6,3,17
1845,2018-03-15,용산구,26.5,0,6,0,3,9
1846,2018-03-15,은평구,17.0,0,1,0,0,1
1847,2018-03-15,종로구,27.0,0,3,1,1,5
1848,2018-03-15,중구,26.0,0,2,1,2,5
1849,2018-03-15,중랑구,29.5,0,1,2,0,3
1850,2018-03-16,강남구,0.0,0,6,0,2,8
1851,2018-03-16,강동구,0.0,0,4,1,4,9
1852,2018-03-16,강북구,0.0,0,2,0,1,3
1853,2018-03-16,강서구,0.0,0,2,0,2,4
1854,2018-03-16,관악구,0.0,0,4,0,2,6
1855,2018-03-16,광진구,0.0,0,0,0,3,3
1856,2018-03-16,구로구,0.0,0,8,0,2,10
1857,2018-03-16,금천구,0.0,0,4,0,1,5
1858,2018-03-16,노원구,0.0,0,2,0,1,3
1859,2018-03-16,도봉구,0.0,0,2,0,1,3
1860,2018-03-16,동대문구,0.0,0,2,0,3,5
1861,2018-03-16,동작구,0.0,0,8,0,0,8
1862,2018-03-16,마포구,0.0,0,5,0,2,7
1863,2018-03-16,서대문구,0.0,0,2,0,1,3
1864,2018-03-16,서초구,0.0,0,3,0,4,7
1865,2018-03-16,성동구,0.0,0,4,1,2,7
1866,2018-03-16,성북구,0.0,0,2,2,5,9
1867,2018-03-16,송파구,0.0,0,5,3,1,9
1868,2018-03-16,양천구,0.0,0,8,1,0,9
1869,2018-03-16,영등포구,0.0,1,10,1,6,18
1870,2018-03-16,용산구,0.0,0,3,0,1,4
1871,2018-03-16,은평구,0.0,0,4,0,2,6
1872,2018-03-16,종로구,0.0,0,1,2,1,4
1873,2018-03-16,중구,0.0,0,4,1,1,6
1874,2018-03-16,중랑구,0.0,0,6,0,3,9
1875,2018-03-17,강남구,0.0,1,10,1,7,19
1876,2018-03-17,강동구,0.0,0,10,0,4,14
1877,2018-03-17,강북구,0.0,0,5,0,1,6
1878,2018-03-17,강서구,0.0,0,3,1,0,4
1879,2018-03-17,관악구,0.0,0,4,0,1,5
1880,2018-03-17,광진구,0.0,0,2,0,1,3
1881,2018-03-17,구로구,0.0,0,11,0,2,13
1882,2018-03-17,금천구,0.0,0,0,0,1,1
1883,2018-03-17,노원구,0.0,0,4,0,0,4
1884,2018-03-17,도봉구,0.0,0,2,0,0,2
1885,2018-03-17,동대문구,0.0,0,1,0,0,1
1886,2018-03-17,동작구,0.0,0,2,0,0,2
1887,2018-03-17,마포구,0.0,0,10,0,1,11
1888,2018-03-17,서대문구,0.0,0,3,0,0,3
1889,2018-03-17,서초구,0.0,0,13,0,2,15
1890,2018-03-17,성동구,0.0,0,2,0,0,2
1891,2018-03-17,성북구,0.0,0,5,0,1,6
1892,2018-03-17,송파구,0.0,0,12,4,2,18
1893,2018-03-17,양천구,0.0,0,7,3,1,11
1894,2018-03-17,영등포구,0.0,0,6,1,1,8
1895,2018-03-17,용산구,0.0,0,7,0,1,8
1896,2018-03-17,은평구,0.0,0,4,0,0,4
1897,2018-03-17,종로구,0.0,0,10,1,1,12
1898,2018-03-17,중구,0.0,0,3,0,2,5
1899,2018-03-17,중랑구,0.0,0,5,0,2,7
1900,2018-03-18,강남구,1.0,1,3,1,3,8
1901,2018-03-18,강동구,0.5,0,2,1,0,3
1902,2018-03-18,강북구,0.0,0,1,0,0,1
1903,2018-03-18,강서구,0.5,0,6,1,2,9
1904,2018-03-18,관악구,1.5,0,3,0,0,3
1905,2018-03-18,광진구,0.5,0,4,0,0,4
1906,2018-03-18,구로구,1.0,0,3,2,0,5
1907,2018-03-18,금천구,1.5,0,2,0,2,4
1908,2018-03-18,노원구,0.0,0,5,0,0,5
1909,2018-03-18,도봉구,1.0,0,1,0,1,2
1910,2018-03-18,동대문구,0.5,0,8,0,0,8
1911,2018-03-18,동작구,1.0,0,4,0,0,4
1912,2018-03-18,마포구,0.5,0,7,2,0,9
1913,2018-03-18,서대문구,0.5,0,0,0,0,0
1914,2018-03-18,서초구,1.0,0,1,0,1,2
1915,2018-03-18,성동구,0.5,1,16,0,3,20
1916,2018-03-18,성북구,0.5,0,3,1,1,5
1917,2018-03-18,송파구,0.5,0,6,1,1,8
1918,2018-03-18,양천구,0.5,0,4,0,1,5
1919,2018-03-18,영등포구,0.5,0,8,0,0,8
1920,2018-03-18,용산구,1.0,0,2,1,2,5
1921,2018-03-18,은평구,1.5,0,1,0,0,1
1922,2018-03-18,종로구,0.5,0,3,0,1,4
1923,2018-03-18,중구,0.5,0,0,0,0,0
1924,2018-03-18,중랑구,0.5,0,5,0,3,8
1925,2018-03-19,강남구,2.0,0,12,0,5,17
1926,2018-03-19,강동구,1.5,0,0,0,0,0
1927,2018-03-19,강북구,0.5,0,5,0,0,5
1928,2018-03-19,강서구,1.5,0,1,0,0,1
1929,2018-03-19,관악구,2.75,0,5,0,0,5
1930,2018-03-19,광진구,2.0,0,1,0,2,3
1931,2018-03-19,구로구,1.5,0,2,0,2,4
1932,2018-03-19,금천구,1.5,0,1,0,1,2
1933,2018-03-19,노원구,1.0,0,3,0,0,3
1934,2018-03-19,도봉구,1.5,0,1,0,1,2
1935,2018-03-19,동대문구,1.5,0,2,0,2,4
1936,2018-03-19,동작구,1.75,0,2,0,0,2
1937,2018-03-19,마포구,1.0,0,1,0,1,2
1938,2018-03-19,서대문구,2.0,0,2,0,1,3
1939,2018-03-19,서초구,2.5,0,8,1,2,11
1940,2018-03-19,성동구,1.5,0,1,0,0,1
1941,2018-03-19,성북구,1.0,0,3,0,0,3
1942,2018-03-19,송파구,1.5,0,5,1,5,11
1943,2018-03-19,양천구,1.5,0,2,1,2,5
1944,2018-03-19,영등포구,1.0,0,5,0,1,6
1945,2018-03-19,용산구,1.5,0,6,0,0,6
1946,2018-03-19,은평구,1.5,0,1,0,0,1
1947,2018-03-19,종로구,1.0,0,5,0,0,5
1948,2018-03-19,중구,0.5,0,5,1,0,6
1949,2018-03-19,중랑구,1.0,0,6,0,1,7
1950,2018-03-20,강남구,0.0,1,9,1,4,15
1951,2018-03-20,강동구,0.0,1,5,2,0,8
1952,2018-03-20,강북구,0.0,0,1,0,0,1
1953,2018-03-20,강서구,0.0,0,8,0,1,9
1954,2018-03-20,관악구,0.0,0,0,1,0,1
1955,2018-03-20,광진구,0.0,0,1,0,1,2
1956,2018-03-20,구로구,0.0,0,4,0,0,4
1957,2018-03-20,금천구,0.0,0,1,0,1,2
1958,2018-03-20,노원구,0.0,0,2,0,3,5
1959,2018-03-20,도봉구,0.0,0,0,0,1,1
1960,2018-03-20,동대문구,0.0,0,2,1,0,3
1961,2018-03-20,동작구,0.0,0,1,0,1,2
1962,2018-03-20,마포구,0.0,0,11,0,0,11
1963,2018-03-20,서대문구,0.0,0,1,0,2,3
1964,2018-03-20,서초구,0.0,0,5,0,1,6
1965,2018-03-20,성동구,0.0,0,5,1,1,7
1966,2018-03-20,성북구,0.0,0,2,0,4,6
1967,2018-03-20,송파구,0.0,0,5,0,3,8
1968,2018-03-20,양천구,0.0,0,1,0,2,3
1969,2018-03-20,영등포구,0.0,0,5,1,0,6
1970,2018-03-20,용산구,0.0,0,1,0,3,4
1971,2018-03-20,은평구,0.0,0,4,1,1,6
1972,2018-03-20,종로구,0.0,0,1,0,1,2
1973,2018-03-20,중구,0.0,0,3,0,2,5
1974,2018-03-20,중랑구,0.0,0,3,1,0,4
1975,2018-03-21,강남구,0.5,0,5,0,0,5
1976,2018-03-21,강동구,0.0,0,3,0,1,4
1977,2018-03-21,강북구,1.0,0,3,0,0,3
1978,2018-03-21,강서구,1.0,0,7,0,0,7
1979,2018-03-21,관악구,1.25,0,1,0,0,1
1980,2018-03-21,광진구,0.0,0,6,0,1,7
1981,2018-03-21,구로구,2.0,0,2,0,3,5
1982,2018-03-21,금천구,2.0,0,2,0,0,2
1983,2018-03-21,노원구,0.0,0,5,0,0,5
1984,2018-03-21,도봉구,1.5,0,1,0,0,1
1985,2018-03-21,동대문구,1.0,0,0,1,2,3
1986,2018-03-21,동작구,1.25,0,3,0,2,5
1987,2018-03-21,마포구,0.5,0,2,0,0,2
1988,2018-03-21,서대문구,1.0,0,1,1,0,2
1989,2018-03-21,서초구,0.0,0,6,2,2,10
1990,2018-03-21,성동구,1.0,0,3,1,1,5
1991,2018-03-21,성북구,2.5,0,3,0,0,3
1992,2018-03-21,송파구,0.0,0,7,3,3,13
1993,2018-03-21,양천구,1.0,0,3,1,2,6
1994,2018-03-21,영등포구,1.25,0,6,0,1,7
1995,2018-03-21,용산구,1.0,0,2,0,1,3
1996,2018-03-21,은평구,2.5,0,3,0,0,3
1997,2018-03-21,종로구,1.0,0,3,0,0,3
1998,2018-03-21,중구,0.0,0,2,0,1,3
1999,2018-03-21,중랑구,0.0,0,0,2,3,5
2000,2018-03-22,강남구,0.0,0,13,2,4,19
2001,2018-03-22,강동구,0.0,1,1,0,1,3
2002,2018-03-22,강북구,0.0,0,3,1,0,4
2003,2018-03-22,강서구,0.0,0,5,0,1,6
2004,2018-03-22,관악구,0.0,0,1,0,0,1
2005,2018-03-22,광진구,0.0,0,3,0,1,4
2006,2018-03-22,구로구,0.0,0,5,1,2,8
2007,2018-03-22,금천구,0.0,0,2,0,2,4
2008,2018-03-22,노원구,0.0,0,11,2,5,18
2009,2018-03-22,도봉구,0.0,0,4,1,2,7
2010,2018-03-22,동대문구,0.0,0,6,1,1,8
2011,2018-03-22,동작구,0.0,0,0,0,0,0
2012,2018-03-22,마포구,0.0,0,3,0,1,4
2013,2018-03-22,서대문구,0.0,0,3,1,1,5
2014,2018-03-22,서초구,0.0,0,10,0,4,14
2015,2018-03-22,성동구,0.0,0,0,0,0,0
2016,2018-03-22,성북구,0.0,0,2,0,1,3
2017,2018-03-22,송파구,0.0,0,3,1,1,5
2018,2018-03-22,양천구,0.0,0,6,0,3,9
2019,2018-03-22,영등포구,0.0,0,8,0,0,8
2020,2018-03-22,용산구,0.0,0,3,1,1,5
2021,2018-03-22,은평구,0.0,0,1,0,1,2
2022,2018-03-22,종로구,0.0,0,2,0,2,4
2023,2018-03-22,중구,0.0,0,4,0,0,4
2024,2018-03-22,중랑구,0.0,1,2,0,1,4
2025,2018-03-23,강남구,0.0,0,9,1,5,15
2026,2018-03-23,강동구,0.0,0,1,1,2,4
2027,2018-03-23,강북구,0.0,0,4,0,3,7
2028,2018-03-23,강서구,0.0,0,3,0,1,4
2029,2018-03-23,관악구,0.0,0,4,2,0,6
2030,2018-03-23,광진구,0.0,0,5,2,0,7
2031,2018-03-23,구로구,0.0,0,2,0,2,4
2032,2018-03-23,금천구,0.0,0,2,0,2,4
2033,2018-03-23,노원구,0.0,0,1,0,2,3
2034,2018-03-23,도봉구,0.0,0,0,0,2,2
2035,2018-03-23,동대문구,0.0,0,3,2,0,5
2036,2018-03-23,동작구,0.0,0,4,0,0,4
2037,2018-03-23,마포구,0.0,0,3,0,4,7
2038,2018-03-23,서대문구,0.0,0,1,1,0,2
2039,2018-03-23,서초구,0.0,0,9,0,3,12
2040,2018-03-23,성동구,0.0,0,3,0,0,3
2041,2018-03-23,성북구,0.0,0,2,0,2,4
2042,2018-03-23,송파구,0.0,0,7,2,2,11
2043,2018-03-23,양천구,0.0,0,1,1,1,3
2044,2018-03-23,영등포구,0.0,0,6,1,3,10
2045,2018-03-23,용산구,0.0,0,1,1,1,3
2046,2018-03-23,은평구,0.0,0,0,0,1,1
2047,2018-03-23,종로구,0.0,0,9,1,3,13
2048,2018-03-23,중구,0.0,1,2,0,3,6
2049,2018-03-23,중랑구,0.0,0,1,0,1,2
2050,2018-03-24,강남구,0.0,0,13,1,2,16
2051,2018-03-24,강동구,0.0,0,3,0,1,4
2052,2018-03-24,강북구,0.0,0,4,0,1,5
2053,2018-03-24,강서구,0.0,0,2,0,2,4
2054,2018-03-24,관악구,0.0,0,3,2,0,5
2055,2018-03-24,광진구,0.0,0,0,0,0,0
2056,2018-03-24,구로구,0.0,0,1,0,1,2
2057,2018-03-24,금천구,0.0,0,2,0,1,3
2058,2018-03-24,노원구,0.0,0,9,1,1,11
2059,2018-03-24,도봉구,0.0,0,0,0,0,0
2060,2018-03-24,동대문구,0.0,0,0,0,1,1
2061,2018-03-24,동작구,0.0,0,4,0,0,4
2062,2018-03-24,마포구,0.0,0,6,0,0,6
2063,2018-03-24,서대문구,0.0,0,1,0,2,3
2064,2018-03-24,서초구,0.0,1,5,1,3,10
2065,2018-03-24,성동구,0.0,0,2,0,1,3
2066,2018-03-24,성북구,0.0,0,2,0,1,3
2067,2018-03-24,송파구,0.0,0,8,1,1,10
2068,2018-03-24,양천구,0.0,0,3,0,0,3
2069,2018-03-24,영등포구,0.0,0,10,1,0,11
2070,2018-03-24,용산구,0.0,0,4,2,2,8
2071,2018-03-24,은평구,0.0,0,4,1,2,7
2072,2018-03-24,종로구,0.0,0,4,2,3,9
2073,2018-03-24,중구,0.0,0,4,1,2,7
2074,2018-03-24,중랑구,0.0,0,3,0,2,5
2075,2018-03-25,강남구,0.0,0,15,4,2,21
2076,2018-03-25,강동구,0.0,0,0,0,0,0
2077,2018-03-25,강북구,0.0,0,0,0,0,0
2078,2018-03-25,강서구,0.0,0,1,0,0,1
2079,2018-03-25,관악구,0.0,0,1,0,1,2
2080,2018-03-25,광진구,0.0,0,4,0,1,5
2081,2018-03-25,구로구,0.0,0,4,0,3,7
2082,2018-03-25,금천구,0.0,0,20,1,1,22
2083,2018-03-25,노원구,0.0,0,15,1,3,19
2084,2018-03-25,도봉구,0.0,0,1,0,0,1
2085,2018-03-25,동대문구,0.0,0,2,0,1,3
2086,2018-03-25,동작구,0.0,0,3,1,0,4
2087,2018-03-25,마포구,0.0,0,11,0,1,12
2088,2018-03-25,서대문구,0.0,0,1,0,0,1
2089,2018-03-25,서초구,0.0,0,6,1,3,10
2090,2018-03-25,성동구,0.0,0,4,0,2,6
2091,2018-03-25,성북구,0.0,0,4,0,1,5
2092,2018-03-25,송파구,0.0,0,4,1,1,6
2093,2018-03-25,양천구,0.0,0,1,0,1,2
2094,2018-03-25,영등포구,0.0,0,7,1,1,9
2095,2018-03-25,용산구,0.0,0,1,0,1,2
2096,2018-03-25,은평구,0.0,0,6,2,1,9
2097,2018-03-25,종로구,0.0,0,2,1,1,4
2098,2018-03-25,중구,0.0,0,1,0,1,2
2099,2018-03-25,중랑구,0.0,0,0,0,0,0
2100,2018-03-26,강남구,0.0,0,7,3,2,12
2101,2018-03-26,강동구,0.0,0,2,1,1,4
2102,2018-03-26,강북구,0.0,0,0,0,1,1
2103,2018-03-26,강서구,0.0,0,2,0,2,4
2104,2018-03-26,관악구,0.0,0,1,1,1,3
2105,2018-03-26,광진구,0.0,0,1,0,2,3
2106,2018-03-26,구로구,0.0,0,2,1,0,3
2107,2018-03-26,금천구,0.0,0,4,0,5,9
2108,2018-03-26,노원구,0.0,0,9,0,1,10
2109,2018-03-26,도봉구,0.0,0,0,0,0,0
2110,2018-03-26,동대문구,0.0,1,2,2,3,8
2111,2018-03-26,동작구,0.0,0,2,0,0,2
2112,2018-03-26,마포구,0.0,0,5,0,0,5
2113,2018-03-26,서대문구,0.0,0,1,0,1,2
2114,2018-03-26,서초구,0.0,0,10,0,2,12
2115,2018-03-26,성동구,0.0,0,6,0,1,7
2116,2018-03-26,성북구,0.0,0,4,2,0,6
2117,2018-03-26,송파구,0.0,0,7,1,4,12
2118,2018-03-26,양천구,0.0,1,3,1,0,5
2119,2018-03-26,영등포구,0.0,0,3,0,0,3
2120,2018-03-26,용산구,0.0,0,2,0,2,4
2121,2018-03-26,은평구,0.0,0,2,1,1,4
2122,2018-03-26,종로구,0.0,0,1,1,1,3
2123,2018-03-26,중구,0.0,0,5,0,1,6
2124,2018-03-26,중랑구,0.0,0,3,0,2,5
2125,2018-03-27,강남구,0.0,0,6,2,2,10
2126,2018-03-27,강동구,0.0,0,3,0,1,4
2127,2018-03-27,강북구,0.0,0,5,0,1,6
2128,2018-03-27,강서구,0.0,0,2,0,0,2
2129,2018-03-27,관악구,0.0,0,2,0,3,5
2130,2018-03-27,광진구,0.0,0,1,0,2,3
2131,2018-03-27,구로구,0.0,0,6,0,0,6
2132,2018-03-27,금천구,0.0,0,3,0,1,4
2133,2018-03-27,노원구,0.0,0,0,0,1,1
2134,2018-03-27,도봉구,0.0,0,0,1,0,1
2135,2018-03-27,동대문구,0.0,0,3,0,1,4
2136,2018-03-27,동작구,0.0,0,4,2,1,7
2137,2018-03-27,마포구,0.0,0,1,4,1,6
2138,2018-03-27,서대문구,0.0,0,4,0,1,5
2139,2018-03-27,서초구,0.0,0,8,2,1,11
2140,2018-03-27,성동구,0.0,0,7,1,1,9
2141,2018-03-27,성북구,0.0,0,5,0,1,6
2142,2018-03-27,송파구,0.0,0,6,2,3,11
2143,2018-03-27,양천구,0.0,0,4,0,1,5
2144,2018-03-27,영등포구,0.0,0,3,1,0,4
2145,2018-03-27,용산구,0.0,0,8,0,2,10
2146,2018-03-27,은평구,0.0,0,4,0,1,5
2147,2018-03-27,종로구,0.0,0,2,0,0,2
2148,2018-03-27,중구,0.0,0,1,1,2,4
2149,2018-03-27,중랑구,0.0,0,3,1,2,6
2150,2018-03-28,강남구,0.0,0,8,1,0,9
2151,2018-03-28,강동구,0.0,0,2,0,2,4
2152,2018-03-28,강북구,0.0,0,6,0,2,8
2153,2018-03-28,강서구,0.0,0,3,0,2,5
2154,2018-03-28,관악구,0.0,0,1,0,1,2
2155,2018-03-28,광진구,0.0,0,5,0,2,7
2156,2018-03-28,구로구,0.0,0,0,0,3,3
2157,2018-03-28,금천구,0.0,0,2,0,1,3
2158,2018-03-28,노원구,0.0,0,10,0,0,10
2159,2018-03-28,도봉구,0.0,0,1,1,0,2
2160,2018-03-28,동대문구,0.0,0,0,0,1,1
2161,2018-03-28,동작구,0.0,0,4,0,3,7
2162,2018-03-28,마포구,0.0,0,3,0,0,3
2163,2018-03-28,서대문구,0.0,0,0,0,3,3
2164,2018-03-28,서초구,0.0,0,15,0,2,17
2165,2018-03-28,성동구,0.0,0,6,0,3,9
2166,2018-03-28,성북구,0.0,0,0,0,4,4
2167,2018-03-28,송파구,0.0,0,6,1,1,8
2168,2018-03-28,양천구,0.0,0,10,0,2,12
2169,2018-03-28,영등포구,0.0,0,4,1,0,5
2170,2018-03-28,용산구,0.0,0,3,1,1,5
2171,2018-03-28,은평구,0.0,0,0,0,3,3
2172,2018-03-28,종로구,0.0,0,3,0,1,4
2173,2018-03-28,중구,0.0,0,2,2,1,5
2174,2018-03-28,중랑구,0.0,0,5,0,2,7
2175,2018-03-29,강남구,0.0,0,8,1,3,12
2176,2018-03-29,강동구,0.0,0,7,0,2,9
2177,2018-03-29,강북구,0.0,0,0,0,2,2
2178,2018-03-29,강서구,0.0,0,5,0,0,5
2179,2018-03-29,관악구,0.0,0,6,0,3,9
2180,2018-03-29,광진구,0.0,0,2,0,0,2
2181,2018-03-29,구로구,0.0,0,3,0,3,6
2182,2018-03-29,금천구,0.0,0,6,0,1,7
2183,2018-03-29,노원구,0.0,0,5,0,0,5
2184,2018-03-29,도봉구,0.0,0,2,1,3,6
2185,2018-03-29,동대문구,0.0,0,11,0,5,16
2186,2018-03-29,동작구,0.0,0,0,1,0,1
2187,2018-03-29,마포구,0.0,0,2,0,1,3
2188,2018-03-29,서대문구,0.0,0,3,1,0,4
2189,2018-03-29,서초구,0.0,0,8,0,1,9
2190,2018-03-29,성동구,0.0,0,2,0,2,4
2191,2018-03-29,성북구,0.0,0,10,0,2,12
2192,2018-03-29,송파구,0.0,0,17,1,2,20
2193,2018-03-29,양천구,0.0,0,0,0,0,0
2194,2018-03-29,영등포구,0.0,0,8,0,4,12
2195,2018-03-29,용산구,0.0,0,3,1,2,6
2196,2018-03-29,은평구,0.0,0,1,0,1,2
2197,2018-03-29,종로구,0.0,0,3,0,2,5
2198,2018-03-29,중구,0.0,0,2,1,0,3
2199,2018-03-29,중랑구,0.0,0,3,1,1,5
2200,2018-03-30,강남구,0.0,0,3,4,3,10
2201,2018-03-30,강동구,0.0,0,1,1,3,5
2202,2018-03-30,강북구,0.0,0,5,0,2,7
2203,2018-03-30,강서구,0.0,0,7,0,5,12
2204,2018-03-30,관악구,0.0,0,2,1,1,4
2205,2018-03-30,광진구,0.0,0,3,0,0,3
2206,2018-03-30,구로구,0.0,0,5,1,1,7
2207,2018-03-30,금천구,0.0,0,1,0,0,1
2208,2018-03-30,노원구,0.0,0,7,0,0,7
2209,2018-03-30,도봉구,0.0,0,1,0,2,3
2210,2018-03-30,동대문구,0.0,0,4,0,0,4
2211,2018-03-30,동작구,0.0,0,0,0,2,2
2212,2018-03-30,마포구,0.0,0,0,0,0,0
2213,2018-03-30,서대문구,0.0,0,1,0,0,1
2214,2018-03-30,서초구,0.0,0,11,1,4,16
2215,2018-03-30,성동구,0.0,0,2,0,4,6
2216,2018-03-30,성북구,0.0,0,5,0,1,6
2217,2018-03-30,송파구,0.0,0,6,1,3,10
2218,2018-03-30,양천구,0.0,0,5,1,3,9
2219,2018-03-30,영등포구,0.0,0,8,1,4,13
2220,2018-03-30,용산구,0.0,0,2,0,3,5
2221,2018-03-30,은평구,0.0,0,1,0,0,1
2222,2018-03-30,종로구,0.0,0,5,10,1,16
2223,2018-03-30,중구,0.0,0,4,1,0,5
2224,2018-03-30,중랑구,0.0,0,2,0,0,2
2225,2018-03-31,강남구,0.0,0,4,2,3,9
2226,2018-03-31,강동구,0.0,0,1,0,1,2
2227,2018-03-31,강북구,0.0,0,2,0,1,3
2228,2018-03-31,강서구,0.0,0,0,1,0,1
2229,2018-03-31,관악구,0.0,0,2,0,0,2
2230,2018-03-31,광진구,0.0,0,5,0,1,6
2231,2018-03-31,구로구,0.0,0,6,0,4,10
2232,2018-03-31,금천구,0.0,0,2,0,1,3
2233,2018-03-31,노원구,0.0,0,5,1,2,8
2234,2018-03-31,도봉구,0.0,0,1,0,1,2
2235,2018-03-31,동대문구,0.0,0,3,0,3,6
2236,2018-03-31,동작구,0.0,0,4,1,3,8
2237,2018-03-31,마포구,0.0,0,14,0,1,15
2238,2018-03-31,서대문구,0.0,0,2,1,2,5
2239,2018-03-31,서초구,0.0,0,16,2,2,20
2240,2018-03-31,성동구,0.0,0,2,0,1,3
2241,2018-03-31,성북구,0.0,0,3,1,0,4
2242,2018-03-31,송파구,0.0,0,3,1,1,5
2243,2018-03-31,양천구,0.0,0,2,0,1,3
2244,2018-03-31,영등포구,0.0,0,11,1,3,15
2245,2018-03-31,용산구,0.0,0,17,0,1,18
2246,2018-03-31,은평구,0.0,0,1,0,1,2
2247,2018-03-31,종로구,0.0,0,4,1,1,6
2248,2018-03-31,중구,0.0,0,7,2,2,11
2249,2018-03-31,중랑구,0.0,0,0,1,0,1
2250,2018-04-01,강남구,0.0,0,1,0,2,3
2251,2018-04-01,강동구,0.0,0,4,0,1,5
2252,2018-04-01,강북구,0.0,0,3,0,1,4
2253,2018-04-01,강서구,0.0,0,2,0,0,2
2254,2018-04-01,관악구,0.0,0,1,1,1,3
2255,2018-04-01,광진구,0.0,0,2,0,0,2
2256,2018-04-01,구로구,0.0,0,0,0,0,0
2257,2018-04-01,금천구,0.0,0,3,0,0,3
2258,2018-04-01,노원구,0.0,0,3,0,0,3
2259,2018-04-01,도봉구,0.0,0,3,1,1,5
2260,2018-04-01,동대문구,0.0,1,1,0,0,2
2261,2018-04-01,동작구,0.0,0,4,0,1,5
2262,2018-04-01,마포구,0.0,0,7,0,2,9
2263,2018-04-01,서대문구,0.0,0,7,0,1,8
2264,2018-04-01,서초구,0.0,0,4,1,0,5
2265,2018-04-01,성동구,0.0,0,2,0,0,2
2266,2018-04-01,성북구,0.0,0,2,0,0,2
2267,2018-04-01,송파구,0.0,0,5,0,4,9
2268,2018-04-01,양천구,0.0,0,1,1,2,4
2269,2018-04-01,영등포구,0.0,0,7,0,2,9
2270,2018-04-01,용산구,0.0,0,7,2,1,10
2271,2018-04-01,은평구,0.0,0,2,0,0,2
2272,2018-04-01,종로구,0.0,0,3,0,0,3
2273,2018-04-01,중구,0.0,0,2,0,0,2
2274,2018-04-01,중랑구,0.0,0,2,0,1,3
2275,2018-04-02,강남구,0.0,0,17,0,2,19
2276,2018-04-02,강동구,0.0,0,2,0,1,3
2277,2018-04-02,강북구,0.0,0,2,0,1,3
2278,2018-04-02,강서구,0.0,0,3,0,0,3
2279,2018-04-02,관악구,0.0,0,6,3,2,11
2280,2018-04-02,광진구,0.0,0,3,0,0,3
2281,2018-04-02,구로구,0.0,0,6,0,1,7
2282,2018-04-02,금천구,0.0,0,2,0,2,4
2283,2018-04-02,노원구,0.0,0,0,3,1,4
2284,2018-04-02,도봉구,0.0,0,3,0,1,4
2285,2018-04-02,동대문구,0.0,0,2,1,3,6
2286,2018-04-02,동작구,0.0,0,11,0,1,12
2287,2018-04-02,마포구,0.0,0,3,0,0,3
2288,2018-04-02,서대문구,0.0,1,3,1,0,5
2289,2018-04-02,서초구,0.0,0,3,0,1,4
2290,2018-04-02,성동구,0.0,0,5,0,1,6
2291,2018-04-02,성북구,0.0,0,10,1,2,13
2292,2018-04-02,송파구,0.0,0,12,1,0,13
2293,2018-04-02,양천구,0.0,0,2,0,1,3
2294,2018-04-02,영등포구,0.0,0,3,0,2,5
2295,2018-04-02,용산구,0.0,0,3,0,0,3
2296,2018-04-02,은평구,0.0,0,5,2,0,7
2297,2018-04-02,종로구,0.0,0,4,0,2,6
2298,2018-04-02,중구,0.0,0,2,3,1,6
2299,2018-04-02,중랑구,0.0,0,6,0,1,7
2300,2018-04-03,강남구,0.0,0,14,1,3,18
2301,2018-04-03,강동구,0.0,0,0,0,0,0
2302,2018-04-03,강북구,0.0,0,3,1,0,4
2303,2018-04-03,강서구,0.0,0,2,0,1,3
2304,2018-04-03,관악구,0.0,0,10,0,0,10
2305,2018-04-03,광진구,0.0,0,0,0,1,1
2306,2018-04-03,구로구,0.0,0,6,0,1,7
2307,2018-04-03,금천구,0.0,0,1,1,0,2
2308,2018-04-03,노원구,0.0,0,3,1,5,9
2309,2018-04-03,도봉구,0.0,0,1,0,1,2
2310,2018-04-03,동대문구,0.0,0,5,1,0,6
2311,2018-04-03,동작구,0.0,0,5,0,0,5
2312,2018-04-03,마포구,0.0,0,6,0,2,8
2313,2018-04-03,서대문구,0.0,0,3,1,0,4
2314,2018-04-03,서초구,0.0,0,4,0,4,8
2315,2018-04-03,성동구,0.0,0,4,0,3,7
2316,2018-04-03,성북구,0.0,0,12,0,6,18
2317,2018-04-03,송파구,0.0,0,8,0,2,10
2318,2018-04-03,양천구,0.0,0,2,0,2,4
2319,2018-04-03,영등포구,0.0,0,4,0,1,5
2320,2018-04-03,용산구,0.0,0,7,1,0,8
2321,2018-04-03,은평구,0.0,0,4,0,3,7
2322,2018-04-03,종로구,0.1,0,6,0,2,8
2323,2018-04-03,중구,0.0,0,5,0,1,6
2324,2018-04-03,중랑구,0.0,0,9,0,2,11
2325,2018-04-04,강남구,20.5,0,15,0,3,18
2326,2018-04-04,강동구,17.0,0,3,0,3,6
2327,2018-04-04,강북구,11.5,0,2,0,1,3
2328,2018-04-04,강서구,13.5,0,2,0,1,3
2329,2018-04-04,관악구,22.0,0,2,1,1,4
2330,2018-04-04,광진구,17.5,0,1,0,2,3
2331,2018-04-04,구로구,16.0,0,1,0,0,1
2332,2018-04-04,금천구,17.0,0,1,0,1,2
2333,2018-04-04,노원구,15.0,0,3,0,1,4
2334,2018-04-04,도봉구,13.5,0,4,0,0,4
2335,2018-04-04,동대문구,17.0,0,2,2,4,8
2336,2018-04-04,동작구,19.25,0,5,0,0,5
2337,2018-04-04,마포구,15.0,0,3,0,1,4
2338,2018-04-04,서대문구,17.0,0,3,0,2,5
2339,2018-04-04,서초구,19.5,0,5,0,2,7
2340,2018-04-04,성동구,16.5,0,1,0,0,1
2341,2018-04-04,성북구,16.5,0,2,0,0,2
2342,2018-04-04,송파구,18.5,0,6,3,6,15
2343,2018-04-04,양천구,15.5,0,3,0,3,6
2344,2018-04-04,영등포구,18.0,0,5,0,1,6
2345,2018-04-04,용산구,17.0,0,6,0,0,6
2346,2018-04-04,은평구,17.0,0,2,0,0,2
2347,2018-04-04,종로구,18.5,0,1,1,0,2
2348,2018-04-04,중구,11.5,0,1,0,0,1
2349,2018-04-04,중랑구,17.5,0,3,1,0,4
2350,2018-04-05,강남구,17.5,0,13,2,5,20
2351,2018-04-05,강동구,13.5,0,3,1,3,7
2352,2018-04-05,강북구,11.0,0,1,0,0,1
2353,2018-04-05,강서구,10.0,0,4,1,0,5
2354,2018-04-05,관악구,14.25,0,3,0,1,4
2355,2018-04-05,광진구,14.0,0,4,0,4,8
2356,2018-04-05,구로구,12.0,0,2,0,0,2
2357,2018-04-05,금천구,11.5,0,2,2,1,5
2358,2018-04-05,노원구,8.5,0,6,2,2,10
2359,2018-04-05,도봉구,16.5,0,1,0,1,2
2360,2018-04-05,동대문구,11.5,0,3,0,2,5
2361,2018-04-05,동작구,12.0,0,4,1,0,5
2362,2018-04-05,마포구,10.5,0,5,3,2,10
2363,2018-04-05,서대문구,13.0,0,1,0,1,2
2364,2018-04-05,서초구,14.0,1,10,0,4,15
2365,2018-04-05,성동구,13.5,0,3,0,0,3
2366,2018-04-05,성북구,12.5,0,6,0,4,10
2367,2018-04-05,송파구,14.5,0,6,0,3,9
2368,2018-04-05,양천구,11.5,0,3,1,3,7
2369,2018-04-05,영등포구,9.0,0,11,0,0,11
2370,2018-04-05,용산구,12.5,0,3,0,4,7
2371,2018-04-05,은평구,7.5,0,3,0,1,4
2372,2018-04-05,종로구,10.5,0,4,1,1,6
2373,2018-04-05,중구,7.5,0,5,0,0,5
2374,2018-04-05,중랑구,13.5,0,5,0,3,8
2375,2018-04-06,강남구,9.0,1,3,3,4,11
2376,2018-04-06,강동구,8.0,0,4,1,3,8
2377,2018-04-06,강북구,4.5,0,4,0,1,5
2378,2018-04-06,강서구,7.5,0,7,0,1,8
2379,2018-04-06,관악구,9.25,0,4,0,1,5
2380,2018-04-06,광진구,8.0,0,5,0,1,6
2381,2018-04-06,구로구,7.0,0,8,0,2,10
2382,2018-04-06,금천구,8.0,0,4,0,1,5
2383,2018-04-06,노원구,6.0,0,7,0,0,7
2384,2018-04-06,도봉구,8.0,0,1,1,0,2
2385,2018-04-06,동대문구,7.5,1,3,0,3,7
2386,2018-04-06,동작구,8.25,0,2,0,1,3
2387,2018-04-06,마포구,6.5,0,8,4,1,13
2388,2018-04-06,서대문구,8.0,0,3,1,2,6
2389,2018-04-06,서초구,9.5,0,5,1,4,10
2390,2018-04-06,성동구,8.5,0,5,0,1,6
2391,2018-04-06,성북구,7.5,0,4,0,2,6
2392,2018-04-06,송파구,7.5,0,6,4,4,14
2393,2018-04-06,양천구,7.0,0,3,0,0,3
2394,2018-04-06,영등포구,7.5,0,11,2,2,15
2395,2018-04-06,용산구,7.5,0,2,0,0,2
2396,2018-04-06,은평구,7.0,0,1,0,1,2
2397,2018-04-06,종로구,6.5,0,2,0,0,2
2398,2018-04-06,중구,6.5,0,4,0,1,5
2399,2018-04-06,중랑구,7.5,0,1,0,3,4
2400,2018-04-07,강남구,0.0,0,7,0,8,15
2401,2018-04-07,강동구,0.0,0,2,1,5,8
2402,2018-04-07,강북구,0.0,0,1,0,0,1
2403,2018-04-07,강서구,0.0,0,9,0,5,14
2404,2018-04-07,관악구,0.25,0,2,2,0,4
2405,2018-04-07,광진구,0.0,0,8,0,1,9
2406,2018-04-07,구로구,0.0,0,6,1,0,7
2407,2018-04-07,금천구,0.0,1,4,0,1,6
2408,2018-04-07,노원구,0.0,0,4,1,0,5
2409,2018-04-07,도봉구,0.0,0,2,0,1,3
2410,2018-04-07,동대문구,0.0,0,6,2,0,8
2411,2018-04-07,동작구,0.0,0,1,0,1,2
2412,2018-04-07,마포구,0.0,0,8,0,0,8
2413,2018-04-07,서대문구,0.0,0,7,1,1,9
2414,2018-04-07,서초구,0.0,0,6,1,0,7
2415,2018-04-07,성동구,0.5,0,0,1,2,3
2416,2018-04-07,성북구,0.5,0,2,1,1,4
2417,2018-04-07,송파구,0.0,0,16,5,7,28
2418,2018-04-07,양천구,0.0,0,3,1,0,4
2419,2018-04-07,영등포구,0.0,0,4,1,1,6
2420,2018-04-07,용산구,0.0,0,2,1,5,8
2421,2018-04-07,은평구,0.5,0,5,1,0,6
2422,2018-04-07,종로구,0.2,0,9,1,5,15
2423,2018-04-07,중구,0.0,0,7,1,1,9
2424,2018-04-07,중랑구,0.0,0,4,0,2,6
2425,2018-04-08,강남구,4.0,0,17,1,2,20
2426,2018-04-08,강동구,3.5,1,0,0,0,1
2427,2018-04-08,강북구,3.0,0,9,0,2,11
2428,2018-04-08,강서구,2.0,0,4,1,2,7
2429,2018-04-08,관악구,4.25,0,4,0,1,5
2430,2018-04-08,광진구,3.5,0,0,0,2,2
2431,2018-04-08,구로구,4.5,0,2,0,0,2
2432,2018-04-08,금천구,3.5,0,6,0,0,6
2433,2018-04-08,노원구,2.5,0,1,1,1,3
2434,2018-04-08,도봉구,5.0,0,3,3,1,7
2435,2018-04-08,동대문구,4.5,0,5,0,1,6
2436,2018-04-08,동작구,3.75,0,4,1,3,8
2437,2018-04-08,마포구,3.0,0,3,1,0,4
2438,2018-04-08,서대문구,4.5,0,2,0,0,2
2439,2018-04-08,서초구,4.0,0,2,0,0,2
2440,2018-04-08,성동구,4.0,0,2,0,0,2
2441,2018-04-08,성북구,3.0,0,5,0,0,5
2442,2018-04-08,송파구,3.5,0,7,0,3,10
2443,2018-04-08,양천구,3.0,0,5,0,1,6
2444,2018-04-08,영등포구,3.0,0,5,0,6,11
2445,2018-04-08,용산구,3.5,0,8,0,1,9
2446,2018-04-08,은평구,3.5,0,1,0,1,2
2447,2018-04-08,종로구,3.0,0,0,1,2,3
2448,2018-04-08,중구,0.5,0,2,0,0,2
2449,2018-04-08,중랑구,4.0,0,3,0,0,3
2450,2018-04-09,강남구,0.0,0,4,2,1,7
2451,2018-04-09,강동구,0.0,0,2,0,3,5
2452,2018-04-09,강북구,0.0,0,0,0,0,0
2453,2018-04-09,강서구,0.0,0,2,0,0,2
2454,2018-04-09,관악구,0.0,0,8,0,0,8
2455,2018-04-09,광진구,0.0,0,1,1,3,5
2456,2018-04-09,구로구,0.0,0,11,2,3,16
2457,2018-04-09,금천구,0.0,0,2,0,1,3
2458,2018-04-09,노원구,0.0,0,6,0,0,6
2459,2018-04-09,도봉구,0.0,0,3,0,0,3
2460,2018-04-09,동대문구,0.0,0,0,0,3,3
2461,2018-04-09,동작구,0.0,0,6,0,1,7
2462,2018-04-09,마포구,0.0,0,3,0,0,3
2463,2018-04-09,서대문구,0.0,0,3,1,2,6
2464,2018-04-09,서초구,0.0,0,3,2,1,6
2465,2018-04-09,성동구,0.0,0,3,0,0,3
2466,2018-04-09,성북구,0.0,0,2,0,1,3
2467,2018-04-09,송파구,0.0,0,11,0,2,13
2468,2018-04-09,양천구,0.0,0,3,0,0,3
2469,2018-04-09,영등포구,0.0,0,9,0,0,9
2470,2018-04-09,용산구,0.0,0,4,0,2,6
2471,2018-04-09,은평구,0.0,0,7,0,1,8
2472,2018-04-09,종로구,0.0,0,5,1,1,7
2473,2018-04-09,중구,0.0,0,5,0,1,6
2474,2018-04-09,중랑구,0.0,0,4,0,4,8
2475,2018-04-10,강남구,3.5,0,4,0,3,7
2476,2018-04-10,강동구,0.0,0,3,1,2,6
2477,2018-04-10,강북구,6.0,1,2,0,0,3
2478,2018-04-10,강서구,3.0,0,4,0,1,5
2479,2018-04-10,관악구,3.5,0,0,0,1,1
2480,2018-04-10,광진구,0.0,0,0,0,1,1
2481,2018-04-10,구로구,1.5,0,5,1,2,8
2482,2018-04-10,금천구,1.5,0,3,0,0,3
2483,2018-04-10,노원구,0.0,0,8,0,1,9
2484,2018-04-10,도봉구,6.0,0,1,0,0,1
2485,2018-04-10,동대문구,7.0,0,2,0,2,4
2486,2018-04-10,동작구,2.5,0,3,0,0,3
2487,2018-04-10,마포구,4.0,1,2,2,1,6
2488,2018-04-10,서대문구,4.5,0,2,1,5,8
2489,2018-04-10,서초구,3.0,0,3,2,1,6
2490,2018-04-10,성동구,4.0,0,2,0,1,3
2491,2018-04-10,성북구,5.0,0,4,0,1,5
2492,2018-04-10,송파구,3.5,0,12,2,8,22
2493,2018-04-10,양천구,3.0,0,1,1,2,4
2494,2018-04-10,영등포구,3.5,0,9,0,2,11
2495,2018-04-10,용산구,1.5,0,4,0,0,4
2496,2018-04-10,은평구,4.0,0,6,0,0,6
2497,2018-04-10,종로구,5.0,0,0,0,0,0
2498,2018-04-10,중구,4.5,0,3,1,1,5
2499,2018-04-10,중랑구,6.5,0,6,0,0,6
2500,2018-04-11,강남구,0.0,0,7,0,2,9
2501,2018-04-11,강동구,0.0,0,2,1,1,4
2502,2018-04-11,강북구,0.0,0,1,0,2,3
2503,2018-04-11,강서구,0.0,0,4,0,2,6
2504,2018-04-11,관악구,0.0,0,3,0,1,4
2505,2018-04-11,광진구,0.0,0,6,0,0,6
2506,2018-04-11,구로구,0.0,0,2,0,0,2
2507,2018-04-11,금천구,0.0,0,2,1,1,4
2508,2018-04-11,노원구,0.0,0,2,1,0,3
2509,2018-04-11,도봉구,0.0,0,1,0,1,2
2510,2018-04-11,동대문구,0.0,0,2,0,1,3
2511,2018-04-11,동작구,0.0,0,2,0,2,4
2512,2018-04-11,마포구,0.0,0,0,0,0,0
2513,2018-04-11,서대문구,0.0,0,1,1,1,3
2514,2018-04-11,서초구,0.0,0,4,0,2,6
2515,2018-04-11,성동구,0.0,0,2,0,1,3
2516,2018-04-11,성북구,0.0,0,0,0,0,0
2517,2018-04-11,송파구,0.0,0,3,2,1,6
2518,2018-04-11,양천구,0.0,0,7,0,1,8
2519,2018-04-11,영등포구,0.0,0,5,0,0,5
2520,2018-04-11,용산구,0.0,0,5,0,1,6
2521,2018-04-11,은평구,0.0,0,3,0,1,4
2522,2018-04-11,종로구,0.0,0,0,0,2,2
2523,2018-04-11,중구,0.0,0,2,0,2,4
2524,2018-04-11,중랑구,0.0,0,4,0,1,5
2525,2018-04-12,강남구,0.0,0,15,1,5,21
2526,2018-04-12,강동구,0.0,0,3,5,4,12
2527,2018-04-12,강북구,0.0,0,3,0,0,3
2528,2018-04-12,강서구,0.0,0,2,0,0,2
2529,2018-04-12,관악구,0.0,0,3,0,2,5
2530,2018-04-12,광진구,0.0,0,2,0,2,4
2531,2018-04-12,구로구,0.0,0,3,0,3,6
2532,2018-04-12,금천구,0.0,0,1,0,2,3
2533,2018-04-12,노원구,0.0,0,1,0,0,1
2534,2018-04-12,도봉구,0.0,0,1,1,0,2
2535,2018-04-12,동대문구,0.0,0,4,0,1,5
2536,2018-04-12,동작구,0.0,0,2,0,2,4
2537,2018-04-12,마포구,0.0,0,5,1,1,7
2538,2018-04-12,서대문구,0.0,0,2,2,1,5
2539,2018-04-12,서초구,0.0,0,13,0,1,14
2540,2018-04-12,성동구,0.0,0,2,0,0,2
2541,2018-04-12,성북구,0.0,0,2,0,0,2
2542,2018-04-12,송파구,0.0,1,8,1,4,14
2543,2018-04-12,양천구,0.0,0,3,0,1,4
2544,2018-04-12,영등포구,0.0,0,8,3,2,13
2545,2018-04-12,용산구,0.0,0,2,0,1,3
2546,2018-04-12,은평구,0.0,0,0,1,0,1
2547,2018-04-12,종로구,0.0,0,3,0,3,6
2548,2018-04-12,중구,0.0,0,5,2,2,9
2549,2018-04-12,중랑구,0.0,0,2,1,3,6
2550,2018-04-13,강남구,0.0,0,12,0,0,12
2551,2018-04-13,강동구,0.0,0,2,0,3,5
2552,2018-04-13,강북구,0.0,0,2,1,1,4
2553,2018-04-13,강서구,0.0,0,3,0,1,4
2554,2018-04-13,관악구,0.0,0,3,0,2,5
2555,2018-04-13,광진구,0.0,0,3,2,1,6
2556,2018-04-13,구로구,0.0,0,9,0,0,9
2557,2018-04-13,금천구,0.0,0,5,0,0,5
2558,2018-04-13,노원구,0.0,0,3,0,3,6
2559,2018-04-13,도봉구,0.0,0,0,0,1,1
2560,2018-04-13,동대문구,0.0,0,4,1,3,8
2561,2018-04-13,동작구,0.0,1,2,1,0,4
2562,2018-04-13,마포구,0.0,0,7,1,3,11
2563,2018-04-13,서대문구,0.0,1,1,0,3,5
2564,2018-04-13,서초구,0.0,0,2,0,2,4
2565,2018-04-13,성동구,0.0,0,4,0,3,7
2566,2018-04-13,성북구,0.0,0,0,0,0,0
2567,2018-04-13,송파구,0.0,0,11,3,1,15
2568,2018-04-13,양천구,0.0,0,4,0,2,6
2569,2018-04-13,영등포구,0.0,0,9,2,1,12
2570,2018-04-13,용산구,0.0,0,1,0,0,1
2571,2018-04-13,은평구,0.0,0,2,0,0,2
2572,2018-04-13,종로구,0.0,0,1,0,1,2
2573,2018-04-13,중구,0.0,0,4,3,3,10
2574,2018-04-13,중랑구,0.0,0,4,1,0,5
2575,2018-04-14,강남구,12.5,0,16,4,3,23
2576,2018-04-14,강동구,11.0,0,2,1,0,3
2577,2018-04-14,강북구,7.5,0,3,0,0,3
2578,2018-04-14,강서구,7.0,0,2,0,0,2
2579,2018-04-14,관악구,13.0,0,0,0,1,1
2580,2018-04-14,광진구,11.5,0,2,0,0,2
2581,2018-04-14,구로구,9.5,0,3,0,3,6
2582,2018-04-14,금천구,10.5,0,2,0,4,6
2583,2018-04-14,노원구,9.0,0,7,0,3,10
2584,2018-04-14,도봉구,8.0,0,6,0,1,7
2585,2018-04-14,동대문구,11.5,0,3,1,3,7
2586,2018-04-14,동작구,10.0,1,2,0,0,3
2587,2018-04-14,마포구,9.5,0,3,0,0,3
2588,2018-04-14,서대문구,9.5,0,3,0,0,3
2589,2018-04-14,서초구,12.5,0,5,0,1,6
2590,2018-04-14,성동구,11.0,0,3,0,0,3
2591,2018-04-14,성북구,8.5,0,5,1,1,7
2592,2018-04-14,송파구,12.5,0,9,3,2,14
2593,2018-04-14,양천구,9.0,0,0,0,1,1
2594,2018-04-14,영등포구,8.25,0,4,2,1,7
2595,2018-04-14,용산구,9.0,0,1,0,3,4
2596,2018-04-14,은평구,8.0,0,4,1,2,7
2597,2018-04-14,종로구,9.0,0,3,1,0,4
2598,2018-04-14,중구,6.5,0,0,0,0,0
2599,2018-04-14,중랑구,11.5,0,2,0,1,3
2600,2018-04-15,강남구,0.0,0,3,0,2,5
2601,2018-04-15,강동구,0.0,0,2,0,1,3
2602,2018-04-15,강북구,0.0,0,1,0,0,1
2603,2018-04-15,강서구,0.0,0,4,0,1,5
2604,2018-04-15,관악구,0.0,0,3,0,2,5
2605,2018-04-15,광진구,0.0,0,1,0,0,1
2606,2018-04-15,구로구,0.0,0,0,0,0,0
2607,2018-04-15,금천구,0.0,0,5,0,2,7
2608,2018-04-15,노원구,0.0,0,0,0,0,0
2609,2018-04-15,도봉구,0.0,0,0,0,0,0
2610,2018-04-15,동대문구,0.0,0,1,3,3,7
2611,2018-04-15,동작구,0.0,0,5,1,1,7
2612,2018-04-15,마포구,0.0,0,1,0,1,2
2613,2018-04-15,서대문구,0.0,0,0,1,0,1
2614,2018-04-15,서초구,0.0,0,2,0,0,2
2615,2018-04-15,성동구,0.0,0,2,0,1,3
2616,2018-04-15,성북구,0.0,0,13,0,4,17
2617,2018-04-15,송파구,0.0,1,7,1,0,9
2618,2018-04-15,양천구,0.0,0,0,0,0,0
2619,2018-04-15,영등포구,0.0,0,7,0,1,8
2620,2018-04-15,용산구,0.0,0,1,0,1,2
2621,2018-04-15,은평구,0.0,0,2,0,0,2
2622,2018-04-15,종로구,0.0,0,1,0,1,2
2623,2018-04-15,중구,0.0,0,0,0,0,0
2624,2018-04-15,중랑구,0.0,0,1,0,2,3
2625,2018-04-16,강남구,0.0,0,3,0,3,6
2626,2018-04-16,강동구,0.0,0,1,1,0,2
2627,2018-04-16,강북구,0.0,0,6,0,2,8
2628,2018-04-16,강서구,0.0,0,4,1,0,5
2629,2018-04-16,관악구,0.0,0,8,0,2,10
2630,2018-04-16,광진구,0.0,0,3,1,1,5
2631,2018-04-16,구로구,0.0,0,7,0,1,8
2632,2018-04-16,금천구,0.0,0,0,0,2,2
2633,2018-04-16,노원구,0.0,0,4,3,2,9
2634,2018-04-16,도봉구,0.0,0,1,2,0,3
2635,2018-04-16,동대문구,0.0,0,0,1,1,2
2636,2018-04-16,동작구,0.0,0,3,0,0,3
2637,2018-04-16,마포구,0.0,0,13,0,0,13
2638,2018-04-16,서대문구,0.0,0,0,0,0,0
2639,2018-04-16,서초구,0.0,0,4,1,0,5
2640,2018-04-16,성동구,0.0,0,5,0,0,5
2641,2018-04-16,성북구,0.0,0,10,0,1,11
2642,2018-04-16,송파구,0.0,1,14,1,3,19
2643,2018-04-16,양천구,0.0,0,0,0,4,4
2644,2018-04-16,영등포구,0.0,0,10,1,3,14
2645,2018-04-16,용산구,0.0,0,3,0,0,3
2646,2018-04-16,은평구,0.0,0,6,0,1,7
2647,2018-04-16,종로구,0.0,0,2,1,1,4
2648,2018-04-16,중구,0.0,0,2,0,0,2
2649,2018-04-16,중랑구,0.0,0,2,0,0,2
2650,2018-04-17,강남구,0.0,0,14,1,2,17
2651,2018-04-17,강동구,0.0,0,3,0,2,5
2652,2018-04-17,강북구,0.0,0,4,0,0,4
2653,2018-04-17,강서구,0.0,0,18,3,2,23
2654,2018-04-17,관악구,0.0,0,10,1,1,12
2655,2018-04-17,광진구,0.0,0,1,1,3,5
2656,2018-04-17,구로구,0.0,0,6,0,5,11
2657,2018-04-17,금천구,0.0,0,2,0,0,2
2658,2018-04-17,노원구,0.0,0,4,0,1,5
2659,2018-04-17,도봉구,0.0,0,0,0,0,0
2660,2018-04-17,동대문구,0.0,0,4,1,2,7
2661,2018-04-17,동작구,0.0,1,3,0,0,4
2662,2018-04-17,마포구,0.0,0,10,1,0,11
2663,2018-04-17,서대문구,0.0,0,7,1,1,9
2664,2018-04-17,서초구,0.0,0,3,0,4,7
2665,2018-04-17,성동구,0.0,0,2,0,1,3
2666,2018-04-17,성북구,0.0,0,2,0,5,7
2667,2018-04-17,송파구,0.0,0,10,0,0,10
2668,2018-04-17,양천구,0.0,0,5,0,0,5
2669,2018-04-17,영등포구,0.0,0,12,0,2,14
2670,2018-04-17,용산구,0.0,0,2,1,0,3
2671,2018-04-17,은평구,0.0,0,1,0,2,3
2672,2018-04-17,종로구,0.0,0,2,0,0,2
2673,2018-04-17,중구,0.0,0,1,0,2,3
2674,2018-04-17,중랑구,0.0,0,2,1,1,4
2675,2018-04-18,강남구,0.0,0,8,5,3,16
2676,2018-04-18,강동구,0.0,0,1,0,0,1
2677,2018-04-18,강북구,0.0,0,6,0,1,7
2678,2018-04-18,강서구,0.0,0,5,3,5,13
2679,2018-04-18,관악구,0.0,0,5,0,1,6
2680,2018-04-18,광진구,0.0,0,5,0,0,5
2681,2018-04-18,구로구,0.0,0,1,0,0,1
2682,2018-04-18,금천구,0.0,0,3,0,2,5
2683,2018-04-18,노원구,0.0,0,1,0,2,3
2684,2018-04-18,도봉구,0.0,0,1,0,1,2
2685,2018-04-18,동대문구,0.0,0,4,0,1,5
2686,2018-04-18,동작구,0.0,0,11,1,1,13
2687,2018-04-18,마포구,0.0,0,4,0,1,5
2688,2018-04-18,서대문구,0.0,0,10,0,3,13
2689,2018-04-18,서초구,0.0,0,20,1,3,24
2690,2018-04-18,성동구,0.0,0,3,0,0,3
2691,2018-04-18,성북구,0.0,0,2,0,1,3
2692,2018-04-18,송파구,0.0,0,6,1,2,9
2693,2018-04-18,양천구,0.0,0,3,0,0,3
2694,2018-04-18,영등포구,0.0,0,7,0,0,7
2695,2018-04-18,용산구,0.0,0,2,1,1,4
2696,2018-04-18,은평구,0.0,0,1,1,1,3
2697,2018-04-18,종로구,0.0,0,1,1,0,2
2698,2018-04-18,중구,0.0,0,6,0,2,8
2699,2018-04-18,중랑구,0.0,0,4,0,0,4
2700,2018-04-19,강남구,0.0,0,12,0,1,13
2701,2018-04-19,강동구,0.0,0,1,0,1,2
2702,2018-04-19,강북구,0.0,0,5,0,2,7
2703,2018-04-19,강서구,0.0,0,3,2,0,5
2704,2018-04-19,관악구,0.0,0,2,0,1,3
2705,2018-04-19,광진구,0.0,0,4,0,1,5
2706,2018-04-19,구로구,0.0,0,3,2,1,6
2707,2018-04-19,금천구,0.0,0,0,0,0,0
2708,2018-04-19,노원구,0.0,0,3,2,1,6
2709,2018-04-19,도봉구,0.0,0,0,0,1,1
2710,2018-04-19,동대문구,0.0,0,3,1,2,6
2711,2018-04-19,동작구,0.0,0,12,1,0,13
2712,2018-04-19,마포구,0.0,0,3,0,1,4
2713,2018-04-19,서대문구,0.0,0,3,0,1,4
2714,2018-04-19,서초구,0.0,0,9,2,4,15
2715,2018-04-19,성동구,0.0,0,3,0,1,4
2716,2018-04-19,성북구,0.0,0,3,1,0,4
2717,2018-04-19,송파구,0.0,0,4,1,3,8
2718,2018-04-19,양천구,0.0,0,6,2,2,10
2719,2018-04-19,영등포구,0.0,0,3,1,2,6
2720,2018-04-19,용산구,0.0,0,4,0,1,5
2721,2018-04-19,은평구,0.0,0,9,0,0,9
2722,2018-04-19,종로구,0.0,0,2,0,0,2
2723,2018-04-19,중구,0.0,0,5,1,0,6
2724,2018-04-19,중랑구,0.0,0,2,0,1,3
2725,2018-04-20,강남구,0.0,0,9,1,6,16
2726,2018-04-20,강동구,0.0,0,3,3,1,7
2727,2018-04-20,강북구,0.0,0,8,2,0,10
2728,2018-04-20,강서구,0.0,0,2,0,1,3
2729,2018-04-20,관악구,0.0,0,2,0,2,4
2730,2018-04-20,광진구,0.0,0,3,0,1,4
2731,2018-04-20,구로구,0.0,0,4,0,1,5
2732,2018-04-20,금천구,0.0,0,3,0,0,3
2733,2018-04-20,노원구,0.0,0,8,0,2,10
2734,2018-04-20,도봉구,0.0,0,1,0,2,3
2735,2018-04-20,동대문구,0.0,0,7,0,1,8
2736,2018-04-20,동작구,0.0,0,6,1,1,8
2737,2018-04-20,마포구,0.0,0,7,0,2,9
2738,2018-04-20,서대문구,0.0,0,0,2,3,5
2739,2018-04-20,서초구,0.0,0,13,5,2,20
2740,2018-04-20,성동구,0.0,0,1,0,0,1
2741,2018-04-20,성북구,0.0,0,3,0,1,4
2742,2018-04-20,송파구,0.0,0,7,1,3,11
2743,2018-04-20,양천구,0.0,0,1,0,0,1
2744,2018-04-20,영등포구,0.0,0,6,0,1,7
2745,2018-04-20,용산구,0.0,0,2,2,2,6
2746,2018-04-20,은평구,0.0,0,1,0,1,2
2747,2018-04-20,종로구,0.0,0,4,0,0,4
2748,2018-04-20,중구,0.0,0,1,0,0,1
2749,2018-04-20,중랑구,0.0,0,4,0,2,6
2750,2018-04-21,강남구,0.0,0,18,1,3,22
2751,2018-04-21,강동구,0.0,0,3,1,2,6
2752,2018-04-21,강북구,0.0,0,9,0,1,10
2753,2018-04-21,강서구,0.0,0,10,2,1,13
2754,2018-04-21,관악구,0.0,0,1,0,1,2
2755,2018-04-21,광진구,0.0,0,4,0,0,4
2756,2018-04-21,구로구,0.0,0,8,0,2,10
2757,2018-04-21,금천구,0.0,0,5,1,2,8
2758,2018-04-21,노원구,0.0,0,6,1,1,8
2759,2018-04-21,도봉구,0.0,0,2,1,1,4
2760,2018-04-21,동대문구,0.0,0,1,0,1,2
2761,2018-04-21,동작구,0.0,0,10,5,2,17
2762,2018-04-21,마포구,0.0,0,2,1,0,3
2763,2018-04-21,서대문구,0.0,0,4,0,0,4
2764,2018-04-21,서초구,0.0,0,10,3,1,14
2765,2018-04-21,성동구,0.0,0,5,0,3,8
2766,2018-04-21,성북구,0.0,0,9,0,1,10
2767,2018-04-21,송파구,0.0,0,12,2,6,20
2768,2018-04-21,양천구,0.0,0,3,1,1,5
2769,2018-04-21,영등포구,0.0,0,15,0,2,17
2770,2018-04-21,용산구,0.0,0,7,1,3,11
2771,2018-04-21,은평구,0.0,0,6,0,0,6
2772,2018-04-21,종로구,0.0,0,0,0,1,1
2773,2018-04-21,중구,0.0,1,0,0,1,2
2774,2018-04-21,중랑구,0.0,0,7,2,0,9
2775,2018-04-22,강남구,10.0,0,10,0,3,13
2776,2018-04-22,강동구,9.5,1,9,0,2,12
2777,2018-04-22,강북구,13.0,0,3,0,1,4
2778,2018-04-22,강서구,15.5,0,3,0,2,5
2779,2018-04-22,관악구,12.0,0,6,0,0,6
2780,2018-04-22,광진구,9.5,0,1,0,1,2
2781,2018-04-22,구로구,11.5,0,2,0,2,4
2782,2018-04-22,금천구,9.5,0,1,0,0,1
2783,2018-04-22,노원구,14.0,0,4,1,4,9
2784,2018-04-22,도봉구,14.0,0,3,1,2,6
2785,2018-04-22,동대문구,15.0,0,5,2,2,9
2786,2018-04-22,동작구,9.5,0,2,1,0,3
2787,2018-04-22,마포구,12.0,0,8,0,1,9
2788,2018-04-22,서대문구,16.5,0,2,0,0,2
2789,2018-04-22,서초구,8.5,0,2,1,1,4
2790,2018-04-22,성동구,12.5,0,6,4,3,13
2791,2018-04-22,성북구,17.0,0,3,0,0,3
2792,2018-04-22,송파구,7.5,0,4,1,0,5
2793,2018-04-22,양천구,13.0,0,6,0,0,6
2794,2018-04-22,영등포구,9.25,0,2,2,1,5
2795,2018-04-22,용산구,8.5,0,3,0,0,3
2796,2018-04-22,은평구,16.0,0,4,1,1,6
2797,2018-04-22,종로구,15.5,0,2,0,1,3
2798,2018-04-22,중구,3.5,0,1,2,0,3
2799,2018-04-22,중랑구,16.0,0,5,1,0,6
2800,2018-04-23,강남구,67.5,0,16,2,3,21
2801,2018-04-23,강동구,56.0,0,2,1,1,4
2802,2018-04-23,강북구,61.5,0,2,0,2,4
2803,2018-04-23,강서구,47.5,0,6,0,1,7
2804,2018-04-23,관악구,63.25,0,2,0,1,3
2805,2018-04-23,광진구,60.5,0,6,1,0,7
2806,2018-04-23,구로구,58.5,0,5,0,0,5
2807,2018-04-23,금천구,53.0,0,4,2,0,6
2808,2018-04-23,노원구,56.0,0,7,0,2,9
2809,2018-04-23,도봉구,76.0,0,0,0,0,0
2810,2018-04-23,동대문구,63.0,0,5,1,0,6
2811,2018-04-23,동작구,49.5,0,3,0,0,3
2812,2018-04-23,마포구,55.5,0,0,1,1,2
2813,2018-04-23,서대문구,56.5,0,1,0,1,2
2814,2018-04-23,서초구,63.0,0,3,0,1,4
2815,2018-04-23,성동구,66.0,0,2,0,0,2
2816,2018-04-23,성북구,64.5,0,3,0,0,3
2817,2018-04-23,송파구,59.5,0,3,1,5,9
2818,2018-04-23,양천구,58.5,0,6,0,1,7
2819,2018-04-23,영등포구,44.75,0,12,1,2,15
2820,2018-04-23,용산구,49.5,0,2,0,0,2
2821,2018-04-23,은평구,40.0,0,2,0,0,2
2822,2018-04-23,종로구,59.0,0,0,0,0,0
2823,2018-04-23,중구,22.0,0,6,0,2,8
2824,2018-04-23,중랑구,67.5,0,2,0,0,2
2825,2018-04-24,강남구,1.5,0,6,2,0,8
2826,2018-04-24,강동구,1.0,0,3,0,3,6
2827,2018-04-24,강북구,1.5,0,6,0,1,7
2828,2018-04-24,강서구,4.5,0,16,2,2,20
2829,2018-04-24,관악구,0.75,0,4,0,2,6
2830,2018-04-24,광진구,2.0,0,5,0,0,5
2831,2018-04-24,구로구,1.0,0,4,0,1,5
2832,2018-04-24,금천구,0.5,0,1,0,1,2
2833,2018-04-24,노원구,3.0,0,6,0,1,7
2834,2018-04-24,도봉구,1.0,0,0,0,1,1
2835,2018-04-24,동대문구,3.0,0,8,0,0,8
2836,2018-04-24,동작구,0.75,0,4,1,1,6
2837,2018-04-24,마포구,2.0,0,3,0,1,4
2838,2018-04-24,서대문구,3.5,0,1,0,0,1
2839,2018-04-24,서초구,0.5,0,7,0,0,7
2840,2018-04-24,성동구,1.0,0,4,1,1,6
2841,2018-04-24,성북구,2.5,0,3,0,1,4
2842,2018-04-24,송파구,1.5,0,7,0,0,7
2843,2018-04-24,양천구,1.5,0,0,1,0,1
2844,2018-04-24,영등포구,0.75,1,3,1,2,7
2845,2018-04-24,용산구,0.5,0,0,0,1,1
2846,2018-04-24,은평구,1.0,0,3,0,0,3
2847,2018-04-24,종로구,3.0,0,9,0,0,9
2848,2018-04-24,중구,0.5,0,5,1,2,8
2849,2018-04-24,중랑구,3.0,0,3,0,0,3
2850,2018-04-25,강남구,0.0,0,19,0,2,21
2851,2018-04-25,강동구,0.0,0,4,0,2,6
2852,2018-04-25,강북구,0.0,0,10,0,2,12
2853,2018-04-25,강서구,0.0,0,0,2,0,2
2854,2018-04-25,관악구,0.0,0,1,0,0,1
2855,2018-04-25,광진구,0.0,0,7,0,2,9
2856,2018-04-25,구로구,0.0,0,1,0,0,1
2857,2018-04-25,금천구,0.0,0,0,1,0,1
2858,2018-04-25,노원구,0.0,1,7,0,2,10
2859,2018-04-25,도봉구,0.0,0,2,1,2,5
2860,2018-04-25,동대문구,0.0,0,2,1,1,4
2861,2018-04-25,동작구,0.0,0,2,1,4,7
2862,2018-04-25,마포구,0.0,0,3,0,0,3
2863,2018-04-25,서대문구,0.0,0,5,0,1,6
2864,2018-04-25,서초구,0.0,0,8,0,2,10
2865,2018-04-25,성동구,0.0,0,1,0,1,2
2866,2018-04-25,성북구,0.0,0,6,1,2,9
2867,2018-04-25,송파구,0.0,0,13,2,6,21
2868,2018-04-25,양천구,0.0,0,6,0,2,8
2869,2018-04-25,영등포구,0.0,0,5,0,0,5
2870,2018-04-25,용산구,0.0,0,7,0,0,7
2871,2018-04-25,은평구,0.0,0,0,0,1,1
2872,2018-04-25,종로구,0.0,0,2,1,3,6
2873,2018-04-25,중구,0.0,0,0,0,2,2
2874,2018-04-25,중랑구,0.0,0,11,0,0,11
2875,2018-04-26,강남구,0.0,0,2,0,1,3
2876,2018-04-26,강동구,0.0,0,6,2,3,11
2877,2018-04-26,강북구,0.0,0,3,0,2,5
2878,2018-04-26,강서구,0.0,0,6,1,3,10
2879,2018-04-26,관악구,0.0,0,1,0,0,1
2880,2018-04-26,광진구,0.0,0,1,1,0,2
2881,2018-04-26,구로구,0.0,0,0,0,3,3
2882,2018-04-26,금천구,0.0,0,5,1,2,8
2883,2018-04-26,노원구,0.0,0,3,1,0,4
2884,2018-04-26,도봉구,0.0,0,1,1,2,4
2885,2018-04-26,동대문구,0.0,0,3,1,1,5
2886,2018-04-26,동작구,0.0,0,10,1,1,12
2887,2018-04-26,마포구,0.0,0,7,0,0,7
2888,2018-04-26,서대문구,0.0,0,1,0,0,1
2889,2018-04-26,서초구,0.0,0,5,0,0,5
2890,2018-04-26,성동구,0.0,0,2,0,3,5
2891,2018-04-26,성북구,0.0,0,4,0,1,5
2892,2018-04-26,송파구,0.0,0,7,1,2,10
2893,2018-04-26,양천구,0.0,0,4,0,0,4
2894,2018-04-26,영등포구,0.0,0,7,2,3,12
2895,2018-04-26,용산구,0.0,0,1,1,1,3
2896,2018-04-26,은평구,0.0,0,0,1,1,2
2897,2018-04-26,종로구,0.0,0,3,0,1,4
2898,2018-04-26,중구,0.0,0,2,1,0,3
2899,2018-04-26,중랑구,0.0,0,2,3,2,7
2900,2018-04-27,강남구,0.0,0,8,4,5,17
2901,2018-04-27,강동구,0.0,0,3,0,0,3
2902,2018-04-27,강북구,0.0,0,3,0,1,4
2903,2018-04-27,강서구,0.0,0,5,1,1,7
2904,2018-04-27,관악구,0.0,0,3,1,0,4
2905,2018-04-27,광진구,0.0,0,1,0,2,3
2906,2018-04-27,구로구,0.0,0,6,1,0,7
2907,2018-04-27,금천구,0.0,0,1,0,1,2
2908,2018-04-27,노원구,0.0,0,3,1,3,7
2909,2018-04-27,도봉구,0.0,0,1,0,0,1
2910,2018-04-27,동대문구,0.0,0,10,0,3,13
2911,2018-04-27,동작구,0.0,0,2,1,4,7
2912,2018-04-27,마포구,0.0,0,6,1,0,7
2913,2018-04-27,서대문구,0.0,0,4,3,1,8
2914,2018-04-27,서초구,0.0,0,6,0,1,7
2915,2018-04-27,성동구,0.0,0,0,0,0,0
2916,2018-04-27,성북구,0.0,0,6,0,1,7
2917,2018-04-27,송파구,0.0,1,5,1,3,10
2918,2018-04-27,양천구,0.0,0,4,0,2,6
2919,2018-04-27,영등포구,0.0,0,9,0,2,11
2920,2018-04-27,용산구,0.0,0,8,1,3,12
2921,2018-04-27,은평구,0.0,0,2,0,1,3
2922,2018-04-27,종로구,0.0,0,1,0,0,1
2923,2018-04-27,중구,0.0,0,1,0,0,1
2924,2018-04-27,중랑구,0.0,0,7,0,2,9
2925,2018-04-28,강남구,0.0,0,10,1,2,13
2926,2018-04-28,강동구,0.0,0,3,1,2,6
2927,2018-04-28,강북구,0.0,0,1,1,0,2
2928,2018-04-28,강서구,0.0,0,8,2,1,11
2929,2018-04-28,관악구,0.0,0,3,0,1,4
2930,2018-04-28,광진구,0.0,0,3,1,3,7
2931,2018-04-28,구로구,0.0,1,0,0,0,1
2932,2018-04-28,금천구,0.0,0,1,1,0,2
2933,2018-04-28,노원구,0.0,0,3,1,1,5
2934,2018-04-28,도봉구,0.0,0,0,1,2,3
2935,2018-04-28,동대문구,0.0,0,0,0,1,1
2936,2018-04-28,동작구,0.0,0,4,2,0,6
2937,2018-04-28,마포구,0.0,0,6,0,3,9
2938,2018-04-28,서대문구,0.0,0,0,2,0,2
2939,2018-04-28,서초구,0.0,0,7,0,2,9
2940,2018-04-28,성동구,0.0,0,1,0,1,2
2941,2018-04-28,성북구,0.0,1,6,0,0,7
2942,2018-04-28,송파구,0.0,0,5,2,3,10
2943,2018-04-28,양천구,0.0,0,5,1,1,7
2944,2018-04-28,영등포구,0.0,0,2,1,2,5
2945,2018-04-28,용산구,0.0,0,10,0,3,13
2946,2018-04-28,은평구,0.0,1,4,1,0,6
2947,2018-04-28,종로구,0.0,0,2,0,0,2
2948,2018-04-28,중구,0.0,0,0,1,0,1
2949,2018-04-28,중랑구,0.0,0,1,1,3,5
2950,2018-04-29,강남구,0.0,0,5,1,5,11
2951,2018-04-29,강동구,0.0,0,2,0,1,3
2952,2018-04-29,강북구,0.0,0,2,0,0,2
2953,2018-04-29,강서구,0.0,0,3,0,1,4
2954,2018-04-29,관악구,0.0,0,8,0,0,8
2955,2018-04-29,광진구,0.0,0,1,0,1,2
2956,2018-04-29,구로구,0.0,0,2,0,0,2
2957,2018-04-29,금천구,0.0,0,1,0,1,2
2958,2018-04-29,노원구,0.0,0,2,1,0,3
2959,2018-04-29,도봉구,0.0,0,0,0,1,1
2960,2018-04-29,동대문구,0.0,0,4,0,2,6
2961,2018-04-29,동작구,0.0,0,0,0,1,1
2962,2018-04-29,마포구,0.0,0,2,0,1,3
2963,2018-04-29,서대문구,0.0,0,0,2,0,2
2964,2018-04-29,서초구,0.0,0,5,1,3,9
2965,2018-04-29,성동구,0.0,0,0,1,0,1
2966,2018-04-29,성북구,0.0,0,0,1,1,2
2967,2018-04-29,송파구,0.0,0,8,1,1,10
2968,2018-04-29,양천구,0.0,0,2,0,1,3
2969,2018-04-29,영등포구,0.0,0,3,1,2,6
2970,2018-04-29,용산구,0.0,0,3,0,2,5
2971,2018-04-29,은평구,0.0,0,1,0,0,1
2972,2018-04-29,종로구,0.0,0,3,0,0,3
2973,2018-04-29,중구,0.0,0,0,0,0,0
2974,2018-04-29,중랑구,0.0,0,3,0,1,4
2975,2018-04-30,강남구,0.0,0,6,1,0,7
2976,2018-04-30,강동구,0.0,0,1,1,2,4
2977,2018-04-30,강북구,0.0,0,1,0,1,2
2978,2018-04-30,강서구,0.0,0,5,1,1,7
2979,2018-04-30,관악구,0.0,0,2,1,0,3
2980,2018-04-30,광진구,0.0,0,0,0,2,2
2981,2018-04-30,구로구,0.0,0,5,3,0,8
2982,2018-04-30,금천구,0.0,0,7,0,0,7
2983,2018-04-30,노원구,0.0,0,3,0,3,6
2984,2018-04-30,도봉구,0.0,0,3,1,1,5
2985,2018-04-30,동대문구,0.0,0,1,0,0,1
2986,2018-04-30,동작구,0.0,0,0,0,2,2
2987,2018-04-30,마포구,0.0,0,1,0,1,2
2988,2018-04-30,서대문구,0.0,0,3,2,3,8
2989,2018-04-30,서초구,0.0,0,5,0,0,5
2990,2018-04-30,성동구,0.0,0,4,0,0,4
2991,2018-04-30,성북구,0.0,0,3,0,3,6
2992,2018-04-30,송파구,0.0,0,7,2,0,9
2993,2018-04-30,양천구,0.0,0,5,0,3,8
2994,2018-04-30,영등포구,0.0,0,3,0,3,6
2995,2018-04-30,용산구,0.0,0,4,0,1,5
2996,2018-04-30,은평구,0.0,0,2,0,2,4
2997,2018-04-30,종로구,0.0,0,3,0,0,3
2998,2018-04-30,중구,0.0,0,5,5,3,13
2999,2018-04-30,중랑구,0.0,0,1,1,0,2
3000,2018-05-01,강남구,0.0,0,11,1,4,16
3001,2018-05-01,강동구,0.0,0,18,1,7,26
3002,2018-05-01,강북구,0.0,0,2,0,2,4
3003,2018-05-01,강서구,0.0,0,3,0,0,3
3004,2018-05-01,관악구,0.0,0,4,0,1,5
3005,2018-05-01,광진구,0.0,0,3,0,0,3
3006,2018-05-01,구로구,0.0,0,3,2,1,6
3007,2018-05-01,금천구,0.0,0,2,0,0,2
3008,2018-05-01,노원구,0.0,0,2,1,1,4
3009,2018-05-01,도봉구,0.0,0,1,1,0,2
3010,2018-05-01,동대문구,0.0,0,6,1,0,7
3011,2018-05-01,동작구,0.0,0,3,1,0,4
3012,2018-05-01,마포구,0.0,0,4,0,2,6
3013,2018-05-01,서대문구,0.0,0,3,1,0,4
3014,2018-05-01,서초구,0.0,0,3,0,0,3
3015,2018-05-01,성동구,0.0,0,7,3,1,11
3016,2018-05-01,성북구,0.0,0,6,0,2,8
3017,2018-05-01,송파구,0.0,0,11,0,2,13
3018,2018-05-01,양천구,0.0,0,4,0,0,4
3019,2018-05-01,영등포구,0.0,0,5,0,1,6
3020,2018-05-01,용산구,0.0,0,3,1,3,7
3021,2018-05-01,은평구,0.0,0,3,0,0,3
3022,2018-05-01,종로구,0.0,0,0,0,1,1
3023,2018-05-01,중구,0.0,0,1,1,0,2
3024,2018-05-01,중랑구,0.0,0,2,0,1,3
3025,2018-05-02,강남구,5.5,0,6,1,3,10
3026,2018-05-02,강동구,4.5,0,2,0,1,3
3027,2018-05-02,강북구,17.0,0,1,1,2,4
3028,2018-05-02,강서구,4.5,0,3,1,0,4
3029,2018-05-02,관악구,6.25,0,1,0,0,1
3030,2018-05-02,광진구,5.0,0,2,0,1,3
3031,2018-05-02,구로구,4.5,0,2,0,1,3
3032,2018-05-02,금천구,10.0,0,9,0,3,12
3033,2018-05-02,노원구,14.5,0,5,1,0,6
3034,2018-05-02,도봉구,19.0,0,2,1,0,3
3035,2018-05-02,동대문구,11.0,0,9,0,2,11
3036,2018-05-02,동작구,6.0,0,7,0,3,10
3037,2018-05-02,마포구,11.0,0,1,0,1,2
3038,2018-05-02,서대문구,8.5,0,5,1,0,6
3039,2018-05-02,서초구,4.5,0,9,1,3,13
3040,2018-05-02,성동구,8.5,0,1,0,0,1
3041,2018-05-02,성북구,17.0,0,3,0,1,4
3042,2018-05-02,송파구,5.5,0,9,4,2,15
3043,2018-05-02,양천구,7.5,0,7,0,0,7
3044,2018-05-02,영등포구,6.25,0,6,0,1,7
3045,2018-05-02,용산구,10.5,0,2,0,1,3
3046,2018-05-02,은평구,13.0,0,3,0,1,4
3047,2018-05-02,종로구,12.0,0,4,1,1,6
3048,2018-05-02,중구,10.0,0,0,0,5,5
3049,2018-05-02,중랑구,14.0,0,3,0,2,5
3050,2018-05-03,강남구,5.5,0,14,0,1,15
3051,2018-05-03,강동구,1.5,0,4,2,1,7
3052,2018-05-03,강북구,0.0,0,4,0,3,7
3053,2018-05-03,강서구,0.0,0,3,0,2,5
3054,2018-05-03,관악구,3.0,0,8,1,2,11
3055,2018-05-03,광진구,7.5,0,2,0,0,2
3056,2018-05-03,구로구,0.0,0,4,0,1,5
3057,2018-05-03,금천구,0.0,0,4,0,1,5
3058,2018-05-03,노원구,0.0,0,1,0,0,1
3059,2018-05-03,도봉구,0.0,0,1,1,1,3
3060,2018-05-03,동대문구,0.0,0,0,0,1,1
3061,2018-05-03,동작구,4.5,1,6,0,0,7
3062,2018-05-03,마포구,4.5,0,5,0,3,8
3063,2018-05-03,서대문구,1.5,0,3,0,0,3
3064,2018-05-03,서초구,6.5,1,8,1,0,10
3065,2018-05-03,성동구,10.0,0,3,1,2,6
3066,2018-05-03,성북구,0.0,0,19,0,7,26
3067,2018-05-03,송파구,19.0,0,8,1,3,12
3068,2018-05-03,양천구,1.5,0,11,0,0,11
3069,2018-05-03,영등포구,2.25,0,6,1,2,9
3070,2018-05-03,용산구,1.0,0,7,0,0,7
3071,2018-05-03,은평구,0.0,0,2,1,1,4
3072,2018-05-03,종로구,1.0,1,4,0,1,6
3073,2018-05-03,중구,8.0,1,5,1,3,10
3074,2018-05-03,중랑구,1.0,0,3,1,1,5
3075,2018-05-04,강남구,0.0,0,10,0,2,12
3076,2018-05-04,강동구,0.0,0,2,0,2,4
3077,2018-05-04,강북구,0.0,0,1,0,1,2
3078,2018-05-04,강서구,0.0,0,5,0,1,6
3079,2018-05-04,관악구,0.0,0,8,0,2,10
3080,2018-05-04,광진구,0.0,0,1,0,2,3
3081,2018-05-04,구로구,0.0,0,7,0,2,9
3082,2018-05-04,금천구,0.0,0,2,0,0,2
3083,2018-05-04,노원구,0.0,0,4,1,1,6
3084,2018-05-04,도봉구,0.0,0,1,0,2,3
3085,2018-05-04,동대문구,0.0,0,7,1,4,12
3086,2018-05-04,동작구,0.0,0,4,0,1,5
3087,2018-05-04,마포구,0.0,0,2,0,1,3
3088,2018-05-04,서대문구,0.0,0,3,1,1,5
3089,2018-05-04,서초구,0.0,0,5,0,0,5
3090,2018-05-04,성동구,0.0,0,2,0,1,3
3091,2018-05-04,성북구,0.0,0,11,0,0,11
3092,2018-05-04,송파구,0.0,0,1,1,3,5
3093,2018-05-04,양천구,0.0,0,5,0,1,6
3094,2018-05-04,영등포구,0.0,0,6,0,1,7
3095,2018-05-04,용산구,0.0,0,4,1,2,7
3096,2018-05-04,은평구,0.0,0,2,1,1,4
3097,2018-05-04,종로구,0.0,0,4,0,1,5
3098,2018-05-04,중구,0.0,0,1,0,4,5
3099,2018-05-04,중랑구,0.0,0,6,2,1,9
3100,2018-05-05,강남구,0.0,0,7,1,2,10
3101,2018-05-05,강동구,0.0,0,3,0,0,3
3102,2018-05-05,강북구,0.0,0,2,0,0,2
3103,2018-05-05,강서구,0.0,0,9,0,1,10
3104,2018-05-05,관악구,0.0,0,4,1,0,5
3105,2018-05-05,광진구,0.0,0,5,0,1,6
3106,2018-05-05,구로구,0.0,0,1,0,5,6
3107,2018-05-05,금천구,0.0,0,2,0,1,3
3108,2018-05-05,노원구,0.0,0,3,5,3,11
3109,2018-05-05,도봉구,0.0,0,3,0,0,3
3110,2018-05-05,동대문구,0.0,0,10,1,0,11
3111,2018-05-05,동작구,0.0,0,1,2,0,3
3112,2018-05-05,마포구,0.0,0,4,0,0,4
3113,2018-05-05,서대문구,0.0,0,5,0,0,5
3114,2018-05-05,서초구,0.0,0,4,2,0,6
3115,2018-05-05,성동구,0.0,0,11,3,0,14
3116,2018-05-05,성북구,0.0,0,1,0,1,2
3117,2018-05-05,송파구,0.0,0,5,1,2,8
3118,2018-05-05,양천구,0.0,0,4,0,3,7
3119,2018-05-05,영등포구,0.0,0,7,2,1,10
3120,2018-05-05,용산구,0.0,0,4,0,1,5
3121,2018-05-05,은평구,0.0,0,1,0,1,2
3122,2018-05-05,종로구,0.0,0,3,0,0,3
3123,2018-05-05,중구,0.0,0,1,0,1,2
3124,2018-05-05,중랑구,0.0,0,2,1,1,4
3125,2018-05-06,강남구,25.5,0,2,0,0,2
3126,2018-05-06,강동구,22.0,0,4,0,0,4
3127,2018-05-06,강북구,19.0,0,7,0,2,9
3128,2018-05-06,강서구,17.0,0,1,1,1,3
3129,2018-05-06,관악구,24.5,0,5,0,1,6
3130,2018-05-06,광진구,24.5,0,3,0,1,4
3131,2018-05-06,구로구,25.0,0,5,0,1,6
3132,2018-05-06,금천구,25.0,0,0,0,0,0
3133,2018-05-06,노원구,19.0,0,1,0,1,2
3134,2018-05-06,도봉구,21.5,0,7,0,3,10
3135,2018-05-06,동대문구,21.5,0,1,0,1,2
3136,2018-05-06,동작구,22.5,0,5,0,1,6
3137,2018-05-06,마포구,21.0,0,1,0,0,1
3138,2018-05-06,서대문구,20.5,0,2,0,0,2
3139,2018-05-06,서초구,23.5,0,7,2,0,9
3140,2018-05-06,성동구,23.0,0,1,0,0,1
3141,2018-05-06,성북구,22.0,0,5,2,3,10
3142,2018-05-06,송파구,23.0,0,6,3,6,15
3143,2018-05-06,양천구,21.0,0,5,1,0,6
3144,2018-05-06,영등포구,19.5,0,3,0,0,3
3145,2018-05-06,용산구,18.0,0,3,0,0,3
3146,2018-05-06,은평구,16.5,0,1,0,1,2
3147,2018-05-06,종로구,22.0,0,1,0,0,1
3148,2018-05-06,중구,16.0,0,3,1,3,7
3149,2018-05-06,중랑구,22.5,0,6,2,1,9
3150,2018-05-07,강남구,0.0,0,4,0,2,6
3151,2018-05-07,강동구,0.0,0,1,0,0,1
3152,2018-05-07,강북구,0.0,0,3,0,0,3
3153,2018-05-07,강서구,0.0,0,2,0,1,3
3154,2018-05-07,관악구,0.0,0,3,0,1,4
3155,2018-05-07,광진구,0.0,0,3,0,0,3
3156,2018-05-07,구로구,0.0,0,1,0,0,1
3157,2018-05-07,금천구,0.0,0,5,0,2,7
3158,2018-05-07,노원구,0.0,0,2,0,1,3
3159,2018-05-07,도봉구,0.0,0,1,0,1,2
3160,2018-05-07,동대문구,0.0,0,5,1,3,9
3161,2018-05-07,동작구,0.0,0,1,0,0,1
3162,2018-05-07,마포구,0.0,0,3,0,0,3
3163,2018-05-07,서대문구,0.0,0,2,1,1,4
3164,2018-05-07,서초구,0.0,0,7,0,1,8
3165,2018-05-07,성동구,0.0,0,4,0,2,6
3166,2018-05-07,성북구,0.0,0,1,0,1,2
3167,2018-05-07,송파구,0.0,0,3,1,3,7
3168,2018-05-07,양천구,0.0,0,2,0,0,2
3169,2018-05-07,영등포구,0.0,0,7,0,0,7
3170,2018-05-07,용산구,0.0,0,4,0,2,6
3171,2018-05-07,은평구,0.0,0,4,1,0,5
3172,2018-05-07,종로구,0.0,0,3,3,0,6
3173,2018-05-07,중구,0.0,0,2,0,0,2
3174,2018-05-07,중랑구,0.0,0,6,1,0,7
3175,2018-05-08,강남구,0.0,0,8,0,3,11
3176,2018-05-08,강동구,0.0,0,4,0,1,5
3177,2018-05-08,강북구,0.0,0,3,0,0,3
3178,2018-05-08,강서구,0.0,0,1,0,2,3
3179,2018-05-08,관악구,0.0,0,1,0,1,2
3180,2018-05-08,광진구,0.0,0,4,0,0,4
3181,2018-05-08,구로구,0.0,0,3,0,2,5
3182,2018-05-08,금천구,0.0,0,3,0,4,7
3183,2018-05-08,노원구,0.0,0,2,0,3,5
3184,2018-05-08,도봉구,0.0,0,8,1,1,10
3185,2018-05-08,동대문구,0.0,0,4,0,3,7
3186,2018-05-08,동작구,0.0,0,1,0,1,2
3187,2018-05-08,마포구,0.0,0,4,0,0,4
3188,2018-05-08,서대문구,0.0,0,2,0,1,3
3189,2018-05-08,서초구,0.0,1,11,1,2,15
3190,2018-05-08,성동구,0.0,0,7,0,0,7
3191,2018-05-08,성북구,0.0,0,6,2,1,9
3192,2018-05-08,송파구,0.0,0,5,1,1,7
3193,2018-05-08,양천구,0.0,0,8,0,2,10
3194,2018-05-08,영등포구,0.0,0,5,0,0,5
3195,2018-05-08,용산구,0.0,0,3,0,0,3
3196,2018-05-08,은평구,0.0,0,2,0,0,2
3197,2018-05-08,종로구,0.0,0,2,0,1,3
3198,2018-05-08,중구,0.0,0,3,4,2,9
3199,2018-05-08,중랑구,0.0,0,5,0,2,7
3200,2018-05-09,강남구,0.0,0,9,1,1,11
3201,2018-05-09,강동구,0.0,1,4,0,1,6
3202,2018-05-09,강북구,0.0,0,2,0,3,5
3203,2018-05-09,강서구,0.0,0,4,0,2,6
3204,2018-05-09,관악구,0.0,0,9,0,4,13
3205,2018-05-09,광진구,0.0,0,1,0,1,2
3206,2018-05-09,구로구,0.0,0,4,0,1,5
3207,2018-05-09,금천구,0.0,0,2,1,1,4
3208,2018-05-09,노원구,0.0,0,5,0,2,7
3209,2018-05-09,도봉구,0.0,1,2,1,0,4
3210,2018-05-09,동대문구,0.0,0,2,1,1,4
3211,2018-05-09,동작구,0.0,0,5,0,1,6
3212,2018-05-09,마포구,0.0,0,7,0,1,8
3213,2018-05-09,서대문구,0.0,0,0,0,1,1
3214,2018-05-09,서초구,0.0,0,4,1,3,8
3215,2018-05-09,성동구,0.0,0,2,0,0,2
3216,2018-05-09,성북구,0.0,0,2,0,3,5
3217,2018-05-09,송파구,0.0,0,1,3,7,11
3218,2018-05-09,양천구,0.0,0,10,1,2,13
3219,2018-05-09,영등포구,0.0,0,8,2,2,12
3220,2018-05-09,용산구,0.0,0,2,0,2,4
3221,2018-05-09,은평구,0.0,0,4,0,0,4
3222,2018-05-09,종로구,0.0,0,10,1,0,11
3223,2018-05-09,중구,0.0,0,2,2,2,6
3224,2018-05-09,중랑구,0.0,0,2,1,2,5
3225,2018-05-10,강남구,0.0,0,14,2,2,18
3226,2018-05-10,강동구,0.0,0,4,1,3,8
3227,2018-05-10,강북구,0.0,0,5,0,1,6
3228,2018-05-10,강서구,0.0,0,1,0,0,1
3229,2018-05-10,관악구,0.0,0,1,0,3,4
3230,2018-05-10,광진구,0.0,0,2,0,1,3
3231,2018-05-10,구로구,0.0,0,6,0,0,6
3232,2018-05-10,금천구,0.0,0,4,0,1,5
3233,2018-05-10,노원구,0.0,0,0,1,1,2
3234,2018-05-10,도봉구,0.0,0,2,2,0,4
3235,2018-05-10,동대문구,0.0,0,4,2,3,9
3236,2018-05-10,동작구,0.0,0,8,1,1,10
3237,2018-05-10,마포구,0.0,0,1,1,1,3
3238,2018-05-10,서대문구,0.0,0,8,3,2,13
3239,2018-05-10,서초구,0.0,0,2,0,0,2
3240,2018-05-10,성동구,0.0,0,6,2,1,9
3241,2018-05-10,성북구,0.0,0,6,0,1,7
3242,2018-05-10,송파구,0.0,0,16,2,3,21
3243,2018-05-10,양천구,0.0,0,5,0,0,5
3244,2018-05-10,영등포구,0.0,0,8,1,1,10
3245,2018-05-10,용산구,0.0,0,4,0,2,6
3246,2018-05-10,은평구,0.0,0,4,0,1,5
3247,2018-05-10,종로구,0.0,0,0,0,0,0
3248,2018-05-10,중구,0.0,0,6,1,0,7
3249,2018-05-10,중랑구,0.0,0,2,2,3,7
3250,2018-05-11,강남구,0.0,0,18,4,6,28
3251,2018-05-11,강동구,0.0,0,8,0,2,10
3252,2018-05-11,강북구,0.0,0,2,0,1,3
3253,2018-05-11,강서구,0.0,0,0,1,2,3
3254,2018-05-11,관악구,0.0,0,0,0,1,1
3255,2018-05-11,광진구,0.0,0,2,0,1,3
3256,2018-05-11,구로구,0.0,0,5,1,3,9
3257,2018-05-11,금천구,0.0,0,2,0,0,2
3258,2018-05-11,노원구,0.0,0,6,0,1,7
3259,2018-05-11,도봉구,0.0,0,0,0,0,0
3260,2018-05-11,동대문구,0.0,0,5,1,6,12
3261,2018-05-11,동작구,0.0,0,6,1,5,12
3262,2018-05-11,마포구,0.0,1,1,0,4,6
3263,2018-05-11,서대문구,0.0,0,4,1,0,5
3264,2018-05-11,서초구,0.0,0,9,1,1,11
3265,2018-05-11,성동구,0.0,0,7,0,1,8
3266,2018-05-11,성북구,0.0,0,9,0,1,10
3267,2018-05-11,송파구,0.0,0,6,2,2,10
3268,2018-05-11,양천구,0.0,0,3,1,0,4
3269,2018-05-11,영등포구,0.0,0,12,4,1,17
3270,2018-05-11,용산구,0.0,0,3,0,1,4
3271,2018-05-11,은평구,0.0,0,8,0,1,9
3272,2018-05-11,종로구,0.0,0,1,1,0,2
3273,2018-05-11,중구,0.0,0,1,1,0,2
3274,2018-05-11,중랑구,0.0,0,4,0,0,4
3275,2018-05-12,강남구,33.0,0,13,2,0,15
3276,2018-05-12,강동구,31.5,0,5,0,0,5
3277,2018-05-12,강북구,37.0,0,6,0,6,12
3278,2018-05-12,강서구,23.0,0,1,0,1,2
3279,2018-05-12,관악구,37.25,0,6,0,1,7
3280,2018-05-12,광진구,32.0,0,5,0,2,7
3281,2018-05-12,구로구,30.5,0,0,0,1,1
3282,2018-05-12,금천구,33.5,0,4,0,0,4
3283,2018-05-12,노원구,36.5,0,7,1,2,10
3284,2018-05-12,도봉구,43.0,0,1,0,0,1
3285,2018-05-12,동대문구,36.5,0,3,0,2,5
3286,2018-05-12,동작구,31.5,0,3,1,1,5
3287,2018-05-12,마포구,29.0,0,7,3,2,12
3288,2018-05-12,서대문구,27.0,0,2,0,0,2
3289,2018-05-12,서초구,34.0,0,8,0,2,10
3290,2018-05-12,성동구,33.5,0,3,0,1,4
3291,2018-05-12,성북구,36.0,0,2,0,0,2
3292,2018-05-12,송파구,33.5,0,3,1,1,5
3293,2018-05-12,양천구,28.0,0,9,1,0,10
3294,2018-05-12,영등포구,28.75,0,6,0,3,9
3295,2018-05-12,용산구,28.0,0,1,0,3,4
3296,2018-05-12,은평구,23.5,0,2,1,2,5
3297,2018-05-12,종로구,32.0,0,4,0,0,4
3298,2018-05-12,중구,24.0,0,7,1,0,8
3299,2018-05-12,중랑구,35.0,1,3,0,3,7
3300,2018-05-13,강남구,0.0,0,15,0,5,20
3301,2018-05-13,강동구,0.0,0,0,0,1,1
3302,2018-05-13,강북구,0.0,0,6,0,0,6
3303,2018-05-13,강서구,0.0,0,0,0,0,0
3304,2018-05-13,관악구,0.5,0,5,0,0,5
3305,2018-05-13,광진구,1.0,0,6,0,3,9
3306,2018-05-13,구로구,0.5,0,1,0,0,1
3307,2018-05-13,금천구,0.5,0,4,0,1,5
3308,2018-05-13,노원구,0.0,0,9,0,1,10
3309,2018-05-13,도봉구,0.0,0,4,1,0,5
3310,2018-05-13,동대문구,0.0,0,1,0,2,3
3311,2018-05-13,동작구,0.25,0,2,0,3,5
3312,2018-05-13,마포구,0.5,0,3,0,3,6
3313,2018-05-13,서대문구,1.0,1,3,0,0,4
3314,2018-05-13,서초구,0.5,0,1,0,1,2
3315,2018-05-13,성동구,0.5,0,3,3,3,9
3316,2018-05-13,성북구,0.5,0,6,1,2,9
3317,2018-05-13,송파구,0.0,0,8,0,2,10
3318,2018-05-13,양천구,0.5,0,3,0,0,3
3319,2018-05-13,영등포구,0.25,0,9,1,1,11
3320,2018-05-13,용산구,0.5,0,5,0,2,7
3321,2018-05-13,은평구,1.0,0,6,0,1,7
3322,2018-05-13,종로구,0.5,0,2,1,2,5
3323,2018-05-13,중구,0.5,0,4,1,1,6
3324,2018-05-13,중랑구,0.5,0,3,2,3,8
3325,2018-05-14,강남구,0.0,0,5,2,2,9
3326,2018-05-14,강동구,0.0,0,3,0,1,4
3327,2018-05-14,강북구,0.0,0,6,0,2,8
3328,2018-05-14,강서구,0.0,0,7,0,2,9
3329,2018-05-14,관악구,0.0,0,0,0,0,0
3330,2018-05-14,광진구,0.0,0,2,0,1,3
3331,2018-05-14,구로구,0.0,0,5,0,2,7
3332,2018-05-14,금천구,0.0,0,4,0,0,4
3333,2018-05-14,노원구,0.0,0,6,0,2,8
3334,2018-05-14,도봉구,0.0,0,0,0,0,0
3335,2018-05-14,동대문구,0.0,0,6,0,1,7
3336,2018-05-14,동작구,0.0,0,2,0,1,3
3337,2018-05-14,마포구,0.0,1,1,0,3,5
3338,2018-05-14,서대문구,0.0,0,1,0,2,3
3339,2018-05-14,서초구,0.0,0,4,1,4,9
3340,2018-05-14,성동구,0.0,0,0,1,0,1
3341,2018-05-14,성북구,0.0,0,7,1,2,10
3342,2018-05-14,송파구,0.0,0,5,0,0,5
3343,2018-05-14,양천구,0.0,0,6,1,2,9
3344,2018-05-14,영등포구,0.0,0,5,0,0,5
3345,2018-05-14,용산구,0.0,0,6,0,0,6
3346,2018-05-14,은평구,0.0,0,4,0,0,4
3347,2018-05-14,종로구,0.0,0,5,0,1,6
3348,2018-05-14,중구,0.0,0,0,0,0,0
3349,2018-05-14,중랑구,0.0,0,9,1,2,12
3350,2018-05-15,강남구,0.0,0,11,1,1,13
3351,2018-05-15,강동구,0.0,0,4,0,0,4
3352,2018-05-15,강북구,0.0,0,2,1,3,6
3353,2018-05-15,강서구,0.0,0,6,1,1,8
3354,2018-05-15,관악구,0.0,0,2,2,1,5
3355,2018-05-15,광진구,0.0,0,4,0,1,5
3356,2018-05-15,구로구,0.0,0,2,0,1,3
3357,2018-05-15,금천구,0.0,0,0,0,0,0
3358,2018-05-15,노원구,0.0,0,4,2,1,7
3359,2018-05-15,도봉구,0.0,0,0,1,1,2
3360,2018-05-15,동대문구,0.0,0,2,0,0,2
3361,2018-05-15,동작구,0.0,0,6,1,2,9
3362,2018-05-15,마포구,0.0,1,2,0,0,3
3363,2018-05-15,서대문구,0.0,0,1,0,1,2
3364,2018-05-15,서초구,0.0,0,4,0,2,6
3365,2018-05-15,성동구,0.0,0,3,0,4,7
3366,2018-05-15,성북구,0.0,0,7,0,1,8
3367,2018-05-15,송파구,0.0,0,6,1,2,9
3368,2018-05-15,양천구,0.0,0,3,0,1,4
3369,2018-05-15,영등포구,0.0,0,3,2,1,6
3370,2018-05-15,용산구,0.0,0,4,0,0,4
3371,2018-05-15,은평구,0.0,0,3,0,0,3
3372,2018-05-15,종로구,0.0,0,1,0,0,1
3373,2018-05-15,중구,0.0,0,2,0,0,2
3374,2018-05-15,중랑구,0.0,0,0,1,2,3
3375,2018-05-16,강남구,36.5,0,14,0,2,16
3376,2018-05-16,강동구,40.5,0,3,0,2,5
3377,2018-05-16,강북구,37.0,0,2,0,1,3
3378,2018-05-16,강서구,29.0,0,6,0,1,7
3379,2018-05-16,관악구,28.0,0,5,0,0,5
3380,2018-05-16,광진구,5.5,0,1,0,1,2
3381,2018-05-16,구로구,38.5,0,7,0,1,8
3382,2018-05-16,금천구,27.5,0,2,1,1,4
3383,2018-05-16,노원구,41.5,0,4,0,0,4
3384,2018-05-16,도봉구,36.0,0,4,0,1,5
3385,2018-05-16,동대문구,39.5,0,1,1,1,3
3386,2018-05-16,동작구,42.25,0,2,0,1,3
3387,2018-05-16,마포구,41.0,0,8,0,0,8
3388,2018-05-16,서대문구,44.5,0,2,0,0,2
3389,2018-05-16,서초구,29.0,0,8,3,0,11
3390,2018-05-16,성동구,43.0,0,3,0,1,4
3391,2018-05-16,성북구,41.5,0,5,0,2,7
3392,2018-05-16,송파구,30.5,0,6,1,1,8
3393,2018-05-16,양천구,39.5,0,2,0,2,4
3394,2018-05-16,영등포구,37.75,0,7,0,1,8
3395,2018-05-16,용산구,40.5,0,2,0,4,6
3396,2018-05-16,은평구,34.0,0,7,0,0,7
3397,2018-05-16,종로구,45.0,0,2,0,0,2
3398,2018-05-16,중구,6.0,0,2,0,3,5
3399,2018-05-16,중랑구,44.0,0,0,0,0,0
3400,2018-05-17,강남구,103.0,0,9,0,3,12
3401,2018-05-17,강동구,23.5,0,6,1,0,7
3402,2018-05-17,강북구,76.5,0,0,0,3,3
3403,2018-05-17,강서구,54.5,0,4,2,2,8
3404,2018-05-17,관악구,81.0,0,4,1,0,5
3405,2018-05-17,광진구,10.5,0,11,1,2,14
3406,2018-05-17,구로구,65.0,0,3,0,3,6
3407,2018-05-17,금천구,66.0,0,6,0,1,7
3408,2018-05-17,노원구,98.0,0,6,0,0,6
3409,2018-05-17,도봉구,82.0,0,1,0,0,1
3410,2018-05-17,동대문구,98.5,0,4,1,1,6
3411,2018-05-17,동작구,74.0,0,5,1,1,7
3412,2018-05-17,마포구,64.0,0,2,0,2,4
3413,2018-05-17,서대문구,51.0,0,2,1,1,4
3414,2018-05-17,서초구,86.0,0,13,2,5,20
3415,2018-05-17,성동구,88.0,0,4,0,3,7
3416,2018-05-17,성북구,90.5,0,7,0,0,7
3417,2018-05-17,송파구,88.5,0,11,1,3,15
3418,2018-05-17,양천구,47.0,1,15,1,2,19
3419,2018-05-17,영등포구,78.75,1,5,1,2,9
3420,2018-05-17,용산구,42.0,0,3,0,1,4
3421,2018-05-17,은평구,66.0,0,0,0,0,0
3422,2018-05-17,종로구,83.0,0,9,6,0,15
3423,2018-05-17,중구,55.5,0,1,1,0,2
3424,2018-05-17,중랑구,62.0,0,5,0,3,8
3425,2018-05-18,강남구,6.0,0,5,1,2,8
3426,2018-05-18,강동구,10.0,0,4,0,2,6
3427,2018-05-18,강북구,7.0,0,8,0,1,9
3428,2018-05-18,강서구,5.5,0,0,0,0,0
3429,2018-05-18,관악구,3.75,0,3,2,2,7
3430,2018-05-18,광진구,0.0,0,6,0,3,9
3431,2018-05-18,구로구,5.5,0,4,0,0,4
3432,2018-05-18,금천구,4.5,0,2,0,1,3
3433,2018-05-18,노원구,7.5,0,10,0,1,11
3434,2018-05-18,도봉구,9.0,0,3,0,1,4
3435,2018-05-18,동대문구,8.0,0,1,1,7,9
3436,2018-05-18,동작구,5.25,0,4,1,1,6
3437,2018-05-18,마포구,7.0,0,6,0,2,8
3438,2018-05-18,서대문구,6.0,1,6,0,0,7
3439,2018-05-18,서초구,4.0,0,9,0,6,15
3440,2018-05-18,성동구,7.0,0,3,2,1,6
3441,2018-05-18,성북구,7.5,0,2,0,0,2
3442,2018-05-18,송파구,6.0,1,11,1,3,16
3443,2018-05-18,양천구,6.0,0,4,0,4,8
3444,2018-05-18,영등포구,6.25,0,13,0,1,14
3445,2018-05-18,용산구,6.0,0,11,0,1,12
3446,2018-05-18,은평구,11.0,0,2,0,1,3
3447,2018-05-18,종로구,6.5,0,1,1,2,4
3448,2018-05-18,중구,6.5,0,3,1,0,4
3449,2018-05-18,중랑구,7.5,0,3,1,0,4
3450,2018-05-19,강남구,0.0,0,12,0,3,15
3451,2018-05-19,강동구,0.0,0,1,2,0,3
3452,2018-05-19,강북구,0.0,0,0,0,2,2
3453,2018-05-19,강서구,0.0,0,3,2,4,9
3454,2018-05-19,관악구,0.0,0,4,2,1,7
3455,2018-05-19,광진구,0.0,0,1,0,0,1
3456,2018-05-19,구로구,0.0,0,2,0,2,4
3457,2018-05-19,금천구,0.0,0,3,0,2,5
3458,2018-05-19,노원구,0.0,0,3,0,3,6
3459,2018-05-19,도봉구,0.0,0,0,0,2,2
3460,2018-05-19,동대문구,0.0,0,2,2,3,7
3461,2018-05-19,동작구,0.0,0,4,0,0,4
3462,2018-05-19,마포구,0.0,0,3,0,1,4
3463,2018-05-19,서대문구,0.0,0,7,1,0,8
3464,2018-05-19,서초구,0.0,0,8,19,5,32
3465,2018-05-19,성동구,0.0,0,1,1,2,4
3466,2018-05-19,성북구,0.0,0,11,0,2,13
3467,2018-05-19,송파구,0.0,0,7,1,3,11
3468,2018-05-19,양천구,0.0,0,7,0,2,9
3469,2018-05-19,영등포구,0.0,1,7,2,3,13
3470,2018-05-19,용산구,0.0,0,9,0,2,11
3471,2018-05-19,은평구,0.0,0,1,2,1,4
3472,2018-05-19,종로구,0.0,0,3,0,2,5
3473,2018-05-19,중구,0.0,0,2,0,1,3
3474,2018-05-19,중랑구,0.0,0,4,0,0,4
3475,2018-05-20,강남구,0.0,0,7,1,1,9
3476,2018-05-20,강동구,0.0,0,0,0,2,2
3477,2018-05-20,강북구,0.0,0,7,0,0,7
3478,2018-05-20,강서구,0.0,0,6,0,2,8
3479,2018-05-20,관악구,0.0,0,3,1,0,4
3480,2018-05-20,광진구,0.0,0,2,0,0,2
3481,2018-05-20,구로구,0.0,0,2,0,1,3
3482,2018-05-20,금천구,0.0,0,6,2,1,9
3483,2018-05-20,노원구,0.0,0,2,0,1,3
3484,2018-05-20,도봉구,0.0,0,1,0,0,1
3485,2018-05-20,동대문구,0.0,0,1,0,1,2
3486,2018-05-20,동작구,0.0,0,6,1,3,10
3487,2018-05-20,마포구,0.0,0,8,0,2,10
3488,2018-05-20,서대문구,0.0,0,1,0,3,4
3489,2018-05-20,서초구,0.0,0,9,0,1,10
3490,2018-05-20,성동구,0.0,0,2,1,1,4
3491,2018-05-20,성북구,0.0,0,2,0,0,2
3492,2018-05-20,송파구,0.0,0,12,2,1,15
3493,2018-05-20,양천구,0.0,0,5,1,1,7
3494,2018-05-20,영등포구,0.0,0,10,1,1,12
3495,2018-05-20,용산구,0.0,0,5,0,0,5
3496,2018-05-20,은평구,0.0,0,3,0,2,5
3497,2018-05-20,종로구,0.0,0,3,2,1,6
3498,2018-05-20,중구,0.0,0,0,0,1,1
3499,2018-05-20,중랑구,0.0,0,4,0,5,9
3500,2018-05-21,강남구,0.0,0,9,1,3,13
3501,2018-05-21,강동구,0.0,0,6,0,1,7
3502,2018-05-21,강북구,0.0,0,6,0,0,6
3503,2018-05-21,강서구,0.0,0,5,0,3,8
3504,2018-05-21,관악구,0.0,0,3,0,1,4
3505,2018-05-21,광진구,0.0,0,4,2,1,7
3506,2018-05-21,구로구,0.0,0,2,1,3,6
3507,2018-05-21,금천구,0.0,0,4,0,0,4
3508,2018-05-21,노원구,0.0,0,12,3,2,17
3509,2018-05-21,도봉구,0.0,0,4,0,2,6
3510,2018-05-21,동대문구,0.0,0,9,0,3,12
3511,2018-05-21,동작구,0.0,0,4,0,1,5
3512,2018-05-21,마포구,0.0,0,3,0,3,6
3513,2018-05-21,서대문구,0.0,0,1,1,0,2
3514,2018-05-21,서초구,0.0,0,5,0,3,8
3515,2018-05-21,성동구,0.0,0,3,1,0,4
3516,2018-05-21,성북구,0.0,0,0,0,2,2
3517,2018-05-21,송파구,0.0,0,9,1,3,13
3518,2018-05-21,양천구,0.0,0,5,0,1,6
3519,2018-05-21,영등포구,0.0,0,12,2,2,16
3520,2018-05-21,용산구,0.0,0,1,0,0,1
3521,2018-05-21,은평구,0.0,0,5,0,0,5
3522,2018-05-21,종로구,0.0,0,2,0,1,3
3523,2018-05-21,중구,0.0,0,2,0,0,2
3524,2018-05-21,중랑구,0.0,0,5,0,1,6
3525,2018-05-22,강남구,13.0,0,4,1,2,7
3526,2018-05-22,강동구,13.5,0,0,3,0,3
3527,2018-05-22,강북구,10.0,0,5,0,4,9
3528,2018-05-22,강서구,12.5,0,4,0,0,4
3529,2018-05-22,관악구,14.25,0,1,0,1,2
3530,2018-05-22,광진구,13.0,0,6,0,0,6
3531,2018-05-22,구로구,14.0,0,8,1,1,10
3532,2018-05-22,금천구,13.0,0,0,0,1,1
3533,2018-05-22,노원구,13.0,0,1,1,0,2
3534,2018-05-22,도봉구,12.5,0,4,0,1,5
3535,2018-05-22,동대문구,13.0,0,0,0,1,1
3536,2018-05-22,동작구,13.0,0,3,0,0,3
3537,2018-05-22,마포구,13.0,0,13,0,1,14
3538,2018-05-22,서대문구,13.0,0,0,0,0,0
3539,2018-05-22,서초구,12.5,0,11,2,4,17
3540,2018-05-22,성동구,12.5,0,5,1,0,6
3541,2018-05-22,성북구,13.0,0,4,0,2,6
3542,2018-05-22,송파구,12.5,0,4,1,4,9
3543,2018-05-22,양천구,13.5,0,10,2,2,14
3544,2018-05-22,영등포구,12.5,0,10,3,1,14
3545,2018-05-22,용산구,12.5,0,2,1,0,3
3546,2018-05-22,은평구,11.5,0,4,1,2,7
3547,2018-05-22,종로구,12.5,0,3,1,0,4
3548,2018-05-22,중구,11.5,0,2,0,0,2
3549,2018-05-22,중랑구,14.5,0,3,2,3,8
3550,2018-05-23,강남구,7.0,0,5,2,2,9
3551,2018-05-23,강동구,6.5,0,9,1,5,15
3552,2018-05-23,강북구,4.0,0,5,0,2,7
3553,2018-05-23,강서구,5.5,0,2,0,0,2
3554,2018-05-23,관악구,10.5,0,4,1,2,7
3555,2018-05-23,광진구,7.0,0,2,0,0,2
3556,2018-05-23,구로구,6.5,0,11,1,3,15
3557,2018-05-23,금천구,7.5,0,9,1,0,10
3558,2018-05-23,노원구,5.5,0,7,0,2,9
3559,2018-05-23,도봉구,5.5,0,3,0,2,5
3560,2018-05-23,동대문구,6.0,0,5,0,1,6
3561,2018-05-23,동작구,7.75,0,5,2,0,7
3562,2018-05-23,마포구,6.5,0,9,0,2,11
3563,2018-05-23,서대문구,6.5,0,5,0,0,5
3564,2018-05-23,서초구,7.5,0,8,0,1,9
3565,2018-05-23,성동구,5.5,0,5,1,1,7
3566,2018-05-23,성북구,5.0,0,5,0,0,5
3567,2018-05-23,송파구,6.5,0,8,4,0,12
3568,2018-05-23,양천구,7.0,0,1,0,0,1
3569,2018-05-23,영등포구,7.5,0,6,1,0,7
3570,2018-05-23,용산구,7.5,0,3,0,0,3
3571,2018-05-23,은평구,7.0,0,1,1,1,3
3572,2018-05-23,종로구,6.5,0,3,0,1,4
3573,2018-05-23,중구,6.5,0,1,0,1,2
3574,2018-05-23,중랑구,6.0,0,6,1,3,10
3575,2018-05-24,강남구,0.0,0,5,0,3,8
3576,2018-05-24,강동구,0.0,0,2,0,3,5
3577,2018-05-24,강북구,0.0,0,3,0,0,3
3578,2018-05-24,강서구,0.0,0,1,0,1,2
3579,2018-05-24,관악구,0.0,0,3,0,1,4
3580,2018-05-24,광진구,0.0,0,2,0,0,2
3581,2018-05-24,구로구,0.0,0,5,0,1,6
3582,2018-05-24,금천구,0.0,0,2,0,1,3
3583,2018-05-24,노원구,0.0,0,11,0,1,12
3584,2018-05-24,도봉구,0.0,0,4,0,0,4
3585,2018-05-24,동대문구,0.0,0,1,0,1,2
3586,2018-05-24,동작구,0.0,0,2,0,1,3
3587,2018-05-24,마포구,0.0,0,7,0,2,9
3588,2018-05-24,서대문구,0.0,0,1,3,1,5
3589,2018-05-24,서초구,0.0,1,7,0,1,9
3590,2018-05-24,성동구,0.0,0,3,1,1,5
3591,2018-05-24,성북구,0.0,0,5,0,1,6
3592,2018-05-24,송파구,0.0,0,14,4,1,19
3593,2018-05-24,양천구,0.0,0,2,0,1,3
3594,2018-05-24,영등포구,0.0,0,4,0,0,4
3595,2018-05-24,용산구,0.0,0,6,0,2,8
3596,2018-05-24,은평구,0.0,0,3,0,0,3
3597,2018-05-24,종로구,0.0,0,3,0,2,5
3598,2018-05-24,중구,0.0,0,4,0,1,5
3599,2018-05-24,중랑구,0.0,0,3,1,0,4
3600,2018-05-25,강남구,0.0,0,11,2,6,19
3601,2018-05-25,강동구,0.0,0,5,1,0,6
3602,2018-05-25,강북구,0.0,0,0,0,1,1
3603,2018-05-25,강서구,0.0,0,2,2,0,4
3604,2018-05-25,관악구,0.0,0,2,0,1,3
3605,2018-05-25,광진구,0.0,0,4,0,4,8
3606,2018-05-25,구로구,0.0,0,7,0,0,7
3607,2018-05-25,금천구,0.0,0,1,0,4,5
3608,2018-05-25,노원구,0.0,0,3,0,1,4
3609,2018-05-25,도봉구,0.0,0,5,0,1,6
3610,2018-05-25,동대문구,0.0,0,2,1,0,3
3611,2018-05-25,동작구,0.0,0,4,1,2,7
3612,2018-05-25,마포구,0.0,0,2,0,1,3
3613,2018-05-25,서대문구,0.0,0,3,0,0,3
3614,2018-05-25,서초구,0.0,0,2,1,3,6
3615,2018-05-25,성동구,0.0,0,3,0,0,3
3616,2018-05-25,성북구,0.0,0,3,0,3,6
3617,2018-05-25,송파구,0.0,0,7,0,2,9
3618,2018-05-25,양천구,0.0,0,2,0,0,2
3619,2018-05-25,영등포구,0.0,0,7,0,2,9
3620,2018-05-25,용산구,0.0,0,4,2,0,6
3621,2018-05-25,은평구,0.0,0,1,0,0,1
3622,2018-05-25,종로구,0.0,0,6,0,3,9
3623,2018-05-25,중구,0.0,0,1,0,0,1
3624,2018-05-25,중랑구,0.0,0,12,1,4,17
3625,2018-05-26,강남구,0.0,0,16,2,0,18
3626,2018-05-26,강동구,0.0,0,2,0,0,2
3627,2018-05-26,강북구,0.0,0,5,0,0,5
3628,2018-05-26,강서구,0.0,0,3,1,2,6
3629,2018-05-26,관악구,0.0,0,6,0,2,8
3630,2018-05-26,광진구,0.0,0,7,0,2,9
3631,2018-05-26,구로구,0.0,0,1,2,1,4
3632,2018-05-26,금천구,0.0,0,1,0,0,1
3633,2018-05-26,노원구,0.0,0,4,0,0,4
3634,2018-05-26,도봉구,0.0,0,1,0,1,2
3635,2018-05-26,동대문구,0.0,0,10,0,1,11
3636,2018-05-26,동작구,0.0,0,4,0,0,4
3637,2018-05-26,마포구,0.0,0,9,1,2,12
3638,2018-05-26,서대문구,0.0,0,5,0,2,7
3639,2018-05-26,서초구,0.0,0,6,0,3,9
3640,2018-05-26,성동구,0.0,0,3,0,2,5
3641,2018-05-26,성북구,0.0,0,2,0,3,5
3642,2018-05-26,송파구,0.0,0,14,2,0,16
3643,2018-05-26,양천구,0.0,0,4,1,0,5
3644,2018-05-26,영등포구,0.0,0,5,0,1,6
3645,2018-05-26,용산구,0.0,0,10,0,2,12
3646,2018-05-26,은평구,0.0,0,2,1,2,5
3647,2018-05-26,종로구,0.0,0,3,1,0,4
3648,2018-05-26,중구,0.0,0,7,0,1,8
3649,2018-05-26,중랑구,0.0,0,4,0,5,9
3650,2018-05-27,강남구,0.0,0,12,0,3,15
3651,2018-05-27,강동구,0.0,0,8,0,1,9
3652,2018-05-27,강북구,0.0,0,2,2,1,5
3653,2018-05-27,강서구,0.0,0,0,1,1,2
3654,2018-05-27,관악구,0.0,0,2,0,3,5
3655,2018-05-27,광진구,0.0,0,2,0,0,2
3656,2018-05-27,구로구,0.0,0,4,0,0,4
3657,2018-05-27,금천구,0.0,0,1,0,0,1
3658,2018-05-27,노원구,0.0,0,0,2,0,2
3659,2018-05-27,도봉구,0.0,0,1,0,0,1
3660,2018-05-27,동대문구,0.0,0,3,1,1,5
3661,2018-05-27,동작구,0.0,0,3,0,2,5
3662,2018-05-27,마포구,0.0,0,7,0,3,10
3663,2018-05-27,서대문구,0.0,0,3,0,0,3
3664,2018-05-27,서초구,0.0,0,8,2,0,10
3665,2018-05-27,성동구,0.0,0,1,0,0,1
3666,2018-05-27,성북구,0.0,0,3,0,2,5
3667,2018-05-27,송파구,0.0,0,2,1,0,3
3668,2018-05-27,양천구,0.0,0,2,0,0,2
3669,2018-05-27,영등포구,0.0,0,1,1,1,3
3670,2018-05-27,용산구,0.0,0,5,0,3,8
3671,2018-05-27,은평구,0.0,0,8,1,2,11
3672,2018-05-27,종로구,0.0,0,2,0,0,2
3673,2018-05-27,중구,0.0,0,3,0,2,5
3674,2018-05-27,중랑구,0.0,0,6,0,2,8
3675,2018-05-28,강남구,0.0,0,8,0,1,9
3676,2018-05-28,강동구,0.0,0,7,1,2,10
3677,2018-05-28,강북구,0.0,0,4,0,0,4
3678,2018-05-28,강서구,0.0,0,4,0,1,5
3679,2018-05-28,관악구,0.0,0,1,0,2,3
3680,2018-05-28,광진구,0.0,0,1,0,0,1
3681,2018-05-28,구로구,0.0,0,2,1,0,3
3682,2018-05-28,금천구,0.0,0,1,0,0,1
3683,2018-05-28,노원구,0.0,0,1,0,0,1
3684,2018-05-28,도봉구,0.0,0,1,0,1,2
3685,2018-05-28,동대문구,0.0,0,11,1,6,18
3686,2018-05-28,동작구,0.0,0,0,0,0,0
3687,2018-05-28,마포구,0.0,0,3,0,1,4
3688,2018-05-28,서대문구,0.0,0,2,0,0,2
3689,2018-05-28,서초구,0.0,0,3,0,2,5
3690,2018-05-28,성동구,0.0,0,7,0,3,10
3691,2018-05-28,성북구,0.0,0,6,0,2,8
3692,2018-05-28,송파구,0.0,0,4,1,2,7
3693,2018-05-28,양천구,0.0,0,3,1,1,5
3694,2018-05-28,영등포구,0.0,0,7,1,0,8
3695,2018-05-28,용산구,0.0,1,2,0,0,3
3696,2018-05-28,은평구,0.0,0,0,2,1,3
3697,2018-05-28,종로구,0.0,0,3,1,0,4
3698,2018-05-28,중구,0.0,0,1,0,1,2
3699,2018-05-28,중랑구,0.0,0,5,0,3,8
3700,2018-05-29,강남구,2.5,0,9,1,6,16
3701,2018-05-29,강동구,1.5,0,7,1,3,11
3702,2018-05-29,강북구,1.5,0,9,0,1,10
3703,2018-05-29,강서구,0.5,0,1,0,4,5
3704,2018-05-29,관악구,3.5,0,2,0,1,3
3705,2018-05-29,광진구,2.0,0,3,0,1,4
3706,2018-05-29,구로구,2.0,0,6,0,2,8
3707,2018-05-29,금천구,3.5,0,3,0,0,3
3708,2018-05-29,노원구,0.0,0,10,0,5,15
3709,2018-05-29,도봉구,0.5,0,2,0,0,2
3710,2018-05-29,동대문구,0.5,0,5,0,0,5
3711,2018-05-29,동작구,2.25,0,6,0,1,7
3712,2018-05-29,마포구,2.5,0,4,3,1,8
3713,2018-05-29,서대문구,1.0,0,2,0,0,2
3714,2018-05-29,서초구,3.5,0,6,1,3,10
3715,2018-05-29,성동구,1.5,0,0,1,0,1
3716,2018-05-29,성북구,0.0,0,1,0,0,1
3717,2018-05-29,송파구,2.5,0,8,2,3,13
3718,2018-05-29,양천구,1.5,0,3,0,0,3
3719,2018-05-29,영등포구,1.5,0,10,1,5,16
3720,2018-05-29,용산구,2.0,0,6,1,1,8
3721,2018-05-29,은평구,1.0,0,3,0,0,3
3722,2018-05-29,종로구,1.0,0,3,1,3,7
3723,2018-05-29,중구,2.0,0,0,0,5,5
3724,2018-05-29,중랑구,0.5,0,2,0,0,2
3725,2018-05-30,강남구,0.0,0,9,3,7,19
3726,2018-05-30,강동구,0.0,0,2,0,0,2
3727,2018-05-30,강북구,0.0,0,3,0,1,4
3728,2018-05-30,강서구,0.0,1,3,0,1,5
3729,2018-05-30,관악구,0.0,0,3,0,0,3
3730,2018-05-30,광진구,0.0,0,0,0,0,0
3731,2018-05-30,구로구,0.5,0,6,0,3,9
3732,2018-05-30,금천구,0.0,0,0,0,0,0
3733,2018-05-30,노원구,0.0,0,1,2,1,4
3734,2018-05-30,도봉구,0.0,0,0,0,0,0
3735,2018-05-30,동대문구,0.0,0,3,0,3,6
3736,2018-05-30,동작구,0.25,0,4,3,0,7
3737,2018-05-30,마포구,0.5,0,5,0,1,6
3738,2018-05-30,서대문구,0.5,0,3,0,0,3
3739,2018-05-30,서초구,0.0,0,6,1,2,9
3740,2018-05-30,성동구,0.5,0,3,0,0,3
3741,2018-05-30,성북구,0.0,0,4,0,0,4
3742,2018-05-30,송파구,0.0,1,13,2,8,24
3743,2018-05-30,양천구,0.0,0,9,0,0,9
3744,2018-05-30,영등포구,0.5,0,4,0,2,6
3745,2018-05-30,용산구,0.0,0,4,0,1,5
3746,2018-05-30,은평구,0.0,0,0,0,0,0
3747,2018-05-30,종로구,0.0,0,3,1,0,4
3748,2018-05-30,중구,0.5,0,3,0,2,5
3749,2018-05-30,중랑구,0.5,0,5,3,1,9
3750,2018-05-31,강남구,0.0,0,10,2,3,15
3751,2018-05-31,강동구,0.0,0,4,1,2,7
3752,2018-05-31,강북구,0.0,0,0,0,0,0
3753,2018-05-31,강서구,0.0,0,10,0,5,15
3754,2018-05-31,관악구,0.0,0,5,1,0,6
3755,2018-05-31,광진구,0.0,0,1,1,3,5
3756,2018-05-31,구로구,0.0,0,2,1,3,6
3757,2018-05-31,금천구,0.0,0,3,0,1,4
3758,2018-05-31,노원구,0.0,0,2,2,0,4
3759,2018-05-31,도봉구,0.0,0,2,0,3,5
3760,2018-05-31,동대문구,0.0,0,4,0,3,7
3761,2018-05-31,동작구,0.0,0,8,1,2,11
3762,2018-05-31,마포구,0.0,0,3,0,2,5
3763,2018-05-31,서대문구,0.0,0,1,0,2,3
3764,2018-05-31,서초구,0.0,0,10,0,6,16
3765,2018-05-31,성동구,0.0,0,5,1,1,7
3766,2018-05-31,성북구,0.0,0,6,0,2,8
3767,2018-05-31,송파구,0.0,0,9,1,1,11
3768,2018-05-31,양천구,0.0,0,2,2,0,4
3769,2018-05-31,영등포구,0.0,0,7,2,1,10
3770,2018-05-31,용산구,0.0,1,6,0,6,13
3771,2018-05-31,은평구,0.0,0,0,0,0,0
3772,2018-05-31,종로구,0.0,0,3,2,1,6
3773,2018-05-31,중구,0.0,0,6,0,4,10
3774,2018-05-31,중랑구,0.0,0,9,1,3,13
3775,2018-06-01,강남구,0.0,0,15,3,5,23
3776,2018-06-01,강동구,0.0,0,2,1,1,4
3777,2018-06-01,강북구,0.0,0,2,0,1,3
3778,2018-06-01,강서구,0.0,0,4,0,0,4
3779,2018-06-01,관악구,0.0,0,2,0,3,5
3780,2018-06-01,광진구,0.0,0,2,0,1,3
3781,2018-06-01,구로구,0.0,0,3,0,4,7
3782,2018-06-01,금천구,0.0,0,2,1,0,3
3783,2018-06-01,노원구,0.0,1,1,0,1,3
3784,2018-06-01,도봉구,0.0,0,4,0,2,6
3785,2018-06-01,동대문구,0.0,0,3,0,4,7
3786,2018-06-01,동작구,0.0,0,2,0,2,4
3787,2018-06-01,마포구,0.0,0,7,0,2,9
3788,2018-06-01,서대문구,0.0,0,1,0,1,2
3789,2018-06-01,서초구,0.0,0,3,0,4,7
3790,2018-06-01,성동구,0.0,0,7,0,3,10
3791,2018-06-01,성북구,0.0,0,4,1,1,6
3792,2018-06-01,송파구,0.0,1,9,3,2,15
3793,2018-06-01,양천구,0.0,0,3,1,2,6
3794,2018-06-01,영등포구,0.0,0,8,0,1,9
3795,2018-06-01,용산구,0.0,0,4,0,1,5
3796,2018-06-01,은평구,0.0,0,3,0,3,6
3797,2018-06-01,종로구,0.0,0,4,0,0,4
3798,2018-06-01,중구,0.0,0,3,0,2,5
3799,2018-06-01,중랑구,0.0,0,1,2,1,4
3800,2018-06-02,강남구,0.0,0,17,5,0,22
3801,2018-06-02,강동구,0.0,0,7,2,0,9
3802,2018-06-02,강북구,0.0,0,3,0,0,3
3803,2018-06-02,강서구,0.0,0,3,0,1,4
3804,2018-06-02,관악구,0.0,0,2,0,0,2
3805,2018-06-02,광진구,0.0,0,5,0,2,7
3806,2018-06-02,구로구,0.0,0,8,0,1,9
3807,2018-06-02,금천구,0.0,0,1,1,1,3
3808,2018-06-02,노원구,0.0,0,4,0,2,6
3809,2018-06-02,도봉구,0.0,0,2,0,1,3
3810,2018-06-02,동대문구,0.0,0,4,1,1,6
3811,2018-06-02,동작구,0.0,0,11,0,3,14
3812,2018-06-02,마포구,0.0,0,1,0,2,3
3813,2018-06-02,서대문구,0.0,0,6,0,0,6
3814,2018-06-02,서초구,0.0,0,10,0,0,10
3815,2018-06-02,성동구,0.0,0,6,0,0,6
3816,2018-06-02,성북구,0.0,0,5,2,1,8
3817,2018-06-02,송파구,0.0,0,8,1,3,12
3818,2018-06-02,양천구,0.0,0,12,0,0,12
3819,2018-06-02,영등포구,0.0,0,12,3,2,17
3820,2018-06-02,용산구,0.0,0,2,0,0,2
3821,2018-06-02,은평구,0.0,0,1,1,1,3
3822,2018-06-02,종로구,0.0,0,4,0,4,8
3823,2018-06-02,중구,0.0,0,5,0,1,6
3824,2018-06-02,중랑구,0.0,0,6,2,0,8
3825,2018-06-03,강남구,0.0,0,12,0,3,15
3826,2018-06-03,강동구,0.0,0,7,0,0,7
3827,2018-06-03,강북구,0.0,0,3,0,1,4
3828,2018-06-03,강서구,0.0,0,1,0,0,1
3829,2018-06-03,관악구,0.0,0,1,0,1,2
3830,2018-06-03,광진구,0.0,0,7,0,1,8
3831,2018-06-03,구로구,0.0,0,1,1,0,2
3832,2018-06-03,금천구,0.0,0,1,0,0,1
3833,2018-06-03,노원구,0.0,0,1,0,1,2
3834,2018-06-03,도봉구,0.0,0,0,1,0,1
3835,2018-06-03,동대문구,0.0,0,4,0,1,5
3836,2018-06-03,동작구,0.0,0,3,0,1,4
3837,2018-06-03,마포구,0.0,0,6,1,0,7
3838,2018-06-03,서대문구,0.0,0,2,1,3,6
3839,2018-06-03,서초구,0.0,0,11,0,0,11
3840,2018-06-03,성동구,0.0,0,1,0,0,1
3841,2018-06-03,성북구,0.0,0,2,0,2,4
3842,2018-06-03,송파구,0.0,0,5,2,3,10
3843,2018-06-03,양천구,0.0,0,5,2,1,8
3844,2018-06-03,영등포구,0.0,0,7,0,1,8
3845,2018-06-03,용산구,0.0,0,5,0,1,6
3846,2018-06-03,은평구,0.0,0,1,1,4,6
3847,2018-06-03,종로구,0.0,1,2,0,2,5
3848,2018-06-03,중구,0.0,0,4,0,0,4
3849,2018-06-03,중랑구,0.0,0,2,0,3,5
3850,2018-06-04,강남구,0.0,0,9,1,2,12
3851,2018-06-04,강동구,0.0,0,7,0,4,11
3852,2018-06-04,강북구,0.0,0,5,0,1,6
3853,2018-06-04,강서구,0.0,0,2,0,2,4
3854,2018-06-04,관악구,0.0,0,3,0,2,5
3855,2018-06-04,광진구,0.0,0,0,2,1,3
3856,2018-06-04,구로구,0.0,0,7,0,1,8
3857,2018-06-04,금천구,0.0,0,1,0,1,2
3858,2018-06-04,노원구,0.0,0,0,0,0,0
3859,2018-06-04,도봉구,0.0,0,2,0,2,4
3860,2018-06-04,동대문구,0.0,0,7,0,1,8
3861,2018-06-04,동작구,0.0,0,5,0,1,6
3862,2018-06-04,마포구,0.0,0,6,3,3,12
3863,2018-06-04,서대문구,0.0,0,1,0,0,1
3864,2018-06-04,서초구,0.0,0,14,3,2,19
3865,2018-06-04,성동구,0.0,0,1,0,0,1
3866,2018-06-04,성북구,0.0,1,2,1,2,6
3867,2018-06-04,송파구,0.0,0,8,1,1,10
3868,2018-06-04,양천구,0.0,0,2,0,2,4
3869,2018-06-04,영등포구,0.0,0,10,0,2,12
3870,2018-06-04,용산구,0.0,0,2,1,1,4
3871,2018-06-04,은평구,0.0,0,2,0,0,2
3872,2018-06-04,종로구,0.0,0,3,0,0,3
3873,2018-06-04,중구,0.0,0,6,1,0,7
3874,2018-06-04,중랑구,0.0,0,0,1,1,2
3875,2018-06-05,강남구,0.0,0,9,1,4,14
3876,2018-06-05,강동구,0.0,0,2,1,1,4
3877,2018-06-05,강북구,0.0,0,3,0,1,4
3878,2018-06-05,강서구,0.0,0,1,0,1,2
3879,2018-06-05,관악구,0.0,0,0,0,1,1
3880,2018-06-05,광진구,0.0,0,9,0,1,10
3881,2018-06-05,구로구,0.0,0,5,0,3,8
3882,2018-06-05,금천구,0.0,0,0,0,0,0
3883,2018-06-05,노원구,0.0,0,4,1,1,6
3884,2018-06-05,도봉구,0.0,0,1,0,1,2
3885,2018-06-05,동대문구,0.0,0,5,1,1,7
3886,2018-06-05,동작구,0.0,1,4,0,1,6
3887,2018-06-05,마포구,0.0,0,5,0,2,7
3888,2018-06-05,서대문구,0.0,0,6,0,3,9
3889,2018-06-05,서초구,0.0,0,8,0,2,10
3890,2018-06-05,성동구,0.0,0,2,1,1,4
3891,2018-06-05,성북구,0.0,0,2,0,0,2
3892,2018-06-05,송파구,0.0,0,4,0,1,5
3893,2018-06-05,양천구,0.0,0,4,0,1,5
3894,2018-06-05,영등포구,0.0,0,13,4,2,19
3895,2018-06-05,용산구,0.0,0,3,0,1,4
3896,2018-06-05,은평구,0.0,0,2,2,0,4
3897,2018-06-05,종로구,0.0,0,6,1,2,9
3898,2018-06-05,중구,0.0,0,1,1,2,4
3899,2018-06-05,중랑구,0.0,0,4,0,1,5
3900,2018-06-06,강남구,0.0,0,14,0,2,16
3901,2018-06-06,강동구,0.0,0,3,0,2,5
3902,2018-06-06,강북구,0.0,0,1,0,1,2
3903,2018-06-06,강서구,0.0,0,10,1,1,12
3904,2018-06-06,관악구,0.0,0,2,0,0,2
3905,2018-06-06,광진구,0.0,0,5,0,1,6
3906,2018-06-06,구로구,0.0,0,5,0,2,7
3907,2018-06-06,금천구,0.0,0,3,1,0,4
3908,2018-06-06,노원구,0.0,0,3,0,3,6
3909,2018-06-06,도봉구,0.0,0,2,0,0,2
3910,2018-06-06,동대문구,0.0,0,8,1,0,9
3911,2018-06-06,동작구,0.0,0,5,2,1,8
3912,2018-06-06,마포구,0.0,0,13,0,0,13
3913,2018-06-06,서대문구,0.0,0,1,0,0,1
3914,2018-06-06,서초구,0.0,0,1,0,0,1
3915,2018-06-06,성동구,0.0,0,2,0,0,2
3916,2018-06-06,성북구,0.0,0,9,1,1,11
3917,2018-06-06,송파구,0.0,0,5,2,3,10
3918,2018-06-06,양천구,0.0,0,6,0,1,7
3919,2018-06-06,영등포구,0.0,0,10,2,3,15
3920,2018-06-06,용산구,0.0,0,2,0,2,4
3921,2018-06-06,은평구,0.0,0,1,0,2,3
3922,2018-06-06,종로구,0.0,0,1,0,1,2
3923,2018-06-06,중구,0.0,0,3,0,0,3
3924,2018-06-06,중랑구,0.0,0,4,0,1,5
3925,2018-06-07,강남구,0.0,0,11,1,1,13
3926,2018-06-07,강동구,0.0,0,4,0,2,6
3927,2018-06-07,강북구,0.0,0,2,0,0,2
3928,2018-06-07,강서구,0.0,0,5,0,1,6
3929,2018-06-07,관악구,0.0,0,0,0,0,0
3930,2018-06-07,광진구,0.0,0,2,0,0,2
3931,2018-06-07,구로구,0.0,0,3,1,1,5
3932,2018-06-07,금천구,0.0,0,4,0,1,5
3933,2018-06-07,노원구,0.0,0,6,1,0,7
3934,2018-06-07,도봉구,0.0,0,1,0,1,2
3935,2018-06-07,동대문구,0.0,0,2,0,0,2
3936,2018-06-07,동작구,0.0,0,2,2,0,4
3937,2018-06-07,마포구,0.0,0,3,0,0,3
3938,2018-06-07,서대문구,0.0,0,6,1,0,7
3939,2018-06-07,서초구,0.0,0,5,1,3,9
3940,2018-06-07,성동구,0.0,0,6,0,1,7
3941,2018-06-07,성북구,0.0,0,2,0,0,2
3942,2018-06-07,송파구,0.0,0,4,1,1,6
3943,2018-06-07,양천구,0.0,0,2,1,0,3
3944,2018-06-07,영등포구,0.0,0,8,0,0,8
3945,2018-06-07,용산구,0.0,0,1,0,1,2
3946,2018-06-07,은평구,0.0,0,3,0,0,3
3947,2018-06-07,종로구,0.0,0,1,0,2,3
3948,2018-06-07,중구,0.0,0,1,1,3,5
3949,2018-06-07,중랑구,0.0,0,7,0,0,7
3950,2018-06-08,강남구,0.0,0,19,2,2,23
3951,2018-06-08,강동구,0.0,0,1,0,1,2
3952,2018-06-08,강북구,0.0,0,5,0,3,8
3953,2018-06-08,강서구,0.0,0,3,2,2,7
3954,2018-06-08,관악구,0.0,0,2,0,1,3
3955,2018-06-08,광진구,0.0,0,3,0,1,4
3956,2018-06-08,구로구,0.0,0,7,0,1,8
3957,2018-06-08,금천구,0.0,0,0,1,0,1
3958,2018-06-08,노원구,0.0,0,2,1,2,5
3959,2018-06-08,도봉구,0.0,0,1,1,0,2
3960,2018-06-08,동대문구,0.0,0,3,0,1,4
3961,2018-06-08,동작구,0.0,0,7,1,0,8
3962,2018-06-08,마포구,0.0,0,5,1,0,6
3963,2018-06-08,서대문구,0.0,0,2,2,0,4
3964,2018-06-08,서초구,0.0,0,9,8,1,18
3965,2018-06-08,성동구,0.0,0,5,1,0,6
3966,2018-06-08,성북구,0.0,0,1,1,2,4
3967,2018-06-08,송파구,0.0,0,11,1,5,17
3968,2018-06-08,양천구,0.0,0,3,1,1,5
3969,2018-06-08,영등포구,0.0,0,10,1,1,12
3970,2018-06-08,용산구,0.0,0,1,0,1,2
3971,2018-06-08,은평구,0.0,0,5,0,1,6
3972,2018-06-08,종로구,0.0,0,3,0,0,3
3973,2018-06-08,중구,0.0,0,7,1,2,10
3974,2018-06-08,중랑구,0.0,0,3,1,3,7
3975,2018-06-09,강남구,1.0,0,22,1,3,26
3976,2018-06-09,강동구,0.0,0,8,0,1,9
3977,2018-06-09,강북구,0.5,0,1,0,1,2
3978,2018-06-09,강서구,6.0,0,8,5,4,17
3979,2018-06-09,관악구,1.75,0,8,2,3,13
3980,2018-06-09,광진구,0.5,0,4,1,1,6
3981,2018-06-09,구로구,2.5,0,3,1,0,4
3982,2018-06-09,금천구,1.0,0,1,0,1,2
3983,2018-06-09,노원구,0.5,1,2,0,2,5
3984,2018-06-09,도봉구,1.0,0,2,0,2,4
3985,2018-06-09,동대문구,0.5,0,5,2,1,8
3986,2018-06-09,동작구,5.0,0,0,0,0,0
3987,2018-06-09,마포구,2.5,0,8,0,1,9
3988,2018-06-09,서대문구,2.0,0,6,0,5,11
3989,2018-06-09,서초구,1.0,0,4,1,0,5
3990,2018-06-09,성동구,0.5,0,3,0,1,4
3991,2018-06-09,성북구,0.5,0,4,0,0,4
3992,2018-06-09,송파구,0.5,0,7,1,2,10
3993,2018-06-09,양천구,4.5,0,6,0,4,10
3994,2018-06-09,영등포구,4.75,0,8,2,5,15
3995,2018-06-09,용산구,0.5,2,7,1,1,11
3996,2018-06-09,은평구,1.5,0,2,0,1,3
3997,2018-06-09,종로구,0.5,0,1,1,2,4
3998,2018-06-09,중구,0.0,0,4,1,0,5
3999,2018-06-09,중랑구,0.5,0,6,1,2,9
4000,2018-06-10,강남구,0.5,0,12,0,3,15
4001,2018-06-10,강동구,0.5,0,0,2,1,3
4002,2018-06-10,강북구,1.0,0,5,0,1,6
4003,2018-06-10,강서구,1.0,0,0,1,0,1
4004,2018-06-10,관악구,1.25,0,4,0,3,7
4005,2018-06-10,광진구,0.5,0,6,2,2,10
4006,2018-06-10,구로구,1.5,0,5,1,1,7
4007,2018-06-10,금천구,1.0,0,0,0,0,0
4008,2018-06-10,노원구,0.5,0,4,2,0,6
4009,2018-06-10,도봉구,1.0,0,0,0,0,0
4010,2018-06-10,동대문구,0.5,0,5,1,4,10
4011,2018-06-10,동작구,1.0,0,0,0,0,0
4012,2018-06-10,마포구,1.0,0,4,0,2,6
4013,2018-06-10,서대문구,0.5,0,1,1,1,3
4014,2018-06-10,서초구,0.5,0,5,0,2,7
4015,2018-06-10,성동구,0.5,0,8,0,2,10
4016,2018-06-10,성북구,1.0,0,4,1,2,7
4017,2018-06-10,송파구,0.5,0,7,3,4,14
4018,2018-06-10,양천구,0.5,0,4,0,0,4
4019,2018-06-10,영등포구,0.5,0,3,1,6,10
4020,2018-06-10,용산구,0.5,0,2,0,0,2
4021,2018-06-10,은평구,1.0,0,1,0,2,3
4022,2018-06-10,종로구,0.5,0,3,0,2,5
4023,2018-06-10,중구,0.5,0,2,0,1,3
4024,2018-06-10,중랑구,0.0,0,2,7,0,9
4025,2018-06-11,강남구,2.0,0,6,1,1,8
4026,2018-06-11,강동구,0.5,0,4,0,0,4
4027,2018-06-11,강북구,1.0,0,3,0,0,3
4028,2018-06-11,강서구,3.5,0,5,0,1,6
4029,2018-06-11,관악구,2.5,0,4,2,0,6
4030,2018-06-11,광진구,4.0,0,2,0,2,4
4031,2018-06-11,구로구,12.0,0,4,0,2,6
4032,2018-06-11,금천구,4.0,0,1,0,0,1
4033,2018-06-11,노원구,0.5,0,2,0,2,4
4034,2018-06-11,도봉구,0.5,0,1,0,5,6
4035,2018-06-11,동대문구,0.5,0,8,3,3,14
4036,2018-06-11,동작구,1.75,0,2,0,2,4
4037,2018-06-11,마포구,3.0,0,1,1,1,3
4038,2018-06-11,서대문구,3.5,0,3,0,1,4
4039,2018-06-11,서초구,0.5,0,11,0,2,13
4040,2018-06-11,성동구,3.0,0,0,0,2,2
4041,2018-06-11,성북구,0.0,0,5,0,0,5
4042,2018-06-11,송파구,2.0,0,4,5,0,9
4043,2018-06-11,양천구,6.5,0,6,0,2,8
4044,2018-06-11,영등포구,6.0,0,9,0,2,11
4045,2018-06-11,용산구,4.5,0,4,0,1,5
4046,2018-06-11,은평구,2.0,0,0,0,0,0
4047,2018-06-11,종로구,5.0,0,6,0,1,7
4048,2018-06-11,중구,2.0,0,2,0,1,3
4049,2018-06-11,중랑구,0.5,0,2,0,3,5
4050,2018-06-12,강남구,1.0,0,4,3,1,8
4051,2018-06-12,강동구,0.5,0,3,0,0,3
4052,2018-06-12,강북구,0.0,0,2,0,0,2
4053,2018-06-12,강서구,0.5,0,2,0,2,4
4054,2018-06-12,관악구,2.75,0,5,0,1,6
4055,2018-06-12,광진구,0.0,0,2,0,0,2
4056,2018-06-12,구로구,1.0,0,9,0,2,11
4057,2018-06-12,금천구,1.0,0,1,0,1,2
4058,2018-06-12,노원구,0.5,0,9,0,0,9
4059,2018-06-12,도봉구,0.0,0,3,2,1,6
4060,2018-06-12,동대문구,0.0,0,0,0,2,2
4061,2018-06-12,동작구,2.5,0,3,0,1,4
4062,2018-06-12,마포구,0.0,0,6,0,2,8
4063,2018-06-12,서대문구,0.5,0,3,0,0,3
4064,2018-06-12,서초구,3.5,0,6,0,2,8
4065,2018-06-12,성동구,0.0,0,1,0,2,3
4066,2018-06-12,성북구,0.0,0,5,0,0,5
4067,2018-06-12,송파구,0.5,0,4,0,1,5
4068,2018-06-12,양천구,1.5,0,6,0,0,6
4069,2018-06-12,영등포구,2.0,0,8,1,0,9
4070,2018-06-12,용산구,2.5,0,5,0,1,6
4071,2018-06-12,은평구,0.0,0,3,0,1,4
4072,2018-06-12,종로구,0.0,0,6,0,2,8
4073,2018-06-12,중구,0.0,0,4,1,0,5
4074,2018-06-12,중랑구,0.5,0,2,0,0,2
4075,2018-06-13,강남구,0.0,0,6,0,3,9
4076,2018-06-13,강동구,0.0,0,1,0,1,2
4077,2018-06-13,강북구,0.0,0,4,0,1,5
4078,2018-06-13,강서구,0.0,0,2,0,1,3
4079,2018-06-13,관악구,0.0,0,3,0,1,4
4080,2018-06-13,광진구,0.0,0,1,0,1,2
4081,2018-06-13,구로구,0.0,0,3,2,1,6
4082,2018-06-13,금천구,0.0,0,6,0,2,8
4083,2018-06-13,노원구,0.0,1,6,2,2,11
4084,2018-06-13,도봉구,0.0,0,1,0,0,1
4085,2018-06-13,동대문구,0.0,0,2,1,2,5
4086,2018-06-13,동작구,0.0,0,2,1,1,4
4087,2018-06-13,마포구,0.0,0,9,0,1,10
4088,2018-06-13,서대문구,0.0,0,1,0,0,1
4089,2018-06-13,서초구,0.0,0,3,0,0,3
4090,2018-06-13,성동구,0.0,0,3,2,0,5
4091,2018-06-13,성북구,0.0,0,0,1,1,2
4092,2018-06-13,송파구,0.0,0,4,3,1,8
4093,2018-06-13,양천구,0.0,0,3,0,1,4
4094,2018-06-13,영등포구,0.0,0,3,1,2,6
4095,2018-06-13,용산구,0.0,0,1,3,1,5
4096,2018-06-13,은평구,0.0,0,0,0,0,0
4097,2018-06-13,종로구,0.0,0,0,0,0,0
4098,2018-06-13,중구,0.0,0,2,0,0,2
4099,2018-06-13,중랑구,0.0,0,7,0,0,7
4100,2018-06-14,강남구,2.5,0,8,3,0,11
4101,2018-06-14,강동구,1.0,0,7,0,2,9
4102,2018-06-14,강북구,39.0,0,1,0,2,3
4103,2018-06-14,강서구,60.0,0,7,1,4,12
4104,2018-06-14,관악구,11.0,0,4,0,1,5
4105,2018-06-14,광진구,2.0,0,3,1,4,8
4106,2018-06-14,구로구,34.0,0,4,2,0,6
4107,2018-06-14,금천구,15.0,0,3,0,0,3
4108,2018-06-14,노원구,23.5,0,2,1,0,3
4109,2018-06-14,도봉구,43.5,0,3,0,0,3
4110,2018-06-14,동대문구,17.5,0,2,2,2,6
4111,2018-06-14,동작구,18.25,0,3,0,2,5
4112,2018-06-14,마포구,24.0,0,8,1,3,12
4113,2018-06-14,서대문구,23.0,0,1,0,2,3
4114,2018-06-14,서초구,4.0,0,17,0,1,18
4115,2018-06-14,성동구,11.0,0,5,0,1,6
4116,2018-06-14,성북구,36.5,0,4,1,2,7
4117,2018-06-14,송파구,1.5,0,0,1,4,5
4118,2018-06-14,양천구,25.5,1,2,0,1,4
4119,2018-06-14,영등포구,24.25,0,9,1,3,13
4120,2018-06-14,용산구,20.0,0,1,0,0,1
4121,2018-06-14,은평구,40.0,0,2,0,1,3
4122,2018-06-14,종로구,29.0,0,4,0,2,6
4123,2018-06-14,중구,22.0,0,2,1,0,3
4124,2018-06-14,중랑구,12.5,0,5,1,0,6
4125,2018-06-15,강남구,0.5,0,9,1,4,14
4126,2018-06-15,강동구,0.5,0,6,1,2,9
4127,2018-06-15,강북구,9.5,0,3,0,0,3
4128,2018-06-15,강서구,1.0,0,2,0,0,2
4129,2018-06-15,관악구,0.5,0,2,2,0,4
4130,2018-06-15,광진구,3.0,0,2,0,0,2
4131,2018-06-15,구로구,1.0,0,2,0,0,2
4132,2018-06-15,금천구,10.5,0,5,0,0,5
4133,2018-06-15,노원구,0.5,0,6,2,3,11
4134,2018-06-15,도봉구,5.5,0,4,0,1,5
4135,2018-06-15,동대문구,0.5,0,4,0,2,6
4136,2018-06-15,동작구,6.0,0,5,1,2,8
4137,2018-06-15,마포구,11.0,0,6,0,2,8
4138,2018-06-15,서대문구,6.0,0,3,1,1,5
4139,2018-06-15,서초구,0.0,0,13,1,1,15
4140,2018-06-15,성동구,0.5,0,1,0,2,3
4141,2018-06-15,성북구,14.0,0,0,1,0,1
4142,2018-06-15,송파구,2.0,0,11,4,0,15
4143,2018-06-15,양천구,1.5,0,9,0,1,10
4144,2018-06-15,영등포구,9.0,0,4,1,0,5
4145,2018-06-15,용산구,1.0,0,5,1,1,7
4146,2018-06-15,은평구,0.5,0,4,1,1,6
4147,2018-06-15,종로구,16.5,0,1,0,2,3
4148,2018-06-15,중구,1.0,0,3,0,2,5
4149,2018-06-15,중랑구,0.5,0,1,0,0,1
4150,2018-06-16,강남구,0.0,0,12,0,3,15
4151,2018-06-16,강동구,0.0,0,6,2,7,15
4152,2018-06-16,강북구,0.0,0,9,1,1,11
4153,2018-06-16,강서구,0.0,0,5,1,1,7
4154,2018-06-16,관악구,0.0,0,3,0,0,3
4155,2018-06-16,광진구,0.0,0,5,1,1,7
4156,2018-06-16,구로구,0.0,0,2,1,0,3
4157,2018-06-16,금천구,0.0,0,0,0,1,1
4158,2018-06-16,노원구,0.0,0,4,4,0,8
4159,2018-06-16,도봉구,0.0,0,0,1,1,2
4160,2018-06-16,동대문구,0.0,0,5,0,2,7
4161,2018-06-16,동작구,0.0,0,3,0,2,5
4162,2018-06-16,마포구,0.0,0,6,1,0,7
4163,2018-06-16,서대문구,0.0,0,3,0,1,4
4164,2018-06-16,서초구,0.0,0,3,0,1,4
4165,2018-06-16,성동구,0.0,0,4,0,4,8
4166,2018-06-16,성북구,0.0,0,1,0,0,1
4167,2018-06-16,송파구,0.0,0,14,1,2,17
4168,2018-06-16,양천구,0.0,0,2,0,1,3
4169,2018-06-16,영등포구,0.0,0,10,0,2,12
4170,2018-06-16,용산구,0.0,0,2,0,1,3
4171,2018-06-16,은평구,0.0,0,5,2,2,9
4172,2018-06-16,종로구,0.0,0,5,1,0,6
4173,2018-06-16,중구,0.0,0,4,0,1,5
4174,2018-06-16,중랑구,0.0,0,3,1,3,7
4175,2018-06-17,강남구,0.0,0,10,0,1,11
4176,2018-06-17,강동구,0.0,0,1,0,2,3
4177,2018-06-17,강북구,0.0,0,3,0,0,3
4178,2018-06-17,강서구,0.0,0,5,0,0,5
4179,2018-06-17,관악구,0.0,0,1,0,1,2
4180,2018-06-17,광진구,0.0,0,0,0,0,0
4181,2018-06-17,구로구,0.0,0,0,0,0,0
4182,2018-06-17,금천구,0.0,0,0,0,0,0
4183,2018-06-17,노원구,0.0,0,2,1,0,3
4184,2018-06-17,도봉구,0.0,0,0,0,0,0
4185,2018-06-17,동대문구,0.0,0,4,0,1,5
4186,2018-06-17,동작구,0.0,0,2,0,1,3
4187,2018-06-17,마포구,0.0,0,3,0,0,3
4188,2018-06-17,서대문구,0.0,0,0,0,1,1
4189,2018-06-17,서초구,0.0,0,6,0,3,9
4190,2018-06-17,성동구,0.0,1,0,0,0,1
4191,2018-06-17,성북구,0.0,0,1,0,2,3
4192,2018-06-17,송파구,0.0,0,2,0,3,5
4193,2018-06-17,양천구,0.0,0,4,2,3,9
4194,2018-06-17,영등포구,0.0,1,4,1,0,6
4195,2018-06-17,용산구,0.0,0,3,0,1,4
4196,2018-06-17,은평구,0.0,0,2,0,1,3
4197,2018-06-17,종로구,0.0,0,1,0,1,2
4198,2018-06-17,중구,0.0,0,0,0,0,0
4199,2018-06-17,중랑구,0.0,0,4,0,0,4
4200,2018-06-18,강남구,0.0,0,15,3,5,23
4201,2018-06-18,강동구,0.0,0,7,0,4,11
4202,2018-06-18,강북구,0.0,0,2,0,1,3
4203,2018-06-18,강서구,0.0,0,5,0,0,5
4204,2018-06-18,관악구,0.0,0,2,0,2,4
4205,2018-06-18,광진구,0.0,0,3,2,1,6
4206,2018-06-18,구로구,0.0,0,1,1,1,3
4207,2018-06-18,금천구,0.0,0,1,0,0,1
4208,2018-06-18,노원구,0.0,0,2,0,0,2
4209,2018-06-18,도봉구,0.0,0,6,0,0,6
4210,2018-06-18,동대문구,0.0,0,9,2,2,13
4211,2018-06-18,동작구,0.0,0,3,0,2,5
4212,2018-06-18,마포구,0.0,0,2,0,0,2
4213,2018-06-18,서대문구,0.0,0,1,0,2,3
4214,2018-06-18,서초구,0.0,0,5,0,1,6
4215,2018-06-18,성동구,0.0,0,3,0,0,3
4216,2018-06-18,성북구,0.0,0,3,1,3,7
4217,2018-06-18,송파구,0.0,0,2,1,0,3
4218,2018-06-18,양천구,0.0,0,5,0,4,9
4219,2018-06-18,영등포구,0.0,0,7,3,1,11
4220,2018-06-18,용산구,0.0,0,3,0,0,3
4221,2018-06-18,은평구,0.0,0,1,0,0,1
4222,2018-06-18,종로구,0.0,0,2,0,1,3
4223,2018-06-18,중구,0.0,0,5,0,1,6
4224,2018-06-18,중랑구,0.0,0,8,1,2,11
4225,2018-06-19,강남구,0.0,0,15,3,4,22
4226,2018-06-19,강동구,0.0,0,4,1,1,6
4227,2018-06-19,강북구,0.0,1,3,0,2,6
4228,2018-06-19,강서구,0.0,0,2,0,2,4
4229,2018-06-19,관악구,0.0,0,2,0,1,3
4230,2018-06-19,광진구,0.0,0,2,1,0,3
4231,2018-06-19,구로구,0.0,0,0,1,3,4
4232,2018-06-19,금천구,0.0,0,0,0,1,1
4233,2018-06-19,노원구,0.0,0,6,0,2,8
4234,2018-06-19,도봉구,0.0,1,2,0,1,4
4235,2018-06-19,동대문구,0.0,0,3,0,2,5
4236,2018-06-19,동작구,0.0,0,4,1,1,6
4237,2018-06-19,마포구,0.0,0,3,2,2,7
4238,2018-06-19,서대문구,0.0,0,2,0,0,2
4239,2018-06-19,서초구,0.0,0,5,0,2,7
4240,2018-06-19,성동구,0.0,0,1,0,0,1
4241,2018-06-19,성북구,0.0,1,3,0,2,6
4242,2018-06-19,송파구,0.0,0,11,1,2,14
4243,2018-06-19,양천구,0.0,0,4,0,0,4
4244,2018-06-19,영등포구,0.0,0,6,0,4,10
4245,2018-06-19,용산구,0.0,0,0,1,1,2
4246,2018-06-19,은평구,0.0,0,3,0,3,6
4247,2018-06-19,종로구,0.0,0,0,0,0,0
4248,2018-06-19,중구,0.0,0,6,0,1,7
4249,2018-06-19,중랑구,0.0,0,1,0,1,2
4250,2018-06-20,강남구,0.0,0,5,4,1,10
4251,2018-06-20,강동구,0.0,0,5,0,1,6
4252,2018-06-20,강북구,0.0,0,3,0,1,4
4253,2018-06-20,강서구,0.0,0,5,1,1,7
4254,2018-06-20,관악구,0.0,0,1,0,1,2
4255,2018-06-20,광진구,0.0,0,3,0,0,3
4256,2018-06-20,구로구,0.0,0,0,0,0,0
4257,2018-06-20,금천구,0.0,0,2,0,1,3
4258,2018-06-20,노원구,0.0,0,10,0,0,10
4259,2018-06-20,도봉구,0.0,0,0,0,0,0
4260,2018-06-20,동대문구,0.0,0,3,0,1,4
4261,2018-06-20,동작구,0.0,0,3,0,1,4
4262,2018-06-20,마포구,0.0,0,9,0,1,10
4263,2018-06-20,서대문구,0.0,0,2,0,2,4
4264,2018-06-20,서초구,0.0,0,3,0,0,3
4265,2018-06-20,성동구,0.0,0,3,0,0,3
4266,2018-06-20,성북구,0.0,0,4,0,1,5
4267,2018-06-20,송파구,0.0,0,8,2,5,15
4268,2018-06-20,양천구,0.0,0,3,1,2,6
4269,2018-06-20,영등포구,0.0,0,5,2,0,7
4270,2018-06-20,용산구,0.0,0,6,1,2,9
4271,2018-06-20,은평구,0.0,0,4,0,0,4
4272,2018-06-20,종로구,0.0,0,0,0,0,0
4273,2018-06-20,중구,0.0,0,5,0,0,5
4274,2018-06-20,중랑구,0.0,0,3,0,2,5
4275,2018-06-21,강남구,0.0,0,4,5,1,10
4276,2018-06-21,강동구,0.0,0,1,0,0,1
4277,2018-06-21,강북구,0.0,0,4,1,0,5
4278,2018-06-21,강서구,0.0,0,5,0,1,6
4279,2018-06-21,관악구,0.0,0,2,0,0,2
4280,2018-06-21,광진구,0.0,0,2,0,1,3
4281,2018-06-21,구로구,0.0,0,12,0,2,14
4282,2018-06-21,금천구,0.0,0,4,1,1,6
4283,2018-06-21,노원구,0.0,0,0,0,1,1
4284,2018-06-21,도봉구,0.0,0,2,0,1,3
4285,2018-06-21,동대문구,0.0,0,4,0,1,5
4286,2018-06-21,동작구,0.0,0,3,1,2,6
4287,2018-06-21,마포구,0.0,0,6,0,0,6
4288,2018-06-21,서대문구,0.0,0,4,1,1,6
4289,2018-06-21,서초구,0.0,0,6,1,2,9
4290,2018-06-21,성동구,0.0,0,1,0,1,2
4291,2018-06-21,성북구,0.0,0,8,0,1,9
4292,2018-06-21,송파구,0.0,0,19,1,1,21
4293,2018-06-21,양천구,0.0,0,0,0,1,1
4294,2018-06-21,영등포구,0.0,0,7,1,3,11
4295,2018-06-21,용산구,0.0,0,8,1,1,10
4296,2018-06-21,은평구,0.0,0,7,1,3,11
4297,2018-06-21,종로구,0.0,0,0,1,0,1
4298,2018-06-21,중구,0.0,0,2,0,3,5
4299,2018-06-21,중랑구,0.0,0,2,0,1,3
4300,2018-06-22,강남구,0.0,0,8,3,5,16
4301,2018-06-22,강동구,0.0,0,2,2,2,6
4302,2018-06-22,강북구,0.0,0,2,0,3,5
4303,2018-06-22,강서구,0.0,0,6,0,4,10
4304,2018-06-22,관악구,0.0,0,5,1,2,8
4305,2018-06-22,광진구,0.0,0,2,0,1,3
4306,2018-06-22,구로구,0.0,0,6,0,1,7
4307,2018-06-22,금천구,0.0,0,4,1,1,6
4308,2018-06-22,노원구,0.0,0,4,1,2,7
4309,2018-06-22,도봉구,0.0,0,4,1,1,6
4310,2018-06-22,동대문구,0.0,1,4,1,1,7
4311,2018-06-22,동작구,0.0,0,5,0,2,7
4312,2018-06-22,마포구,0.0,0,4,0,3,7
4313,2018-06-22,서대문구,0.0,0,1,0,0,1
4314,2018-06-22,서초구,0.0,0,18,0,5,23
4315,2018-06-22,성동구,0.0,0,3,0,1,4
4316,2018-06-22,성북구,0.0,0,11,1,0,12
4317,2018-06-22,송파구,0.0,0,14,2,3,19
4318,2018-06-22,양천구,0.0,0,1,0,0,1
4319,2018-06-22,영등포구,0.0,0,9,1,3,13
4320,2018-06-22,용산구,0.0,0,9,1,3,13
4321,2018-06-22,은평구,0.0,0,4,0,3,7
4322,2018-06-22,종로구,0.0,0,0,1,0,1
4323,2018-06-22,중구,0.0,0,5,0,2,7
4324,2018-06-22,중랑구,0.0,0,9,0,3,12
4325,2018-06-23,강남구,0.0,0,8,0,4,12
4326,2018-06-23,강동구,0.0,0,2,0,3,5
4327,2018-06-23,강북구,0.0,0,5,0,0,5
4328,2018-06-23,강서구,0.0,0,8,0,3,11
4329,2018-06-23,관악구,0.0,0,11,0,3,14
4330,2018-06-23,광진구,0.0,0,2,0,1,3
4331,2018-06-23,구로구,0.0,0,1,1,3,5
4332,2018-06-23,금천구,0.0,0,1,1,0,2
4333,2018-06-23,노원구,0.0,0,5,0,1,6
4334,2018-06-23,도봉구,0.0,0,1,1,0,2
4335,2018-06-23,동대문구,0.0,0,4,0,5,9
4336,2018-06-23,동작구,0.0,0,6,0,1,7
4337,2018-06-23,마포구,0.0,0,10,0,1,11
4338,2018-06-23,서대문구,0.0,0,3,0,0,3
4339,2018-06-23,서초구,0.0,0,9,0,3,12
4340,2018-06-23,성동구,0.0,0,1,1,0,2
4341,2018-06-23,성북구,0.0,0,2,0,0,2
4342,2018-06-23,송파구,0.0,0,7,3,2,12
4343,2018-06-23,양천구,0.0,0,5,1,2,8
4344,2018-06-23,영등포구,0.0,0,2,1,2,5
4345,2018-06-23,용산구,0.0,0,4,0,0,4
4346,2018-06-23,은평구,0.0,0,5,0,0,5
4347,2018-06-23,종로구,0.0,0,8,0,2,10
4348,2018-06-23,중구,0.0,0,0,0,1,1
4349,2018-06-23,중랑구,0.0,0,3,1,2,6
4350,2018-06-24,강남구,0.0,0,4,0,0,4
4351,2018-06-24,강동구,0.0,0,10,0,1,11
4352,2018-06-24,강북구,0.0,0,0,0,1,1
4353,2018-06-24,강서구,0.0,0,12,0,1,13
4354,2018-06-24,관악구,0.0,0,2,0,0,2
4355,2018-06-24,광진구,0.0,0,3,0,4,7
4356,2018-06-24,구로구,0.0,0,2,1,2,5
4357,2018-06-24,금천구,0.0,0,0,1,0,1
4358,2018-06-24,노원구,0.0,0,2,0,1,3
4359,2018-06-24,도봉구,0.0,0,0,2,0,2
4360,2018-06-24,동대문구,0.0,0,5,0,0,5
4361,2018-06-24,동작구,0.0,0,8,1,2,11
4362,2018-06-24,마포구,0.0,0,7,0,2,9
4363,2018-06-24,서대문구,0.0,0,1,1,1,3
4364,2018-06-24,서초구,0.0,0,1,1,1,3
4365,2018-06-24,성동구,0.0,0,2,0,0,2
4366,2018-06-24,성북구,0.0,0,0,0,2,2
4367,2018-06-24,송파구,0.0,0,4,0,0,4
4368,2018-06-24,양천구,0.0,0,1,0,1,2
4369,2018-06-24,영등포구,0.0,0,6,0,1,7
4370,2018-06-24,용산구,0.0,0,6,0,0,6
4371,2018-06-24,은평구,0.0,0,0,0,1,1
4372,2018-06-24,종로구,0.0,0,3,0,1,4
4373,2018-06-24,중구,0.0,0,1,1,2,4
4374,2018-06-24,중랑구,0.0,0,5,0,4,9
4375,2018-06-25,강남구,0.0,0,8,1,2,11
4376,2018-06-25,강동구,0.0,0,5,0,1,6
4377,2018-06-25,강북구,0.0,0,1,0,1,2
4378,2018-06-25,강서구,0.0,0,0,2,3,5
4379,2018-06-25,관악구,0.0,0,7,0,0,7
4380,2018-06-25,광진구,0.0,0,8,0,1,9
4381,2018-06-25,구로구,0.0,0,5,0,1,6
4382,2018-06-25,금천구,0.0,0,1,0,1,2
4383,2018-06-25,노원구,0.0,1,0,1,0,2
4384,2018-06-25,도봉구,0.0,0,2,0,2,4
4385,2018-06-25,동대문구,0.0,0,3,0,0,3
4386,2018-06-25,동작구,0.0,0,4,1,2,7
4387,2018-06-25,마포구,0.0,0,5,1,0,6
4388,2018-06-25,서대문구,0.0,0,2,1,2,5
4389,2018-06-25,서초구,0.0,0,5,0,4,9
4390,2018-06-25,성동구,0.0,0,5,0,2,7
4391,2018-06-25,성북구,0.0,0,4,0,1,5
4392,2018-06-25,송파구,0.0,1,11,1,3,16
4393,2018-06-25,양천구,0.0,0,3,0,2,5
4394,2018-06-25,영등포구,0.0,0,11,2,0,13
4395,2018-06-25,용산구,0.0,0,3,1,1,5
4396,2018-06-25,은평구,0.0,0,3,0,3,6
4397,2018-06-25,종로구,0.0,0,2,1,1,4
4398,2018-06-25,중구,0.0,0,1,1,1,3
4399,2018-06-25,중랑구,0.0,0,4,0,2,6
4400,2018-06-26,강남구,48.5,0,10,5,4,19
4401,2018-06-26,강동구,76.0,0,0,1,4,5
4402,2018-06-26,강북구,79.5,0,7,0,0,7
4403,2018-06-26,강서구,74.5,0,1,0,0,1
4404,2018-06-26,관악구,86.25,0,3,0,1,4
4405,2018-06-26,광진구,83.0,0,6,1,1,8
4406,2018-06-26,구로구,69.0,0,7,2,1,10
4407,2018-06-26,금천구,66.5,0,1,0,0,1
4408,2018-06-26,노원구,76.5,0,3,1,0,4
4409,2018-06-26,도봉구,90.5,0,5,0,0,5
4410,2018-06-26,동대문구,72.0,0,4,0,2,6
4411,2018-06-26,동작구,74.25,0,4,2,0,6
4412,2018-06-26,마포구,69.5,0,1,0,1,2
4413,2018-06-26,서대문구,69.5,0,0,0,1,1
4414,2018-06-26,서초구,82.0,0,5,0,3,8
4415,2018-06-26,성동구,72.0,0,3,0,2,5
4416,2018-06-26,성북구,91.5,0,9,0,1,10
4417,2018-06-26,송파구,74.0,0,12,0,3,15
4418,2018-06-26,양천구,69.0,0,10,1,5,16
4419,2018-06-26,영등포구,69.25,0,8,1,1,10
4420,2018-06-26,용산구,65.5,0,6,0,0,6
4421,2018-06-26,은평구,53.0,0,3,1,1,5
4422,2018-06-26,종로구,71.5,0,4,1,0,5
4423,2018-06-26,중구,55.0,0,4,0,1,5
4424,2018-06-26,중랑구,71.5,0,4,0,0,4
4425,2018-06-27,강남구,0.5,0,2,1,5,8
4426,2018-06-27,강동구,1.5,0,0,0,3,3
4427,2018-06-27,강북구,0.5,0,2,0,0,2
4428,2018-06-27,강서구,0.5,0,2,2,0,4
4429,2018-06-27,관악구,0.25,0,1,0,0,1
4430,2018-06-27,광진구,0.5,0,1,2,0,3
4431,2018-06-27,구로구,0.5,0,8,0,2,10
4432,2018-06-27,금천구,0.5,0,4,0,0,4
4433,2018-06-27,노원구,1.0,0,2,2,0,4
4434,2018-06-27,도봉구,0.5,0,2,1,1,4
4435,2018-06-27,동대문구,1.0,0,2,0,0,2
4436,2018-06-27,동작구,0.75,0,4,4,2,10
4437,2018-06-27,마포구,0.5,0,4,1,1,6
4438,2018-06-27,서대문구,1.0,0,0,0,0,0
4439,2018-06-27,서초구,0.0,0,1,0,1,2
4440,2018-06-27,성동구,0.5,0,4,0,0,4
4441,2018-06-27,성북구,1.5,0,2,0,0,2
4442,2018-06-27,송파구,0.0,0,7,2,1,10
4443,2018-06-27,양천구,0.5,0,0,0,2,2
4444,2018-06-27,영등포구,0.5,0,5,0,2,7
4445,2018-06-27,용산구,0.0,0,2,0,1,3
4446,2018-06-27,은평구,1.5,0,5,0,2,7
4447,2018-06-27,종로구,1.0,0,2,0,2,4
4448,2018-06-27,중구,1.0,0,1,0,2,3
4449,2018-06-27,중랑구,1.5,0,6,0,2,8
4450,2018-06-28,강남구,10.0,0,9,2,2,13
4451,2018-06-28,강동구,15.0,0,4,0,0,4
4452,2018-06-28,강북구,13.0,0,3,0,0,3
4453,2018-06-28,강서구,12.0,1,6,1,4,12
4454,2018-06-28,관악구,5.25,0,2,0,1,3
4455,2018-06-28,광진구,13.0,0,3,1,0,4
4456,2018-06-28,구로구,13.0,0,4,0,2,6
4457,2018-06-28,금천구,9.0,0,6,0,2,8
4458,2018-06-28,노원구,21.5,0,3,0,1,4
4459,2018-06-28,도봉구,25.0,0,3,0,1,4
4460,2018-06-28,동대문구,31.5,0,6,0,4,10
4461,2018-06-28,동작구,7.75,0,10,0,2,12
4462,2018-06-28,마포구,15.0,0,3,1,3,7
4463,2018-06-28,서대문구,25.0,0,2,0,0,2
4464,2018-06-28,서초구,6.0,0,8,3,1,12
4465,2018-06-28,성동구,20.5,0,5,0,1,6
4466,2018-06-28,성북구,18.5,0,6,0,0,6
4467,2018-06-28,송파구,11.5,0,5,3,6,14
4468,2018-06-28,양천구,12.0,0,3,0,2,5
4469,2018-06-28,영등포구,12.75,0,6,2,1,9
4470,2018-06-28,용산구,8.5,0,0,0,3,3
4471,2018-06-28,은평구,11.0,0,6,1,1,8
4472,2018-06-28,종로구,26.5,0,5,0,0,5
4473,2018-06-28,중구,11.0,0,1,0,3,4
4474,2018-06-28,중랑구,33.5,0,7,0,1,8
4475,2018-06-29,강남구,1.5,0,14,3,1,18
4476,2018-06-29,강동구,1.0,0,2,3,1,6
4477,2018-06-29,강북구,1.5,0,4,0,0,4
4478,2018-06-29,강서구,0.5,0,2,0,2,4
4479,2018-06-29,관악구,0.5,0,2,1,0,3
4480,2018-06-29,광진구,0.5,0,1,0,0,1
4481,2018-06-29,구로구,2.0,0,4,0,0,4
4482,2018-06-29,금천구,1.5,0,2,0,1,3
4483,2018-06-29,노원구,11.0,0,6,0,2,8
4484,2018-06-29,도봉구,0.5,0,0,0,0,0
4485,2018-06-29,동대문구,2.5,0,1,0,0,1
4486,2018-06-29,동작구,1.0,0,6,1,0,7
4487,2018-06-29,마포구,1.5,0,7,0,4,11
4488,2018-06-29,서대문구,2.5,0,2,2,1,5
4489,2018-06-29,서초구,0.5,0,6,0,2,8
4490,2018-06-29,성동구,2.0,0,2,1,2,5
4491,2018-06-29,성북구,2.0,0,4,0,0,4
4492,2018-06-29,송파구,2.0,0,6,1,2,9
4493,2018-06-29,양천구,1.0,0,3,0,3,6
4494,2018-06-29,영등포구,1.5,0,9,2,0,11
4495,2018-06-29,용산구,1.5,0,4,0,0,4
4496,2018-06-29,은평구,1.0,0,5,0,0,5
4497,2018-06-29,종로구,6.5,0,3,0,2,5
4498,2018-06-29,중구,6.5,0,3,0,0,3
4499,2018-06-29,중랑구,1.0,0,1,1,1,3
4500,2018-06-30,강남구,3.5,0,11,0,4,15
4501,2018-06-30,강동구,24.0,0,2,0,1,3
4502,2018-06-30,강북구,3.0,0,2,0,0,2
4503,2018-06-30,강서구,6.0,1,9,0,2,12
4504,2018-06-30,관악구,0.75,0,2,0,1,3
4505,2018-06-30,광진구,3.5,0,3,0,0,3
4506,2018-06-30,구로구,1.0,0,4,0,0,4
4507,2018-06-30,금천구,2.5,0,1,0,0,1
4508,2018-06-30,노원구,81.5,0,5,0,0,5
4509,2018-06-30,도봉구,32.0,0,1,1,0,2
4510,2018-06-30,동대문구,9.0,0,2,1,1,4
4511,2018-06-30,동작구,9.75,0,3,1,1,5
4512,2018-06-30,마포구,14.0,0,3,1,1,5
4513,2018-06-30,서대문구,8.5,0,0,0,0,0
4514,2018-06-30,서초구,0.5,0,1,0,1,2
4515,2018-06-30,성동구,2.0,0,2,0,0,2
4516,2018-06-30,성북구,14.5,0,6,0,0,6
4517,2018-06-30,송파구,3.0,0,8,1,4,13
4518,2018-06-30,양천구,10.0,0,3,5,0,8
4519,2018-06-30,영등포구,24.75,0,8,0,1,9
4520,2018-06-30,용산구,20.0,1,1,0,2,4
4521,2018-06-30,은평구,23.5,0,3,0,0,3
4522,2018-06-30,종로구,14.5,0,4,0,0,4
4523,2018-06-30,중구,5.0,0,0,0,1,1
4524,2018-06-30,중랑구,14.0,0,7,2,1,10
4525,2018-07-01,강남구,81.5,0,8,3,2,13
4526,2018-07-01,강동구,84.0,0,12,0,2,14
4527,2018-07-01,강북구,68.0,0,0,0,1,1
4528,2018-07-01,강서구,61.0,0,2,0,1,3
4529,2018-07-01,관악구,92.75,0,2,0,0,2
4530,2018-07-01,광진구,80.5,0,3,0,1,4
4531,2018-07-01,구로구,77.0,0,7,0,1,8
4532,2018-07-01,금천구,83.0,0,5,0,1,6
4533,2018-07-01,노원구,71.0,0,5,0,2,7
4534,2018-07-01,도봉구,85.0,0,1,0,1,2
4535,2018-07-01,동대문구,78.5,0,7,1,0,8
4536,2018-07-01,동작구,86.25,0,0,4,3,7
4537,2018-07-01,마포구,80.5,0,1,0,0,1
4538,2018-07-01,서대문구,79.0,0,0,0,1,1
4539,2018-07-01,서초구,85.0,0,5,1,1,7
4540,2018-07-01,성동구,83.5,0,3,0,0,3
4541,2018-07-01,성북구,84.0,0,6,0,1,7
4542,2018-07-01,송파구,89.0,0,12,1,3,16
4543,2018-07-01,양천구,75.5,0,2,0,1,3
4544,2018-07-01,영등포구,82.75,0,7,1,0,8
4545,2018-07-01,용산구,80.5,0,3,0,1,4
4546,2018-07-01,은평구,58.0,0,3,0,1,4
4547,2018-07-01,종로구,83.5,0,0,0,0,0
4548,2018-07-01,중구,63.0,0,5,0,1,6
4549,2018-07-01,중랑구,73.5,0,5,0,2,7
4550,2018-07-02,강남구,73.0,1,10,0,4,15
4551,2018-07-02,강동구,81.0,0,4,1,1,6
4552,2018-07-02,강북구,57.0,0,5,0,1,6
4553,2018-07-02,강서구,41.0,0,2,0,1,3
4554,2018-07-02,관악구,86.25,0,2,1,0,3
4555,2018-07-02,광진구,70.5,0,1,0,1,2
4556,2018-07-02,구로구,36.0,0,3,0,0,3
4557,2018-07-02,금천구,55.0,0,5,0,0,5
4558,2018-07-02,노원구,63.0,0,8,2,2,12
4559,2018-07-02,도봉구,68.0,0,6,0,1,7
4560,2018-07-02,동대문구,58.5,0,3,0,2,5
4561,2018-07-02,동작구,55.25,0,2,0,0,2
4562,2018-07-02,마포구,54.0,0,5,1,0,6
4563,2018-07-02,서대문구,67.5,0,3,0,2,5
4564,2018-07-02,서초구,82.0,0,6,1,3,10
4565,2018-07-02,성동구,59.0,0,1,0,1,2
4566,2018-07-02,성북구,60.0,0,1,1,0,2
4567,2018-07-02,송파구,83.5,0,6,0,7,13
4568,2018-07-02,양천구,56.0,0,5,1,1,7
4569,2018-07-02,영등포구,40.5,0,8,0,1,9
4570,2018-07-02,용산구,57.5,0,6,0,0,6
4571,2018-07-02,은평구,45.0,0,4,1,0,5
4572,2018-07-02,종로구,59.5,0,2,0,2,4
4573,2018-07-02,중구,46.5,0,2,2,2,6
4574,2018-07-02,중랑구,57.0,0,1,0,0,1
4575,2018-07-03,강남구,0.0,0,8,0,6,14
4576,2018-07-03,강동구,0.0,0,4,0,2,6
4577,2018-07-03,강북구,0.5,0,3,1,0,4
4578,2018-07-03,강서구,0.0,0,2,0,2,4
4579,2018-07-03,관악구,0.0,0,0,0,2,2
4580,2018-07-03,광진구,0.0,0,4,0,2,6
4581,2018-07-03,구로구,0.0,0,3,0,0,3
4582,2018-07-03,금천구,0.0,1,5,0,1,7
4583,2018-07-03,노원구,0.0,0,5,1,1,7
4584,2018-07-03,도봉구,3.0,0,1,1,1,3
4585,2018-07-03,동대문구,0.5,0,4,0,5,9
4586,2018-07-03,동작구,0.75,0,4,0,1,5
4587,2018-07-03,마포구,0.0,0,2,0,1,3
4588,2018-07-03,서대문구,0.0,0,2,0,0,2
4589,2018-07-03,서초구,0.0,0,5,1,0,6
4590,2018-07-03,성동구,0.0,0,1,0,0,1
4591,2018-07-03,성북구,0.0,0,3,1,2,6
4592,2018-07-03,송파구,0.0,0,8,0,4,12
4593,2018-07-03,양천구,0.0,0,0,0,1,1
4594,2018-07-03,영등포구,0.25,0,5,0,0,5
4595,2018-07-03,용산구,4.0,0,1,1,1,3
4596,2018-07-03,은평구,0.0,0,1,0,1,2
4597,2018-07-03,종로구,0.1,0,1,0,0,1
4598,2018-07-03,중구,0.5,0,3,1,1,5
4599,2018-07-03,중랑구,0.0,0,7,0,1,8
4600,2018-07-04,강남구,0.0,0,9,1,1,11
4601,2018-07-04,강동구,0.0,0,1,1,0,2
4602,2018-07-04,강북구,0.0,0,4,0,1,5
4603,2018-07-04,강서구,0.0,0,6,0,0,6
4604,2018-07-04,관악구,0.0,0,8,1,2,11
4605,2018-07-04,광진구,0.0,0,1,0,2,3
4606,2018-07-04,구로구,0.0,0,5,2,0,7
4607,2018-07-04,금천구,0.0,0,0,0,0,0
4608,2018-07-04,노원구,0.0,0,2,1,0,3
4609,2018-07-04,도봉구,0.0,0,2,0,0,2
4610,2018-07-04,동대문구,0.0,0,5,0,0,5
4611,2018-07-04,동작구,0.0,0,1,1,0,2
4612,2018-07-04,마포구,0.0,0,6,1,2,9
4613,2018-07-04,서대문구,0.0,0,0,0,1,1
4614,2018-07-04,서초구,0.0,0,6,0,0,6
4615,2018-07-04,성동구,0.0,0,4,0,1,5
4616,2018-07-04,성북구,0.0,0,1,0,0,1
4617,2018-07-04,송파구,0.0,0,14,3,2,19
4618,2018-07-04,양천구,0.0,0,7,0,1,8
4619,2018-07-04,영등포구,0.0,0,10,1,2,13
4620,2018-07-04,용산구,0.0,0,9,0,3,12
4621,2018-07-04,은평구,0.0,0,3,0,0,3
4622,2018-07-04,종로구,0.0,0,1,1,4,6
4623,2018-07-04,중구,0.0,0,4,0,3,7
4624,2018-07-04,중랑구,0.0,0,0,0,1,1
4625,2018-07-05,강남구,1.0,0,5,2,4,11
4626,2018-07-05,강동구,6.0,0,1,0,3,4
4627,2018-07-05,강북구,0.0,0,2,0,0,2
4628,2018-07-05,강서구,0.0,0,3,0,0,3
4629,2018-07-05,관악구,5.25,0,7,0,0,7
4630,2018-07-05,광진구,7.5,0,2,0,1,3
4631,2018-07-05,구로구,11.0,0,1,1,1,3
4632,2018-07-05,금천구,0.0,0,2,1,0,3
4633,2018-07-05,노원구,1.5,0,8,4,1,13
4634,2018-07-05,도봉구,0.0,0,0,0,2,2
4635,2018-07-05,동대문구,0.5,0,3,0,2,5
4636,2018-07-05,동작구,0.75,0,2,1,4,7
4637,2018-07-05,마포구,0.0,0,8,0,1,9
4638,2018-07-05,서대문구,0.0,0,0,2,0,2
4639,2018-07-05,서초구,0.5,0,4,2,1,7
4640,2018-07-05,성동구,10.5,0,1,0,1,2
4641,2018-07-05,성북구,0.5,0,2,0,3,5
4642,2018-07-05,송파구,3.0,0,8,2,2,12
4643,2018-07-05,양천구,0.0,0,4,0,1,5
4644,2018-07-05,영등포구,4.5,0,7,0,0,7
4645,2018-07-05,용산구,9.5,0,4,1,1,6
4646,2018-07-05,은평구,0.0,0,1,0,0,1
4647,2018-07-05,종로구,0.5,0,1,0,0,1
4648,2018-07-05,중구,0.0,0,2,2,2,6
4649,2018-07-05,중랑구,0.5,0,8,0,1,9
4650,2018-07-06,강남구,0.0,0,11,0,2,13
4651,2018-07-06,강동구,0.0,0,9,0,2,11
4652,2018-07-06,강북구,0.0,0,3,0,1,4
4653,2018-07-06,강서구,0.0,0,4,0,3,7
4654,2018-07-06,관악구,0.0,0,2,0,0,2
4655,2018-07-06,광진구,0.0,0,1,0,0,1
4656,2018-07-06,구로구,0.0,0,5,0,0,5
4657,2018-07-06,금천구,0.0,0,1,1,1,3
4658,2018-07-06,노원구,0.0,0,6,1,1,8
4659,2018-07-06,도봉구,0.0,1,1,0,1,3
4660,2018-07-06,동대문구,0.0,0,5,0,3,8
4661,2018-07-06,동작구,0.0,0,4,1,2,7
4662,2018-07-06,마포구,0.0,0,5,1,0,6
4663,2018-07-06,서대문구,0.0,0,3,1,1,5
4664,2018-07-06,서초구,0.0,0,3,0,1,4
4665,2018-07-06,성동구,0.0,0,2,3,2,7
4666,2018-07-06,성북구,0.0,0,4,2,1,7
4667,2018-07-06,송파구,0.0,0,8,1,0,9
4668,2018-07-06,양천구,0.0,0,1,2,1,4
4669,2018-07-06,영등포구,0.0,0,3,1,1,5
4670,2018-07-06,용산구,0.0,0,1,0,1,2
4671,2018-07-06,은평구,0.0,0,1,0,1,2
4672,2018-07-06,종로구,0.0,0,1,0,1,2
4673,2018-07-06,중구,0.0,0,5,0,2,7
4674,2018-07-06,중랑구,0.0,0,3,2,0,5
4675,2018-07-07,강남구,0.0,0,2,0,3,5
4676,2018-07-07,강동구,0.0,1,2,0,3,6
4677,2018-07-07,강북구,0.0,0,4,0,0,4
4678,2018-07-07,강서구,0.0,0,18,0,1,19
4679,2018-07-07,관악구,0.0,0,8,0,7,15
4680,2018-07-07,광진구,0.0,0,3,0,0,3
4681,2018-07-07,구로구,0.0,0,2,0,2,4
4682,2018-07-07,금천구,0.0,0,0,0,1,1
4683,2018-07-07,노원구,0.0,0,8,0,2,10
4684,2018-07-07,도봉구,0.0,0,3,0,1,4
4685,2018-07-07,동대문구,0.0,0,0,1,0,1
4686,2018-07-07,동작구,0.0,0,7,0,5,12
4687,2018-07-07,마포구,0.0,0,9,0,1,10
4688,2018-07-07,서대문구,0.0,0,2,1,2,5
4689,2018-07-07,서초구,0.0,0,7,1,1,9
4690,2018-07-07,성동구,0.0,0,1,0,0,1
4691,2018-07-07,성북구,0.0,0,1,0,2,3
4692,2018-07-07,송파구,0.0,0,12,3,2,17
4693,2018-07-07,양천구,0.0,0,12,2,0,14
4694,2018-07-07,영등포구,0.0,0,4,2,1,7
4695,2018-07-07,용산구,0.0,0,3,0,1,4
4696,2018-07-07,은평구,0.0,0,3,0,0,3
4697,2018-07-07,종로구,0.0,0,7,2,0,9
4698,2018-07-07,중구,0.0,0,0,0,0,0
4699,2018-07-07,중랑구,0.0,0,2,1,1,4
4700,2018-07-08,강남구,0.0,0,0,2,0,2
4701,2018-07-08,강동구,0.0,0,0,0,0,0
4702,2018-07-08,강북구,0.0,0,0,0,2,2
4703,2018-07-08,강서구,0.0,0,1,0,1,2
4704,2018-07-08,관악구,0.0,0,0,2,0,2
4705,2018-07-08,광진구,0.0,0,2,0,1,3
4706,2018-07-08,구로구,0.0,0,1,0,2,3
4707,2018-07-08,금천구,0.0,0,2,0,0,2
4708,2018-07-08,노원구,0.0,0,3,0,2,5
4709,2018-07-08,도봉구,0.0,0,1,0,1,2
4710,2018-07-08,동대문구,0.0,0,3,0,1,4
4711,2018-07-08,동작구,0.0,0,0,0,0,0
4712,2018-07-08,마포구,0.0,0,5,0,0,5
4713,2018-07-08,서대문구,0.0,0,2,2,0,4
4714,2018-07-08,서초구,0.0,0,7,0,2,9
4715,2018-07-08,성동구,0.0,0,4,0,0,4
4716,2018-07-08,성북구,0.0,0,2,1,0,3
4717,2018-07-08,송파구,0.0,0,11,1,1,13
4718,2018-07-08,양천구,0.0,0,2,0,1,3
4719,2018-07-08,영등포구,0.0,0,5,1,1,7
4720,2018-07-08,용산구,0.0,0,2,0,1,3
4721,2018-07-08,은평구,0.0,0,2,0,0,2
4722,2018-07-08,종로구,0.0,0,0,0,0,0
4723,2018-07-08,중구,0.0,0,0,0,1,1
4724,2018-07-08,중랑구,0.0,0,7,0,2,9
4725,2018-07-09,강남구,11.5,0,12,0,7,19
4726,2018-07-09,강동구,9.5,0,5,1,5,11
4727,2018-07-09,강북구,12.5,1,6,0,0,7
4728,2018-07-09,강서구,20.5,0,5,0,1,6
4729,2018-07-09,관악구,12.5,0,0,1,0,1
4730,2018-07-09,광진구,11.0,0,3,0,0,3
4731,2018-07-09,구로구,16.5,0,6,1,6,13
4732,2018-07-09,금천구,12.5,1,2,0,1,4
4733,2018-07-09,노원구,12.0,0,6,0,1,7
4734,2018-07-09,도봉구,15.5,0,0,0,0,0
4735,2018-07-09,동대문구,13.0,0,1,0,1,2
4736,2018-07-09,동작구,10.5,0,0,0,0,0
4737,2018-07-09,마포구,14.0,0,1,0,1,2
4738,2018-07-09,서대문구,14.5,0,3,0,2,5
4739,2018-07-09,서초구,12.0,0,1,1,1,3
4740,2018-07-09,성동구,11.5,0,1,0,1,2
4741,2018-07-09,성북구,15.0,0,2,0,2,4
4742,2018-07-09,송파구,10.0,0,5,1,3,9
4743,2018-07-09,양천구,14.0,0,3,0,1,4
4744,2018-07-09,영등포구,12.0,0,6,0,1,7
4745,2018-07-09,용산구,12.0,0,1,0,1,2
4746,2018-07-09,은평구,12.0,0,6,1,1,8
4747,2018-07-09,종로구,14.0,0,3,1,1,5
4748,2018-07-09,중구,9.0,0,3,0,2,5
4749,2018-07-09,중랑구,10.5,0,1,0,0,1
4750,2018-07-10,강남구,10.0,0,11,1,2,14
4751,2018-07-10,강동구,15.0,0,2,0,1,3
4752,2018-07-10,강북구,25.5,0,2,0,4,6
4753,2018-07-10,강서구,13.0,0,5,0,0,5
4754,2018-07-10,관악구,11.0,0,4,0,0,4
4755,2018-07-10,광진구,13.0,0,1,0,1,2
4756,2018-07-10,구로구,12.5,0,4,0,0,4
4757,2018-07-10,금천구,14.0,0,3,1,0,4
4758,2018-07-10,노원구,26.5,0,0,0,1,1
4759,2018-07-10,도봉구,26.0,0,5,1,1,7
4760,2018-07-10,동대문구,22.5,0,7,0,0,7
4761,2018-07-10,동작구,16.5,0,1,0,1,2
4762,2018-07-10,마포구,16.0,0,2,0,0,2
4763,2018-07-10,서대문구,16.0,0,1,0,1,2
4764,2018-07-10,서초구,8.5,0,4,1,1,6
4765,2018-07-10,성동구,18.0,0,2,0,1,3
4766,2018-07-10,성북구,22.5,0,1,0,2,3
4767,2018-07-10,송파구,9.5,0,8,2,0,10
4768,2018-07-10,양천구,15.5,0,3,0,0,3
4769,2018-07-10,영등포구,15.25,0,9,0,1,10
4770,2018-07-10,용산구,18.0,0,5,0,1,6
4771,2018-07-10,은평구,14.5,0,3,0,0,3
4772,2018-07-10,종로구,16.5,0,4,2,0,6
4773,2018-07-10,중구,13.5,0,1,0,4,5
4774,2018-07-10,중랑구,23.5,0,1,1,1,3
4775,2018-07-11,강남구,2.5,0,6,1,2,9
4776,2018-07-11,강동구,2.0,0,2,1,0,3
4777,2018-07-11,강북구,7.5,0,2,0,0,2
4778,2018-07-11,강서구,5.5,0,7,0,0,7
4779,2018-07-11,관악구,2.0,0,6,0,0,6
4780,2018-07-11,광진구,2.0,1,0,0,0,1
4781,2018-07-11,구로구,2.0,0,6,1,2,9
4782,2018-07-11,금천구,2.5,0,0,0,0,0
4783,2018-07-11,노원구,5.5,0,0,0,0,0
4784,2018-07-11,도봉구,9.5,0,2,0,3,5
4785,2018-07-11,동대문구,3.0,0,3,1,0,4
4786,2018-07-11,동작구,2.25,0,4,0,0,4
4787,2018-07-11,마포구,2.5,0,2,1,0,3
4788,2018-07-11,서대문구,3.0,0,2,0,1,3
4789,2018-07-11,서초구,2.0,0,2,1,3,6
4790,2018-07-11,성동구,3.0,0,0,0,1,1
4791,2018-07-11,성북구,4.5,0,5,1,1,7
4792,2018-07-11,송파구,2.0,0,6,1,1,8
4793,2018-07-11,양천구,2.5,0,7,2,2,11
4794,2018-07-11,영등포구,2.25,0,10,0,0,10
4795,2018-07-11,용산구,2.5,0,3,0,0,3
4796,2018-07-11,은평구,8.0,0,3,0,0,3
4797,2018-07-11,종로구,3.0,0,5,0,2,7
4798,2018-07-11,중구,3.0,0,0,2,2,4
4799,2018-07-11,중랑구,3.0,0,0,0,3,3
4800,2018-07-12,강남구,0.5,0,7,1,5,13
4801,2018-07-12,강동구,0.0,0,4,0,3,7
4802,2018-07-12,강북구,0.0,0,1,0,1,2
4803,2018-07-12,강서구,0.5,0,1,0,0,1
4804,2018-07-12,관악구,0.75,0,1,1,3,5
4805,2018-07-12,광진구,0.5,2,6,2,3,13
4806,2018-07-12,구로구,1.0,0,12,2,4,18
4807,2018-07-12,금천구,0.0,0,4,0,1,5
4808,2018-07-12,노원구,0.0,0,1,0,0,1
4809,2018-07-12,도봉구,1.5,0,2,0,1,3
4810,2018-07-12,동대문구,0.0,0,2,1,4,7
4811,2018-07-12,동작구,0.0,1,2,2,3,8
4812,2018-07-12,마포구,1.0,0,8,0,0,8
4813,2018-07-12,서대문구,1.0,0,1,1,0,2
4814,2018-07-12,서초구,0.5,0,7,1,2,10
4815,2018-07-12,성동구,0.0,0,1,0,0,1
4816,2018-07-12,성북구,0.0,0,1,0,1,2
4817,2018-07-12,송파구,0.0,0,19,2,3,24
4818,2018-07-12,양천구,1.0,0,3,0,0,3
4819,2018-07-12,영등포구,0.75,0,9,1,2,12
4820,2018-07-12,용산구,0.0,1,4,1,0,6
4821,2018-07-12,은평구,1.0,0,1,0,3,4
4822,2018-07-12,종로구,1.0,0,2,0,0,2
4823,2018-07-12,중구,0.0,0,3,0,3,6
4824,2018-07-12,중랑구,0.0,0,2,1,1,4
4825,2018-07-13,강남구,0.0,0,12,1,2,15
4826,2018-07-13,강동구,0.0,0,5,1,0,6
4827,2018-07-13,강북구,0.0,0,2,0,0,2
4828,2018-07-13,강서구,0.0,0,4,0,3,7
4829,2018-07-13,관악구,0.0,0,0,0,0,0
4830,2018-07-13,광진구,0.0,0,7,0,1,8
4831,2018-07-13,구로구,0.0,0,5,0,1,6
4832,2018-07-13,금천구,0.0,0,2,0,2,4
4833,2018-07-13,노원구,0.0,0,6,1,0,7
4834,2018-07-13,도봉구,0.0,0,0,0,0,0
4835,2018-07-13,동대문구,0.0,0,4,0,1,5
4836,2018-07-13,동작구,0.0,0,8,2,4,14
4837,2018-07-13,마포구,0.0,0,5,0,2,7
4838,2018-07-13,서대문구,0.0,0,0,2,0,2
4839,2018-07-13,서초구,0.0,0,4,1,0,5
4840,2018-07-13,성동구,0.0,0,4,1,0,5
4841,2018-07-13,성북구,0.0,0,3,0,0,3
4842,2018-07-13,송파구,0.0,0,6,3,1,10
4843,2018-07-13,양천구,0.0,0,5,0,1,6
4844,2018-07-13,영등포구,0.0,1,3,1,2,7
4845,2018-07-13,용산구,0.0,0,3,1,0,4
4846,2018-07-13,은평구,0.0,1,6,0,0,7
4847,2018-07-13,종로구,0.0,0,3,1,0,4
4848,2018-07-13,중구,0.0,0,2,0,0,2
4849,2018-07-13,중랑구,0.0,0,1,2,0,3
4850,2018-07-14,강남구,0.0,0,9,0,1,10
4851,2018-07-14,강동구,0.0,0,6,3,1,10
4852,2018-07-14,강북구,0.0,0,7,0,0,7
4853,2018-07-14,강서구,0.0,0,2,2,0,4
4854,2018-07-14,관악구,0.0,0,1,0,0,1
4855,2018-07-14,광진구,0.0,0,4,1,0,5
4856,2018-07-14,구로구,0.0,0,1,0,0,1
4857,2018-07-14,금천구,0.0,0,4,1,2,7
4858,2018-07-14,노원구,0.0,0,6,2,0,8
4859,2018-07-14,도봉구,0.0,0,1,0,0,1
4860,2018-07-14,동대문구,0.0,0,4,1,3,8
4861,2018-07-14,동작구,0.0,0,4,1,0,5
4862,2018-07-14,마포구,0.0,0,5,2,1,8
4863,2018-07-14,서대문구,0.0,0,4,0,1,5
4864,2018-07-14,서초구,0.0,0,15,0,1,16
4865,2018-07-14,성동구,0.0,0,4,0,1,5
4866,2018-07-14,성북구,0.0,0,4,1,1,6
4867,2018-07-14,송파구,0.0,0,1,0,1,2
4868,2018-07-14,양천구,0.0,0,7,1,2,10
4869,2018-07-14,영등포구,0.0,0,6,1,0,7
4870,2018-07-14,용산구,0.0,0,0,0,1,1
4871,2018-07-14,은평구,0.0,0,6,0,3,9
4872,2018-07-14,종로구,0.0,0,1,0,3,4
4873,2018-07-14,중구,0.0,0,5,0,0,5
4874,2018-07-14,중랑구,0.0,0,1,0,1,2
4875,2018-07-15,강남구,0.0,0,4,2,1,7
4876,2018-07-15,강동구,0.0,0,2,0,1,3
4877,2018-07-15,강북구,0.0,0,4,0,1,5
4878,2018-07-15,강서구,0.0,0,0,0,1,1
4879,2018-07-15,관악구,0.0,0,3,0,1,4
4880,2018-07-15,광진구,0.0,0,6,2,0,8
4881,2018-07-15,구로구,0.0,0,4,0,0,4
4882,2018-07-15,금천구,0.0,0,1,0,0,1
4883,2018-07-15,노원구,0.0,0,13,2,1,16
4884,2018-07-15,도봉구,0.0,0,1,0,1,2
4885,2018-07-15,동대문구,0.0,0,2,0,1,3
4886,2018-07-15,동작구,0.0,0,0,1,0,1
4887,2018-07-15,마포구,0.0,0,5,0,4,9
4888,2018-07-15,서대문구,0.0,0,2,1,0,3
4889,2018-07-15,서초구,0.0,1,18,6,2,27
4890,2018-07-15,성동구,0.0,0,2,0,1,3
4891,2018-07-15,성북구,0.0,0,2,1,0,3
4892,2018-07-15,송파구,0.0,0,8,0,0,8
4893,2018-07-15,양천구,0.0,0,5,0,1,6
4894,2018-07-15,영등포구,0.0,0,5,2,2,9
4895,2018-07-15,용산구,0.0,0,1,1,0,2
4896,2018-07-15,은평구,0.0,0,2,0,2,4
4897,2018-07-15,종로구,0.0,0,1,0,0,1
4898,2018-07-15,중구,0.0,0,3,0,1,4
4899,2018-07-15,중랑구,0.0,0,5,0,0,5
4900,2018-07-16,강남구,0.0,0,19,1,3,23
4901,2018-07-16,강동구,0.0,0,1,1,2,4
4902,2018-07-16,강북구,0.0,1,9,1,2,13
4903,2018-07-16,강서구,0.0,0,6,0,0,6
4904,2018-07-16,관악구,0.0,0,1,1,1,3
4905,2018-07-16,광진구,0.0,0,1,0,0,1
4906,2018-07-16,구로구,0.0,1,12,0,1,14
4907,2018-07-16,금천구,0.0,0,2,0,0,2
4908,2018-07-16,노원구,0.0,0,11,3,1,15
4909,2018-07-16,도봉구,0.0,0,1,0,0,1
4910,2018-07-16,동대문구,0.0,0,5,0,1,6
4911,2018-07-16,동작구,0.0,0,4,0,0,4
4912,2018-07-16,마포구,0.0,0,3,0,1,4
4913,2018-07-16,서대문구,0.0,0,2,0,1,3
4914,2018-07-16,서초구,0.0,0,7,0,2,9
4915,2018-07-16,성동구,0.0,0,3,0,1,4
4916,2018-07-16,성북구,0.0,0,5,0,3,8
4917,2018-07-16,송파구,0.0,0,9,0,4,13
4918,2018-07-16,양천구,0.0,0,4,1,0,5
4919,2018-07-16,영등포구,0.0,0,5,0,4,9
4920,2018-07-16,용산구,0.0,0,2,1,0,3
4921,2018-07-16,은평구,0.0,0,2,0,1,3
4922,2018-07-16,종로구,0.0,0,3,1,0,4
4923,2018-07-16,중구,0.0,0,2,0,0,2
4924,2018-07-16,중랑구,0.0,0,14,3,4,21
4925,2018-07-17,강남구,0.0,0,14,1,3,18
4926,2018-07-17,강동구,0.0,0,2,1,1,4
4927,2018-07-17,강북구,0.0,0,3,0,1,4
4928,2018-07-17,강서구,0.0,0,3,0,1,4
4929,2018-07-17,관악구,0.0,0,7,1,1,9
4930,2018-07-17,광진구,0.0,0,1,0,3,4
4931,2018-07-17,구로구,0.0,0,1,0,0,1
4932,2018-07-17,금천구,0.0,0,2,0,0,2
4933,2018-07-17,노원구,0.0,0,0,1,2,3
4934,2018-07-17,도봉구,0.0,0,4,1,2,7
4935,2018-07-17,동대문구,0.0,0,6,0,1,7
4936,2018-07-17,동작구,0.0,0,3,1,1,5
4937,2018-07-17,마포구,0.0,0,9,1,1,11
4938,2018-07-17,서대문구,0.0,0,3,0,1,4
4939,2018-07-17,서초구,0.0,0,9,0,2,11
4940,2018-07-17,성동구,0.0,0,8,0,1,9
4941,2018-07-17,성북구,0.0,0,5,0,0,5
4942,2018-07-17,송파구,0.0,0,10,2,4,16
4943,2018-07-17,양천구,0.0,0,6,1,0,7
4944,2018-07-17,영등포구,0.0,0,7,0,0,7
4945,2018-07-17,용산구,0.0,0,2,0,1,3
4946,2018-07-17,은평구,0.0,0,1,0,2,3
4947,2018-07-17,종로구,0.0,0,5,1,1,7
4948,2018-07-17,중구,0.0,0,3,0,0,3
4949,2018-07-17,중랑구,0.0,0,2,0,2,4
4950,2018-07-18,강남구,0.0,0,15,1,2,18
4951,2018-07-18,강동구,0.0,0,5,0,0,5
4952,2018-07-18,강북구,0.0,0,1,0,0,1
4953,2018-07-18,강서구,0.0,0,3,0,0,3
4954,2018-07-18,관악구,0.0,0,5,0,0,5
4955,2018-07-18,광진구,0.0,0,0,0,0,0
4956,2018-07-18,구로구,0.0,0,3,2,0,5
4957,2018-07-18,금천구,0.0,0,2,0,2,4
4958,2018-07-18,노원구,0.0,1,3,0,1,5
4959,2018-07-18,도봉구,0.0,0,2,0,1,3
4960,2018-07-18,동대문구,0.0,0,4,0,2,6
4961,2018-07-18,동작구,0.0,0,4,0,1,5
4962,2018-07-18,마포구,0.0,0,13,0,2,15
4963,2018-07-18,서대문구,0.0,0,1,1,0,2
4964,2018-07-18,서초구,0.0,0,1,0,3,4
4965,2018-07-18,성동구,0.0,0,8,3,2,13
4966,2018-07-18,성북구,0.0,0,1,0,0,1
4967,2018-07-18,송파구,0.0,1,6,0,2,9
4968,2018-07-18,양천구,0.0,0,0,0,0,0
4969,2018-07-18,영등포구,0.0,0,7,2,2,11
4970,2018-07-18,용산구,0.0,0,4,0,0,4
4971,2018-07-18,은평구,0.0,0,6,0,2,8
4972,2018-07-18,종로구,0.0,0,4,2,0,6
4973,2018-07-18,중구,0.0,0,2,0,0,2
4974,2018-07-18,중랑구,0.0,0,1,1,3,5
4975,2018-07-19,강남구,0.0,1,11,0,1,13
4976,2018-07-19,강동구,0.0,0,4,1,0,5
4977,2018-07-19,강북구,0.0,0,3,0,0,3
4978,2018-07-19,강서구,0.0,0,2,0,0,2
4979,2018-07-19,관악구,0.0,0,2,0,2,4
4980,2018-07-19,광진구,0.0,0,3,0,2,5
4981,2018-07-19,구로구,0.0,0,4,0,0,4
4982,2018-07-19,금천구,0.0,0,1,2,1,4
4983,2018-07-19,노원구,0.0,1,7,0,0,8
4984,2018-07-19,도봉구,0.0,0,1,0,0,1
4985,2018-07-19,동대문구,0.0,0,4,1,2,7
4986,2018-07-19,동작구,0.0,0,4,0,0,4
4987,2018-07-19,마포구,0.0,0,7,0,1,8
4988,2018-07-19,서대문구,0.0,0,3,0,1,4
4989,2018-07-19,서초구,0.0,0,5,1,2,8
4990,2018-07-19,성동구,0.0,0,4,3,1,8
4991,2018-07-19,성북구,0.0,0,4,1,0,5
4992,2018-07-19,송파구,0.0,0,8,1,1,10
4993,2018-07-19,양천구,0.0,0,7,0,0,7
4994,2018-07-19,영등포구,0.0,0,5,1,6,12
4995,2018-07-19,용산구,0.0,0,5,0,0,5
4996,2018-07-19,은평구,0.0,0,5,1,0,6
4997,2018-07-19,종로구,0.0,0,5,1,0,6
4998,2018-07-19,중구,0.0,0,0,0,1,1
4999,2018-07-19,중랑구,0.0,0,1,2,3,6
5000,2018-07-20,강남구,0.0,0,12,1,5,18
5001,2018-07-20,강동구,0.0,0,4,0,3,7
5002,2018-07-20,강북구,0.0,0,5,1,1,7
5003,2018-07-20,강서구,0.0,0,1,0,1,2
5004,2018-07-20,관악구,0.0,0,4,0,0,4
5005,2018-07-20,광진구,0.0,0,7,0,0,7
5006,2018-07-20,구로구,0.0,0,1,1,2,4
5007,2018-07-20,금천구,0.0,0,3,1,1,5
5008,2018-07-20,노원구,0.0,0,4,2,3,9
5009,2018-07-20,도봉구,0.0,0,0,1,1,2
5010,2018-07-20,동대문구,0.0,0,6,0,3,9
5011,2018-07-20,동작구,0.0,0,5,1,3,9
5012,2018-07-20,마포구,0.0,0,4,0,3,7
5013,2018-07-20,서대문구,0.0,0,9,1,1,11
5014,2018-07-20,서초구,0.0,0,10,3,6,19
5015,2018-07-20,성동구,0.0,0,8,0,0,8
5016,2018-07-20,성북구,0.0,0,1,1,2,4
5017,2018-07-20,송파구,0.0,2,5,1,2,10
5018,2018-07-20,양천구,0.0,0,10,1,0,11
5019,2018-07-20,영등포구,0.0,1,11,2,2,16
5020,2018-07-20,용산구,0.0,0,2,1,0,3
5021,2018-07-20,은평구,0.0,0,5,1,3,9
5022,2018-07-20,종로구,0.0,0,5,4,1,10
5023,2018-07-20,중구,0.0,0,2,0,0,2
5024,2018-07-20,중랑구,0.0,0,8,0,3,11
5025,2018-07-21,강남구,0.0,0,13,0,3,16
5026,2018-07-21,강동구,0.0,0,0,1,2,3
5027,2018-07-21,강북구,0.0,0,3,0,1,4
5028,2018-07-21,강서구,0.0,0,7,0,6,13
5029,2018-07-21,관악구,0.0,0,1,1,0,2
5030,2018-07-21,광진구,0.0,0,5,0,1,6
5031,2018-07-21,구로구,0.0,0,5,0,1,6
5032,2018-07-21,금천구,0.0,0,1,0,0,1
5033,2018-07-21,노원구,0.0,0,0,0,2,2
5034,2018-07-21,도봉구,0.0,0,3,0,1,4
5035,2018-07-21,동대문구,0.0,0,2,1,0,3
5036,2018-07-21,동작구,0.0,0,5,1,2,8
5037,2018-07-21,마포구,0.0,0,2,0,1,3
5038,2018-07-21,서대문구,0.0,0,11,1,2,14
5039,2018-07-21,서초구,0.0,0,12,2,3,17
5040,2018-07-21,성동구,0.0,0,5,1,1,7
5041,2018-07-21,성북구,0.0,0,4,0,0,4
5042,2018-07-21,송파구,0.0,1,15,0,0,16
5043,2018-07-21,양천구,0.0,0,3,0,0,3
5044,2018-07-21,영등포구,0.0,0,7,0,1,8
5045,2018-07-21,용산구,0.0,0,4,0,1,5
5046,2018-07-21,은평구,0.0,0,2,0,3,5
5047,2018-07-21,종로구,0.0,0,4,0,0,4
5048,2018-07-21,중구,0.0,0,0,0,0,0
5049,2018-07-21,중랑구,0.0,0,5,3,3,11
5050,2018-07-22,강남구,0.0,0,8,0,2,10
5051,2018-07-22,강동구,0.0,0,3,0,0,3
5052,2018-07-22,강북구,0.0,1,3,0,2,6
5053,2018-07-22,강서구,0.0,0,9,0,0,9
5054,2018-07-22,관악구,0.0,0,3,0,1,4
5055,2018-07-22,광진구,0.0,0,3,2,1,6
5056,2018-07-22,구로구,0.0,0,5,0,2,7
5057,2018-07-22,금천구,0.0,0,6,2,0,8
5058,2018-07-22,노원구,0.0,0,2,0,0,2
5059,2018-07-22,도봉구,0.0,0,2,0,1,3
5060,2018-07-22,동대문구,0.0,0,2,1,3,6
5061,2018-07-22,동작구,0.0,0,3,1,1,5
5062,2018-07-22,마포구,0.0,0,10,0,1,11
5063,2018-07-22,서대문구,0.0,0,1,0,0,1
5064,2018-07-22,서초구,0.0,0,7,2,3,12
5065,2018-07-22,성동구,0.0,0,0,1,1,2
5066,2018-07-22,성북구,0.0,0,6,1,0,7
5067,2018-07-22,송파구,0.0,0,5,2,1,8
5068,2018-07-22,양천구,0.0,0,3,0,1,4
5069,2018-07-22,영등포구,0.0,0,11,3,2,16
5070,2018-07-22,용산구,0.0,0,1,0,1,2
5071,2018-07-22,은평구,0.0,0,1,0,1,2
5072,2018-07-22,종로구,0.0,0,1,0,0,1
5073,2018-07-22,중구,0.0,0,3,0,0,3
5074,2018-07-22,중랑구,0.0,0,0,0,1,1
5075,2018-07-23,강남구,0.0,0,14,1,2,17
5076,2018-07-23,강동구,0.0,1,0,1,1,3
5077,2018-07-23,강북구,0.0,0,1,0,2,3
5078,2018-07-23,강서구,0.0,0,1,0,2,3
5079,2018-07-23,관악구,0.0,0,1,1,1,3
5080,2018-07-23,광진구,0.0,0,7,0,1,8
5081,2018-07-23,구로구,0.0,0,7,0,0,7
5082,2018-07-23,금천구,0.0,0,7,0,0,7
5083,2018-07-23,노원구,0.0,0,2,0,0,2
5084,2018-07-23,도봉구,0.0,0,3,0,1,4
5085,2018-07-23,동대문구,0.0,0,4,0,3,7
5086,2018-07-23,동작구,0.0,0,1,2,0,3
5087,2018-07-23,마포구,0.0,0,0,0,0,0
5088,2018-07-23,서대문구,0.0,0,3,0,0,3
5089,2018-07-23,서초구,0.0,0,12,0,1,13
5090,2018-07-23,성동구,0.0,0,0,1,0,1
5091,2018-07-23,성북구,0.0,0,4,0,2,6
5092,2018-07-23,송파구,0.0,0,5,0,1,6
5093,2018-07-23,양천구,0.0,0,4,0,3,7
5094,2018-07-23,영등포구,0.0,0,3,1,3,7
5095,2018-07-23,용산구,0.0,0,6,1,2,9
5096,2018-07-23,은평구,0.0,0,4,1,1,6
5097,2018-07-23,종로구,0.0,0,2,0,4,6
5098,2018-07-23,중구,0.0,0,1,0,0,1
5099,2018-07-23,중랑구,0.0,0,4,1,1,6
5100,2018-07-24,강남구,0.0,0,8,0,1,9
5101,2018-07-24,강동구,0.0,0,10,1,0,11
5102,2018-07-24,강북구,0.0,0,17,0,2,19
5103,2018-07-24,강서구,0.0,0,9,0,0,9
5104,2018-07-24,관악구,0.0,0,4,0,0,4
5105,2018-07-24,광진구,0.0,0,3,0,1,4
5106,2018-07-24,구로구,0.0,0,1,0,0,1
5107,2018-07-24,금천구,0.0,0,3,0,2,5
5108,2018-07-24,노원구,0.5,0,9,0,1,10
5109,2018-07-24,도봉구,0.0,0,4,0,2,6
5110,2018-07-24,동대문구,0.0,0,3,1,1,5
5111,2018-07-24,동작구,0.0,0,3,1,0,4
5112,2018-07-24,마포구,0.0,0,3,1,0,4
5113,2018-07-24,서대문구,0.0,0,4,1,0,5
5114,2018-07-24,서초구,0.0,0,5,0,0,5
5115,2018-07-24,성동구,0.0,0,5,0,2,7
5116,2018-07-24,성북구,0.0,0,4,0,0,4
5117,2018-07-24,송파구,0.0,0,9,3,1,13
5118,2018-07-24,양천구,0.0,0,5,0,1,6
5119,2018-07-24,영등포구,0.0,0,9,0,5,14
5120,2018-07-24,용산구,0.0,0,3,0,2,5
5121,2018-07-24,은평구,0.0,0,8,1,4,13
5122,2018-07-24,종로구,0.0,0,1,1,0,2
5123,2018-07-24,중구,0.0,0,6,1,2,9
5124,2018-07-24,중랑구,0.0,0,4,0,1,5
5125,2018-07-25,강남구,0.0,0,23,1,2,26
5126,2018-07-25,강동구,0.0,0,3,3,2,8
5127,2018-07-25,강북구,0.0,0,2,0,0,2
5128,2018-07-25,강서구,0.0,0,4,0,1,5
5129,2018-07-25,관악구,0.0,0,4,1,2,7
5130,2018-07-25,광진구,0.0,0,3,0,0,3
5131,2018-07-25,구로구,0.0,0,2,0,0,2
5132,2018-07-25,금천구,0.0,0,0,1,0,1
5133,2018-07-25,노원구,0.0,0,2,1,0,3
5134,2018-07-25,도봉구,0.0,0,2,1,0,3
5135,2018-07-25,동대문구,0.0,0,2,1,3,6
5136,2018-07-25,동작구,0.0,0,5,1,0,6
5137,2018-07-25,마포구,0.0,0,8,0,1,9
5138,2018-07-25,서대문구,0.0,0,5,1,0,6
5139,2018-07-25,서초구,0.0,0,5,1,2,8
5140,2018-07-25,성동구,0.0,0,5,0,0,5
5141,2018-07-25,성북구,0.0,0,1,0,2,3
5142,2018-07-25,송파구,0.0,0,8,0,4,12
5143,2018-07-25,양천구,0.0,0,1,0,2,3
5144,2018-07-25,영등포구,0.0,0,10,1,2,13
5145,2018-07-25,용산구,0.0,0,7,0,2,9
5146,2018-07-25,은평구,0.0,0,1,0,0,1
5147,2018-07-25,종로구,0.0,0,0,0,0,0
5148,2018-07-25,중구,0.0,0,7,0,0,7
5149,2018-07-25,중랑구,0.0,0,6,2,3,11
5150,2018-07-26,강남구,0.0,0,13,0,7,20
5151,2018-07-26,강동구,0.0,0,1,1,1,3
5152,2018-07-26,강북구,0.0,0,2,0,0,2
5153,2018-07-26,강서구,0.0,0,4,0,1,5
5154,2018-07-26,관악구,0.0,0,3,0,2,5
5155,2018-07-26,광진구,0.0,0,2,0,0,2
5156,2018-07-26,구로구,0.0,0,7,0,0,7
5157,2018-07-26,금천구,0.0,0,2,0,0,2
5158,2018-07-26,노원구,0.0,0,0,0,1,1
5159,2018-07-26,도봉구,0.0,0,1,0,0,1
5160,2018-07-26,동대문구,0.0,0,3,0,1,4
5161,2018-07-26,동작구,0.0,0,3,1,1,5
5162,2018-07-26,마포구,0.0,0,8,0,0,8
5163,2018-07-26,서대문구,0.0,0,5,2,0,7
5164,2018-07-26,서초구,0.0,0,10,0,0,10
5165,2018-07-26,성동구,0.0,1,0,0,2,3
5166,2018-07-26,성북구,0.0,0,7,1,2,10
5167,2018-07-26,송파구,0.0,0,9,3,5,17
5168,2018-07-26,양천구,0.0,1,3,3,0,7
5169,2018-07-26,영등포구,0.0,0,8,1,1,10
5170,2018-07-26,용산구,0.0,0,2,0,0,2
5171,2018-07-26,은평구,0.0,0,0,0,1,1
5172,2018-07-26,종로구,0.0,0,3,0,0,3
5173,2018-07-26,중구,0.0,0,0,0,2,2
5174,2018-07-26,중랑구,0.0,0,4,1,1,6
5175,2018-07-27,강남구,0.0,0,14,2,5,21
5176,2018-07-27,강동구,0.0,0,3,1,0,4
5177,2018-07-27,강북구,0.0,0,2,1,1,4
5178,2018-07-27,강서구,0.0,0,7,1,1,9
5179,2018-07-27,관악구,0.0,0,10,0,2,12
5180,2018-07-27,광진구,0.0,0,4,1,1,6
5181,2018-07-27,구로구,0.0,0,8,2,6,16
5182,2018-07-27,금천구,0.0,0,4,0,1,5
5183,2018-07-27,노원구,0.0,0,0,0,3,3
5184,2018-07-27,도봉구,0.0,0,0,0,1,1
5185,2018-07-27,동대문구,0.0,0,6,0,3,9
5186,2018-07-27,동작구,0.0,0,4,2,2,8
5187,2018-07-27,마포구,0.0,0,11,0,0,11
5188,2018-07-27,서대문구,0.0,0,2,0,0,2
5189,2018-07-27,서초구,0.0,0,11,1,7,19
5190,2018-07-27,성동구,0.0,0,7,1,2,10
5191,2018-07-27,성북구,0.0,0,7,1,2,10
5192,2018-07-27,송파구,0.0,0,11,1,4,16
5193,2018-07-27,양천구,0.0,0,6,0,1,7
5194,2018-07-27,영등포구,0.0,0,9,0,0,9
5195,2018-07-27,용산구,0.0,0,7,0,2,9
5196,2018-07-27,은평구,0.0,0,5,2,0,7
5197,2018-07-27,종로구,0.0,0,3,0,3,6
5198,2018-07-27,중구,0.0,0,1,0,1,2
5199,2018-07-27,중랑구,0.0,0,3,1,5,9
5200,2018-07-28,강남구,16.0,0,10,0,2,12
5201,2018-07-28,강동구,0.0,0,8,0,2,10
5202,2018-07-28,강북구,0.5,0,2,0,1,3
5203,2018-07-28,강서구,14.5,0,6,3,3,12
5204,2018-07-28,관악구,11.25,0,2,0,2,4
5205,2018-07-28,광진구,1.5,0,0,0,0,0
5206,2018-07-28,구로구,12.5,0,11,1,0,12
5207,2018-07-28,금천구,4.0,0,1,0,1,2
5208,2018-07-28,노원구,0.0,0,2,0,0,2
5209,2018-07-28,도봉구,0.5,0,2,0,1,3
5210,2018-07-28,동대문구,0.0,0,8,0,1,9
5211,2018-07-28,동작구,16.5,0,2,1,0,3
5212,2018-07-28,마포구,9.5,0,7,4,2,13
5213,2018-07-28,서대문구,0.5,0,1,0,0,1
5214,2018-07-28,서초구,11.5,0,3,0,1,4
5215,2018-07-28,성동구,10.0,0,5,1,0,6
5216,2018-07-28,성북구,6.5,0,0,0,4,4
5217,2018-07-28,송파구,6.5,0,17,2,8,27
5218,2018-07-28,양천구,21.5,0,1,0,0,1
5219,2018-07-28,영등포구,22.5,0,2,1,3,6
5220,2018-07-28,용산구,19.5,0,4,1,0,5
5221,2018-07-28,은평구,0.5,0,2,0,1,3
5222,2018-07-28,종로구,7.5,0,2,0,0,2
5223,2018-07-28,중구,29.5,0,2,1,1,4
5224,2018-07-28,중랑구,0.0,0,1,0,1,2
5225,2018-07-29,강남구,0.0,0,7,2,3,12
5226,2018-07-29,강동구,0.0,0,3,0,1,4
5227,2018-07-29,강북구,0.0,0,1,0,0,1
5228,2018-07-29,강서구,0.0,0,0,1,2,3
5229,2018-07-29,관악구,0.0,0,0,0,1,1
5230,2018-07-29,광진구,0.0,0,9,0,0,9
5231,2018-07-29,구로구,0.0,0,2,0,0,2
5232,2018-07-29,금천구,0.0,0,3,0,0,3
5233,2018-07-29,노원구,0.0,0,1,0,2,3
5234,2018-07-29,도봉구,0.0,0,1,1,1,3
5235,2018-07-29,동대문구,0.0,0,5,0,0,5
5236,2018-07-29,동작구,0.0,0,1,0,1,2
5237,2018-07-29,마포구,0.0,0,9,7,4,20
5238,2018-07-29,서대문구,0.0,0,1,0,0,1
5239,2018-07-29,서초구,0.0,0,3,1,0,4
5240,2018-07-29,성동구,0.0,0,1,0,0,1
5241,2018-07-29,성북구,0.0,0,3,0,0,3
5242,2018-07-29,송파구,0.0,0,7,6,5,18
5243,2018-07-29,양천구,0.0,0,1,1,3,5
5244,2018-07-29,영등포구,0.0,0,8,0,0,8
5245,2018-07-29,용산구,0.0,0,2,0,4,6
5246,2018-07-29,은평구,0.0,0,1,0,1,2
5247,2018-07-29,종로구,0.0,0,7,0,2,9
5248,2018-07-29,중구,0.0,0,3,1,1,5
5249,2018-07-29,중랑구,0.0,0,2,0,1,3
5250,2018-07-30,강남구,0.0,0,15,0,5,20
5251,2018-07-30,강동구,0.0,0,3,1,0,4
5252,2018-07-30,강북구,0.0,0,1,0,0,1
5253,2018-07-30,강서구,0.0,0,4,0,3,7
5254,2018-07-30,관악구,0.0,0,7,0,1,8
5255,2018-07-30,광진구,0.0,0,2,0,0,2
5256,2018-07-30,구로구,0.0,0,6,0,0,6
5257,2018-07-30,금천구,0.0,0,0,0,0,0
5258,2018-07-30,노원구,0.0,0,3,1,1,5
5259,2018-07-30,도봉구,0.0,0,1,1,2,4
5260,2018-07-30,동대문구,0.0,0,3,0,1,4
5261,2018-07-30,동작구,0.0,0,1,1,0,2
5262,2018-07-30,마포구,0.0,0,3,3,1,7
5263,2018-07-30,서대문구,0.0,0,0,0,2,2
5264,2018-07-30,서초구,0.0,0,12,1,8,21
5265,2018-07-30,성동구,0.0,0,2,0,2,4
5266,2018-07-30,성북구,0.0,0,3,0,2,5
5267,2018-07-30,송파구,0.0,1,10,2,6,19
5268,2018-07-30,양천구,0.0,0,2,0,1,3
5269,2018-07-30,영등포구,0.0,0,7,2,1,10
5270,2018-07-30,용산구,0.0,0,5,0,1,6
5271,2018-07-30,은평구,0.0,0,2,1,2,5
5272,2018-07-30,종로구,0.0,0,5,0,2,7
5273,2018-07-30,중구,0.0,0,0,0,1,1
5274,2018-07-30,중랑구,0.0,0,10,2,6,18
5275,2018-07-31,강남구,0.0,0,4,0,1,5
5276,2018-07-31,강동구,0.0,0,3,0,0,3
5277,2018-07-31,강북구,0.0,0,3,0,1,4
5278,2018-07-31,강서구,0.0,0,2,1,0,3
5279,2018-07-31,관악구,0.0,0,5,0,3,8
5280,2018-07-31,광진구,0.0,0,3,0,2,5
5281,2018-07-31,구로구,0.0,0,16,2,4,22
5282,2018-07-31,금천구,0.0,0,4,1,0,5
5283,2018-07-31,노원구,0.0,0,1,0,1,2
5284,2018-07-31,도봉구,0.0,0,2,2,1,5
5285,2018-07-31,동대문구,0.0,0,4,0,4,8
5286,2018-07-31,동작구,0.0,0,0,1,1,2
5287,2018-07-31,마포구,0.0,0,4,0,5,9
5288,2018-07-31,서대문구,0.0,0,0,1,0,1
5289,2018-07-31,서초구,0.0,0,14,0,4,18
5290,2018-07-31,성동구,0.0,0,1,0,2,3
5291,2018-07-31,성북구,0.0,0,0,0,1,1
5292,2018-07-31,송파구,0.0,0,5,0,4,9
5293,2018-07-31,양천구,0.0,0,3,0,0,3
5294,2018-07-31,영등포구,0.0,0,6,0,0,6
5295,2018-07-31,용산구,0.0,0,6,0,0,6
5296,2018-07-31,은평구,0.0,0,3,0,2,5
5297,2018-07-31,종로구,0.0,0,1,0,2,3
5298,2018-07-31,중구,0.0,0,2,0,1,3
5299,2018-07-31,중랑구,0.0,0,3,0,1,4
5300,2018-08-01,강남구,0.0,0,14,0,4,18
5301,2018-08-01,강동구,0.0,0,8,0,3,11
5302,2018-08-01,강북구,0.0,0,4,0,1,5
5303,2018-08-01,강서구,0.0,0,5,0,1,6
5304,2018-08-01,관악구,0.0,0,8,2,0,10
5305,2018-08-01,광진구,0.0,0,6,0,0,6
5306,2018-08-01,구로구,0.0,0,4,2,0,6
5307,2018-08-01,금천구,0.0,0,0,0,1,1
5308,2018-08-01,노원구,0.0,0,7,0,1,8
5309,2018-08-01,도봉구,0.0,0,0,1,1,2
5310,2018-08-01,동대문구,0.0,0,6,0,1,7
5311,2018-08-01,동작구,0.0,0,6,0,1,7
5312,2018-08-01,마포구,0.0,0,8,0,0,8
5313,2018-08-01,서대문구,0.0,0,0,0,1,1
5314,2018-08-01,서초구,0.0,0,6,1,0,7
5315,2018-08-01,성동구,0.0,0,4,1,0,5
5316,2018-08-01,성북구,0.0,1,5,0,2,8
5317,2018-08-01,송파구,0.0,0,13,2,1,16
5318,2018-08-01,양천구,0.0,0,5,0,4,9
5319,2018-08-01,영등포구,0.0,0,4,1,2,7
5320,2018-08-01,용산구,0.0,0,7,1,0,8
5321,2018-08-01,은평구,0.0,0,2,0,2,4
5322,2018-08-01,종로구,0.0,0,0,0,0,0
5323,2018-08-01,중구,0.0,0,1,1,0,2
5324,2018-08-01,중랑구,0.0,0,1,0,0,1
5325,2018-08-02,강남구,0.0,0,18,1,1,20
5326,2018-08-02,강동구,0.0,0,1,2,3,6
5327,2018-08-02,강북구,0.0,0,3,1,0,4
5328,2018-08-02,강서구,0.0,0,8,1,3,12
5329,2018-08-02,관악구,0.0,0,8,0,0,8
5330,2018-08-02,광진구,0.0,0,3,0,1,4
5331,2018-08-02,구로구,0.0,0,6,0,1,7
5332,2018-08-02,금천구,0.0,0,2,0,0,2
5333,2018-08-02,노원구,0.0,0,5,0,0,5
5334,2018-08-02,도봉구,0.0,0,2,0,1,3
5335,2018-08-02,동대문구,0.0,0,6,0,1,7
5336,2018-08-02,동작구,0.0,0,0,1,2,3
5337,2018-08-02,마포구,0.0,0,4,0,3,7
5338,2018-08-02,서대문구,0.0,0,1,1,0,2
5339,2018-08-02,서초구,0.0,0,5,1,2,8
5340,2018-08-02,성동구,0.0,0,4,0,0,4
5341,2018-08-02,성북구,0.0,0,2,1,1,4
5342,2018-08-02,송파구,0.0,0,7,3,5,15
5343,2018-08-02,양천구,0.0,0,3,0,0,3
5344,2018-08-02,영등포구,0.0,0,10,3,2,15
5345,2018-08-02,용산구,0.0,0,1,0,2,3
5346,2018-08-02,은평구,0.0,0,3,0,1,4
5347,2018-08-02,종로구,0.0,0,2,0,2,4
5348,2018-08-02,중구,0.0,0,5,0,0,5
5349,2018-08-02,중랑구,0.0,0,1,0,1,2
5350,2018-08-03,강남구,0.0,0,7,0,0,7
5351,2018-08-03,강동구,0.0,0,8,0,4,12
5352,2018-08-03,강북구,0.0,0,1,0,0,1
5353,2018-08-03,강서구,0.0,0,3,0,0,3
5354,2018-08-03,관악구,0.0,0,2,0,0,2
5355,2018-08-03,광진구,0.0,0,3,1,1,5
5356,2018-08-03,구로구,0.0,0,0,0,4,4
5357,2018-08-03,금천구,0.0,0,2,0,1,3
5358,2018-08-03,노원구,0.0,0,9,1,0,10
5359,2018-08-03,도봉구,0.0,0,3,0,1,4
5360,2018-08-03,동대문구,0.0,0,3,0,2,5
5361,2018-08-03,동작구,0.0,0,7,1,0,8
5362,2018-08-03,마포구,0.0,0,3,0,3,6
5363,2018-08-03,서대문구,0.0,0,0,2,3,5
5364,2018-08-03,서초구,0.0,0,7,0,3,10
5365,2018-08-03,성동구,0.0,0,3,0,1,4
5366,2018-08-03,성북구,0.0,0,1,0,1,2
5367,2018-08-03,송파구,0.0,0,9,4,1,14
5368,2018-08-03,양천구,0.0,0,3,0,1,4
5369,2018-08-03,영등포구,0.0,0,8,0,2,10
5370,2018-08-03,용산구,0.0,0,4,0,1,5
5371,2018-08-03,은평구,0.0,0,3,0,2,5
5372,2018-08-03,종로구,0.0,0,2,0,2,4
5373,2018-08-03,중구,0.0,0,5,0,0,5
5374,2018-08-03,중랑구,0.0,0,3,0,0,3
5375,2018-08-04,강남구,0.0,0,8,1,1,10
5376,2018-08-04,강동구,0.0,0,3,1,0,4
5377,2018-08-04,강북구,0.0,0,2,1,0,3
5378,2018-08-04,강서구,0.0,0,5,1,2,8
5379,2018-08-04,관악구,0.0,0,6,1,1,8
5380,2018-08-04,광진구,0.0,0,3,0,0,3
5381,2018-08-04,구로구,0.0,0,0,0,0,0
5382,2018-08-04,금천구,0.0,0,4,0,5,9
5383,2018-08-04,노원구,0.0,0,2,0,0,2
5384,2018-08-04,도봉구,0.0,0,1,0,1,2
5385,2018-08-04,동대문구,0.0,0,7,1,4,12
5386,2018-08-04,동작구,0.0,0,4,0,0,4
5387,2018-08-04,마포구,0.0,0,12,0,1,13
5388,2018-08-04,서대문구,0.0,0,3,1,0,4
5389,2018-08-04,서초구,0.0,0,3,0,1,4
5390,2018-08-04,성동구,0.0,0,1,1,0,2
5391,2018-08-04,성북구,0.0,0,3,2,0,5
5392,2018-08-04,송파구,0.0,0,7,2,0,9
5393,2018-08-04,양천구,0.0,0,3,2,0,5
5394,2018-08-04,영등포구,0.0,0,5,1,1,7
5395,2018-08-04,용산구,0.0,0,2,2,0,4
5396,2018-08-04,은평구,0.0,0,1,0,0,1
5397,2018-08-04,종로구,0.0,0,1,3,1,5
5398,2018-08-04,중구,0.0,0,2,0,0,2
5399,2018-08-04,중랑구,0.0,1,4,1,1,7
5400,2018-08-05,강남구,0.5,0,10,5,2,17
5401,2018-08-05,강동구,0.5,0,4,0,0,4
5402,2018-08-05,강북구,0.0,0,1,0,1,2
5403,2018-08-05,강서구,0.0,0,2,0,0,2
5404,2018-08-05,관악구,0.0,0,3,0,0,3
5405,2018-08-05,광진구,0.0,0,0,0,1,1
5406,2018-08-05,구로구,1.0,0,2,2,2,6
5407,2018-08-05,금천구,0.0,0,6,0,0,6
5408,2018-08-05,노원구,0.0,0,3,0,0,3
5409,2018-08-05,도봉구,0.0,0,0,1,0,1
5410,2018-08-05,동대문구,1.0,0,0,1,1,2
5411,2018-08-05,동작구,0.0,0,6,0,1,7
5412,2018-08-05,마포구,1.0,0,5,1,0,6
5413,2018-08-05,서대문구,0.0,0,7,0,0,7
5414,2018-08-05,서초구,0.5,0,2,0,0,2
5415,2018-08-05,성동구,0.5,0,2,0,0,2
5416,2018-08-05,성북구,2.0,0,3,0,2,5
5417,2018-08-05,송파구,1.5,0,9,0,1,10
5418,2018-08-05,양천구,0.5,0,1,1,0,2
5419,2018-08-05,영등포구,0.0,0,0,1,0,1
5420,2018-08-05,용산구,2.0,0,9,0,2,11
5421,2018-08-05,은평구,0.5,0,6,3,0,9
5422,2018-08-05,종로구,2.0,0,0,0,0,0
5423,2018-08-05,중구,3.5,0,3,0,1,4
5424,2018-08-05,중랑구,0.0,0,2,1,0,3
5425,2018-08-06,강남구,53.5,0,7,0,2,9
5426,2018-08-06,강동구,9.0,0,8,0,0,8
5427,2018-08-06,강북구,0.0,0,1,0,0,1
5428,2018-08-06,강서구,0.0,0,2,0,1,3
5429,2018-08-06,관악구,2.75,0,1,0,1,2
5430,2018-08-06,광진구,17.0,0,1,0,1,2
5431,2018-08-06,구로구,21.0,0,1,0,1,2
5432,2018-08-06,금천구,2.0,0,4,0,0,4
5433,2018-08-06,노원구,15.5,0,1,1,1,3
5434,2018-08-06,도봉구,0.0,0,0,0,0,0
5435,2018-08-06,동대문구,0.0,0,2,0,0,2
5436,2018-08-06,동작구,8.75,0,4,1,1,6
5437,2018-08-06,마포구,4.0,0,4,1,1,6
5438,2018-08-06,서대문구,4.5,0,1,1,1,3
5439,2018-08-06,서초구,20.5,0,9,1,0,10
5440,2018-08-06,성동구,31.5,0,4,0,0,4
5441,2018-08-06,성북구,0.0,0,0,0,1,1
5442,2018-08-06,송파구,25.0,1,6,1,2,10
5443,2018-08-06,양천구,0.5,0,9,0,1,10
5444,2018-08-06,영등포구,11.75,0,10,0,1,11
5445,2018-08-06,용산구,12.5,0,3,0,0,3
5446,2018-08-06,은평구,0.5,0,2,1,1,4
5447,2018-08-06,종로구,6.5,0,0,0,0,0
5448,2018-08-06,중구,2.0,0,0,0,2,2
5449,2018-08-06,중랑구,0.0,0,0,0,2,2
5450,2018-08-07,강남구,0.0,0,3,0,4,7
5451,2018-08-07,강동구,0.0,0,1,1,1,3
5452,2018-08-07,강북구,0.0,0,1,0,0,1
5453,2018-08-07,강서구,0.0,0,2,0,1,3
5454,2018-08-07,관악구,0.0,0,1,1,1,3
5455,2018-08-07,광진구,0.0,0,3,1,1,5
5456,2018-08-07,구로구,0.0,0,4,0,0,4
5457,2018-08-07,금천구,0.0,0,1,0,0,1
5458,2018-08-07,노원구,0.0,1,5,0,0,6
5459,2018-08-07,도봉구,0.0,0,4,0,0,4
5460,2018-08-07,동대문구,0.0,0,2,0,0,2
5461,2018-08-07,동작구,0.0,0,6,2,1,9
5462,2018-08-07,마포구,0.0,0,1,0,0,1
5463,2018-08-07,서대문구,0.0,0,5,0,1,6
5464,2018-08-07,서초구,0.0,0,5,0,0,5
5465,2018-08-07,성동구,0.0,0,0,0,1,1
5466,2018-08-07,성북구,0.0,0,2,0,1,3
5467,2018-08-07,송파구,0.0,0,6,1,2,9
5468,2018-08-07,양천구,0.0,0,2,0,1,3
5469,2018-08-07,영등포구,0.0,0,7,0,3,10
5470,2018-08-07,용산구,0.0,0,5,0,0,5
5471,2018-08-07,은평구,0.0,0,2,0,2,4
5472,2018-08-07,종로구,0.0,0,4,1,0,5
5473,2018-08-07,중구,0.0,0,4,0,0,4
5474,2018-08-07,중랑구,0.0,0,4,0,0,4
5475,2018-08-08,강남구,0.0,0,7,1,1,9
5476,2018-08-08,강동구,0.0,0,3,0,0,3
5477,2018-08-08,강북구,0.0,0,2,0,0,2
5478,2018-08-08,강서구,0.0,0,0,0,1,1
5479,2018-08-08,관악구,0.0,0,1,0,2,3
5480,2018-08-08,광진구,0.0,1,2,0,0,3
5481,2018-08-08,구로구,0.0,0,4,0,1,5
5482,2018-08-08,금천구,0.0,0,2,2,0,4
5483,2018-08-08,노원구,0.0,0,2,0,1,3
5484,2018-08-08,도봉구,0.0,0,3,0,2,5
5485,2018-08-08,동대문구,0.0,0,8,1,1,10
5486,2018-08-08,동작구,0.0,0,5,1,0,6
5487,2018-08-08,마포구,0.0,0,6,0,1,7
5488,2018-08-08,서대문구,0.0,0,1,0,1,2
5489,2018-08-08,서초구,0.0,0,14,0,5,19
5490,2018-08-08,성동구,0.0,0,4,0,1,5
5491,2018-08-08,성북구,0.0,0,3,0,1,4
5492,2018-08-08,송파구,0.0,0,6,1,0,7
5493,2018-08-08,양천구,0.0,0,2,0,0,2
5494,2018-08-08,영등포구,0.0,0,8,0,1,9
5495,2018-08-08,용산구,0.0,0,4,0,0,4
5496,2018-08-08,은평구,0.0,0,1,0,1,2
5497,2018-08-08,종로구,0.0,0,0,1,1,2
5498,2018-08-08,중구,0.0,0,2,1,8,11
5499,2018-08-08,중랑구,0.0,0,1,2,3,6
5500,2018-08-09,강남구,30.5,0,15,3,5,23
5501,2018-08-09,강동구,0.0,0,2,0,0,2
5502,2018-08-09,강북구,1.5,0,4,0,1,5
5503,2018-08-09,강서구,2.0,0,2,2,1,5
5504,2018-08-09,관악구,5.0,1,3,0,1,5
5505,2018-08-09,광진구,2.0,0,1,0,1,2
5506,2018-08-09,구로구,0.0,0,1,1,1,3
5507,2018-08-09,금천구,2.0,0,3,0,1,4
5508,2018-08-09,노원구,0.0,0,5,2,1,8
5509,2018-08-09,도봉구,0.0,0,4,1,1,6
5510,2018-08-09,동대문구,6.0,0,14,0,5,19
5511,2018-08-09,동작구,4.25,0,3,0,2,5
5512,2018-08-09,마포구,1.5,0,6,1,0,7
5513,2018-08-09,서대문구,0.5,0,0,0,1,1
5514,2018-08-09,서초구,15.0,1,16,0,0,17
5515,2018-08-09,성동구,2.5,0,5,0,2,7
5516,2018-08-09,성북구,20.5,0,5,1,1,7
5517,2018-08-09,송파구,14.5,0,9,1,0,10
5518,2018-08-09,양천구,1.0,0,3,3,0,6
5519,2018-08-09,영등포구,0.25,2,4,1,2,9
5520,2018-08-09,용산구,0.0,0,3,0,2,5
5521,2018-08-09,은평구,23.0,0,2,1,0,3
5522,2018-08-09,종로구,2.0,0,8,0,1,9
5523,2018-08-09,중구,0.0,0,4,0,1,5
5524,2018-08-09,중랑구,1.5,0,5,2,2,9
5525,2018-08-10,강남구,0.0,0,5,0,4,9
5526,2018-08-10,강동구,0.0,0,1,0,2,3
5527,2018-08-10,강북구,0.0,0,2,0,1,3
5528,2018-08-10,강서구,0.0,0,0,2,2,4
5529,2018-08-10,관악구,0.0,0,6,0,3,9
5530,2018-08-10,광진구,0.0,0,3,0,1,4
5531,2018-08-10,구로구,0.0,0,2,0,0,2
5532,2018-08-10,금천구,0.0,0,1,0,2,3
5533,2018-08-10,노원구,0.0,0,4,0,0,4
5534,2018-08-10,도봉구,0.0,0,2,0,0,2
5535,2018-08-10,동대문구,0.0,0,3,0,3,6
5536,2018-08-10,동작구,0.0,0,4,0,1,5
5537,2018-08-10,마포구,0.0,0,3,2,1,6
5538,2018-08-10,서대문구,0.0,0,2,0,0,2
5539,2018-08-10,서초구,0.0,0,11,0,4,15
5540,2018-08-10,성동구,0.0,0,2,0,0,2
5541,2018-08-10,성북구,0.0,0,7,0,1,8
5542,2018-08-10,송파구,0.0,0,7,1,2,10
5543,2018-08-10,양천구,0.0,0,4,1,1,6
5544,2018-08-10,영등포구,0.0,0,8,0,4,12
5545,2018-08-10,용산구,0.0,0,4,0,3,7
5546,2018-08-10,은평구,0.0,0,1,0,2,3
5547,2018-08-10,종로구,0.0,0,0,0,0,0
5548,2018-08-10,중구,0.0,0,2,2,0,4
5549,2018-08-10,중랑구,0.0,0,2,0,1,3
5550,2018-08-11,강남구,0.0,0,11,1,2,14
5551,2018-08-11,강동구,0.0,0,1,0,1,2
5552,2018-08-11,강북구,0.0,0,11,1,3,15
5553,2018-08-11,강서구,19.5,0,4,1,0,5
5554,2018-08-11,관악구,0.0,0,8,0,2,10
5555,2018-08-11,광진구,0.0,0,1,2,1,4
5556,2018-08-11,구로구,0.0,0,2,0,0,2
5557,2018-08-11,금천구,0.0,0,2,0,1,3
5558,2018-08-11,노원구,0.0,0,1,0,1,2
5559,2018-08-11,도봉구,0.0,0,1,0,1,2
5560,2018-08-11,동대문구,0.0,0,3,1,1,5
5561,2018-08-11,동작구,0.0,0,0,0,1,1
5562,2018-08-11,마포구,0.0,0,6,0,1,7
5563,2018-08-11,서대문구,0.0,0,1,0,2,3
5564,2018-08-11,서초구,0.0,0,17,1,0,18
5565,2018-08-11,성동구,0.0,0,4,1,0,5
5566,2018-08-11,성북구,0.0,1,0,0,2,3
5567,2018-08-11,송파구,0.0,0,3,0,0,3
5568,2018-08-11,양천구,0.0,0,3,1,0,4
5569,2018-08-11,영등포구,0.0,0,3,1,1,5
5570,2018-08-11,용산구,0.0,1,1,1,2,5
5571,2018-08-11,은평구,0.0,0,1,1,0,2
5572,2018-08-11,종로구,0.0,0,2,0,0,2
5573,2018-08-11,중구,0.0,0,2,0,1,3
5574,2018-08-11,중랑구,0.0,0,1,0,2,3
5575,2018-08-12,강남구,0.0,1,5,0,2,8
5576,2018-08-12,강동구,0.0,0,3,0,0,3
5577,2018-08-12,강북구,3.5,0,8,0,1,9
5578,2018-08-12,강서구,3.5,0,2,0,1,3
5579,2018-08-12,관악구,0.25,0,8,0,2,10
5580,2018-08-12,광진구,0.0,0,1,0,0,1
5581,2018-08-12,구로구,0.0,0,1,1,2,4
5582,2018-08-12,금천구,0.0,0,0,0,0,0
5583,2018-08-12,노원구,11.5,0,6,0,3,9
5584,2018-08-12,도봉구,0.0,0,4,1,1,6
5585,2018-08-12,동대문구,3.5,0,6,0,4,10
5586,2018-08-12,동작구,1.75,0,1,0,1,2
5587,2018-08-12,마포구,0.0,0,3,0,2,5
5588,2018-08-12,서대문구,0.5,0,1,0,1,2
5589,2018-08-12,서초구,0.0,0,10,0,0,10
5590,2018-08-12,성동구,0.0,0,2,0,4,6
5591,2018-08-12,성북구,4.0,0,7,0,1,8
5592,2018-08-12,송파구,0.0,0,5,3,3,11
5593,2018-08-12,양천구,0.0,0,0,0,0,0
5594,2018-08-12,영등포구,1.0,0,12,0,2,14
5595,2018-08-12,용산구,3.5,0,3,0,0,3
5596,2018-08-12,은평구,0.0,0,1,0,0,1
5597,2018-08-12,종로구,5.0,0,4,0,0,4
5598,2018-08-12,중구,1.5,0,6,0,0,6
5599,2018-08-12,중랑구,0.0,0,3,0,5,8
5600,2018-08-13,강남구,3.0,1,7,0,1,9
5601,2018-08-13,강동구,7.5,0,4,0,0,4
5602,2018-08-13,강북구,4.0,0,3,0,1,4
5603,2018-08-13,강서구,2.5,1,2,1,1,5
5604,2018-08-13,관악구,1.0,0,4,0,0,4
5605,2018-08-13,광진구,4.5,0,0,1,0,1
5606,2018-08-13,구로구,0.0,0,5,1,2,8
5607,2018-08-13,금천구,0.0,0,4,0,1,5
5608,2018-08-13,노원구,3.5,0,2,0,0,2
5609,2018-08-13,도봉구,5.0,0,0,0,1,1
5610,2018-08-13,동대문구,1.5,0,5,1,1,7
5611,2018-08-13,동작구,0.0,0,4,0,3,7
5612,2018-08-13,마포구,3.0,0,1,0,0,1
5613,2018-08-13,서대문구,2.5,0,3,1,1,5
5614,2018-08-13,서초구,2.0,0,2,1,2,5
5615,2018-08-13,성동구,0.5,0,3,0,1,4
5616,2018-08-13,성북구,2.0,0,3,1,1,5
5617,2018-08-13,송파구,5.5,0,5,0,1,6
5618,2018-08-13,양천구,0.0,0,1,1,1,3
5619,2018-08-13,영등포구,1.0,0,7,1,3,11
5620,2018-08-13,용산구,2.5,0,5,0,0,5
5621,2018-08-13,은평구,4.5,0,3,0,0,3
5622,2018-08-13,종로구,1.0,0,3,1,3,7
5623,2018-08-13,중구,1.5,0,3,0,0,3
5624,2018-08-13,중랑구,1.5,1,5,0,2,8
5625,2018-08-14,강남구,0.0,0,9,0,1,10
5626,2018-08-14,강동구,0.0,0,6,2,0,8
5627,2018-08-14,강북구,0.0,0,0,0,1,1
5628,2018-08-14,강서구,0.0,0,12,3,1,16
5629,2018-08-14,관악구,0.0,0,3,2,1,6
5630,2018-08-14,광진구,0.0,0,2,0,2,4
5631,2018-08-14,구로구,0.0,0,3,0,1,4
5632,2018-08-14,금천구,0.0,0,4,0,0,4
5633,2018-08-14,노원구,0.0,0,2,0,0,2
5634,2018-08-14,도봉구,0.0,0,3,0,0,3
5635,2018-08-14,동대문구,0.0,0,5,0,1,6
5636,2018-08-14,동작구,0.0,0,2,0,1,3
5637,2018-08-14,마포구,0.0,1,4,0,2,7
5638,2018-08-14,서대문구,0.0,0,2,0,0,2
5639,2018-08-14,서초구,0.0,0,10,2,2,14
5640,2018-08-14,성동구,0.0,0,8,2,0,10
5641,2018-08-14,성북구,0.0,0,3,2,0,5
5642,2018-08-14,송파구,0.0,0,7,1,0,8
5643,2018-08-14,양천구,0.0,0,2,1,0,3
5644,2018-08-14,영등포구,0.0,0,10,4,0,14
5645,2018-08-14,용산구,0.0,0,2,2,2,6
5646,2018-08-14,은평구,0.0,0,8,0,3,11
5647,2018-08-14,종로구,0.0,0,4,1,0,5
5648,2018-08-14,중구,0.0,0,3,0,1,4
5649,2018-08-14,중랑구,0.0,0,8,0,0,8
5650,2018-08-15,강남구,1.0,0,14,3,2,19
5651,2018-08-15,강동구,0.0,0,5,0,1,6
5652,2018-08-15,강북구,0.0,0,3,1,0,4
5653,2018-08-15,강서구,0.0,0,6,0,2,8
5654,2018-08-15,관악구,0.0,0,4,0,1,5
5655,2018-08-15,광진구,5.5,0,3,1,3,7
5656,2018-08-15,구로구,0.0,0,5,0,1,6
5657,2018-08-15,금천구,0.0,0,0,0,0,0
5658,2018-08-15,노원구,2.0,0,3,0,1,4
5659,2018-08-15,도봉구,0.0,0,1,0,0,1
5660,2018-08-15,동대문구,18.5,0,4,0,0,4
5661,2018-08-15,동작구,0.0,0,3,0,0,3
5662,2018-08-15,마포구,0.0,0,2,0,1,3
5663,2018-08-15,서대문구,0.5,0,7,4,1,12
5664,2018-08-15,서초구,0.0,0,6,1,2,9
5665,2018-08-15,성동구,33.5,0,2,1,1,4
5666,2018-08-15,성북구,2.0,0,3,0,0,3
5667,2018-08-15,송파구,0.0,0,11,0,1,12
5668,2018-08-15,양천구,0.0,0,4,0,3,7
5669,2018-08-15,영등포구,0.0,0,8,0,3,11
5670,2018-08-15,용산구,0.0,0,6,0,7,13
5671,2018-08-15,은평구,1.5,0,2,1,0,3
5672,2018-08-15,종로구,1.0,0,4,1,1,6
5673,2018-08-15,중구,3.5,0,4,0,2,6
5674,2018-08-15,중랑구,16.5,0,0,0,1,1
5675,2018-08-16,강남구,0.0,0,10,1,2,13
5676,2018-08-16,강동구,0.0,0,5,1,0,6
5677,2018-08-16,강북구,0.0,0,3,0,2,5
5678,2018-08-16,강서구,0.0,0,7,1,1,9
5679,2018-08-16,관악구,0.0,0,3,1,0,4
5680,2018-08-16,광진구,0.0,0,1,1,1,3
5681,2018-08-16,구로구,0.0,0,0,0,0,0
5682,2018-08-16,금천구,0.0,0,1,0,0,1
5683,2018-08-16,노원구,0.0,0,3,1,0,4
5684,2018-08-16,도봉구,0.0,0,4,1,1,6
5685,2018-08-16,동대문구,0.0,0,1,1,2,4
5686,2018-08-16,동작구,0.0,0,5,1,2,8
5687,2018-08-16,마포구,0.0,0,3,0,0,3
5688,2018-08-16,서대문구,0.0,0,2,0,1,3
5689,2018-08-16,서초구,0.0,0,17,0,4,21
5690,2018-08-16,성동구,0.0,0,1,0,0,1
5691,2018-08-16,성북구,0.0,0,5,0,0,5
5692,2018-08-16,송파구,0.0,0,5,2,2,9
5693,2018-08-16,양천구,0.0,0,3,1,1,5
5694,2018-08-16,영등포구,0.0,0,5,2,4,11
5695,2018-08-16,용산구,0.0,0,6,0,1,7
5696,2018-08-16,은평구,0.0,0,4,0,1,5
5697,2018-08-16,종로구,0.0,0,5,0,1,6
5698,2018-08-16,중구,0.0,0,6,0,1,7
5699,2018-08-16,중랑구,0.0,0,6,0,0,6
5700,2018-08-17,강남구,0.0,0,17,1,2,20
5701,2018-08-17,강동구,0.0,0,4,1,1,6
5702,2018-08-17,강북구,0.0,0,3,0,4,7
5703,2018-08-17,강서구,0.0,0,6,1,3,10
5704,2018-08-17,관악구,0.0,0,7,0,1,8
5705,2018-08-17,광진구,0.0,0,2,0,1,3
5706,2018-08-17,구로구,0.0,0,10,1,2,13
5707,2018-08-17,금천구,0.0,0,1,0,2,3
5708,2018-08-17,노원구,0.0,0,2,1,0,3
5709,2018-08-17,도봉구,0.0,0,6,0,0,6
5710,2018-08-17,동대문구,0.0,0,7,0,0,7
5711,2018-08-17,동작구,0.0,0,2,2,0,4
5712,2018-08-17,마포구,0.0,0,4,0,2,6
5713,2018-08-17,서대문구,0.0,0,5,2,0,7
5714,2018-08-17,서초구,0.0,0,7,1,1,9
5715,2018-08-17,성동구,0.0,0,3,0,0,3
5716,2018-08-17,성북구,0.0,0,2,0,0,2
5717,2018-08-17,송파구,0.0,0,11,3,2,16
5718,2018-08-17,양천구,0.0,0,6,0,2,8
5719,2018-08-17,영등포구,0.0,0,8,0,3,11
5720,2018-08-17,용산구,0.0,0,5,0,1,6
5721,2018-08-17,은평구,0.0,0,8,3,3,14
5722,2018-08-17,종로구,0.0,0,7,0,0,7
5723,2018-08-17,중구,0.0,0,1,2,1,4
5724,2018-08-17,중랑구,0.0,0,2,0,3,5
5725,2018-08-18,강남구,0.0,0,13,1,3,17
5726,2018-08-18,강동구,0.0,0,1,3,2,6
5727,2018-08-18,강북구,0.0,0,1,0,2,3
5728,2018-08-18,강서구,0.0,0,8,5,0,13
5729,2018-08-18,관악구,0.0,0,2,0,0,2
5730,2018-08-18,광진구,0.0,0,3,0,2,5
5731,2018-08-18,구로구,0.0,0,5,2,2,9
5732,2018-08-18,금천구,0.0,0,4,0,3,7
5733,2018-08-18,노원구,0.0,0,4,0,1,5
5734,2018-08-18,도봉구,0.0,0,1,0,1,2
5735,2018-08-18,동대문구,0.0,0,10,1,1,12
5736,2018-08-18,동작구,0.0,0,6,1,1,8
5737,2018-08-18,마포구,0.0,0,8,3,1,12
5738,2018-08-18,서대문구,0.0,0,0,0,0,0
5739,2018-08-18,서초구,0.0,0,6,2,6,14
5740,2018-08-18,성동구,0.0,0,1,0,0,1
5741,2018-08-18,성북구,0.0,0,1,0,6,7
5742,2018-08-18,송파구,0.0,0,1,1,1,3
5743,2018-08-18,양천구,0.0,0,6,1,0,7
5744,2018-08-18,영등포구,0.0,0,9,2,1,12
5745,2018-08-18,용산구,0.0,0,4,0,0,4
5746,2018-08-18,은평구,0.0,0,4,0,1,5
5747,2018-08-18,종로구,0.0,0,3,0,0,3
5748,2018-08-18,중구,0.0,0,1,1,0,2
5749,2018-08-18,중랑구,0.0,0,3,0,2,5
5750,2018-08-19,강남구,0.0,0,11,0,3,14
5751,2018-08-19,강동구,0.0,0,5,1,3,9
5752,2018-08-19,강북구,0.0,0,2,0,2,4
5753,2018-08-19,강서구,0.0,0,7,0,0,7
5754,2018-08-19,관악구,0.0,0,3,0,1,4
5755,2018-08-19,광진구,0.0,0,6,0,1,7
5756,2018-08-19,구로구,0.0,0,3,1,1,5
5757,2018-08-19,금천구,0.0,0,1,0,0,1
5758,2018-08-19,노원구,0.0,0,3,0,1,4
5759,2018-08-19,도봉구,0.0,0,4,0,2,6
5760,2018-08-19,동대문구,0.0,0,2,0,0,2
5761,2018-08-19,동작구,0.0,0,2,1,1,4
5762,2018-08-19,마포구,0.0,0,6,1,1,8
5763,2018-08-19,서대문구,0.0,0,1,0,0,1
5764,2018-08-19,서초구,0.0,0,1,0,0,1
5765,2018-08-19,성동구,0.0,0,1,0,1,2
5766,2018-08-19,성북구,0.0,0,10,1,11,22
5767,2018-08-19,송파구,0.0,0,4,2,1,7
5768,2018-08-19,양천구,0.0,0,1,2,0,3
5769,2018-08-19,영등포구,0.0,0,7,1,3,11
5770,2018-08-19,용산구,0.0,0,3,1,0,4
5771,2018-08-19,은평구,0.0,0,2,0,2,4
5772,2018-08-19,종로구,0.0,0,2,0,0,2
5773,2018-08-19,중구,0.0,0,0,0,1,1
5774,2018-08-19,중랑구,0.0,0,12,1,1,14
5775,2018-08-20,강남구,0.0,0,14,3,2,19
5776,2018-08-20,강동구,0.0,0,6,1,0,7
5777,2018-08-20,강북구,0.0,0,9,2,1,12
5778,2018-08-20,강서구,0.0,0,3,0,0,3
5779,2018-08-20,관악구,0.0,0,5,1,0,6
5780,2018-08-20,광진구,0.0,0,3,0,5,8
5781,2018-08-20,구로구,0.0,0,6,1,2,9
5782,2018-08-20,금천구,0.0,0,1,0,0,1
5783,2018-08-20,노원구,0.0,0,2,0,1,3
5784,2018-08-20,도봉구,0.0,0,0,0,0,0
5785,2018-08-20,동대문구,0.0,0,4,1,1,6
5786,2018-08-20,동작구,0.0,0,2,1,0,3
5787,2018-08-20,마포구,0.0,0,2,0,0,2
5788,2018-08-20,서대문구,0.0,0,3,0,0,3
5789,2018-08-20,서초구,0.0,0,8,1,1,10
5790,2018-08-20,성동구,0.0,0,1,0,0,1
5791,2018-08-20,성북구,0.0,0,10,0,0,10
5792,2018-08-20,송파구,0.0,0,8,4,2,14
5793,2018-08-20,양천구,0.0,0,2,0,2,4
5794,2018-08-20,영등포구,0.0,0,7,1,1,9
5795,2018-08-20,용산구,0.0,0,1,0,0,1
5796,2018-08-20,은평구,0.0,0,1,1,0,2
5797,2018-08-20,종로구,0.0,0,1,0,1,2
5798,2018-08-20,중구,0.0,0,3,2,0,5
5799,2018-08-20,중랑구,0.0,0,1,0,0,1
5800,2018-08-21,강남구,4.5,0,14,1,4,19
5801,2018-08-21,강동구,3.0,0,7,0,1,8
5802,2018-08-21,강북구,5.5,0,2,0,2,4
5803,2018-08-21,강서구,10.0,1,6,0,3,10
5804,2018-08-21,관악구,7.5,0,1,0,3,4
5805,2018-08-21,광진구,4.0,0,2,1,2,5
5806,2018-08-21,구로구,8.0,1,3,0,3,7
5807,2018-08-21,금천구,7.0,0,2,0,0,2
5808,2018-08-21,노원구,3.0,0,5,0,1,6
5809,2018-08-21,도봉구,11.0,0,0,0,0,0
5810,2018-08-21,동대문구,3.0,0,4,0,4,8
5811,2018-08-21,동작구,5.75,0,1,2,2,5
5812,2018-08-21,마포구,6.0,0,8,0,0,8
5813,2018-08-21,서대문구,6.5,0,5,0,1,6
5814,2018-08-21,서초구,6.0,0,5,0,0,5
5815,2018-08-21,성동구,2.5,0,4,0,0,4
5816,2018-08-21,성북구,5.0,0,2,0,1,3
5817,2018-08-21,송파구,3.5,0,4,5,2,11
5818,2018-08-21,양천구,6.5,0,3,0,0,3
5819,2018-08-21,영등포구,3.0,0,1,2,2,5
5820,2018-08-21,용산구,3.5,0,3,1,1,5
5821,2018-08-21,은평구,11.0,0,4,1,0,5
5822,2018-08-21,종로구,5.0,0,3,1,1,5
5823,2018-08-21,중구,4.5,1,2,1,0,4
5824,2018-08-21,중랑구,2.5,0,7,0,1,8
5825,2018-08-22,강남구,0.0,0,11,2,5,18
5826,2018-08-22,강동구,0.0,0,5,0,1,6
5827,2018-08-22,강북구,0.0,0,2,0,0,2
5828,2018-08-22,강서구,0.0,0,2,1,2,5
5829,2018-08-22,관악구,0.0,0,1,0,0,1
5830,2018-08-22,광진구,0.0,0,3,0,1,4
5831,2018-08-22,구로구,0.0,0,1,1,1,3
5832,2018-08-22,금천구,0.0,0,2,0,3,5
5833,2018-08-22,노원구,0.0,0,6,0,1,7
5834,2018-08-22,도봉구,0.0,0,7,0,3,10
5835,2018-08-22,동대문구,0.0,0,7,2,1,10
5836,2018-08-22,동작구,0.0,0,5,1,3,9
5837,2018-08-22,마포구,0.0,0,4,0,2,6
5838,2018-08-22,서대문구,0.0,0,3,0,1,4
5839,2018-08-22,서초구,0.0,0,4,1,1,6
5840,2018-08-22,성동구,0.0,0,4,0,1,5
5841,2018-08-22,성북구,0.0,0,4,0,0,4
5842,2018-08-22,송파구,0.0,1,4,1,2,8
5843,2018-08-22,양천구,0.0,0,8,1,4,13
5844,2018-08-22,영등포구,0.0,0,10,1,1,12
5845,2018-08-22,용산구,0.0,0,6,0,3,9
5846,2018-08-22,은평구,0.0,1,7,2,1,11
5847,2018-08-22,종로구,0.0,0,2,2,1,5
5848,2018-08-22,중구,0.0,0,1,0,3,4
5849,2018-08-22,중랑구,0.0,0,1,0,3,4
5850,2018-08-23,강남구,2.0,0,7,0,5,12
5851,2018-08-23,강동구,0.5,0,0,0,0,0
5852,2018-08-23,강북구,2.0,1,6,1,2,10
5853,2018-08-23,강서구,3.0,0,5,1,0,6
5854,2018-08-23,관악구,4.0,0,2,0,1,3
5855,2018-08-23,광진구,3.0,0,0,0,1,1
5856,2018-08-23,구로구,4.5,0,11,0,0,11
5857,2018-08-23,금천구,3.0,0,1,0,0,1
5858,2018-08-23,노원구,1.0,0,9,0,1,10
5859,2018-08-23,도봉구,2.0,0,2,0,1,3
5860,2018-08-23,동대문구,2.0,0,2,0,1,3
5861,2018-08-23,동작구,3.25,0,7,1,1,9
5862,2018-08-23,마포구,4.0,0,3,0,0,3
5863,2018-08-23,서대문구,3.5,0,4,0,1,5
5864,2018-08-23,서초구,2.5,0,8,1,1,10
5865,2018-08-23,성동구,1.5,0,4,0,1,5
5866,2018-08-23,성북구,2.0,0,12,1,1,14
5867,2018-08-23,송파구,2.0,0,2,0,0,2
5868,2018-08-23,양천구,2.5,0,5,1,1,7
5869,2018-08-23,영등포구,3.0,0,10,1,4,15
5870,2018-08-23,용산구,2.5,0,5,0,0,5
5871,2018-08-23,은평구,2.5,0,4,0,1,5
5872,2018-08-23,종로구,3.0,0,6,0,3,9
5873,2018-08-23,중구,0.5,0,1,1,1,3
5874,2018-08-23,중랑구,0.5,0,1,2,0,3
5875,2018-08-24,강남구,10.5,0,5,3,6,14
5876,2018-08-24,강동구,15.5,0,7,0,1,8
5877,2018-08-24,강북구,10.0,0,0,0,1,1
5878,2018-08-24,강서구,3.0,0,8,0,2,10
5879,2018-08-24,관악구,10.5,0,2,0,2,4
5880,2018-08-24,광진구,13.0,0,1,0,0,1
5881,2018-08-24,구로구,3.0,0,0,0,1,1
5882,2018-08-24,금천구,4.5,0,4,0,0,4
5883,2018-08-24,노원구,12.5,0,1,0,1,2
5884,2018-08-24,도봉구,12.0,0,1,0,5,6
5885,2018-08-24,동대문구,9.5,0,2,0,3,5
5886,2018-08-24,동작구,6.75,0,3,1,0,4
5887,2018-08-24,마포구,7.0,0,4,0,2,6
5888,2018-08-24,서대문구,8.5,0,2,0,0,2
5889,2018-08-24,서초구,9.0,0,8,1,2,11
5890,2018-08-24,성동구,8.5,0,4,0,3,7
5891,2018-08-24,성북구,12.0,0,1,1,0,2
5892,2018-08-24,송파구,15.0,0,10,0,4,14
5893,2018-08-24,양천구,4.0,0,3,1,1,5
5894,2018-08-24,영등포구,4.75,0,6,0,4,10
5895,2018-08-24,용산구,6.5,0,3,1,2,6
5896,2018-08-24,은평구,12.0,0,0,1,0,1
5897,2018-08-24,종로구,7.5,0,3,0,1,4
5898,2018-08-24,중구,4.0,0,2,0,1,3
5899,2018-08-24,중랑구,11.5,0,1,0,0,1
5900,2018-08-25,강남구,0.0,0,14,1,1,16
5901,2018-08-25,강동구,0.0,0,5,2,1,8
5902,2018-08-25,강북구,0.0,0,7,1,4,12
5903,2018-08-25,강서구,0.0,0,21,4,9,34
5904,2018-08-25,관악구,0.0,0,2,0,1,3
5905,2018-08-25,광진구,0.0,0,2,2,0,4
5906,2018-08-25,구로구,0.0,0,5,0,0,5
5907,2018-08-25,금천구,0.0,0,4,1,1,6
5908,2018-08-25,노원구,0.0,0,2,0,0,2
5909,2018-08-25,도봉구,0.0,0,3,3,0,6
5910,2018-08-25,동대문구,0.0,0,1,1,2,4
5911,2018-08-25,동작구,0.0,0,4,0,0,4
5912,2018-08-25,마포구,0.0,0,9,0,2,11
5913,2018-08-25,서대문구,0.0,0,2,0,4,6
5914,2018-08-25,서초구,0.0,0,10,4,1,15
5915,2018-08-25,성동구,0.0,0,3,0,0,3
5916,2018-08-25,성북구,0.0,0,1,0,1,2
5917,2018-08-25,송파구,0.0,0,10,2,2,14
5918,2018-08-25,양천구,0.0,0,4,2,0,6
5919,2018-08-25,영등포구,0.0,0,9,2,3,14
5920,2018-08-25,용산구,0.0,0,3,0,2,5
5921,2018-08-25,은평구,0.0,0,4,1,1,6
5922,2018-08-25,종로구,0.0,0,4,0,3,7
5923,2018-08-25,중구,0.0,0,2,0,0,2
5924,2018-08-25,중랑구,0.0,0,5,0,0,5
5925,2018-08-26,강남구,1.5,0,7,3,1,11
5926,2018-08-26,강동구,1.5,0,2,0,1,3
5927,2018-08-26,강북구,0.0,0,1,0,0,1
5928,2018-08-26,강서구,0.0,0,9,0,2,11
5929,2018-08-26,관악구,2.75,1,1,0,0,2
5930,2018-08-26,광진구,1.5,0,16,0,2,18
5931,2018-08-26,구로구,0.5,0,1,0,0,1
5932,2018-08-26,금천구,1.5,0,0,0,0,0
5933,2018-08-26,노원구,1.0,0,0,0,2,2
5934,2018-08-26,도봉구,0.0,0,0,0,1,1
5935,2018-08-26,동대문구,2.5,0,0,0,0,0
5936,2018-08-26,동작구,1.25,0,5,1,2,8
5937,2018-08-26,마포구,0.0,0,4,1,2,7
5938,2018-08-26,서대문구,0.5,0,0,0,0,0
5939,2018-08-26,서초구,5.0,0,0,1,1,2
5940,2018-08-26,성동구,0.5,0,4,0,1,5
5941,2018-08-26,성북구,1.0,0,4,0,0,4
5942,2018-08-26,송파구,2.5,0,10,1,1,12
5943,2018-08-26,양천구,0.0,0,1,2,0,3
5944,2018-08-26,영등포구,0.25,0,3,1,1,5
5945,2018-08-26,용산구,1.5,0,6,0,2,8
5946,2018-08-26,은평구,0.0,0,1,0,0,1
5947,2018-08-26,종로구,2.0,0,0,0,0,0
5948,2018-08-26,중구,0.0,0,1,0,0,1
5949,2018-08-26,중랑구,3.5,0,0,0,2,2
5950,2018-08-27,강남구,24.5,0,20,3,1,24
5951,2018-08-27,강동구,24.5,0,2,0,0,2
5952,2018-08-27,강북구,27.5,0,2,0,0,2
5953,2018-08-27,강서구,16.5,0,1,1,0,2
5954,2018-08-27,관악구,25.0,1,2,0,0,3
5955,2018-08-27,광진구,21.5,0,7,0,2,9
5956,2018-08-27,구로구,15.0,0,7,0,1,8
5957,2018-08-27,금천구,15.0,0,8,1,1,10
5958,2018-08-27,노원구,31.0,0,5,0,2,7
5959,2018-08-27,도봉구,44.0,0,0,0,1,1
5960,2018-08-27,동대문구,25.0,0,2,1,2,5
5961,2018-08-27,동작구,19.5,0,2,0,2,4
5962,2018-08-27,마포구,18.0,1,1,0,0,2
5963,2018-08-27,서대문구,19.5,0,3,0,0,3
5964,2018-08-27,서초구,25.5,0,7,1,3,11
5965,2018-08-27,성동구,22.5,0,3,0,1,4
5966,2018-08-27,성북구,30.5,0,0,0,0,0
5967,2018-08-27,송파구,26.0,0,6,0,2,8
5968,2018-08-27,양천구,16.0,0,9,0,1,10
5969,2018-08-27,영등포구,16.0,0,5,4,0,9
5970,2018-08-27,용산구,19.0,0,3,0,0,3
5971,2018-08-27,은평구,29.5,0,7,0,1,8
5972,2018-08-27,종로구,19.5,0,5,0,3,8
5973,2018-08-27,중구,9.0,0,3,1,1,5
5974,2018-08-27,중랑구,26.0,0,4,1,2,7
5975,2018-08-28,강남구,98.0,0,12,0,4,16
5976,2018-08-28,강동구,84.5,0,3,0,0,3
5977,2018-08-28,강북구,180.5,0,2,1,1,4
5978,2018-08-28,강서구,117.0,0,7,1,3,11
5979,2018-08-28,관악구,106.0,0,5,2,5,12
5980,2018-08-28,광진구,87.5,0,5,0,1,6
5981,2018-08-28,구로구,97.0,0,2,0,1,3
5982,2018-08-28,금천구,115.5,0,1,0,0,1
5983,2018-08-28,노원구,123.5,0,16,0,2,18
5984,2018-08-28,도봉구,185.0,0,3,1,1,5
5985,2018-08-28,동대문구,114.5,0,2,0,0,2
5986,2018-08-28,동작구,97.75,0,1,0,1,2
5987,2018-08-28,마포구,89.0,0,6,0,1,7
5988,2018-08-28,서대문구,97.0,0,4,0,0,4
5989,2018-08-28,서초구,97.5,0,3,0,0,3
5990,2018-08-28,성동구,81.5,0,9,0,1,10
5991,2018-08-28,성북구,138.0,0,0,0,0,0
5992,2018-08-28,송파구,87.5,0,17,3,5,25
5993,2018-08-28,양천구,108.5,0,11,1,1,13
5994,2018-08-28,영등포구,89.25,0,10,1,1,12
5995,2018-08-28,용산구,85.5,0,3,0,0,3
5996,2018-08-28,은평구,172.5,0,3,0,1,4
5997,2018-08-28,종로구,96.5,0,5,0,2,7
5998,2018-08-28,중구,45.5,0,3,0,0,3
5999,2018-08-28,중랑구,114.0,0,6,1,0,7
6000,2018-08-29,강남구,18.5,0,8,0,2,10
6001,2018-08-29,강동구,26.5,0,3,1,0,4
6002,2018-08-29,강북구,133.0,0,0,0,2,2
6003,2018-08-29,강서구,65.5,0,6,0,0,6
6004,2018-08-29,관악구,14.75,0,1,1,0,2
6005,2018-08-29,광진구,21.0,0,0,0,2,2
6006,2018-08-29,구로구,15.5,0,6,0,2,8
6007,2018-08-29,금천구,12.5,0,3,0,0,3
6008,2018-08-29,노원구,54.5,0,4,0,6,10
6009,2018-08-29,도봉구,249.5,0,4,0,1,5
6010,2018-08-29,동대문구,43.0,0,1,1,3,5
6011,2018-08-29,동작구,15.25,0,2,0,1,3
6012,2018-08-29,마포구,33.5,0,2,0,1,3
6013,2018-08-29,서대문구,47.0,0,0,2,1,3
6014,2018-08-29,서초구,14.5,0,6,1,3,10
6015,2018-08-29,성동구,31.0,0,2,0,0,2
6016,2018-08-29,성북구,86.0,0,5,0,0,5
6017,2018-08-29,송파구,15.5,0,7,1,0,8
6018,2018-08-29,양천구,26.5,0,13,1,4,18
6019,2018-08-29,영등포구,23.0,1,5,2,0,8
6020,2018-08-29,용산구,18.5,0,7,0,1,8
6021,2018-08-29,은평구,153.0,0,3,1,1,5
6022,2018-08-29,종로구,42.0,0,2,2,0,4
6023,2018-08-29,중구,26.0,0,2,0,0,2
6024,2018-08-29,중랑구,38.5,0,6,0,2,8
6025,2018-08-30,강남구,7.0,1,10,2,0,13
6026,2018-08-30,강동구,12.0,0,3,0,0,3
6027,2018-08-30,강북구,37.0,0,0,1,2,3
6028,2018-08-30,강서구,16.5,0,2,0,1,3
6029,2018-08-30,관악구,2.75,0,3,0,0,3
6030,2018-08-30,광진구,13.0,0,3,0,1,4
6031,2018-08-30,구로구,8.0,0,1,0,1,2
6032,2018-08-30,금천구,5.0,0,3,0,0,3
6033,2018-08-30,노원구,30.0,0,5,0,0,5
6034,2018-08-30,도봉구,62.5,0,1,1,0,2
6035,2018-08-30,동대문구,15.5,0,1,0,1,2
6036,2018-08-30,동작구,5.0,0,5,0,2,7
6037,2018-08-30,마포구,6.5,0,7,0,1,8
6038,2018-08-30,서대문구,9.5,0,4,0,0,4
6039,2018-08-30,서초구,3.5,0,6,2,0,8
6040,2018-08-30,성동구,11.5,0,0,0,1,1
6041,2018-08-30,성북구,31.0,0,4,0,0,4
6042,2018-08-30,송파구,4.0,0,3,0,1,4
6043,2018-08-30,양천구,8.5,0,1,1,0,2
6044,2018-08-30,영등포구,9.0,0,9,1,0,10
6045,2018-08-30,용산구,7.5,0,2,0,1,3
6046,2018-08-30,은평구,0.0,0,2,0,1,3
6047,2018-08-30,종로구,9.5,0,3,0,1,4
6048,2018-08-30,중구,18.5,0,3,0,2,5
6049,2018-08-30,중랑구,25.5,0,3,1,1,5
6050,2018-08-31,강남구,0.5,0,14,0,2,16
6051,2018-08-31,강동구,1.0,0,2,0,1,3
6052,2018-08-31,강북구,0.0,0,4,0,1,5
6053,2018-08-31,강서구,0.0,0,5,1,0,6
6054,2018-08-31,관악구,0.5,0,11,2,2,15
6055,2018-08-31,광진구,1.0,0,5,0,0,5
6056,2018-08-31,구로구,0.5,0,3,0,0,3
6057,2018-08-31,금천구,0.5,0,6,0,0,6
6058,2018-08-31,노원구,0.0,0,6,4,1,11
6059,2018-08-31,도봉구,0.0,0,0,0,1,1
6060,2018-08-31,동대문구,0.0,0,4,2,0,6
6061,2018-08-31,동작구,1.25,0,8,1,2,11
6062,2018-08-31,마포구,0.0,0,3,1,1,5
6063,2018-08-31,서대문구,0.0,0,1,0,0,1
6064,2018-08-31,서초구,0.5,0,5,1,2,8
6065,2018-08-31,성동구,0.0,0,9,0,1,10
6066,2018-08-31,성북구,0.0,0,7,1,0,8
6067,2018-08-31,송파구,0.0,0,3,2,1,6
6068,2018-08-31,양천구,0.0,0,2,0,0,2
6069,2018-08-31,영등포구,0.25,0,12,0,1,13
6070,2018-08-31,용산구,0.5,0,3,1,2,6
6071,2018-08-31,은평구,0.0,0,9,2,1,12
6072,2018-08-31,종로구,0.1,0,0,0,1,1
6073,2018-08-31,중구,0.0,0,0,0,1,1
6074,2018-08-31,중랑구,0.0,0,5,0,1,6
6075,2018-09-01,강남구,0.0,0,7,1,3,11
6076,2018-09-01,강동구,0.0,0,2,1,1,4
6077,2018-09-01,강북구,0.0,0,5,1,2,8
6078,2018-09-01,강서구,0.0,0,3,0,0,3
6079,2018-09-01,관악구,0.0,0,5,0,0,5
6080,2018-09-01,광진구,0.0,0,3,0,1,4
6081,2018-09-01,구로구,0.0,0,2,0,1,3
6082,2018-09-01,금천구,0.0,0,3,1,0,4
6083,2018-09-01,노원구,0.0,0,12,0,1,13
6084,2018-09-01,도봉구,0.0,0,2,0,0,2
6085,2018-09-01,동대문구,0.0,0,4,2,3,9
6086,2018-09-01,동작구,0.0,0,1,0,0,1
6087,2018-09-01,마포구,0.0,0,3,1,1,5
6088,2018-09-01,서대문구,0.0,0,3,0,1,4
6089,2018-09-01,서초구,0.0,1,13,1,1,16
6090,2018-09-01,성동구,0.0,0,4,0,0,4
6091,2018-09-01,성북구,0.0,0,3,1,2,6
6092,2018-09-01,송파구,0.0,0,6,5,2,13
6093,2018-09-01,양천구,0.0,0,1,0,0,1
6094,2018-09-01,영등포구,0.0,0,9,0,2,11
6095,2018-09-01,용산구,0.0,0,7,1,3,11
6096,2018-09-01,은평구,0.0,0,1,0,1,2
6097,2018-09-01,종로구,0.0,0,4,1,3,8
6098,2018-09-01,중구,0.0,0,1,1,1,3
6099,2018-09-01,중랑구,0.0,0,2,1,2,5
6100,2018-09-02,강남구,0.0,0,6,0,0,6
6101,2018-09-02,강동구,0.0,0,2,0,3,5
6102,2018-09-02,강북구,0.0,0,5,0,0,5
6103,2018-09-02,강서구,0.0,0,11,1,3,15
6104,2018-09-02,관악구,0.0,0,3,0,0,3
6105,2018-09-02,광진구,0.0,0,3,1,0,4
6106,2018-09-02,구로구,0.0,0,4,0,0,4
6107,2018-09-02,금천구,0.0,0,3,0,1,4
6108,2018-09-02,노원구,0.0,0,10,0,0,10
6109,2018-09-02,도봉구,0.0,0,0,0,0,0
6110,2018-09-02,동대문구,0.0,0,6,0,1,7
6111,2018-09-02,동작구,0.0,0,1,0,0,1
6112,2018-09-02,마포구,0.0,0,5,2,1,8
6113,2018-09-02,서대문구,0.0,0,1,0,0,1
6114,2018-09-02,서초구,0.0,0,2,0,1,3
6115,2018-09-02,성동구,0.0,0,1,0,0,1
6116,2018-09-02,성북구,0.0,0,3,0,0,3
6117,2018-09-02,송파구,0.0,0,8,1,3,12
6118,2018-09-02,양천구,0.0,0,5,1,2,8
6119,2018-09-02,영등포구,0.0,0,7,0,2,9
6120,2018-09-02,용산구,0.0,1,6,0,0,7
6121,2018-09-02,은평구,0.0,0,4,1,1,6
6122,2018-09-02,종로구,0.0,0,0,0,0,0
6123,2018-09-02,중구,0.0,0,0,0,2,2
6124,2018-09-02,중랑구,0.0,0,1,0,1,2
6125,2018-09-03,강남구,46.5,0,7,1,1,9
6126,2018-09-03,강동구,37.0,0,3,0,0,3
6127,2018-09-03,강북구,25.5,0,2,2,0,4
6128,2018-09-03,강서구,15.5,0,2,0,1,3
6129,2018-09-03,관악구,37.5,0,2,0,0,2
6130,2018-09-03,광진구,44.0,0,5,1,0,6
6131,2018-09-03,구로구,31.0,0,5,0,0,5
6132,2018-09-03,금천구,41.0,0,4,1,1,6
6133,2018-09-03,노원구,31.0,0,3,2,1,6
6134,2018-09-03,도봉구,19.0,0,1,0,2,3
6135,2018-09-03,동대문구,32.0,1,4,0,3,8
6136,2018-09-03,동작구,33.5,0,5,3,3,11
6137,2018-09-03,마포구,30.5,0,5,1,0,6
6138,2018-09-03,서대문구,30.0,0,1,2,0,3
6139,2018-09-03,서초구,42.0,0,6,1,2,9
6140,2018-09-03,성동구,34.5,0,2,0,0,2
6141,2018-09-03,성북구,32.5,0,2,0,0,2
6142,2018-09-03,송파구,42.0,0,8,1,1,10
6143,2018-09-03,양천구,28.0,0,0,0,0,0
6144,2018-09-03,영등포구,34.0,1,4,1,2,8
6145,2018-09-03,용산구,33.5,0,5,2,4,11
6146,2018-09-03,은평구,23.5,0,1,0,0,1
6147,2018-09-03,종로구,34.5,0,2,0,0,2
6148,2018-09-03,중구,30.0,0,3,0,1,4
6149,2018-09-03,중랑구,33.5,0,2,0,0,2
6150,2018-09-04,강남구,0.0,0,12,1,1,14
6151,2018-09-04,강동구,0.0,0,1,0,2,3
6152,2018-09-04,강북구,0.0,0,4,0,2,6
6153,2018-09-04,강서구,0.0,0,1,0,1,2
6154,2018-09-04,관악구,0.0,0,1,1,6,8
6155,2018-09-04,광진구,0.0,0,3,0,0,3
6156,2018-09-04,구로구,0.0,0,2,0,3,5
6157,2018-09-04,금천구,0.0,0,4,1,1,6
6158,2018-09-04,노원구,0.0,0,3,0,0,3
6159,2018-09-04,도봉구,0.0,0,4,0,1,5
6160,2018-09-04,동대문구,0.0,0,7,0,3,10
6161,2018-09-04,동작구,0.0,0,4,2,1,7
6162,2018-09-04,마포구,0.0,0,3,0,1,4
6163,2018-09-04,서대문구,0.0,0,2,0,2,4
6164,2018-09-04,서초구,0.0,0,5,0,3,8
6165,2018-09-04,성동구,0.0,0,2,0,1,3
6166,2018-09-04,성북구,0.0,0,1,0,4,5
6167,2018-09-04,송파구,0.0,0,7,1,2,10
6168,2018-09-04,양천구,0.0,0,1,0,0,1
6169,2018-09-04,영등포구,0.0,0,9,1,0,10
6170,2018-09-04,용산구,0.0,0,1,0,0,1
6171,2018-09-04,은평구,0.0,0,2,1,1,4
6172,2018-09-04,종로구,0.0,0,4,1,0,5
6173,2018-09-04,중구,0.0,0,3,0,3,6
6174,2018-09-04,중랑구,0.0,0,0,0,3,3
6175,2018-09-05,강남구,0.0,0,18,2,4,24
6176,2018-09-05,강동구,0.0,0,2,1,2,5
6177,2018-09-05,강북구,0.0,0,1,0,0,1
6178,2018-09-05,강서구,0.0,0,6,0,3,9
6179,2018-09-05,관악구,0.0,0,5,2,0,7
6180,2018-09-05,광진구,0.0,0,1,0,0,1
6181,2018-09-05,구로구,0.0,0,6,1,3,10
6182,2018-09-05,금천구,0.0,0,1,0,0,1
6183,2018-09-05,노원구,0.0,0,3,0,1,4
6184,2018-09-05,도봉구,0.0,0,3,0,2,5
6185,2018-09-05,동대문구,0.0,0,3,0,2,5
6186,2018-09-05,동작구,0.0,0,4,2,2,8
6187,2018-09-05,마포구,0.0,0,8,1,0,9
6188,2018-09-05,서대문구,0.0,0,5,0,0,5
6189,2018-09-05,서초구,0.0,0,10,2,0,12
6190,2018-09-05,성동구,0.0,0,5,0,1,6
6191,2018-09-05,성북구,0.0,0,1,1,1,3
6192,2018-09-05,송파구,0.0,0,4,3,2,9
6193,2018-09-05,양천구,0.0,0,4,0,1,5
6194,2018-09-05,영등포구,0.0,0,14,1,3,18
6195,2018-09-05,용산구,0.0,0,6,0,4,10
6196,2018-09-05,은평구,0.0,0,2,0,1,3
6197,2018-09-05,종로구,0.0,0,2,0,0,2
6198,2018-09-05,중구,0.0,0,1,2,1,4
6199,2018-09-05,중랑구,0.0,0,9,0,1,10
6200,2018-09-06,강남구,1.0,0,9,1,3,13
6201,2018-09-06,강동구,3.5,0,4,1,0,5
6202,2018-09-06,강북구,0.5,0,1,1,1,3
6203,2018-09-06,강서구,0.0,0,2,1,1,4
6204,2018-09-06,관악구,2.0,0,4,0,1,5
6205,2018-09-06,광진구,5.0,0,6,0,2,8
6206,2018-09-06,구로구,0.5,0,1,0,0,1
6207,2018-09-06,금천구,1.5,0,7,0,0,7
6208,2018-09-06,노원구,4.5,0,4,1,1,6
6209,2018-09-06,도봉구,0.5,0,0,1,0,1
6210,2018-09-06,동대문구,9.0,0,1,0,1,2
6211,2018-09-06,동작구,1.25,0,2,0,0,2
6212,2018-09-06,마포구,1.5,0,8,0,1,9
6213,2018-09-06,서대문구,0.0,0,1,0,0,1
6214,2018-09-06,서초구,2.0,0,6,5,2,13
6215,2018-09-06,성동구,6.0,0,1,0,0,1
6216,2018-09-06,성북구,0.0,0,6,0,2,8
6217,2018-09-06,송파구,0.0,0,5,4,1,10
6218,2018-09-06,양천구,0.0,0,1,1,0,2
6219,2018-09-06,영등포구,2.0,0,4,0,2,6
6220,2018-09-06,용산구,1.0,0,4,0,1,5
6221,2018-09-06,은평구,0.0,0,2,0,0,2
6222,2018-09-06,종로구,1.0,0,2,0,1,3
6223,2018-09-06,중구,0.5,0,1,0,0,1
6224,2018-09-06,중랑구,9.5,0,5,0,1,6
6225,2018-09-07,강남구,1.0,0,4,0,2,6
6226,2018-09-07,강동구,4.0,0,2,0,1,3
6227,2018-09-07,강북구,0.5,0,5,0,0,5
6228,2018-09-07,강서구,1.5,0,3,0,2,5
6229,2018-09-07,관악구,5.5,0,7,1,1,9
6230,2018-09-07,광진구,2.5,0,1,1,1,3
6231,2018-09-07,구로구,1.5,0,2,2,0,4
6232,2018-09-07,금천구,1.0,0,4,0,0,4
6233,2018-09-07,노원구,0.5,0,5,0,1,6
6234,2018-09-07,도봉구,1.0,0,3,3,2,8
6235,2018-09-07,동대문구,0.0,0,4,1,1,6
6236,2018-09-07,동작구,2.25,0,9,3,3,15
6237,2018-09-07,마포구,1.0,0,1,1,0,2
6238,2018-09-07,서대문구,0.5,0,2,0,1,3
6239,2018-09-07,서초구,2.5,0,9,1,5,15
6240,2018-09-07,성동구,1.0,0,3,1,1,5
6241,2018-09-07,성북구,1.0,0,4,1,0,5
6242,2018-09-07,송파구,3.0,0,6,3,2,11
6243,2018-09-07,양천구,1.0,0,1,1,2,4
6244,2018-09-07,영등포구,1.0,0,7,0,0,7
6245,2018-09-07,용산구,2.5,0,2,0,1,3
6246,2018-09-07,은평구,1.5,0,1,3,2,6
6247,2018-09-07,종로구,0.5,0,3,2,2,7
6248,2018-09-07,중구,0.5,0,2,0,0,2
6249,2018-09-07,중랑구,0.0,0,6,0,2,8
6250,2018-09-08,강남구,0.0,0,12,0,1,13
6251,2018-09-08,강동구,0.0,0,3,0,2,5
6252,2018-09-08,강북구,0.0,0,5,0,1,6
6253,2018-09-08,강서구,0.0,0,3,0,1,4
6254,2018-09-08,관악구,0.0,0,6,0,1,7
6255,2018-09-08,광진구,0.0,0,1,0,1,2
6256,2018-09-08,구로구,0.0,0,3,0,3,6
6257,2018-09-08,금천구,0.0,0,2,0,0,2
6258,2018-09-08,노원구,0.0,0,1,0,3,4
6259,2018-09-08,도봉구,0.0,0,5,1,0,6
6260,2018-09-08,동대문구,0.0,0,3,1,5,9
6261,2018-09-08,동작구,0.0,0,2,0,2,4
6262,2018-09-08,마포구,0.0,0,6,2,1,9
6263,2018-09-08,서대문구,0.0,0,3,0,1,4
6264,2018-09-08,서초구,0.0,0,16,2,1,19
6265,2018-09-08,성동구,0.0,0,5,0,2,7
6266,2018-09-08,성북구,0.0,0,6,1,0,7
6267,2018-09-08,송파구,0.0,0,6,2,6,14
6268,2018-09-08,양천구,0.0,0,4,0,0,4
6269,2018-09-08,영등포구,0.0,0,14,0,2,16
6270,2018-09-08,용산구,0.0,0,4,1,0,5
6271,2018-09-08,은평구,0.0,0,3,0,1,4
6272,2018-09-08,종로구,0.0,0,3,0,0,3
6273,2018-09-08,중구,0.0,0,4,2,1,7
6274,2018-09-08,중랑구,0.0,0,2,1,2,5
6275,2018-09-09,강남구,0.0,0,6,1,0,7
6276,2018-09-09,강동구,0.0,0,0,0,0,0
6277,2018-09-09,강북구,0.0,0,7,0,3,10
6278,2018-09-09,강서구,0.0,0,4,1,0,5
6279,2018-09-09,관악구,0.0,0,5,1,0,6
6280,2018-09-09,광진구,0.0,0,3,0,0,3
6281,2018-09-09,구로구,0.0,0,9,0,3,12
6282,2018-09-09,금천구,0.0,0,2,0,0,2
6283,2018-09-09,노원구,0.0,0,4,0,1,5
6284,2018-09-09,도봉구,0.0,0,1,0,0,1
6285,2018-09-09,동대문구,0.0,0,2,2,0,4
6286,2018-09-09,동작구,0.0,0,4,1,1,6
6287,2018-09-09,마포구,0.0,0,3,1,0,4
6288,2018-09-09,서대문구,0.0,0,2,0,0,2
6289,2018-09-09,서초구,0.0,0,3,0,1,4
6290,2018-09-09,성동구,0.0,0,4,0,2,6
6291,2018-09-09,성북구,0.0,0,3,0,2,5
6292,2018-09-09,송파구,0.0,0,4,2,2,8
6293,2018-09-09,양천구,0.0,0,0,0,0,0
6294,2018-09-09,영등포구,0.0,0,10,2,3,15
6295,2018-09-09,용산구,0.0,0,1,0,1,2
6296,2018-09-09,은평구,0.0,1,4,0,2,7
6297,2018-09-09,종로구,0.0,0,8,0,1,9
6298,2018-09-09,중구,0.0,0,3,0,1,4
6299,2018-09-09,중랑구,0.0,0,2,2,0,4
6300,2018-09-10,강남구,0.0,0,10,0,0,10
6301,2018-09-10,강동구,0.0,0,1,0,0,1
6302,2018-09-10,강북구,0.0,0,5,0,3,8
6303,2018-09-10,강서구,0.0,0,3,1,2,6
6304,2018-09-10,관악구,0.0,0,2,0,3,5
6305,2018-09-10,광진구,0.0,0,1,0,0,1
6306,2018-09-10,구로구,0.0,0,5,2,3,10
6307,2018-09-10,금천구,0.0,0,3,0,0,3
6308,2018-09-10,노원구,0.0,0,11,0,1,12
6309,2018-09-10,도봉구,0.0,0,1,1,2,4
6310,2018-09-10,동대문구,0.0,0,4,0,4,8
6311,2018-09-10,동작구,0.0,0,9,2,1,12
6312,2018-09-10,마포구,0.0,0,5,1,1,7
6313,2018-09-10,서대문구,0.0,0,6,2,6,14
6314,2018-09-10,서초구,0.0,0,9,0,1,10
6315,2018-09-10,성동구,0.0,0,8,0,2,10
6316,2018-09-10,성북구,0.0,0,3,2,2,7
6317,2018-09-10,송파구,0.0,0,3,1,2,6
6318,2018-09-10,양천구,0.0,0,6,1,0,7
6319,2018-09-10,영등포구,0.0,0,7,0,1,8
6320,2018-09-10,용산구,0.0,0,4,0,0,4
6321,2018-09-10,은평구,0.0,1,2,0,1,4
6322,2018-09-10,종로구,0.0,1,11,2,0,14
6323,2018-09-10,중구,0.0,0,6,0,1,7
6324,2018-09-10,중랑구,0.0,0,1,1,1,3
6325,2018-09-11,강남구,0.0,0,6,0,0,6
6326,2018-09-11,강동구,0.0,0,4,0,3,7
6327,2018-09-11,강북구,0.0,0,3,0,1,4
6328,2018-09-11,강서구,0.0,0,4,0,2,6
6329,2018-09-11,관악구,0.0,0,2,0,0,2
6330,2018-09-11,광진구,0.0,0,2,0,0,2
6331,2018-09-11,구로구,0.0,0,8,0,1,9
6332,2018-09-11,금천구,0.0,0,2,0,0,2
6333,2018-09-11,노원구,0.0,0,6,1,0,7
6334,2018-09-11,도봉구,0.0,0,2,2,0,4
6335,2018-09-11,동대문구,0.0,0,2,0,2,4
6336,2018-09-11,동작구,0.0,0,2,1,2,5
6337,2018-09-11,마포구,0.0,0,3,1,1,5
6338,2018-09-11,서대문구,0.0,0,6,4,1,11
6339,2018-09-11,서초구,0.0,0,4,0,1,5
6340,2018-09-11,성동구,0.0,0,3,0,2,5
6341,2018-09-11,성북구,0.0,0,2,0,0,2
6342,2018-09-11,송파구,0.0,0,4,0,2,6
6343,2018-09-11,양천구,0.0,0,3,0,1,4
6344,2018-09-11,영등포구,0.0,0,19,1,3,23
6345,2018-09-11,용산구,0.0,0,3,0,2,5
6346,2018-09-11,은평구,0.0,0,3,0,1,4
6347,2018-09-11,종로구,0.0,0,5,0,2,7
6348,2018-09-11,중구,0.0,0,3,0,1,4
6349,2018-09-11,중랑구,0.0,0,6,2,2,10
6350,2018-09-12,강남구,0.0,0,9,2,4,15
6351,2018-09-12,강동구,0.0,0,4,3,3,10
6352,2018-09-12,강북구,0.0,0,3,0,0,3
6353,2018-09-12,강서구,0.0,0,4,3,1,8
6354,2018-09-12,관악구,0.0,0,2,2,1,5
6355,2018-09-12,광진구,0.0,0,0,0,1,1
6356,2018-09-12,구로구,0.0,0,5,0,2,7
6357,2018-09-12,금천구,0.0,0,0,0,1,1
6358,2018-09-12,노원구,0.0,0,5,0,1,6
6359,2018-09-12,도봉구,0.0,0,4,1,0,5
6360,2018-09-12,동대문구,0.0,0,8,0,1,9
6361,2018-09-12,동작구,0.0,0,2,0,0,2
6362,2018-09-12,마포구,0.0,0,6,0,0,6
6363,2018-09-12,서대문구,0.0,0,2,1,0,3
6364,2018-09-12,서초구,0.0,0,9,2,1,12
6365,2018-09-12,성동구,0.0,0,8,0,0,8
6366,2018-09-12,성북구,0.0,0,5,0,0,5
6367,2018-09-12,송파구,0.0,0,12,3,1,16
6368,2018-09-12,양천구,0.0,1,1,0,3,5
6369,2018-09-12,영등포구,0.0,0,8,0,2,10
6370,2018-09-12,용산구,0.0,0,4,1,1,6
6371,2018-09-12,은평구,0.0,0,6,0,2,8
6372,2018-09-12,종로구,0.0,0,1,0,0,1
6373,2018-09-12,중구,0.0,0,2,1,0,3
6374,2018-09-12,중랑구,0.0,0,0,0,1,1
6375,2018-09-13,강남구,0.0,0,11,1,1,13
6376,2018-09-13,강동구,0.0,0,6,1,1,8
6377,2018-09-13,강북구,0.0,0,0,0,0,0
6378,2018-09-13,강서구,0.0,0,0,0,0,0
6379,2018-09-13,관악구,0.0,0,1,0,0,1
6380,2018-09-13,광진구,0.0,0,0,0,1,1
6381,2018-09-13,구로구,0.0,0,5,1,1,7
6382,2018-09-13,금천구,0.0,0,1,0,0,1
6383,2018-09-13,노원구,0.0,0,10,0,1,11
6384,2018-09-13,도봉구,0.0,0,1,1,3,5
6385,2018-09-13,동대문구,0.0,0,3,2,1,6
6386,2018-09-13,동작구,0.0,0,1,0,0,1
6387,2018-09-13,마포구,0.0,0,10,0,2,12
6388,2018-09-13,서대문구,0.0,0,6,0,2,8
6389,2018-09-13,서초구,0.0,0,5,2,5,12
6390,2018-09-13,성동구,0.0,1,1,0,2,4
6391,2018-09-13,성북구,0.0,0,3,0,0,3
6392,2018-09-13,송파구,0.0,0,7,0,1,8
6393,2018-09-13,양천구,0.0,0,4,0,2,6
6394,2018-09-13,영등포구,0.0,0,16,1,3,20
6395,2018-09-13,용산구,0.0,0,4,1,0,5
6396,2018-09-13,은평구,0.0,0,2,0,0,2
6397,2018-09-13,종로구,0.0,0,4,0,1,5
6398,2018-09-13,중구,0.0,0,1,0,0,1
6399,2018-09-13,중랑구,0.0,0,6,1,0,7
6400,2018-09-14,강남구,0.5,0,14,0,3,17
6401,2018-09-14,강동구,0.5,0,0,1,2,3
6402,2018-09-14,강북구,0.0,0,1,0,2,3
6403,2018-09-14,강서구,0.0,0,5,1,1,7
6404,2018-09-14,관악구,0.75,0,9,2,2,13
6405,2018-09-14,광진구,0.0,0,4,0,1,5
6406,2018-09-14,구로구,0.0,0,3,0,1,4
6407,2018-09-14,금천구,0.0,0,7,1,1,9
6408,2018-09-14,노원구,0.5,0,8,0,1,9
6409,2018-09-14,도봉구,0.0,0,1,0,0,1
6410,2018-09-14,동대문구,0.5,0,5,0,1,6
6411,2018-09-14,동작구,0.25,0,1,0,1,2
6412,2018-09-14,마포구,0.5,0,6,2,0,8
6413,2018-09-14,서대문구,0.0,0,3,0,2,5
6414,2018-09-14,서초구,0.0,0,4,0,2,6
6415,2018-09-14,성동구,0.5,0,0,0,0,0
6416,2018-09-14,성북구,0.0,0,5,1,1,7
6417,2018-09-14,송파구,0.0,0,13,0,0,13
6418,2018-09-14,양천구,0.0,0,3,0,0,3
6419,2018-09-14,영등포구,0.0,0,8,2,5,15
6420,2018-09-14,용산구,0.0,0,8,1,1,10
6421,2018-09-14,은평구,1.0,0,2,0,1,3
6422,2018-09-14,종로구,0.5,0,0,0,0,0
6423,2018-09-14,중구,0.0,0,3,0,1,4
6424,2018-09-14,중랑구,1.5,0,4,0,2,6
6425,2018-09-15,강남구,1.0,0,14,0,1,15
6426,2018-09-15,강동구,0.0,0,7,3,0,10
6427,2018-09-15,강북구,0.0,0,2,0,1,3
6428,2018-09-15,강서구,0.0,0,2,0,1,3
6429,2018-09-15,관악구,0.75,0,4,0,0,4
6430,2018-09-15,광진구,0.5,0,1,0,4,5
6431,2018-09-15,구로구,0.5,0,11,3,2,16
6432,2018-09-15,금천구,0.5,0,6,0,3,9
6433,2018-09-15,노원구,0.5,0,6,0,1,7
6434,2018-09-15,도봉구,0.0,0,0,2,2,4
6435,2018-09-15,동대문구,0.0,0,6,2,2,10
6436,2018-09-15,동작구,0.0,0,1,0,3,4
6437,2018-09-15,마포구,0.5,0,4,0,2,6
6438,2018-09-15,서대문구,0.5,0,2,0,0,2
6439,2018-09-15,서초구,1.0,0,14,3,3,20
6440,2018-09-15,성동구,0.0,0,0,0,0,0
6441,2018-09-15,성북구,0.0,0,6,0,1,7
6442,2018-09-15,송파구,0.0,0,9,0,4,13
6443,2018-09-15,양천구,0.0,0,1,0,0,1
6444,2018-09-15,영등포구,0.5,0,13,2,2,17
6445,2018-09-15,용산구,1.0,0,3,0,1,4
6446,2018-09-15,은평구,0.0,0,4,0,3,7
6447,2018-09-15,종로구,0.2,0,5,1,0,6
6448,2018-09-15,중구,0.5,0,1,0,0,1
6449,2018-09-15,중랑구,0.0,0,5,0,0,5
6450,2018-09-16,강남구,1.0,0,5,0,1,6
6451,2018-09-16,강동구,1.5,0,1,0,0,1
6452,2018-09-16,강북구,1.0,0,4,0,0,4
6453,2018-09-16,강서구,2.0,0,2,2,0,4
6454,2018-09-16,관악구,1.5,0,3,0,0,3
6455,2018-09-16,광진구,1.0,0,2,0,1,3
6456,2018-09-16,구로구,2.0,0,1,1,3,5
6457,2018-09-16,금천구,1.0,0,0,0,0,0
6458,2018-09-16,노원구,1.0,0,2,1,3,6
6459,2018-09-16,도봉구,1.5,0,5,1,0,6
6460,2018-09-16,동대문구,1.5,0,2,1,1,4
6461,2018-09-16,동작구,1.5,0,3,1,1,5
6462,2018-09-16,마포구,2.5,0,5,2,3,10
6463,2018-09-16,서대문구,2.5,0,5,0,1,6
6464,2018-09-16,서초구,1.0,0,5,1,3,9
6465,2018-09-16,성동구,1.5,0,3,0,2,5
6466,2018-09-16,성북구,1.5,0,11,0,2,13
6467,2018-09-16,송파구,1.0,0,3,0,1,4
6468,2018-09-16,양천구,2.0,0,1,0,0,1
6469,2018-09-16,영등포구,1.5,0,10,0,2,12
6470,2018-09-16,용산구,1.5,0,0,0,0,0
6471,2018-09-16,은평구,2.0,0,1,2,0,3
6472,2018-09-16,종로구,2.0,0,3,0,0,3
6473,2018-09-16,중구,2.0,0,1,1,0,2
6474,2018-09-16,중랑구,1.5,0,6,1,1,8
6475,2018-09-17,강남구,0.0,0,7,0,1,8
6476,2018-09-17,강동구,0.0,0,4,0,0,4
6477,2018-09-17,강북구,0.0,0,7,1,0,8
6478,2018-09-17,강서구,0.0,0,5,1,2,8
6479,2018-09-17,관악구,0.0,0,6,0,0,6
6480,2018-09-17,광진구,0.0,0,1,0,2,3
6481,2018-09-17,구로구,0.0,1,3,0,2,6
6482,2018-09-17,금천구,0.0,0,1,0,1,2
6483,2018-09-17,노원구,0.0,0,3,1,1,5
6484,2018-09-17,도봉구,0.0,0,1,0,0,1
6485,2018-09-17,동대문구,0.0,0,4,0,2,6
6486,2018-09-17,동작구,0.0,0,3,3,2,8
6487,2018-09-17,마포구,0.0,0,5,1,1,7
6488,2018-09-17,서대문구,0.0,0,2,1,0,3
6489,2018-09-17,서초구,0.0,0,8,4,1,13
6490,2018-09-17,성동구,0.0,0,6,0,1,7
6491,2018-09-17,성북구,0.0,0,6,0,0,6
6492,2018-09-17,송파구,0.0,0,8,1,0,9
6493,2018-09-17,양천구,0.0,0,5,0,1,6
6494,2018-09-17,영등포구,0.0,0,10,0,0,10
6495,2018-09-17,용산구,0.0,0,1,0,0,1
6496,2018-09-17,은평구,0.0,0,3,0,0,3
6497,2018-09-17,종로구,0.1,0,4,1,2,7
6498,2018-09-17,중구,0.0,0,2,0,1,3
6499,2018-09-17,중랑구,0.0,0,2,2,1,5
6500,2018-09-18,강남구,0.0,0,12,1,3,16
6501,2018-09-18,강동구,0.0,0,10,1,0,11
6502,2018-09-18,강북구,0.0,0,4,0,1,5
6503,2018-09-18,강서구,0.0,1,3,0,0,4
6504,2018-09-18,관악구,0.0,0,0,0,1,1
6505,2018-09-18,광진구,0.0,0,7,1,1,9
6506,2018-09-18,구로구,0.0,0,7,0,0,7
6507,2018-09-18,금천구,0.0,0,3,0,2,5
6508,2018-09-18,노원구,0.0,0,4,0,1,5
6509,2018-09-18,도봉구,0.0,0,2,2,0,4
6510,2018-09-18,동대문구,0.0,0,3,0,1,4
6511,2018-09-18,동작구,0.0,0,2,0,0,2
6512,2018-09-18,마포구,0.0,0,4,0,1,5
6513,2018-09-18,서대문구,0.0,0,2,0,0,2
6514,2018-09-18,서초구,0.0,0,13,1,3,17
6515,2018-09-18,성동구,0.0,0,1,0,0,1
6516,2018-09-18,성북구,0.0,0,3,2,2,7
6517,2018-09-18,송파구,0.0,0,2,0,2,4
6518,2018-09-18,양천구,0.0,0,7,0,1,8
6519,2018-09-18,영등포구,0.0,0,8,1,1,10
6520,2018-09-18,용산구,0.0,0,2,0,0,2
6521,2018-09-18,은평구,0.0,0,6,1,1,8
6522,2018-09-18,종로구,0.0,0,1,1,1,3
6523,2018-09-18,중구,0.0,0,3,0,2,5
6524,2018-09-18,중랑구,0.0,0,1,1,2,4
6525,2018-09-19,강남구,0.0,0,7,2,2,11
6526,2018-09-19,강동구,0.0,0,5,1,1,7
6527,2018-09-19,강북구,0.0,0,8,0,0,8
6528,2018-09-19,강서구,0.0,0,1,0,1,2
6529,2018-09-19,관악구,0.5,0,2,1,0,3
6530,2018-09-19,광진구,0.0,0,5,0,1,6
6531,2018-09-19,구로구,0.0,0,0,0,2,2
6532,2018-09-19,금천구,0.5,0,3,0,0,3
6533,2018-09-19,노원구,0.0,0,6,1,1,8
6534,2018-09-19,도봉구,0.0,0,2,0,0,2
6535,2018-09-19,동대문구,0.0,0,5,1,2,8
6536,2018-09-19,동작구,0.25,0,4,3,2,9
6537,2018-09-19,마포구,0.0,0,6,0,2,8
6538,2018-09-19,서대문구,0.0,0,1,1,2,4
6539,2018-09-19,서초구,0.0,0,7,2,2,11
6540,2018-09-19,성동구,0.0,0,3,0,2,5
6541,2018-09-19,성북구,0.0,0,4,0,2,6
6542,2018-09-19,송파구,0.0,0,24,3,4,31
6543,2018-09-19,양천구,0.5,0,3,0,0,3
6544,2018-09-19,영등포구,0.25,0,8,0,1,9
6545,2018-09-19,용산구,0.0,0,4,0,0,4
6546,2018-09-19,은평구,0.5,0,3,1,2,6
6547,2018-09-19,종로구,0.2,0,4,0,1,5
6548,2018-09-19,중구,0.0,0,5,0,4,9
6549,2018-09-19,중랑구,0.0,0,11,1,2,14
6550,2018-09-20,강남구,5.5,1,27,1,4,33
6551,2018-09-20,강동구,7.0,0,6,1,1,8
6552,2018-09-20,강북구,5.5,0,2,0,0,2
6553,2018-09-20,강서구,3.0,0,8,0,1,9
6554,2018-09-20,관악구,9.5,0,1,4,1,6
6555,2018-09-20,광진구,5.0,0,5,0,0,5
6556,2018-09-20,구로구,3.5,0,6,0,3,9
6557,2018-09-20,금천구,4.0,0,1,0,1,2
6558,2018-09-20,노원구,5.5,0,4,0,2,6
6559,2018-09-20,도봉구,6.5,0,0,0,1,1
6560,2018-09-20,동대문구,6.0,0,2,2,2,6
6561,2018-09-20,동작구,5.0,0,8,1,1,10
6562,2018-09-20,마포구,3.5,0,12,0,4,16
6563,2018-09-20,서대문구,4.5,0,1,0,0,1
6564,2018-09-20,서초구,6.5,0,8,1,1,10
6565,2018-09-20,성동구,5.5,0,10,2,2,14
6566,2018-09-20,성북구,6.5,1,2,1,1,5
6567,2018-09-20,송파구,5.5,0,8,1,2,11
6568,2018-09-20,양천구,3.0,0,1,0,2,3
6569,2018-09-20,영등포구,2.5,0,8,1,2,11
6570,2018-09-20,용산구,4.0,0,5,0,3,8
6571,2018-09-20,은평구,4.0,0,7,1,0,8
6572,2018-09-20,종로구,5.0,0,2,0,0,2
6573,2018-09-20,중구,1.5,0,0,0,0,0
6574,2018-09-20,중랑구,6.5,0,4,0,1,5
6575,2018-09-21,강남구,19.5,0,12,0,1,13
6576,2018-09-21,강동구,19.5,0,8,2,3,13
6577,2018-09-21,강북구,15.0,0,0,0,1,1
6578,2018-09-21,강서구,12.5,0,6,1,1,8
6579,2018-09-21,관악구,20.75,0,4,0,4,8
6580,2018-09-21,광진구,18.0,0,3,0,2,5
6581,2018-09-21,구로구,16.5,0,1,0,2,3
6582,2018-09-21,금천구,16.0,0,3,0,0,3
6583,2018-09-21,노원구,16.5,0,7,0,2,9
6584,2018-09-21,도봉구,17.0,0,0,1,0,1
6585,2018-09-21,동대문구,16.5,0,5,0,1,6
6586,2018-09-21,동작구,17.0,0,8,0,1,9
6587,2018-09-21,마포구,16.0,0,4,0,0,4
6588,2018-09-21,서대문구,15.5,0,2,2,1,5
6589,2018-09-21,서초구,17.0,1,11,0,6,18
6590,2018-09-21,성동구,16.5,0,1,0,0,1
6591,2018-09-21,성북구,15.5,0,5,0,0,5
6592,2018-09-21,송파구,18.0,0,5,1,4,10
6593,2018-09-21,양천구,16.0,0,1,0,1,2
6594,2018-09-21,영등포구,15.0,0,12,1,3,16
6595,2018-09-21,용산구,17.0,0,2,0,2,4
6596,2018-09-21,은평구,12.5,0,2,1,1,4
6597,2018-09-21,종로구,18.0,0,1,0,1,2
6598,2018-09-21,중구,13.0,0,3,0,4,7
6599,2018-09-21,중랑구,18.0,0,5,0,2,7
6600,2018-09-22,강남구,12.0,0,11,1,0,12
6601,2018-09-22,강동구,3.5,0,2,0,3,5
6602,2018-09-22,강북구,1.0,0,1,0,2,3
6603,2018-09-22,강서구,9.0,0,4,1,1,6
6604,2018-09-22,관악구,3.25,0,3,1,2,6
6605,2018-09-22,광진구,8.5,0,4,0,2,6
6606,2018-09-22,구로구,4.5,0,3,0,1,4
6607,2018-09-22,금천구,3.0,0,5,0,1,6
6608,2018-09-22,노원구,0.0,0,9,1,4,14
6609,2018-09-22,도봉구,0.0,0,0,0,1,1
6610,2018-09-22,동대문구,2.0,0,2,0,3,5
6611,2018-09-22,동작구,10.75,0,2,1,2,5
6612,2018-09-22,마포구,6.5,0,6,0,3,9
6613,2018-09-22,서대문구,9.5,0,6,3,0,9
6614,2018-09-22,서초구,6.0,0,8,0,3,11
6615,2018-09-22,성동구,7.5,0,4,0,1,5
6616,2018-09-22,성북구,0.5,0,2,0,2,4
6617,2018-09-22,송파구,11.0,0,11,1,1,13
6618,2018-09-22,양천구,7.0,0,0,2,1,3
6619,2018-09-22,영등포구,8.0,0,11,1,2,14
6620,2018-09-22,용산구,10.0,0,11,2,1,14
6621,2018-09-22,은평구,1.5,0,8,0,0,8
6622,2018-09-22,종로구,6.5,0,0,1,0,1
6623,2018-09-22,중구,5.5,0,2,0,1,3
6624,2018-09-22,중랑구,1.5,0,3,0,1,4
6625,2018-09-23,강남구,0.0,0,1,0,2,3
6626,2018-09-23,강동구,0.0,0,2,0,0,2
6627,2018-09-23,강북구,0.0,0,0,0,0,0
6628,2018-09-23,강서구,0.0,0,1,0,0,1
6629,2018-09-23,관악구,0.0,0,1,0,0,1
6630,2018-09-23,광진구,0.0,0,1,0,0,1
6631,2018-09-23,구로구,0.0,0,1,0,0,1
6632,2018-09-23,금천구,0.0,0,2,0,0,2
6633,2018-09-23,노원구,0.0,0,10,0,1,11
6634,2018-09-23,도봉구,0.0,0,0,1,0,1
6635,2018-09-23,동대문구,0.0,0,3,0,0,3
6636,2018-09-23,동작구,0.0,0,4,3,0,7
6637,2018-09-23,마포구,0.0,0,10,0,0,10
6638,2018-09-23,서대문구,0.0,0,0,1,1,2
6639,2018-09-23,서초구,0.0,0,1,0,0,1
6640,2018-09-23,성동구,0.0,0,1,0,0,1
6641,2018-09-23,성북구,0.0,0,3,0,0,3
6642,2018-09-23,송파구,0.0,0,1,0,0,1
6643,2018-09-23,양천구,0.0,0,3,0,0,3
6644,2018-09-23,영등포구,0.0,0,1,0,2,3
6645,2018-09-23,용산구,0.0,0,1,0,0,1
6646,2018-09-23,은평구,0.0,0,4,1,2,7
6647,2018-09-23,종로구,0.0,0,1,0,0,1
6648,2018-09-23,중구,0.0,0,4,0,0,4
6649,2018-09-23,중랑구,0.0,0,8,0,2,10
6650,2018-09-24,강남구,0.0,0,4,0,1,5
6651,2018-09-24,강동구,0.0,0,8,1,1,10
6652,2018-09-24,강북구,0.0,0,3,0,1,4
6653,2018-09-24,강서구,0.0,0,3,0,0,3
6654,2018-09-24,관악구,0.0,0,7,0,4,11
6655,2018-09-24,광진구,0.0,0,0,0,0,0
6656,2018-09-24,구로구,0.0,0,7,0,0,7
6657,2018-09-24,금천구,0.0,0,0,0,0,0
6658,2018-09-24,노원구,0.0,0,6,0,0,6
6659,2018-09-24,도봉구,0.0,0,0,0,2,2
6660,2018-09-24,동대문구,0.0,0,0,0,1,1
6661,2018-09-24,동작구,0.0,0,1,2,0,3
6662,2018-09-24,마포구,0.0,0,1,0,1,2
6663,2018-09-24,서대문구,0.0,0,2,0,0,2
6664,2018-09-24,서초구,0.0,1,7,0,1,9
6665,2018-09-24,성동구,0.0,0,4,0,1,5
6666,2018-09-24,성북구,0.0,0,4,0,2,6
6667,2018-09-24,송파구,0.0,0,2,0,0,2
6668,2018-09-24,양천구,0.0,0,3,0,0,3
6669,2018-09-24,영등포구,0.0,0,8,0,1,9
6670,2018-09-24,용산구,0.0,0,0,0,0,0
6671,2018-09-24,은평구,0.0,0,6,0,1,7
6672,2018-09-24,종로구,0.0,0,2,0,0,2
6673,2018-09-24,중구,0.0,0,0,0,0,0
6674,2018-09-24,중랑구,0.0,0,5,0,1,6
6675,2018-09-25,강남구,0.0,0,0,0,0,0
6676,2018-09-25,강동구,0.0,0,0,0,1,1
6677,2018-09-25,강북구,0.0,0,1,1,1,3
6678,2018-09-25,강서구,0.0,0,2,2,2,6
6679,2018-09-25,관악구,0.0,0,0,0,0,0
6680,2018-09-25,광진구,0.0,0,1,0,0,1
6681,2018-09-25,구로구,0.0,0,11,0,1,12
6682,2018-09-25,금천구,0.0,0,4,0,0,4
6683,2018-09-25,노원구,0.0,0,9,0,0,9
6684,2018-09-25,도봉구,0.0,0,1,2,0,3
6685,2018-09-25,동대문구,0.0,0,1,0,0,1
6686,2018-09-25,동작구,0.0,0,3,0,2,5
6687,2018-09-25,마포구,0.0,0,7,2,1,10
6688,2018-09-25,서대문구,0.0,0,1,2,0,3
6689,2018-09-25,서초구,0.0,0,2,0,0,2
6690,2018-09-25,성동구,0.0,0,2,0,0,2
6691,2018-09-25,성북구,0.0,0,5,0,0,5
6692,2018-09-25,송파구,0.0,0,6,0,0,6
6693,2018-09-25,양천구,0.0,0,5,0,1,6
6694,2018-09-25,영등포구,0.0,0,8,0,2,10
6695,2018-09-25,용산구,0.0,0,0,0,0,0
6696,2018-09-25,은평구,0.0,0,2,0,0,2
6697,2018-09-25,종로구,0.0,0,1,0,1,2
6698,2018-09-25,중구,0.0,0,0,0,0,0
6699,2018-09-25,중랑구,0.0,0,5,1,0,6
6700,2018-09-26,강남구,0.0,0,7,0,4,11
6701,2018-09-26,강동구,0.0,0,2,0,2,4
6702,2018-09-26,강북구,0.0,0,5,1,0,6
6703,2018-09-26,강서구,0.0,0,1,0,2,3
6704,2018-09-26,관악구,0.0,0,3,0,0,3
6705,2018-09-26,광진구,0.0,0,1,0,0,1
6706,2018-09-26,구로구,0.0,0,4,0,2,6
6707,2018-09-26,금천구,0.0,0,1,0,0,1
6708,2018-09-26,노원구,0.0,0,1,0,2,3
6709,2018-09-26,도봉구,0.0,0,0,0,1,1
6710,2018-09-26,동대문구,0.0,0,3,0,1,4
6711,2018-09-26,동작구,0.0,0,0,1,0,1
6712,2018-09-26,마포구,0.0,0,1,0,3,4
6713,2018-09-26,서대문구,0.0,0,3,0,2,5
6714,2018-09-26,서초구,0.0,0,1,0,0,1
6715,2018-09-26,성동구,0.0,0,0,0,1,1
6716,2018-09-26,성북구,0.0,0,0,0,0,0
6717,2018-09-26,송파구,0.0,0,4,0,0,4
6718,2018-09-26,양천구,0.0,0,5,0,1,6
6719,2018-09-26,영등포구,0.0,0,1,0,1,2
6720,2018-09-26,용산구,0.0,0,2,0,0,2
6721,2018-09-26,은평구,0.0,0,0,0,1,1
6722,2018-09-26,종로구,0.0,0,3,1,1,5
6723,2018-09-26,중구,0.0,0,0,0,0,0
6724,2018-09-26,중랑구,0.0,0,8,0,0,8
6725,2018-09-27,강남구,0.0,0,5,0,2,7
6726,2018-09-27,강동구,0.0,0,2,0,1,3
6727,2018-09-27,강북구,0.0,0,6,0,1,7
6728,2018-09-27,강서구,0.0,0,4,0,4,8
6729,2018-09-27,관악구,0.0,0,3,0,0,3
6730,2018-09-27,광진구,0.0,0,4,0,2,6
6731,2018-09-27,구로구,0.0,0,7,2,1,10
6732,2018-09-27,금천구,0.0,0,3,0,0,3
6733,2018-09-27,노원구,0.0,0,5,1,1,7
6734,2018-09-27,도봉구,0.0,0,3,0,0,3
6735,2018-09-27,동대문구,0.0,0,3,0,2,5
6736,2018-09-27,동작구,0.0,0,2,1,1,4
6737,2018-09-27,마포구,0.0,0,7,0,0,7
6738,2018-09-27,서대문구,0.0,0,2,0,0,2
6739,2018-09-27,서초구,0.0,0,5,0,1,6
6740,2018-09-27,성동구,0.0,0,1,0,1,2
6741,2018-09-27,성북구,0.0,0,3,0,1,4
6742,2018-09-27,송파구,0.0,0,8,0,2,10
6743,2018-09-27,양천구,0.0,0,2,0,1,3
6744,2018-09-27,영등포구,0.0,0,8,0,2,10
6745,2018-09-27,용산구,0.0,0,2,0,0,2
6746,2018-09-27,은평구,0.0,0,0,0,2,2
6747,2018-09-27,종로구,0.0,0,2,0,0,2
6748,2018-09-27,중구,0.0,0,0,0,0,0
6749,2018-09-27,중랑구,0.0,0,4,2,0,6
6750,2018-09-28,강남구,0.0,0,9,5,3,17
6751,2018-09-28,강동구,0.0,0,7,2,0,9
6752,2018-09-28,강북구,0.0,0,3,0,2,5
6753,2018-09-28,강서구,0.0,0,3,0,2,5
6754,2018-09-28,관악구,0.0,0,4,1,1,6
6755,2018-09-28,광진구,0.0,0,4,0,0,4
6756,2018-09-28,구로구,0.0,0,2,1,1,4
6757,2018-09-28,금천구,0.0,0,0,0,0,0
6758,2018-09-28,노원구,0.0,0,2,0,1,3
6759,2018-09-28,도봉구,0.0,0,2,0,1,3
6760,2018-09-28,동대문구,0.0,0,5,1,1,7
6761,2018-09-28,동작구,0.0,0,4,0,1,5
6762,2018-09-28,마포구,0.0,0,7,1,0,8
6763,2018-09-28,서대문구,0.0,0,2,0,1,3
6764,2018-09-28,서초구,0.0,1,3,0,1,5
6765,2018-09-28,성동구,0.0,0,4,0,0,4
6766,2018-09-28,성북구,0.0,0,7,0,1,8
6767,2018-09-28,송파구,0.0,0,3,0,3,6
6768,2018-09-28,양천구,0.0,0,6,1,0,7
6769,2018-09-28,영등포구,0.0,0,4,0,0,4
6770,2018-09-28,용산구,0.0,0,4,0,0,4
6771,2018-09-28,은평구,0.0,1,5,1,0,7
6772,2018-09-28,종로구,0.0,0,7,1,2,10
6773,2018-09-28,중구,0.0,0,2,0,1,3
6774,2018-09-28,중랑구,0.0,0,11,1,3,15
6775,2018-09-29,강남구,0.0,0,16,1,6,23
6776,2018-09-29,강동구,0.0,0,5,0,1,6
6777,2018-09-29,강북구,0.0,0,0,0,1,1
6778,2018-09-29,강서구,0.0,0,13,0,1,14
6779,2018-09-29,관악구,0.0,1,3,0,0,4
6780,2018-09-29,광진구,0.0,0,6,0,0,6
6781,2018-09-29,구로구,0.0,0,10,1,2,13
6782,2018-09-29,금천구,0.0,0,4,0,3,7
6783,2018-09-29,노원구,0.0,0,6,0,3,9
6784,2018-09-29,도봉구,0.0,0,5,0,1,6
6785,2018-09-29,동대문구,0.0,0,6,0,4,10
6786,2018-09-29,동작구,0.0,0,3,2,4,9
6787,2018-09-29,마포구,0.0,0,14,1,3,18
6788,2018-09-29,서대문구,0.0,0,0,0,0,0
6789,2018-09-29,서초구,0.0,0,4,0,1,5
6790,2018-09-29,성동구,0.0,0,4,0,3,7
6791,2018-09-29,성북구,0.0,0,0,0,0,0
6792,2018-09-29,송파구,0.0,0,7,0,0,7
6793,2018-09-29,양천구,0.0,0,3,1,2,6
6794,2018-09-29,영등포구,0.0,0,7,0,2,9
6795,2018-09-29,용산구,0.0,0,2,0,2,4
6796,2018-09-29,은평구,0.0,0,5,0,0,5
6797,2018-09-29,종로구,0.0,0,10,1,3,14
6798,2018-09-29,중구,0.0,0,1,1,2,4
6799,2018-09-29,중랑구,0.0,0,2,0,1,3
6800,2018-09-30,강남구,0.0,1,9,2,2,14
6801,2018-09-30,강동구,0.0,0,2,1,0,3
6802,2018-09-30,강북구,0.0,0,2,1,0,3
6803,2018-09-30,강서구,0.0,0,8,0,1,9
6804,2018-09-30,관악구,0.0,0,1,0,1,2
6805,2018-09-30,광진구,0.0,0,0,1,1,2
6806,2018-09-30,구로구,0.0,0,15,1,2,18
6807,2018-09-30,금천구,0.0,0,7,0,0,7
6808,2018-09-30,노원구,0.0,0,6,0,2,8
6809,2018-09-30,도봉구,0.0,0,0,0,1,1
6810,2018-09-30,동대문구,0.0,1,2,1,0,4
6811,2018-09-30,동작구,0.0,0,3,1,0,4
6812,2018-09-30,마포구,0.0,0,7,2,0,9
6813,2018-09-30,서대문구,0.0,0,0,0,1,1
6814,2018-09-30,서초구,0.0,0,6,1,2,9
6815,2018-09-30,성동구,0.0,0,0,0,0,0
6816,2018-09-30,성북구,0.0,0,2,0,4,6
6817,2018-09-30,송파구,0.0,0,4,0,2,6
6818,2018-09-30,양천구,0.0,0,2,0,0,2
6819,2018-09-30,영등포구,0.0,0,2,1,1,4
6820,2018-09-30,용산구,0.0,0,3,0,0,3
6821,2018-09-30,은평구,0.0,0,3,1,0,4
6822,2018-09-30,종로구,0.0,0,1,0,2,3
6823,2018-09-30,중구,0.0,0,0,0,0,0
6824,2018-09-30,중랑구,0.0,0,1,1,3,5
6825,2018-10-01,강남구,0.0,0,14,0,2,16
6826,2018-10-01,강동구,0.0,0,4,0,0,4
6827,2018-10-01,강북구,0.0,0,3,0,0,3
6828,2018-10-01,강서구,0.0,0,2,0,0,2
6829,2018-10-01,관악구,0.0,0,4,1,0,5
6830,2018-10-01,광진구,0.0,0,0,0,1,1
6831,2018-10-01,구로구,0.0,0,4,0,4,8
6832,2018-10-01,금천구,0.0,0,2,0,3,5
6833,2018-10-01,노원구,0.0,0,1,0,0,1
6834,2018-10-01,도봉구,0.0,0,4,0,1,5
6835,2018-10-01,동대문구,0.0,0,3,2,1,6
6836,2018-10-01,동작구,0.0,0,4,0,0,4
6837,2018-10-01,마포구,0.0,0,6,0,0,6
6838,2018-10-01,서대문구,0.0,0,2,1,0,3
6839,2018-10-01,서초구,0.0,0,9,0,1,10
6840,2018-10-01,성동구,0.0,0,3,0,0,3
6841,2018-10-01,성북구,0.0,0,5,0,1,6
6842,2018-10-01,송파구,0.0,0,7,4,0,11
6843,2018-10-01,양천구,0.0,0,1,0,1,2
6844,2018-10-01,영등포구,0.0,0,3,0,1,4
6845,2018-10-01,용산구,0.0,0,1,0,0,1
6846,2018-10-01,은평구,0.0,0,4,0,1,5
6847,2018-10-01,종로구,0.0,0,2,0,0,2
6848,2018-10-01,중구,0.0,0,3,0,1,4
6849,2018-10-01,중랑구,0.0,0,5,1,2,8
6850,2018-10-02,강남구,0.0,0,7,2,4,13
6851,2018-10-02,강동구,0.0,0,5,1,2,8
6852,2018-10-02,강북구,0.0,0,2,0,1,3
6853,2018-10-02,강서구,0.0,0,1,0,0,1
6854,2018-10-02,관악구,0.0,0,2,3,1,6
6855,2018-10-02,광진구,0.0,0,0,1,1,2
6856,2018-10-02,구로구,0.0,0,4,1,5,10
6857,2018-10-02,금천구,0.0,0,1,0,0,1
6858,2018-10-02,노원구,0.0,0,5,1,2,8
6859,2018-10-02,도봉구,0.0,0,2,2,1,5
6860,2018-10-02,동대문구,0.0,0,10,0,1,11
6861,2018-10-02,동작구,0.0,0,4,3,0,7
6862,2018-10-02,마포구,0.0,0,2,1,2,5
6863,2018-10-02,서대문구,0.0,0,2,0,1,3
6864,2018-10-02,서초구,0.0,0,9,0,2,11
6865,2018-10-02,성동구,0.0,0,2,0,0,2
6866,2018-10-02,성북구,0.0,0,4,3,0,7
6867,2018-10-02,송파구,0.0,0,11,1,4,16
6868,2018-10-02,양천구,0.0,0,8,0,0,8
6869,2018-10-02,영등포구,0.0,0,6,2,2,10
6870,2018-10-02,용산구,0.0,0,6,0,1,7
6871,2018-10-02,은평구,0.0,0,1,0,1,2
6872,2018-10-02,종로구,0.0,0,1,1,0,2
6873,2018-10-02,중구,0.0,0,1,0,0,1
6874,2018-10-02,중랑구,0.0,0,5,1,4,10
6875,2018-10-03,강남구,0.0,0,12,0,3,15
6876,2018-10-03,강동구,0.0,0,1,1,0,2
6877,2018-10-03,강북구,0.0,0,2,0,2,4
6878,2018-10-03,강서구,0.0,0,1,3,0,4
6879,2018-10-03,관악구,0.0,0,2,1,0,3
6880,2018-10-03,광진구,0.0,0,5,0,1,6
6881,2018-10-03,구로구,0.0,0,1,0,0,1
6882,2018-10-03,금천구,0.0,0,3,1,1,5
6883,2018-10-03,노원구,0.0,0,3,0,0,3
6884,2018-10-03,도봉구,0.0,0,0,0,0,0
6885,2018-10-03,동대문구,0.0,0,5,2,0,7
6886,2018-10-03,동작구,0.0,0,5,0,0,5
6887,2018-10-03,마포구,0.0,0,2,1,3,6
6888,2018-10-03,서대문구,0.0,0,1,1,0,2
6889,2018-10-03,서초구,0.0,0,5,0,1,6
6890,2018-10-03,성동구,0.0,0,2,0,0,2
6891,2018-10-03,성북구,0.0,0,10,0,1,11
6892,2018-10-03,송파구,0.0,0,4,2,0,6
6893,2018-10-03,양천구,0.0,0,7,2,1,10
6894,2018-10-03,영등포구,0.0,1,7,0,0,8
6895,2018-10-03,용산구,0.0,0,5,0,0,5
6896,2018-10-03,은평구,0.0,0,1,0,0,1
6897,2018-10-03,종로구,0.0,0,3,0,0,3
6898,2018-10-03,중구,0.0,0,4,0,0,4
6899,2018-10-03,중랑구,0.0,0,7,1,1,9
6900,2018-10-04,강남구,0.0,0,9,1,1,11
6901,2018-10-04,강동구,0.0,0,5,0,2,7
6902,2018-10-04,강북구,0.0,0,5,0,0,5
6903,2018-10-04,강서구,0.0,0,9,2,3,14
6904,2018-10-04,관악구,0.0,0,1,0,0,1
6905,2018-10-04,광진구,0.0,0,1,0,1,2
6906,2018-10-04,구로구,0.0,0,3,2,4,9
6907,2018-10-04,금천구,0.0,0,5,0,1,6
6908,2018-10-04,노원구,0.0,0,6,0,4,10
6909,2018-10-04,도봉구,0.0,0,1,1,1,3
6910,2018-10-04,동대문구,0.0,0,3,1,0,4
6911,2018-10-04,동작구,0.0,0,3,1,5,9
6912,2018-10-04,마포구,0.0,0,5,0,1,6
6913,2018-10-04,서대문구,0.0,0,5,0,1,6
6914,2018-10-04,서초구,0.0,0,9,1,0,10
6915,2018-10-04,성동구,0.0,0,2,2,2,6
6916,2018-10-04,성북구,0.0,0,4,1,0,5
6917,2018-10-04,송파구,0.0,0,18,0,0,18
6918,2018-10-04,양천구,0.0,0,4,0,1,5
6919,2018-10-04,영등포구,0.0,0,11,3,2,16
6920,2018-10-04,용산구,0.0,0,4,0,2,6
6921,2018-10-04,은평구,0.0,0,3,1,0,4
6922,2018-10-04,종로구,0.0,0,1,1,0,2
6923,2018-10-04,중구,0.0,0,0,0,1,1
6924,2018-10-04,중랑구,0.0,0,4,1,0,5
6925,2018-10-05,강남구,42.5,0,20,3,6,29
6926,2018-10-05,강동구,40.0,0,8,0,3,11
6927,2018-10-05,강북구,37.0,1,3,0,2,6
6928,2018-10-05,강서구,23.5,0,4,0,1,5
6929,2018-10-05,관악구,36.25,0,10,0,2,12
6930,2018-10-05,광진구,38.0,0,3,0,1,4
6931,2018-10-05,구로구,25.5,0,1,0,3,4
6932,2018-10-05,금천구,28.5,0,2,1,2,5
6933,2018-10-05,노원구,37.5,0,8,0,2,10
6934,2018-10-05,도봉구,54.0,1,2,1,0,4
6935,2018-10-05,동대문구,39.5,0,14,0,4,18
6936,2018-10-05,동작구,31.5,0,8,2,1,11
6937,2018-10-05,마포구,37.5,0,14,2,5,21
6938,2018-10-05,서대문구,38.0,0,2,0,2,4
6939,2018-10-05,서초구,34.0,0,3,0,4,7
6940,2018-10-05,성동구,40.5,0,1,1,0,2
6941,2018-10-05,성북구,37.5,0,4,1,2,7
6942,2018-10-05,송파구,39.5,0,17,2,5,24
6943,2018-10-05,양천구,28.5,0,9,0,2,11
6944,2018-10-05,영등포구,29.0,0,5,0,3,8
6945,2018-10-05,용산구,33.0,0,4,1,4,9
6946,2018-10-05,은평구,31.5,0,1,0,0,1
6947,2018-10-05,종로구,36.5,0,6,1,0,7
6948,2018-10-05,중구,13.5,0,4,2,0,6
6949,2018-10-05,중랑구,39.0,0,6,1,3,10
6950,2018-10-06,강남구,69.5,0,11,3,5,19
6951,2018-10-06,강동구,95.0,0,3,0,0,3
6952,2018-10-06,강북구,51.5,0,1,0,1,2
6953,2018-10-06,강서구,50.0,0,5,1,2,8
6954,2018-10-06,관악구,75.25,0,3,0,1,4
6955,2018-10-06,광진구,81.0,0,5,0,3,8
6956,2018-10-06,구로구,66.5,0,8,1,0,9
6957,2018-10-06,금천구,77.5,0,3,0,2,5
6958,2018-10-06,노원구,66.0,0,2,1,1,4
6959,2018-10-06,도봉구,52.0,0,0,0,0,0
6960,2018-10-06,동대문구,70.0,0,3,0,0,3
6961,2018-10-06,동작구,66.25,0,5,1,1,7
6962,2018-10-06,마포구,56.0,0,8,0,2,10
6963,2018-10-06,서대문구,53.0,0,4,3,1,8
6964,2018-10-06,서초구,79.0,0,11,0,6,17
6965,2018-10-06,성동구,70.5,0,1,0,1,2
6966,2018-10-06,성북구,59.0,0,4,0,1,5
6967,2018-10-06,송파구,72.5,0,9,0,2,11
6968,2018-10-06,양천구,68.0,0,3,0,0,3
6969,2018-10-06,영등포구,55.25,0,6,2,2,10
6970,2018-10-06,용산구,67.5,0,9,4,3,16
6971,2018-10-06,은평구,45.5,0,8,1,0,9
6972,2018-10-06,종로구,55.5,0,5,1,1,7
6973,2018-10-06,중구,0.0,0,5,0,3,8
6974,2018-10-06,중랑구,71.5,0,6,2,2,10
6975,2018-10-07,강남구,0.0,0,6,1,1,8
6976,2018-10-07,강동구,0.0,0,2,0,1,3
6977,2018-10-07,강북구,0.0,0,6,1,0,7
6978,2018-10-07,강서구,0.0,0,2,0,1,3
6979,2018-10-07,관악구,0.0,0,0,0,1,1
6980,2018-10-07,광진구,0.0,0,4,1,0,5
6981,2018-10-07,구로구,0.0,0,1,1,0,2
6982,2018-10-07,금천구,0.0,0,5,0,1,6
6983,2018-10-07,노원구,0.0,0,2,0,1,3
6984,2018-10-07,도봉구,0.0,0,1,3,1,5
6985,2018-10-07,동대문구,0.0,0,4,0,1,5
6986,2018-10-07,동작구,0.0,0,3,0,2,5
6987,2018-10-07,마포구,0.0,0,7,0,0,7
6988,2018-10-07,서대문구,0.0,0,13,0,2,15
6989,2018-10-07,서초구,0.0,0,5,0,2,7
6990,2018-10-07,성동구,0.0,0,6,0,3,9
6991,2018-10-07,성북구,0.0,0,5,1,2,8
6992,2018-10-07,송파구,0.0,0,4,2,0,6
6993,2018-10-07,양천구,0.0,0,1,0,0,1
6994,2018-10-07,영등포구,0.0,1,3,1,4,9
6995,2018-10-07,용산구,0.0,0,6,0,2,8
6996,2018-10-07,은평구,0.0,0,2,0,1,3
6997,2018-10-07,종로구,0.0,0,2,0,0,2
6998,2018-10-07,중구,0.0,0,3,1,2,6
6999,2018-10-07,중랑구,0.0,0,2,1,0,3
7000,2018-10-08,강남구,0.0,0,4,0,1,5
7001,2018-10-08,강동구,0.0,0,3,1,0,4
7002,2018-10-08,강북구,0.0,0,4,0,0,4
7003,2018-10-08,강서구,0.0,0,4,0,0,4
7004,2018-10-08,관악구,0.0,0,3,0,1,4
7005,2018-10-08,광진구,0.0,0,12,0,3,15
7006,2018-10-08,구로구,0.0,0,7,0,1,8
7007,2018-10-08,금천구,0.0,0,0,0,0,0
7008,2018-10-08,노원구,0.0,0,6,0,1,7
7009,2018-10-08,도봉구,0.0,0,0,0,1,1
7010,2018-10-08,동대문구,0.0,0,2,0,5,7
7011,2018-10-08,동작구,0.0,0,5,3,0,8
7012,2018-10-08,마포구,0.0,0,2,0,1,3
7013,2018-10-08,서대문구,0.0,0,5,0,1,6
7014,2018-10-08,서초구,0.0,0,3,0,8,11
7015,2018-10-08,성동구,0.0,0,2,1,0,3
7016,2018-10-08,성북구,0.0,0,5,0,1,6
7017,2018-10-08,송파구,0.0,0,3,0,2,5
7018,2018-10-08,양천구,0.0,0,7,0,0,7
7019,2018-10-08,영등포구,0.0,0,5,0,3,8
7020,2018-10-08,용산구,0.0,0,13,0,4,17
7021,2018-10-08,은평구,0.0,0,8,1,0,9
7022,2018-10-08,종로구,0.0,0,2,0,1,3
7023,2018-10-08,중구,0.0,0,1,0,1,2
7024,2018-10-08,중랑구,0.0,0,7,2,3,12
7025,2018-10-09,강남구,0.0,0,2,0,3,5
7026,2018-10-09,강동구,0.0,0,7,1,0,8
7027,2018-10-09,강북구,0.0,0,1,0,2,3
7028,2018-10-09,강서구,0.0,0,3,0,1,4
7029,2018-10-09,관악구,0.0,0,4,0,0,4
7030,2018-10-09,광진구,0.0,0,6,0,0,6
7031,2018-10-09,구로구,0.0,0,4,2,1,7
7032,2018-10-09,금천구,0.0,0,4,0,0,4
7033,2018-10-09,노원구,0.0,0,9,3,0,12
7034,2018-10-09,도봉구,0.0,0,9,0,1,10
7035,2018-10-09,동대문구,0.0,1,5,0,0,6
7036,2018-10-09,동작구,0.0,0,2,1,0,3
7037,2018-10-09,마포구,0.0,1,0,1,2,4
7038,2018-10-09,서대문구,0.0,0,2,0,2,4
7039,2018-10-09,서초구,0.0,0,1,0,1,2
7040,2018-10-09,성동구,0.0,0,2,1,1,4
7041,2018-10-09,성북구,0.0,0,4,0,0,4
7042,2018-10-09,송파구,0.0,0,5,1,1,7
7043,2018-10-09,양천구,0.0,1,1,0,2,4
7044,2018-10-09,영등포구,0.0,0,4,0,0,4
7045,2018-10-09,용산구,0.0,0,7,0,1,8
7046,2018-10-09,은평구,0.0,1,0,0,3,4
7047,2018-10-09,종로구,0.0,0,2,0,0,2
7048,2018-10-09,중구,0.0,0,1,1,1,3
7049,2018-10-09,중랑구,0.0,0,3,0,3,6
7050,2018-10-10,강남구,4.0,0,12,0,1,13
7051,2018-10-10,강동구,6.0,0,1,0,3,4
7052,2018-10-10,강북구,10.0,0,3,0,2,5
7053,2018-10-10,강서구,10.5,0,3,1,1,5
7054,2018-10-10,관악구,4.75,0,3,0,0,3
7055,2018-10-10,광진구,5.5,0,2,0,0,2
7056,2018-10-10,구로구,6.5,0,2,0,1,3
7057,2018-10-10,금천구,6.0,0,2,0,0,2
7058,2018-10-10,노원구,8.0,0,2,0,1,3
7059,2018-10-10,도봉구,16.0,0,2,0,2,4
7060,2018-10-10,동대문구,7.5,0,6,1,1,8
7061,2018-10-10,동작구,5.5,0,0,0,0,0
7062,2018-10-10,마포구,7.5,0,4,0,1,5
7063,2018-10-10,서대문구,8.5,0,1,2,2,5
7064,2018-10-10,서초구,5.5,0,8,2,2,12
7065,2018-10-10,성동구,3.5,0,1,0,1,2
7066,2018-10-10,성북구,9.0,0,0,0,0,0
7067,2018-10-10,송파구,4.5,0,5,1,1,7
7068,2018-10-10,양천구,9.0,0,5,0,1,6
7069,2018-10-10,영등포구,4.75,0,3,0,1,4
7070,2018-10-10,용산구,4.5,0,4,0,0,4
7071,2018-10-10,은평구,14.0,0,1,0,3,4
7072,2018-10-10,종로구,7.0,0,5,1,0,6
7073,2018-10-10,중구,5.5,0,1,0,1,2
7074,2018-10-10,중랑구,5.5,0,1,1,2,4
7075,2018-10-11,강남구,0.0,0,8,1,2,11
7076,2018-10-11,강동구,0.0,0,2,0,0,2
7077,2018-10-11,강북구,0.0,0,0,0,3,3
7078,2018-10-11,강서구,0.0,0,5,1,1,7
7079,2018-10-11,관악구,0.0,0,2,0,0,2
7080,2018-10-11,광진구,0.0,0,0,0,1,1
7081,2018-10-11,구로구,0.0,0,4,1,2,7
7082,2018-10-11,금천구,0.0,0,0,0,0,0
7083,2018-10-11,노원구,0.0,0,3,0,0,3
7084,2018-10-11,도봉구,0.0,1,8,0,1,10
7085,2018-10-11,동대문구,0.0,0,5,1,2,8
7086,2018-10-11,동작구,0.0,0,5,0,2,7
7087,2018-10-11,마포구,0.0,0,3,0,2,5
7088,2018-10-11,서대문구,0.0,0,0,0,3,3
7089,2018-10-11,서초구,0.0,0,8,1,3,12
7090,2018-10-11,성동구,0.0,0,1,1,1,3
7091,2018-10-11,성북구,0.0,1,6,2,2,11
7092,2018-10-11,송파구,0.0,0,12,3,5,20
7093,2018-10-11,양천구,0.0,0,3,0,0,3
7094,2018-10-11,영등포구,0.0,0,4,0,1,5
7095,2018-10-11,용산구,0.0,0,5,0,2,7
7096,2018-10-11,은평구,0.0,0,7,0,0,7
7097,2018-10-11,종로구,0.0,0,1,0,0,1
7098,2018-10-11,중구,0.0,0,3,1,2,6
7099,2018-10-11,중랑구,0.0,0,4,1,1,6
7100,2018-10-12,강남구,0.0,0,6,0,0,6
7101,2018-10-12,강동구,0.0,0,2,0,1,3
7102,2018-10-12,강북구,0.0,0,0,0,0,0
7103,2018-10-12,강서구,0.0,0,5,0,0,5
7104,2018-10-12,관악구,0.0,0,2,0,0,2
7105,2018-10-12,광진구,0.0,0,3,0,2,5
7106,2018-10-12,구로구,0.0,0,4,1,1,6
7107,2018-10-12,금천구,0.0,0,2,0,3,5
7108,2018-10-12,노원구,0.0,0,4,0,4,8
7109,2018-10-12,도봉구,0.0,0,1,0,2,3
7110,2018-10-12,동대문구,0.0,0,3,0,2,5
7111,2018-10-12,동작구,0.0,0,4,0,0,4
7112,2018-10-12,마포구,0.0,0,7,0,1,8
7113,2018-10-12,서대문구,0.0,0,2,0,0,2
7114,2018-10-12,서초구,0.0,0,11,0,6,17
7115,2018-10-12,성동구,0.0,0,1,0,2,3
7116,2018-10-12,성북구,0.0,0,2,0,0,2
7117,2018-10-12,송파구,0.0,0,4,2,1,7
7118,2018-10-12,양천구,0.0,0,15,0,0,15
7119,2018-10-12,영등포구,0.0,0,8,2,0,10
7120,2018-10-12,용산구,0.0,0,6,0,2,8
7121,2018-10-12,은평구,0.0,0,3,1,1,5
7122,2018-10-12,종로구,0.0,0,4,3,1,8
7123,2018-10-12,중구,0.0,0,5,0,2,7
7124,2018-10-12,중랑구,0.0,0,11,1,0,12
7125,2018-10-13,강남구,0.0,0,22,1,2,25
7126,2018-10-13,강동구,0.0,0,7,4,1,12
7127,2018-10-13,강북구,0.0,0,1,0,1,2
7128,2018-10-13,강서구,0.0,0,1,0,0,1
7129,2018-10-13,관악구,0.0,0,9,1,1,11
7130,2018-10-13,광진구,0.0,0,4,1,0,5
7131,2018-10-13,구로구,0.0,0,2,0,4,6
7132,2018-10-13,금천구,0.0,0,1,0,0,1
7133,2018-10-13,노원구,0.0,0,1,0,1,2
7134,2018-10-13,도봉구,0.0,0,1,0,0,1
7135,2018-10-13,동대문구,0.0,0,2,1,0,3
7136,2018-10-13,동작구,0.0,0,2,2,1,5
7137,2018-10-13,마포구,0.0,0,9,0,1,10
7138,2018-10-13,서대문구,0.0,0,2,1,0,3
7139,2018-10-13,서초구,0.0,0,9,1,0,10
7140,2018-10-13,성동구,0.0,0,5,0,0,5
7141,2018-10-13,성북구,0.0,0,3,0,0,3
7142,2018-10-13,송파구,0.0,1,4,0,0,5
7143,2018-10-13,양천구,0.0,0,5,1,0,6
7144,2018-10-13,영등포구,0.0,0,9,0,3,12
7145,2018-10-13,용산구,0.0,0,1,0,3,4
7146,2018-10-13,은평구,0.0,0,6,0,1,7
7147,2018-10-13,종로구,0.0,0,10,4,3,17
7148,2018-10-13,중구,0.0,0,2,0,1,3
7149,2018-10-13,중랑구,0.0,0,2,0,0,2
7150,2018-10-14,강남구,0.0,0,8,0,2,10
7151,2018-10-14,강동구,0.0,0,9,0,1,10
7152,2018-10-14,강북구,0.0,0,13,0,2,15
7153,2018-10-14,강서구,0.0,0,2,0,1,3
7154,2018-10-14,관악구,0.0,0,5,0,2,7
7155,2018-10-14,광진구,0.0,0,3,0,2,5
7156,2018-10-14,구로구,0.0,0,2,1,3,6
7157,2018-10-14,금천구,0.0,0,0,0,0,0
7158,2018-10-14,노원구,0.0,0,2,0,1,3
7159,2018-10-14,도봉구,0.0,0,1,1,2,4
7160,2018-10-14,동대문구,0.0,0,5,0,0,5
7161,2018-10-14,동작구,0.0,0,0,0,0,0
7162,2018-10-14,마포구,0.0,0,6,0,2,8
7163,2018-10-14,서대문구,0.0,0,6,0,0,6
7164,2018-10-14,서초구,0.0,0,4,3,1,8
7165,2018-10-14,성동구,0.0,0,4,0,0,4
7166,2018-10-14,성북구,0.0,0,5,0,2,7
7167,2018-10-14,송파구,0.0,0,7,5,1,13
7168,2018-10-14,양천구,0.0,0,4,1,2,7
7169,2018-10-14,영등포구,0.0,0,4,1,2,7
7170,2018-10-14,용산구,0.0,0,2,1,2,5
7171,2018-10-14,은평구,0.0,0,1,0,2,3
7172,2018-10-14,종로구,0.0,0,1,1,3,5
7173,2018-10-14,중구,0.0,0,0,0,0,0
7174,2018-10-14,중랑구,0.0,0,3,1,1,5
7175,2018-10-15,강남구,0.0,0,8,0,0,8
7176,2018-10-15,강동구,0.0,0,3,0,1,4
7177,2018-10-15,강북구,0.0,0,0,0,1,1
7178,2018-10-15,강서구,0.0,0,4,0,0,4
7179,2018-10-15,관악구,0.0,0,1,0,1,2
7180,2018-10-15,광진구,0.0,0,2,0,1,3
7181,2018-10-15,구로구,0.0,0,4,0,0,4
7182,2018-10-15,금천구,0.0,0,4,0,2,6
7183,2018-10-15,노원구,0.0,1,2,1,1,5
7184,2018-10-15,도봉구,0.0,0,1,1,0,2
7185,2018-10-15,동대문구,0.0,0,11,1,2,14
7186,2018-10-15,동작구,0.0,0,0,1,0,1
7187,2018-10-15,마포구,0.0,0,4,0,1,5
7188,2018-10-15,서대문구,0.0,0,0,0,0,0
7189,2018-10-15,서초구,0.0,0,5,1,0,6
7190,2018-10-15,성동구,0.0,0,2,0,0,2
7191,2018-10-15,성북구,0.0,0,8,0,5,13
7192,2018-10-15,송파구,0.0,0,7,1,1,9
7193,2018-10-15,양천구,0.0,0,1,1,0,2
7194,2018-10-15,영등포구,0.0,0,5,0,0,5
7195,2018-10-15,용산구,0.0,0,6,0,1,7
7196,2018-10-15,은평구,0.0,0,2,0,1,3
7197,2018-10-15,종로구,0.0,0,6,0,2,8
7198,2018-10-15,중구,0.0,0,0,0,1,1
7199,2018-10-15,중랑구,0.0,0,6,0,1,7
7200,2018-10-16,강남구,0.0,0,8,1,6,15
7201,2018-10-16,강동구,0.0,0,1,1,1,3
7202,2018-10-16,강북구,0.0,0,3,0,1,4
7203,2018-10-16,강서구,0.0,0,1,0,1,2
7204,2018-10-16,관악구,0.0,0,2,0,1,3
7205,2018-10-16,광진구,0.0,0,2,0,1,3
7206,2018-10-16,구로구,0.0,0,4,2,1,7
7207,2018-10-16,금천구,0.0,0,1,0,0,1
7208,2018-10-16,노원구,0.0,0,4,0,1,5
7209,2018-10-16,도봉구,0.0,0,6,1,1,8
7210,2018-10-16,동대문구,0.0,0,1,0,3,4
7211,2018-10-16,동작구,0.0,0,0,2,2,4
7212,2018-10-16,마포구,0.0,0,2,0,0,2
7213,2018-10-16,서대문구,0.0,0,3,0,1,4
7214,2018-10-16,서초구,0.0,0,3,0,2,5
7215,2018-10-16,성동구,0.0,0,5,2,1,8
7216,2018-10-16,성북구,0.0,0,0,0,0,0
7217,2018-10-16,송파구,0.0,0,3,1,1,5
7218,2018-10-16,양천구,0.0,0,3,0,3,6
7219,2018-10-16,영등포구,0.0,0,5,0,4,9
7220,2018-10-16,용산구,0.0,0,0,0,0,0
7221,2018-10-16,은평구,0.0,0,3,2,1,6
7222,2018-10-16,종로구,0.0,0,1,0,3,4
7223,2018-10-16,중구,0.0,0,4,0,2,6
7224,2018-10-16,중랑구,0.0,0,2,0,4,6
7225,2018-10-17,강남구,0.0,0,9,1,2,12
7226,2018-10-17,강동구,0.0,0,2,2,5,9
7227,2018-10-17,강북구,0.0,0,1,0,0,1
7228,2018-10-17,강서구,0.0,0,3,0,1,4
7229,2018-10-17,관악구,0.0,0,1,0,0,1
7230,2018-10-17,광진구,0.0,0,4,1,0,5
7231,2018-10-17,구로구,0.0,0,5,1,2,8
7232,2018-10-17,금천구,0.0,0,0,0,1,1
7233,2018-10-17,노원구,0.0,0,9,1,1,11
7234,2018-10-17,도봉구,0.0,0,2,0,4,6
7235,2018-10-17,동대문구,0.0,0,0,0,3,3
7236,2018-10-17,동작구,0.0,0,7,1,0,8
7237,2018-10-17,마포구,0.0,0,1,0,1,2
7238,2018-10-17,서대문구,0.0,0,2,0,1,3
7239,2018-10-17,서초구,0.0,0,9,0,2,11
7240,2018-10-17,성동구,0.0,0,2,0,0,2
7241,2018-10-17,성북구,0.0,1,1,0,2,4
7242,2018-10-17,송파구,0.0,0,11,2,4,17
7243,2018-10-17,양천구,0.0,0,1,0,1,2
7244,2018-10-17,영등포구,0.0,0,6,1,1,8
7245,2018-10-17,용산구,0.0,0,3,0,0,3
7246,2018-10-17,은평구,0.0,0,1,0,1,2
7247,2018-10-17,종로구,0.0,0,3,1,1,5
7248,2018-10-17,중구,0.0,0,2,0,2,4
7249,2018-10-17,중랑구,0.0,0,2,0,0,2
7250,2018-10-18,강남구,0.0,0,12,3,2,17
7251,2018-10-18,강동구,0.0,0,3,1,1,5
7252,2018-10-18,강북구,0.0,0,2,0,2,4
7253,2018-10-18,강서구,0.0,0,5,1,2,8
7254,2018-10-18,관악구,0.0,0,8,2,1,11
7255,2018-10-18,광진구,0.0,0,0,0,1,1
7256,2018-10-18,구로구,0.0,0,10,1,0,11
7257,2018-10-18,금천구,0.0,0,4,0,2,6
7258,2018-10-18,노원구,0.0,0,7,0,1,8
7259,2018-10-18,도봉구,0.0,0,1,2,0,3
7260,2018-10-18,동대문구,0.0,0,6,0,1,7
7261,2018-10-18,동작구,0.0,0,3,2,0,5
7262,2018-10-18,마포구,0.0,0,1,0,2,3
7263,2018-10-18,서대문구,0.0,0,3,0,0,3
7264,2018-10-18,서초구,0.0,0,5,0,3,8
7265,2018-10-18,성동구,0.0,0,3,0,0,3
7266,2018-10-18,성북구,0.0,0,5,1,2,8
7267,2018-10-18,송파구,0.0,0,12,2,4,18
7268,2018-10-18,양천구,0.0,0,1,0,2,3
7269,2018-10-18,영등포구,0.0,0,8,2,1,11
7270,2018-10-18,용산구,0.0,0,2,1,0,3
7271,2018-10-18,은평구,0.0,0,7,0,0,7
7272,2018-10-18,종로구,0.0,0,0,1,2,3
7273,2018-10-18,중구,0.0,0,1,1,0,2
7274,2018-10-18,중랑구,0.0,0,0,1,1,2
7275,2018-10-19,강남구,0.0,0,12,0,2,14
7276,2018-10-19,강동구,0.0,0,5,0,2,7
7277,2018-10-19,강북구,0.0,0,4,0,1,5
7278,2018-10-19,강서구,0.0,0,8,0,1,9
7279,2018-10-19,관악구,0.0,0,1,0,0,1
7280,2018-10-19,광진구,0.0,0,4,0,0,4
7281,2018-10-19,구로구,0.0,0,1,0,1,2
7282,2018-10-19,금천구,0.0,0,6,0,1,7
7283,2018-10-19,노원구,0.0,0,5,0,2,7
7284,2018-10-19,도봉구,0.0,0,0,0,1,1
7285,2018-10-19,동대문구,0.0,0,1,0,2,3
7286,2018-10-19,동작구,0.0,0,2,1,1,4
7287,2018-10-19,마포구,0.0,0,11,2,0,13
7288,2018-10-19,서대문구,0.0,0,6,0,1,7
7289,2018-10-19,서초구,0.0,0,4,1,2,7
7290,2018-10-19,성동구,0.0,0,6,1,1,8
7291,2018-10-19,성북구,0.0,0,4,0,0,4
7292,2018-10-19,송파구,0.0,0,6,0,3,9
7293,2018-10-19,양천구,0.0,0,7,0,1,8
7294,2018-10-19,영등포구,0.0,0,9,2,1,12
7295,2018-10-19,용산구,0.0,0,4,0,2,6
7296,2018-10-19,은평구,0.0,0,4,0,3,7
7297,2018-10-19,종로구,0.0,0,5,1,1,7
7298,2018-10-19,중구,0.0,0,4,0,0,4
7299,2018-10-19,중랑구,0.0,0,6,1,1,8
7300,2018-10-20,강남구,0.0,0,7,0,2,9
7301,2018-10-20,강동구,0.0,0,13,1,0,14
7302,2018-10-20,강북구,0.0,0,1,0,4,5
7303,2018-10-20,강서구,0.0,0,11,1,2,14
7304,2018-10-20,관악구,0.0,0,3,0,1,4
7305,2018-10-20,광진구,0.0,0,8,4,0,12
7306,2018-10-20,구로구,0.0,0,4,0,0,4
7307,2018-10-20,금천구,0.0,0,3,1,3,7
7308,2018-10-20,노원구,0.0,0,4,0,1,5
7309,2018-10-20,도봉구,0.0,0,1,1,0,2
7310,2018-10-20,동대문구,0.0,0,2,1,5,8
7311,2018-10-20,동작구,0.0,0,12,2,3,17
7312,2018-10-20,마포구,0.0,0,8,0,1,9
7313,2018-10-20,서대문구,0.0,0,0,0,0,0
7314,2018-10-20,서초구,0.0,0,12,2,6,20
7315,2018-10-20,성동구,0.0,0,20,1,2,23
7316,2018-10-20,성북구,0.0,0,6,0,1,7
7317,2018-10-20,송파구,0.0,0,11,4,4,19
7318,2018-10-20,양천구,0.0,0,2,2,1,5
7319,2018-10-20,영등포구,0.0,0,10,1,0,11
7320,2018-10-20,용산구,0.0,0,6,0,2,8
7321,2018-10-20,은평구,0.0,0,0,1,0,1
7322,2018-10-20,종로구,0.0,0,7,2,0,9
7323,2018-10-20,중구,0.0,0,2,0,0,2
7324,2018-10-20,중랑구,0.0,0,4,0,0,4
7325,2018-10-21,강남구,0.0,0,4,0,1,5
7326,2018-10-21,강동구,0.0,0,1,0,1,2
7327,2018-10-21,강북구,0.0,0,2,0,0,2
7328,2018-10-21,강서구,0.0,0,4,1,2,7
7329,2018-10-21,관악구,0.0,0,4,1,0,5
7330,2018-10-21,광진구,0.0,0,9,0,1,10
7331,2018-10-21,구로구,0.0,0,7,2,2,11
7332,2018-10-21,금천구,0.0,0,2,1,0,3
7333,2018-10-21,노원구,0.0,0,2,2,2,6
7334,2018-10-21,도봉구,0.0,0,1,1,0,2
7335,2018-10-21,동대문구,0.0,0,3,0,1,4
7336,2018-10-21,동작구,0.0,0,0,1,1,2
7337,2018-10-21,마포구,0.0,0,10,1,1,12
7338,2018-10-21,서대문구,0.0,0,5,0,1,6
7339,2018-10-21,서초구,0.0,0,3,0,1,4
7340,2018-10-21,성동구,0.0,0,1,1,2,4
7341,2018-10-21,성북구,0.0,0,6,0,0,6
7342,2018-10-21,송파구,0.0,0,6,1,2,9
7343,2018-10-21,양천구,0.0,0,1,0,0,1
7344,2018-10-21,영등포구,0.0,0,10,1,0,11
7345,2018-10-21,용산구,0.0,0,4,0,0,4
7346,2018-10-21,은평구,0.0,0,2,0,1,3
7347,2018-10-21,종로구,0.0,0,4,1,1,6
7348,2018-10-21,중구,0.0,0,4,0,1,5
7349,2018-10-21,중랑구,0.0,0,8,2,2,12
7350,2018-10-22,강남구,0.0,0,6,0,2,8
7351,2018-10-22,강동구,0.0,0,2,0,1,3
7352,2018-10-22,강북구,0.0,0,2,0,3,5
7353,2018-10-22,강서구,0.0,0,4,0,1,5
7354,2018-10-22,관악구,0.0,0,3,0,2,5
7355,2018-10-22,광진구,0.0,0,0,0,0,0
7356,2018-10-22,구로구,0.0,0,4,0,2,6
7357,2018-10-22,금천구,0.0,0,2,0,1,3
7358,2018-10-22,노원구,0.0,0,6,0,0,6
7359,2018-10-22,도봉구,0.0,0,0,0,3,3
7360,2018-10-22,동대문구,0.0,0,0,0,1,1
7361,2018-10-22,동작구,0.0,0,4,1,2,7
7362,2018-10-22,마포구,0.0,0,3,0,1,4
7363,2018-10-22,서대문구,0.0,0,4,1,1,6
7364,2018-10-22,서초구,0.0,0,13,0,5,18
7365,2018-10-22,성동구,0.0,0,3,0,0,3
7366,2018-10-22,성북구,0.0,0,1,0,0,1
7367,2018-10-22,송파구,0.0,0,5,1,3,9
7368,2018-10-22,양천구,0.0,0,2,0,1,3
7369,2018-10-22,영등포구,0.0,0,7,1,1,9
7370,2018-10-22,용산구,0.0,0,2,0,0,2
7371,2018-10-22,은평구,0.0,0,0,2,0,2
7372,2018-10-22,종로구,0.0,0,1,0,1,2
7373,2018-10-22,중구,0.0,0,2,0,0,2
7374,2018-10-22,중랑구,0.0,0,6,0,2,8
7375,2018-10-23,강남구,4.0,0,9,1,3,13
7376,2018-10-23,강동구,4.5,0,5,2,1,8
7377,2018-10-23,강북구,3.5,0,2,0,2,4
7378,2018-10-23,강서구,7.5,0,7,0,0,7
7379,2018-10-23,관악구,5.25,0,4,0,1,5
7380,2018-10-23,광진구,5.0,0,4,0,0,4
7381,2018-10-23,구로구,6.5,0,9,0,4,13
7382,2018-10-23,금천구,4.5,0,0,0,0,0
7383,2018-10-23,노원구,4.5,0,3,0,0,3
7384,2018-10-23,도봉구,4.5,0,0,0,0,0
7385,2018-10-23,동대문구,5.5,0,3,0,0,3
7386,2018-10-23,동작구,3.75,0,4,0,0,4
7387,2018-10-23,마포구,0.5,0,1,0,1,2
7388,2018-10-23,서대문구,4.5,0,1,0,0,1
7389,2018-10-23,서초구,5.0,0,2,0,0,2
7390,2018-10-23,성동구,5.5,0,2,0,2,4
7391,2018-10-23,성북구,5.5,0,0,0,2,2
7392,2018-10-23,송파구,6.5,0,5,0,2,7
7393,2018-10-23,양천구,6.0,0,4,2,0,6
7394,2018-10-23,영등포구,5.0,0,11,0,2,13
7395,2018-10-23,용산구,3.5,0,8,0,0,8
7396,2018-10-23,은평구,4.5,0,2,0,0,2
7397,2018-10-23,종로구,5.0,0,3,5,0,8
7398,2018-10-23,중구,3.0,0,8,0,1,9
7399,2018-10-23,중랑구,6.0,0,2,0,1,3
7400,2018-10-24,강남구,0.0,0,15,1,3,19
7401,2018-10-24,강동구,0.0,0,2,0,0,2
7402,2018-10-24,강북구,0.0,0,4,0,0,4
7403,2018-10-24,강서구,0.0,0,2,0,1,3
7404,2018-10-24,관악구,0.0,0,3,0,1,4
7405,2018-10-24,광진구,0.0,0,2,0,0,2
7406,2018-10-24,구로구,0.0,0,5,0,0,5
7407,2018-10-24,금천구,0.0,0,2,0,2,4
7408,2018-10-24,노원구,0.0,0,7,3,0,10
7409,2018-10-24,도봉구,0.0,0,4,1,1,6
7410,2018-10-24,동대문구,0.0,0,5,1,2,8
7411,2018-10-24,동작구,0.0,0,7,2,1,10
7412,2018-10-24,마포구,0.0,0,8,1,2,11
7413,2018-10-24,서대문구,0.0,0,0,0,2,2
7414,2018-10-24,서초구,0.0,0,12,1,2,15
7415,2018-10-24,성동구,0.0,0,7,0,1,8
7416,2018-10-24,성북구,0.0,0,4,0,1,5
7417,2018-10-24,송파구,0.0,0,5,2,2,9
7418,2018-10-24,양천구,0.0,0,5,0,1,6
7419,2018-10-24,영등포구,0.0,0,7,1,2,10
7420,2018-10-24,용산구,0.0,1,4,0,1,6
7421,2018-10-24,은평구,0.0,0,2,1,2,5
7422,2018-10-24,종로구,0.0,0,1,2,0,3
7423,2018-10-24,중구,0.0,0,4,1,2,7
7424,2018-10-24,중랑구,0.0,0,3,0,3,6
7425,2018-10-25,강남구,0.0,0,12,1,4,17
7426,2018-10-25,강동구,0.0,0,6,1,0,7
7427,2018-10-25,강북구,0.0,0,5,1,0,6
7428,2018-10-25,강서구,0.0,0,2,0,2,4
7429,2018-10-25,관악구,0.0,0,6,0,2,8
7430,2018-10-25,광진구,0.0,0,1,0,0,1
7431,2018-10-25,구로구,0.0,0,3,0,2,5
7432,2018-10-25,금천구,0.0,0,1,0,1,2
7433,2018-10-25,노원구,0.0,0,9,0,2,11
7434,2018-10-25,도봉구,0.0,0,0,0,0,0
7435,2018-10-25,동대문구,0.0,0,5,1,2,8
7436,2018-10-25,동작구,0.0,0,4,0,0,4
7437,2018-10-25,마포구,0.0,0,3,0,0,3
7438,2018-10-25,서대문구,0.0,0,5,1,0,6
7439,2018-10-25,서초구,0.0,0,6,0,1,7
7440,2018-10-25,성동구,0.0,0,3,1,1,5
7441,2018-10-25,성북구,0.0,0,3,1,1,5
7442,2018-10-25,송파구,0.0,0,3,0,2,5
7443,2018-10-25,양천구,0.0,0,7,0,1,8
7444,2018-10-25,영등포구,0.0,0,5,3,6,14
7445,2018-10-25,용산구,0.0,0,4,0,0,4
7446,2018-10-25,은평구,0.0,0,0,0,1,1
7447,2018-10-25,종로구,0.0,0,5,0,1,6
7448,2018-10-25,중구,0.0,0,4,0,2,6
7449,2018-10-25,중랑구,0.0,0,11,0,1,12
7450,2018-10-26,강남구,8.5,0,13,4,4,21
7451,2018-10-26,강동구,13.5,0,3,1,0,4
7452,2018-10-26,강북구,14.0,0,5,0,1,6
7453,2018-10-26,강서구,11.5,0,3,0,2,5
7454,2018-10-26,관악구,12.5,0,4,0,1,5
7455,2018-10-26,광진구,11.5,0,0,0,2,2
7456,2018-10-26,구로구,13.5,0,0,0,1,1
7457,2018-10-26,금천구,12.0,0,2,0,2,4
7458,2018-10-26,노원구,13.0,0,2,0,1,3
7459,2018-10-26,도봉구,17.0,0,1,1,2,4
7460,2018-10-26,동대문구,12.5,0,1,0,0,1
7461,2018-10-26,동작구,11.25,0,1,0,3,4
7462,2018-10-26,마포구,12.0,1,3,0,1,5
7463,2018-10-26,서대문구,10.5,0,1,0,1,2
7464,2018-10-26,서초구,9.5,0,15,3,1,19
7465,2018-10-26,성동구,12.0,0,3,0,1,4
7466,2018-10-26,성북구,15.5,0,1,0,0,1
7467,2018-10-26,송파구,9.0,0,13,0,2,15
7468,2018-10-26,양천구,12.0,0,5,0,3,8
7469,2018-10-26,영등포구,12.5,0,10,3,2,15
7470,2018-10-26,용산구,12.0,0,4,1,1,6
7471,2018-10-26,은평구,16.5,0,4,0,4,8
7472,2018-10-26,종로구,11.0,0,3,0,1,4
7473,2018-10-26,중구,12.0,0,6,1,3,10
7474,2018-10-26,중랑구,14.0,0,1,0,0,1
7475,2018-10-27,강남구,0.0,0,8,0,2,10
7476,2018-10-27,강동구,0.0,0,8,0,2,10
7477,2018-10-27,강북구,0.0,0,1,1,1,3
7478,2018-10-27,강서구,0.0,0,7,0,1,8
7479,2018-10-27,관악구,0.0,0,4,0,0,4
7480,2018-10-27,광진구,0.0,0,5,0,4,9
7481,2018-10-27,구로구,0.0,0,5,1,0,6
7482,2018-10-27,금천구,0.0,0,3,2,0,5
7483,2018-10-27,노원구,0.0,0,7,0,1,8
7484,2018-10-27,도봉구,0.0,0,2,0,3,5
7485,2018-10-27,동대문구,0.0,0,5,1,1,7
7486,2018-10-27,동작구,0.0,0,2,0,2,4
7487,2018-10-27,마포구,0.0,0,11,0,0,11
7488,2018-10-27,서대문구,0.0,0,7,0,1,8
7489,2018-10-27,서초구,0.0,0,10,1,2,13
7490,2018-10-27,성동구,0.0,0,8,0,1,9
7491,2018-10-27,성북구,0.0,0,11,1,0,12
7492,2018-10-27,송파구,0.0,0,6,4,2,12
7493,2018-10-27,양천구,0.0,0,5,0,0,5
7494,2018-10-27,영등포구,0.0,0,5,1,3,9
7495,2018-10-27,용산구,0.0,0,0,0,0,0
7496,2018-10-27,은평구,0.0,0,1,0,0,1
7497,2018-10-27,종로구,0.0,0,7,1,3,11
7498,2018-10-27,중구,0.0,0,4,0,3,7
7499,2018-10-27,중랑구,0.0,0,15,0,4,19
7500,2018-10-28,강남구,5.5,0,13,0,0,13
7501,2018-10-28,강동구,5.0,0,3,0,1,4
7502,2018-10-28,강북구,7.0,0,2,0,1,3
7503,2018-10-28,강서구,8.5,0,0,0,1,1
7504,2018-10-28,관악구,4.25,0,4,0,1,5
7505,2018-10-28,광진구,4.5,0,2,0,0,2
7506,2018-10-28,구로구,5.5,0,3,0,2,5
7507,2018-10-28,금천구,5.0,0,0,0,0,0
7508,2018-10-28,노원구,8.5,0,1,0,0,1
7509,2018-10-28,도봉구,10.0,0,0,0,1,1
7510,2018-10-28,동대문구,6.0,1,1,2,3,7
7511,2018-10-28,동작구,6.75,0,3,2,0,5
7512,2018-10-28,마포구,3.0,0,4,0,0,4
7513,2018-10-28,서대문구,6.5,0,5,0,7,12
7514,2018-10-28,서초구,5.0,0,6,0,4,10
7515,2018-10-28,성동구,6.0,0,2,0,0,2
7516,2018-10-28,성북구,7.0,0,3,0,1,4
7517,2018-10-28,송파구,4.5,0,5,6,0,11
7518,2018-10-28,양천구,7.0,0,9,0,3,12
7519,2018-10-28,영등포구,4.75,0,2,0,0,2
7520,2018-10-28,용산구,6.0,0,7,0,0,7
7521,2018-10-28,은평구,4.0,0,4,0,4,8
7522,2018-10-28,종로구,5.5,0,7,0,0,7
7523,2018-10-28,중구,3.0,0,3,0,0,3
7524,2018-10-28,중랑구,6.0,0,5,3,0,8
7525,2018-10-29,강남구,0.0,2,10,3,2,17
7526,2018-10-29,강동구,0.0,0,5,1,2,8
7527,2018-10-29,강북구,0.0,0,2,0,0,2
7528,2018-10-29,강서구,0.0,0,2,0,0,2
7529,2018-10-29,관악구,0.25,0,6,1,0,7
7530,2018-10-29,광진구,0.0,0,0,0,2,2
7531,2018-10-29,구로구,0.0,0,3,0,0,3
7532,2018-10-29,금천구,0.0,0,7,0,0,7
7533,2018-10-29,노원구,0.0,0,5,0,2,7
7534,2018-10-29,도봉구,0.0,0,1,0,1,2
7535,2018-10-29,동대문구,0.0,0,4,0,3,7
7536,2018-10-29,동작구,0.0,0,4,0,1,5
7537,2018-10-29,마포구,0.0,0,1,0,1,2
7538,2018-10-29,서대문구,0.0,0,4,0,1,5
7539,2018-10-29,서초구,0.0,0,2,0,2,4
7540,2018-10-29,성동구,0.0,0,8,0,5,13
7541,2018-10-29,성북구,0.0,1,0,0,0,1
7542,2018-10-29,송파구,0.0,0,4,2,4,10
7543,2018-10-29,양천구,0.0,0,6,0,0,6
7544,2018-10-29,영등포구,0.0,1,6,0,2,9
7545,2018-10-29,용산구,0.0,0,3,0,4,7
7546,2018-10-29,은평구,0.0,0,1,1,1,3
7547,2018-10-29,종로구,0.0,0,0,0,0,0
7548,2018-10-29,중구,0.0,0,3,0,1,4
7549,2018-10-29,중랑구,0.0,0,8,0,0,8
7550,2018-10-30,강남구,0.0,0,10,1,5,16
7551,2018-10-30,강동구,0.0,0,8,0,2,10
7552,2018-10-30,강북구,0.0,1,6,0,1,8
7553,2018-10-30,강서구,0.0,0,3,0,1,4
7554,2018-10-30,관악구,0.0,0,5,1,1,7
7555,2018-10-30,광진구,0.0,0,1,0,1,2
7556,2018-10-30,구로구,0.0,0,2,1,0,3
7557,2018-10-30,금천구,0.0,0,7,0,2,9
7558,2018-10-30,노원구,0.0,0,2,0,2,4
7559,2018-10-30,도봉구,0.0,0,6,1,0,7
7560,2018-10-30,동대문구,0.0,0,2,0,2,4
7561,2018-10-30,동작구,0.0,0,1,1,2,4
7562,2018-10-30,마포구,0.0,0,6,1,0,7
7563,2018-10-30,서대문구,0.0,0,1,1,1,3
7564,2018-10-30,서초구,0.0,0,11,3,2,16
7565,2018-10-30,성동구,0.0,0,2,1,2,5
7566,2018-10-30,성북구,0.0,0,4,0,2,6
7567,2018-10-30,송파구,0.0,0,14,1,1,16
7568,2018-10-30,양천구,0.0,0,4,0,2,6
7569,2018-10-30,영등포구,0.0,0,7,0,2,9
7570,2018-10-30,용산구,0.0,0,6,0,3,9
7571,2018-10-30,은평구,0.0,0,7,0,0,7
7572,2018-10-30,종로구,0.0,0,4,0,1,5
7573,2018-10-30,중구,0.0,0,2,0,0,2
7574,2018-10-30,중랑구,0.0,0,10,1,0,11
7575,2018-10-31,강남구,0.0,0,3,2,0,5
7576,2018-10-31,강동구,0.0,0,5,2,1,8
7577,2018-10-31,강북구,0.0,0,3,1,1,5
7578,2018-10-31,강서구,0.5,0,1,0,2,3
7579,2018-10-31,관악구,0.0,0,5,1,1,7
7580,2018-10-31,광진구,0.0,0,3,2,1,6
7581,2018-10-31,구로구,0.0,0,8,0,7,15
7582,2018-10-31,금천구,0.0,0,0,0,0,0
7583,2018-10-31,노원구,0.0,0,2,0,1,3
7584,2018-10-31,도봉구,0.0,0,2,0,2,4
7585,2018-10-31,동대문구,0.0,0,0,1,0,1
7586,2018-10-31,동작구,0.0,0,9,0,2,11
7587,2018-10-31,마포구,0.0,0,1,2,2,5
7588,2018-10-31,서대문구,0.0,0,2,0,1,3
7589,2018-10-31,서초구,0.0,0,8,0,0,8
7590,2018-10-31,성동구,0.0,0,4,0,0,4
7591,2018-10-31,성북구,0.0,0,4,0,0,4
7592,2018-10-31,송파구,0.0,0,19,2,8,29
7593,2018-10-31,양천구,0.0,0,4,0,3,7
7594,2018-10-31,영등포구,0.0,0,9,0,1,10
7595,2018-10-31,용산구,0.0,0,0,0,1,1
7596,2018-10-31,은평구,0.0,0,5,0,2,7
7597,2018-10-31,종로구,0.0,0,7,0,4,11
7598,2018-10-31,중구,0.0,0,0,1,0,1
7599,2018-10-31,중랑구,0.0,0,8,0,0,8
7600,2018-11-01,강남구,0.0,0,9,1,4,14
7601,2018-11-01,강동구,0.0,0,2,0,0,2
7602,2018-11-01,강북구,0.0,1,3,1,0,5
7603,2018-11-01,강서구,0.0,0,9,0,4,13
7604,2018-11-01,관악구,0.0,0,3,0,0,3
7605,2018-11-01,광진구,0.0,0,5,0,2,7
7606,2018-11-01,구로구,0.0,0,5,0,1,6
7607,2018-11-01,금천구,0.0,1,5,3,2,11
7608,2018-11-01,노원구,0.0,0,6,1,0,7
7609,2018-11-01,도봉구,0.0,0,0,0,1,1
7610,2018-11-01,동대문구,0.0,0,4,0,5,9
7611,2018-11-01,동작구,0.0,0,0,0,1,1
7612,2018-11-01,마포구,0.0,0,5,0,3,8
7613,2018-11-01,서대문구,0.0,0,2,0,0,2
7614,2018-11-01,서초구,0.0,0,12,1,2,15
7615,2018-11-01,성동구,0.0,0,3,1,3,7
7616,2018-11-01,성북구,0.0,0,1,0,1,2
7617,2018-11-01,송파구,0.0,0,5,0,1,6
7618,2018-11-01,양천구,0.0,0,2,0,1,3
7619,2018-11-01,영등포구,0.0,1,6,0,1,8
7620,2018-11-01,용산구,0.0,0,4,0,0,4
7621,2018-11-01,은평구,0.0,0,4,0,3,7
7622,2018-11-01,종로구,0.0,0,0,2,0,2
7623,2018-11-01,중구,0.0,0,0,0,0,0
7624,2018-11-01,중랑구,0.0,0,1,1,3,5
7625,2018-11-02,강남구,0.0,0,12,0,1,13
7626,2018-11-02,강동구,0.0,0,9,0,3,12
7627,2018-11-02,강북구,0.0,0,2,0,2,4
7628,2018-11-02,강서구,0.0,0,8,0,1,9
7629,2018-11-02,관악구,0.0,0,3,0,0,3
7630,2018-11-02,광진구,0.0,0,7,1,1,9
7631,2018-11-02,구로구,0.0,0,1,0,1,2
7632,2018-11-02,금천구,0.0,0,0,1,1,2
7633,2018-11-02,노원구,0.0,0,2,0,2,4
7634,2018-11-02,도봉구,0.0,0,1,0,0,1
7635,2018-11-02,동대문구,0.0,0,4,1,1,6
7636,2018-11-02,동작구,0.0,0,1,0,1,2
7637,2018-11-02,마포구,0.0,0,3,0,1,4
7638,2018-11-02,서대문구,0.0,0,1,0,1,2
7639,2018-11-02,서초구,0.0,0,14,2,1,17
7640,2018-11-02,성동구,0.0,0,1,0,1,2
7641,2018-11-02,성북구,0.0,0,0,2,0,2
7642,2018-11-02,송파구,0.0,0,10,0,3,13
7643,2018-11-02,양천구,0.0,0,2,0,3,5
7644,2018-11-02,영등포구,0.0,0,9,4,0,13
7645,2018-11-02,용산구,0.0,0,1,0,1,2
7646,2018-11-02,은평구,0.0,0,1,0,2,3
7647,2018-11-02,종로구,0.0,0,4,0,2,6
7648,2018-11-02,중구,0.0,0,7,0,0,7
7649,2018-11-02,중랑구,0.0,0,7,1,6,14
7650,2018-11-03,강남구,0.0,0,14,0,8,22
7651,2018-11-03,강동구,0.0,0,1,1,1,3
7652,2018-11-03,강북구,0.0,0,4,1,1,6
7653,2018-11-03,강서구,0.0,0,7,1,1,9
7654,2018-11-03,관악구,0.0,0,6,1,0,7
7655,2018-11-03,광진구,0.0,0,2,0,0,2
7656,2018-11-03,구로구,0.0,0,9,1,1,11
7657,2018-11-03,금천구,0.0,0,3,0,2,5
7658,2018-11-03,노원구,0.0,0,5,2,0,7
7659,2018-11-03,도봉구,0.0,0,13,0,1,14
7660,2018-11-03,동대문구,0.0,0,3,1,1,5
7661,2018-11-03,동작구,0.0,0,2,0,2,4
7662,2018-11-03,마포구,0.0,0,4,0,2,6
7663,2018-11-03,서대문구,0.0,0,0,1,2,3
7664,2018-11-03,서초구,0.0,0,7,0,2,9
7665,2018-11-03,성동구,0.0,0,6,1,1,8
7666,2018-11-03,성북구,0.0,0,3,0,1,4
7667,2018-11-03,송파구,0.0,0,3,0,0,3
7668,2018-11-03,양천구,0.0,0,1,0,2,3
7669,2018-11-03,영등포구,0.0,0,2,0,1,3
7670,2018-11-03,용산구,0.0,0,6,0,2,8
7671,2018-11-03,은평구,0.0,0,1,2,2,5
7672,2018-11-03,종로구,0.0,0,5,0,0,5
7673,2018-11-03,중구,0.0,0,7,0,0,7
7674,2018-11-03,중랑구,0.0,0,8,1,3,12
7675,2018-11-04,강남구,0.0,0,10,0,3,13
7676,2018-11-04,강동구,0.0,0,0,2,0,2
7677,2018-11-04,강북구,0.0,0,2,1,3,6
7678,2018-11-04,강서구,0.0,0,2,0,4,6
7679,2018-11-04,관악구,0.0,0,4,0,1,5
7680,2018-11-04,광진구,0.0,0,3,0,0,3
7681,2018-11-04,구로구,0.0,0,1,0,4,5
7682,2018-11-04,금천구,0.0,0,4,0,0,4
7683,2018-11-04,노원구,0.0,0,3,0,2,5
7684,2018-11-04,도봉구,0.0,0,2,0,0,2
7685,2018-11-04,동대문구,0.0,0,7,0,1,8
7686,2018-11-04,동작구,0.0,0,5,0,2,7
7687,2018-11-04,마포구,0.0,0,8,0,4,12
7688,2018-11-04,서대문구,0.0,0,2,0,3,5
7689,2018-11-04,서초구,0.0,0,8,0,0,8
7690,2018-11-04,성동구,0.0,0,0,0,0,0
7691,2018-11-04,성북구,0.0,0,5,0,0,5
7692,2018-11-04,송파구,0.0,1,7,0,1,9
7693,2018-11-04,양천구,0.0,0,2,0,0,2
7694,2018-11-04,영등포구,0.0,0,6,0,1,7
7695,2018-11-04,용산구,0.0,0,3,1,2,6
7696,2018-11-04,은평구,0.0,0,0,0,1,1
7697,2018-11-04,종로구,0.0,0,0,0,2,2
7698,2018-11-04,중구,0.0,0,3,0,0,3
7699,2018-11-04,중랑구,0.0,0,0,0,1,1
7700,2018-11-05,강남구,0.0,1,11,0,2,14
7701,2018-11-05,강동구,0.0,0,1,0,0,1
7702,2018-11-05,강북구,0.0,0,2,0,2,4
7703,2018-11-05,강서구,0.0,0,8,1,1,10
7704,2018-11-05,관악구,0.0,0,7,0,1,8
7705,2018-11-05,광진구,0.0,0,1,1,0,2
7706,2018-11-05,구로구,0.0,0,2,0,1,3
7707,2018-11-05,금천구,0.0,0,2,0,1,3
7708,2018-11-05,노원구,0.0,0,2,0,1,3
7709,2018-11-05,도봉구,0.0,0,1,0,0,1
7710,2018-11-05,동대문구,0.0,0,5,0,3,8
7711,2018-11-05,동작구,0.0,0,0,0,2,2
7712,2018-11-05,마포구,0.0,1,2,1,1,5
7713,2018-11-05,서대문구,0.0,0,1,0,2,3
7714,2018-11-05,서초구,0.0,0,14,1,0,15
7715,2018-11-05,성동구,0.0,0,0,0,2,2
7716,2018-11-05,성북구,0.0,0,6,1,0,7
7717,2018-11-05,송파구,0.0,0,5,1,2,8
7718,2018-11-05,양천구,0.0,0,7,1,0,8
7719,2018-11-05,영등포구,0.0,0,9,2,0,11
7720,2018-11-05,용산구,0.0,0,0,0,1,1
7721,2018-11-05,은평구,0.0,0,4,1,2,7
7722,2018-11-05,종로구,0.0,0,3,0,0,3
7723,2018-11-05,중구,0.0,0,3,1,1,5
7724,2018-11-05,중랑구,0.0,0,0,1,2,3
7725,2018-11-06,강남구,0.0,0,7,1,4,12
7726,2018-11-06,강동구,0.0,0,2,1,0,3
7727,2018-11-06,강북구,0.0,0,0,0,2,2
7728,2018-11-06,강서구,0.0,0,0,0,0,0
7729,2018-11-06,관악구,0.0,0,7,0,0,7
7730,2018-11-06,광진구,0.0,0,2,1,2,5
7731,2018-11-06,구로구,0.0,0,1,0,1,2
7732,2018-11-06,금천구,0.0,0,1,0,0,1
7733,2018-11-06,노원구,0.0,0,0,0,0,0
7734,2018-11-06,도봉구,0.0,0,0,1,2,3
7735,2018-11-06,동대문구,0.0,0,5,0,2,7
7736,2018-11-06,동작구,0.0,0,6,1,1,8
7737,2018-11-06,마포구,0.0,0,4,0,1,5
7738,2018-11-06,서대문구,0.0,0,0,0,0,0
7739,2018-11-06,서초구,0.0,0,5,0,1,6
7740,2018-11-06,성동구,0.0,0,4,0,2,6
7741,2018-11-06,성북구,0.0,0,6,1,1,8
7742,2018-11-06,송파구,0.0,0,18,1,2,21
7743,2018-11-06,양천구,0.0,0,5,0,0,5
7744,2018-11-06,영등포구,0.0,0,3,1,1,5
7745,2018-11-06,용산구,0.0,0,0,0,2,2
7746,2018-11-06,은평구,0.0,0,2,0,1,3
7747,2018-11-06,종로구,0.0,0,2,1,1,4
7748,2018-11-06,중구,0.0,0,3,0,1,4
7749,2018-11-06,중랑구,0.0,0,2,0,0,2
7750,2018-11-07,강남구,1.5,0,11,1,4,16
7751,2018-11-07,강동구,1.5,0,3,2,2,7
7752,2018-11-07,강북구,1.5,0,3,0,0,3
7753,2018-11-07,강서구,3.0,0,0,0,1,1
7754,2018-11-07,관악구,1.5,0,2,1,1,4
7755,2018-11-07,광진구,1.5,0,1,1,1,3
7756,2018-11-07,구로구,2.0,0,3,0,2,5
7757,2018-11-07,금천구,2.0,0,0,0,1,1
7758,2018-11-07,노원구,2.0,0,4,0,2,6
7759,2018-11-07,도봉구,2.5,0,0,0,0,0
7760,2018-11-07,동대문구,1.5,0,3,1,1,5
7761,2018-11-07,동작구,2.0,0,3,0,5,8
7762,2018-11-07,마포구,2.0,0,5,0,1,6
7763,2018-11-07,서대문구,2.0,0,2,0,3,5
7764,2018-11-07,서초구,1.5,0,4,1,2,7
7765,2018-11-07,성동구,1.5,0,3,1,1,5
7766,2018-11-07,성북구,1.5,0,1,1,3,5
7767,2018-11-07,송파구,1.5,0,10,1,3,14
7768,2018-11-07,양천구,2.5,0,6,1,1,8
7769,2018-11-07,영등포구,1.75,0,20,0,6,26
7770,2018-11-07,용산구,1.5,0,2,0,3,5
7771,2018-11-07,은평구,2.5,0,6,1,2,9
7772,2018-11-07,종로구,2.0,0,2,0,0,2
7773,2018-11-07,중구,1.5,0,1,0,2,3
7774,2018-11-07,중랑구,1.5,0,1,1,1,3
7775,2018-11-08,강남구,64.5,0,13,1,5,19
7776,2018-11-08,강동구,59.0,0,3,1,0,4
7777,2018-11-08,강북구,67.0,0,3,0,1,4
7778,2018-11-08,강서구,51.0,0,13,1,2,16
7779,2018-11-08,관악구,82.75,0,3,0,0,3
7780,2018-11-08,광진구,63.0,0,3,0,1,4
7781,2018-11-08,구로구,58.5,0,9,0,4,13
7782,2018-11-08,금천구,62.5,0,3,0,2,5
7783,2018-11-08,노원구,70.0,0,12,0,4,16
7784,2018-11-08,도봉구,79.0,0,4,0,1,5
7785,2018-11-08,동대문구,70.5,0,6,0,2,8
7786,2018-11-08,동작구,64.0,0,1,0,4,5
7787,2018-11-08,마포구,64.0,0,8,1,2,11
7788,2018-11-08,서대문구,62.5,0,6,0,1,7
7789,2018-11-08,서초구,67.0,0,9,0,1,10
7790,2018-11-08,성동구,64.0,0,5,0,2,7
7791,2018-11-08,성북구,74.5,0,5,1,2,8
7792,2018-11-08,송파구,53.0,0,7,0,2,9
7793,2018-11-08,양천구,58.0,0,6,0,1,7
7794,2018-11-08,영등포구,59.75,0,7,3,2,12
7795,2018-11-08,용산구,63.5,0,4,1,2,7
7796,2018-11-08,은평구,52.5,0,2,0,2,4
7797,2018-11-08,종로구,64.0,0,7,1,0,8
7798,2018-11-08,중구,52.0,0,4,0,0,4
7799,2018-11-08,중랑구,66.0,0,2,1,5,8
7800,2018-11-09,강남구,0.5,0,19,3,1,23
7801,2018-11-09,강동구,0.5,0,3,0,1,4
7802,2018-11-09,강북구,1.5,0,4,0,0,4
7803,2018-11-09,강서구,0.0,0,6,0,1,7
7804,2018-11-09,관악구,0.25,0,1,0,0,1
7805,2018-11-09,광진구,0.0,0,4,1,2,7
7806,2018-11-09,구로구,0.5,0,5,2,0,7
7807,2018-11-09,금천구,0.0,0,3,0,0,3
7808,2018-11-09,노원구,1.0,0,10,1,1,12
7809,2018-11-09,도봉구,1.0,0,1,1,1,3
7810,2018-11-09,동대문구,1.0,0,5,0,1,6
7811,2018-11-09,동작구,0.0,0,8,0,0,8
7812,2018-11-09,마포구,0.5,0,9,0,0,9
7813,2018-11-09,서대문구,1.0,0,2,2,0,4
7814,2018-11-09,서초구,0.0,0,14,2,4,20
7815,2018-11-09,성동구,0.0,0,7,0,3,10
7816,2018-11-09,성북구,1.0,0,4,0,2,6
7817,2018-11-09,송파구,0.5,0,7,1,1,9
7818,2018-11-09,양천구,0.0,0,4,1,0,5
7819,2018-11-09,영등포구,0.5,0,5,0,3,8
7820,2018-11-09,용산구,0.0,0,4,1,0,5
7821,2018-11-09,은평구,0.5,0,0,0,0,0
7822,2018-11-09,종로구,1.0,0,2,2,0,4
7823,2018-11-09,중구,0.5,0,4,1,3,8
7824,2018-11-09,중랑구,0.5,0,3,0,0,3
7825,2018-11-10,강남구,0.0,0,10,1,0,11
7826,2018-11-10,강동구,0.0,0,0,2,2,4
7827,2018-11-10,강북구,0.0,0,4,0,1,5
7828,2018-11-10,강서구,0.5,0,7,1,0,8
7829,2018-11-10,관악구,0.0,0,5,3,1,9
7830,2018-11-10,광진구,0.0,0,3,0,3,6
7831,2018-11-10,구로구,0.0,0,4,0,0,4
7832,2018-11-10,금천구,0.0,0,1,0,0,1
7833,2018-11-10,노원구,0.0,0,8,2,0,10
7834,2018-11-10,도봉구,0.0,0,2,0,0,2
7835,2018-11-10,동대문구,0.0,0,4,0,0,4
7836,2018-11-10,동작구,0.0,0,7,2,2,11
7837,2018-11-10,마포구,0.0,0,6,7,1,14
7838,2018-11-10,서대문구,0.0,0,3,0,0,3
7839,2018-11-10,서초구,0.0,0,14,0,0,14
7840,2018-11-10,성동구,0.5,0,4,0,1,5
7841,2018-11-10,성북구,0.0,0,4,0,1,5
7842,2018-11-10,송파구,0.0,0,4,0,3,7
7843,2018-11-10,양천구,0.0,0,5,1,2,8
7844,2018-11-10,영등포구,0.0,0,14,1,2,17
7845,2018-11-10,용산구,0.0,0,3,0,1,4
7846,2018-11-10,은평구,0.0,0,4,1,0,5
7847,2018-11-10,종로구,0.0,0,1,0,0,1
7848,2018-11-10,중구,0.0,0,4,2,1,7
7849,2018-11-10,중랑구,0.0,0,1,1,3,5
7850,2018-11-11,강남구,0.0,0,7,0,3,10
7851,2018-11-11,강동구,0.0,0,0,0,0,0
7852,2018-11-11,강북구,0.0,0,0,0,0,0
7853,2018-11-11,강서구,0.0,0,2,0,0,2
7854,2018-11-11,관악구,0.0,0,4,1,0,5
7855,2018-11-11,광진구,0.0,0,5,0,3,8
7856,2018-11-11,구로구,0.0,0,5,0,0,5
7857,2018-11-11,금천구,0.0,0,29,2,14,45
7858,2018-11-11,노원구,0.0,0,0,1,0,1
7859,2018-11-11,도봉구,0.0,0,1,0,0,1
7860,2018-11-11,동대문구,0.0,0,4,1,1,6
7861,2018-11-11,동작구,0.0,0,0,0,0,0
7862,2018-11-11,마포구,0.0,0,5,1,1,7
7863,2018-11-11,서대문구,0.0,0,0,1,0,1
7864,2018-11-11,서초구,0.0,0,2,0,2,4
7865,2018-11-11,성동구,0.0,0,7,0,3,10
7866,2018-11-11,성북구,0.0,0,5,0,0,5
7867,2018-11-11,송파구,0.0,2,5,2,4,13
7868,2018-11-11,양천구,0.0,0,2,0,0,2
7869,2018-11-11,영등포구,0.0,0,6,0,1,7
7870,2018-11-11,용산구,0.0,0,3,0,3,6
7871,2018-11-11,은평구,0.0,0,4,0,1,5
7872,2018-11-11,종로구,0.0,0,0,0,1,1
7873,2018-11-11,중구,0.0,0,1,0,0,1
7874,2018-11-11,중랑구,0.0,0,2,0,1,3
7875,2018-11-12,강남구,0.0,0,21,3,1,25
7876,2018-11-12,강동구,0.0,0,1,1,1,3
7877,2018-11-12,강북구,0.0,0,3,0,0,3
7878,2018-11-12,강서구,0.0,0,5,0,2,7
7879,2018-11-12,관악구,0.0,0,2,0,0,2
7880,2018-11-12,광진구,0.0,0,0,0,1,1
7881,2018-11-12,구로구,0.0,0,0,0,1,1
7882,2018-11-12,금천구,0.0,0,4,0,2,6
7883,2018-11-12,노원구,0.0,0,4,0,2,6
7884,2018-11-12,도봉구,0.0,0,1,0,2,3
7885,2018-11-12,동대문구,0.0,0,1,0,4,5
7886,2018-11-12,동작구,0.0,0,1,0,1,2
7887,2018-11-12,마포구,0.0,0,2,0,1,3
7888,2018-11-12,서대문구,0.0,0,6,3,0,9
7889,2018-11-12,서초구,0.0,0,4,0,0,4
7890,2018-11-12,성동구,0.0,0,1,0,0,1
7891,2018-11-12,성북구,0.0,0,3,0,0,3
7892,2018-11-12,송파구,0.0,0,3,0,3,6
7893,2018-11-12,양천구,0.0,0,3,1,1,5
7894,2018-11-12,영등포구,0.0,0,5,1,0,6
7895,2018-11-12,용산구,0.0,0,1,0,1,2
7896,2018-11-12,은평구,0.0,0,0,1,0,1
7897,2018-11-12,종로구,0.0,0,3,0,1,4
7898,2018-11-12,중구,0.0,0,1,0,0,1
7899,2018-11-12,중랑구,0.0,0,7,0,3,10
7900,2018-11-13,강남구,0.0,0,13,1,2,16
7901,2018-11-13,강동구,0.0,0,6,0,1,7
7902,2018-11-13,강북구,0.0,0,3,0,3,6
7903,2018-11-13,강서구,0.0,0,10,0,5,15
7904,2018-11-13,관악구,0.0,0,12,0,0,12
7905,2018-11-13,광진구,0.0,0,4,0,1,5
7906,2018-11-13,구로구,0.0,0,8,2,1,11
7907,2018-11-13,금천구,0.0,0,3,0,1,4
7908,2018-11-13,노원구,0.0,0,7,2,0,9
7909,2018-11-13,도봉구,0.0,0,0,0,0,0
7910,2018-11-13,동대문구,0.0,0,2,0,2,4
7911,2018-11-13,동작구,0.0,0,3,0,1,4
7912,2018-11-13,마포구,0.0,0,2,1,0,3
7913,2018-11-13,서대문구,0.0,0,4,0,0,4
7914,2018-11-13,서초구,0.0,0,17,0,2,19
7915,2018-11-13,성동구,0.0,0,2,0,3,5
7916,2018-11-13,성북구,0.0,0,5,1,1,7
7917,2018-11-13,송파구,0.0,0,10,2,2,14
7918,2018-11-13,양천구,0.0,0,1,1,1,3
7919,2018-11-13,영등포구,0.0,0,11,0,4,15
7920,2018-11-13,용산구,0.0,0,2,0,1,3
7921,2018-11-13,은평구,0.0,0,1,0,1,2
7922,2018-11-13,종로구,0.0,0,4,0,2,6
7923,2018-11-13,중구,0.0,1,0,1,0,2
7924,2018-11-13,중랑구,0.0,0,0,0,1,1
7925,2018-11-14,강남구,0.0,1,8,2,3,14
7926,2018-11-14,강동구,0.0,1,4,1,0,6
7927,2018-11-14,강북구,0.0,0,1,1,1,3
7928,2018-11-14,강서구,0.0,0,7,0,1,8
7929,2018-11-14,관악구,0.0,0,6,0,4,10
7930,2018-11-14,광진구,0.0,1,5,0,2,8
7931,2018-11-14,구로구,0.0,0,4,0,0,4
7932,2018-11-14,금천구,0.0,0,1,0,1,2
7933,2018-11-14,노원구,0.0,1,6,0,0,7
7934,2018-11-14,도봉구,0.0,0,3,1,0,4
7935,2018-11-14,동대문구,0.0,0,2,0,0,2
7936,2018-11-14,동작구,0.0,0,2,0,2,4
7937,2018-11-14,마포구,0.0,0,4,0,1,5
7938,2018-11-14,서대문구,0.0,0,2,2,0,4
7939,2018-11-14,서초구,0.0,0,4,0,2,6
7940,2018-11-14,성동구,0.0,0,3,0,0,3
7941,2018-11-14,성북구,0.0,0,2,0,0,2
7942,2018-11-14,송파구,0.0,0,6,1,0,7
7943,2018-11-14,양천구,0.0,0,5,0,0,5
7944,2018-11-14,영등포구,0.0,0,11,0,3,14
7945,2018-11-14,용산구,0.0,0,1,0,3,4
7946,2018-11-14,은평구,0.0,0,2,0,1,3
7947,2018-11-14,종로구,0.0,0,3,0,0,3
7948,2018-11-14,중구,0.0,0,8,1,2,11
7949,2018-11-14,중랑구,0.0,0,8,0,3,11
7950,2018-11-15,강남구,0.0,0,9,2,2,13
7951,2018-11-15,강동구,0.0,0,3,3,2,8
7952,2018-11-15,강북구,0.0,0,10,0,2,12
7953,2018-11-15,강서구,0.0,0,5,0,2,7
7954,2018-11-15,관악구,0.0,0,3,0,2,5
7955,2018-11-15,광진구,0.0,0,4,0,3,7
7956,2018-11-15,구로구,0.0,1,9,1,3,14
7957,2018-11-15,금천구,0.0,0,0,0,0,0
7958,2018-11-15,노원구,0.0,0,3,0,0,3
7959,2018-11-15,도봉구,0.0,0,1,0,0,1
7960,2018-11-15,동대문구,0.0,0,0,0,2,2
7961,2018-11-15,동작구,0.0,0,4,0,0,4
7962,2018-11-15,마포구,0.0,0,5,0,0,5
7963,2018-11-15,서대문구,0.0,0,5,1,1,7
7964,2018-11-15,서초구,0.0,0,3,0,5,8
7965,2018-11-15,성동구,0.0,0,1,0,1,2
7966,2018-11-15,성북구,0.0,0,2,1,1,4
7967,2018-11-15,송파구,0.0,0,8,2,1,11
7968,2018-11-15,양천구,0.0,0,2,0,0,2
7969,2018-11-15,영등포구,0.0,0,5,0,1,6
7970,2018-11-15,용산구,0.0,0,0,0,0,0
7971,2018-11-15,은평구,0.0,0,2,0,0,2
7972,2018-11-15,종로구,0.0,0,1,0,1,2
7973,2018-11-15,중구,0.0,0,3,1,0,4
7974,2018-11-15,중랑구,0.0,0,3,0,2,5
7975,2018-11-16,강남구,0.0,0,11,0,2,13
7976,2018-11-16,강동구,0.0,0,7,0,0,7
7977,2018-11-16,강북구,0.0,0,1,0,2,3
7978,2018-11-16,강서구,0.0,0,0,1,3,4
7979,2018-11-16,관악구,0.0,0,5,0,1,6
7980,2018-11-16,광진구,0.0,0,2,0,1,3
7981,2018-11-16,구로구,0.0,0,2,0,3,5
7982,2018-11-16,금천구,0.0,0,2,2,1,5
7983,2018-11-16,노원구,0.0,0,8,0,2,10
7984,2018-11-16,도봉구,0.0,0,0,0,0,0
7985,2018-11-16,동대문구,0.0,0,8,0,1,9
7986,2018-11-16,동작구,0.0,0,2,0,0,2
7987,2018-11-16,마포구,0.0,0,9,1,4,14
7988,2018-11-16,서대문구,0.0,0,4,1,1,6
7989,2018-11-16,서초구,0.0,0,7,1,4,12
7990,2018-11-16,성동구,0.0,0,3,0,3,6
7991,2018-11-16,성북구,0.0,0,2,0,1,3
7992,2018-11-16,송파구,0.0,0,7,2,2,11
7993,2018-11-16,양천구,0.0,0,1,0,7,8
7994,2018-11-16,영등포구,0.0,0,10,1,2,13
7995,2018-11-16,용산구,0.0,0,6,0,0,6
7996,2018-11-16,은평구,0.0,0,4,0,4,8
7997,2018-11-16,종로구,0.0,0,6,1,0,7
7998,2018-11-16,중구,0.0,0,5,3,2,10
7999,2018-11-16,중랑구,0.0,0,1,0,3,4
8000,2018-11-17,강남구,0.0,0,14,2,4,20
8001,2018-11-17,강동구,0.0,0,5,1,2,8
8002,2018-11-17,강북구,0.0,0,9,1,0,10
8003,2018-11-17,강서구,0.0,0,4,0,4,8
8004,2018-11-17,관악구,0.0,0,7,0,2,9
8005,2018-11-17,광진구,0.0,0,6,0,1,7
8006,2018-11-17,구로구,0.0,0,3,0,2,5
8007,2018-11-17,금천구,0.0,0,1,1,3,5
8008,2018-11-17,노원구,0.0,0,8,0,3,11
8009,2018-11-17,도봉구,0.0,0,5,0,1,6
8010,2018-11-17,동대문구,0.0,1,18,0,5,24
8011,2018-11-17,동작구,0.0,0,1,3,3,7
8012,2018-11-17,마포구,0.0,0,5,0,0,5
8013,2018-11-17,서대문구,0.0,0,7,0,1,8
8014,2018-11-17,서초구,0.0,0,9,2,4,15
8015,2018-11-17,성동구,0.0,0,3,0,0,3
8016,2018-11-17,성북구,0.0,0,0,0,0,0
8017,2018-11-17,송파구,0.0,0,12,0,1,13
8018,2018-11-17,양천구,0.0,0,3,1,1,5
8019,2018-11-17,영등포구,0.0,1,15,2,2,20
8020,2018-11-17,용산구,0.0,0,12,0,2,14
8021,2018-11-17,은평구,0.0,0,0,1,1,2
8022,2018-11-17,종로구,0.0,0,0,1,2,3
8023,2018-11-17,중구,0.0,0,2,0,0,2
8024,2018-11-17,중랑구,0.0,0,1,1,3,5
8025,2018-11-18,강남구,0.0,0,13,0,2,15
8026,2018-11-18,강동구,0.0,0,2,0,0,2
8027,2018-11-18,강북구,0.0,0,0,0,1,1
8028,2018-11-18,강서구,0.0,0,3,0,2,5
8029,2018-11-18,관악구,0.0,0,3,1,2,6
8030,2018-11-18,광진구,0.0,0,4,0,1,5
8031,2018-11-18,구로구,0.0,0,4,0,2,6
8032,2018-11-18,금천구,0.0,0,2,0,1,3
8033,2018-11-18,노원구,0.0,0,2,0,1,3
8034,2018-11-18,도봉구,0.0,0,4,0,3,7
8035,2018-11-18,동대문구,0.0,0,1,1,2,4
8036,2018-11-18,동작구,0.0,0,0,0,1,1
8037,2018-11-18,마포구,0.0,0,0,0,0,0
8038,2018-11-18,서대문구,0.0,0,0,0,2,2
8039,2018-11-18,서초구,0.0,0,2,0,2,4
8040,2018-11-18,성동구,0.0,0,1,0,1,2
8041,2018-11-18,성북구,0.0,0,2,0,0,2
8042,2018-11-18,송파구,0.0,0,1,2,2,5
8043,2018-11-18,양천구,0.0,0,2,0,0,2
8044,2018-11-18,영등포구,0.0,0,4,1,3,8
8045,2018-11-18,용산구,0.0,0,6,0,0,6
8046,2018-11-18,은평구,0.0,0,4,0,1,5
8047,2018-11-18,종로구,0.0,0,3,0,0,3
8048,2018-11-18,중구,0.0,0,2,0,2,4
8049,2018-11-18,중랑구,0.0,0,3,1,1,5
8050,2018-11-19,강남구,0.0,0,13,1,1,15
8051,2018-11-19,강동구,0.0,1,4,1,0,6
8052,2018-11-19,강북구,0.0,0,5,0,0,5
8053,2018-11-19,강서구,0.0,0,4,0,2,6
8054,2018-11-19,관악구,0.0,0,4,0,0,4
8055,2018-11-19,광진구,0.0,0,1,1,0,2
8056,2018-11-19,구로구,0.0,0,7,1,2,10
8057,2018-11-19,금천구,0.0,0,1,0,2,3
8058,2018-11-19,노원구,0.0,0,2,1,0,3
8059,2018-11-19,도봉구,0.0,0,0,0,2,2
8060,2018-11-19,동대문구,0.0,1,5,0,1,7
8061,2018-11-19,동작구,0.0,0,4,0,0,4
8062,2018-11-19,마포구,0.0,0,3,0,0,3
8063,2018-11-19,서대문구,0.0,0,0,0,0,0
8064,2018-11-19,서초구,0.0,0,11,1,2,14
8065,2018-11-19,성동구,0.0,0,1,0,1,2
8066,2018-11-19,성북구,0.0,0,1,0,2,3
8067,2018-11-19,송파구,0.0,0,5,4,0,9
8068,2018-11-19,양천구,0.0,0,3,0,0,3
8069,2018-11-19,영등포구,0.0,0,6,0,0,6
8070,2018-11-19,용산구,0.0,0,2,0,2,4
8071,2018-11-19,은평구,0.0,0,4,0,0,4
8072,2018-11-19,종로구,0.0,0,2,0,1,3
8073,2018-11-19,중구,0.0,0,3,1,0,4
8074,2018-11-19,중랑구,0.0,0,3,0,0,3
8075,2018-11-20,강남구,0.0,0,18,11,4,33
8076,2018-11-20,강동구,0.0,0,3,0,0,3
8077,2018-11-20,강북구,0.0,0,2,0,1,3
8078,2018-11-20,강서구,0.5,0,4,0,0,4
8079,2018-11-20,관악구,0.0,0,3,0,0,3
8080,2018-11-20,광진구,0.0,0,5,0,1,6
8081,2018-11-20,구로구,0.0,0,7,0,0,7
8082,2018-11-20,금천구,0.0,0,4,1,0,5
8083,2018-11-20,노원구,0.0,0,5,0,0,5
8084,2018-11-20,도봉구,0.5,0,0,0,0,0
8085,2018-11-20,동대문구,0.0,0,2,0,2,4
8086,2018-11-20,동작구,0.0,0,4,0,1,5
8087,2018-11-20,마포구,0.0,0,3,0,2,5
8088,2018-11-20,서대문구,0.0,0,1,1,1,3
8089,2018-11-20,서초구,0.0,0,9,2,0,11
8090,2018-11-20,성동구,0.0,0,4,0,0,4
8091,2018-11-20,성북구,0.5,0,2,1,1,4
8092,2018-11-20,송파구,0.0,0,8,0,5,13
8093,2018-11-20,양천구,0.0,1,1,0,1,3
8094,2018-11-20,영등포구,0.0,0,8,0,2,10
8095,2018-11-20,용산구,0.0,0,0,0,1,1
8096,2018-11-20,은평구,1.0,0,5,0,2,7
8097,2018-11-20,종로구,0.2,0,2,0,0,2
8098,2018-11-20,중구,0.0,0,2,3,0,5
8099,2018-11-20,중랑구,0.0,0,2,1,3,6
8100,2018-11-21,강남구,2.0,0,6,1,0,7
8101,2018-11-21,강동구,1.0,0,1,0,0,1
8102,2018-11-21,강북구,1.5,0,1,0,3,4
8103,2018-11-21,강서구,0.5,0,7,1,1,9
8104,2018-11-21,관악구,2.5,0,4,0,1,5
8105,2018-11-21,광진구,1.0,0,3,0,3,6
8106,2018-11-21,구로구,2.5,0,2,0,0,2
8107,2018-11-21,금천구,2.0,0,1,0,0,1
8108,2018-11-21,노원구,1.5,0,2,0,0,2
8109,2018-11-21,도봉구,0.5,0,4,1,1,6
8110,2018-11-21,동대문구,1.5,0,2,0,1,3
8111,2018-11-21,동작구,1.75,0,1,1,1,3
8112,2018-11-21,마포구,1.5,0,5,1,1,7
8113,2018-11-21,서대문구,1.0,0,0,0,0,0
8114,2018-11-21,서초구,2.0,1,5,1,6,13
8115,2018-11-21,성동구,1.0,0,6,0,0,6
8116,2018-11-21,성북구,1.5,0,4,0,4,8
8117,2018-11-21,송파구,1.0,0,7,4,3,14
8118,2018-11-21,양천구,1.5,1,2,0,2,5
8119,2018-11-21,영등포구,1.5,0,7,1,0,8
8120,2018-11-21,용산구,2.0,0,2,0,1,3
8121,2018-11-21,은평구,0.5,0,4,0,1,5
8122,2018-11-21,종로구,1.0,0,0,0,1,1
8123,2018-11-21,중구,1.0,0,0,0,1,1
8124,2018-11-21,중랑구,1.5,0,9,0,2,11
8125,2018-11-22,강남구,0.0,0,4,0,1,5
8126,2018-11-22,강동구,0.0,0,6,3,1,10
8127,2018-11-22,강북구,0.0,0,5,0,1,6
8128,2018-11-22,강서구,0.0,0,6,0,2,8
8129,2018-11-22,관악구,0.0,0,5,0,0,5
8130,2018-11-22,광진구,0.0,0,2,0,0,2
8131,2018-11-22,구로구,0.0,1,4,0,0,5
8132,2018-11-22,금천구,0.0,0,3,0,1,4
8133,2018-11-22,노원구,0.0,0,2,0,1,3
8134,2018-11-22,도봉구,0.0,0,6,0,0,6
8135,2018-11-22,동대문구,0.0,0,3,0,1,4
8136,2018-11-22,동작구,0.0,0,5,2,2,9
8137,2018-11-22,마포구,0.0,0,3,0,1,4
8138,2018-11-22,서대문구,0.0,0,5,0,0,5
8139,2018-11-22,서초구,0.0,0,8,0,4,12
8140,2018-11-22,성동구,0.0,0,1,0,1,2
8141,2018-11-22,성북구,0.0,0,2,3,3,8
8142,2018-11-22,송파구,0.0,0,11,1,1,13
8143,2018-11-22,양천구,0.0,0,3,2,3,8
8144,2018-11-22,영등포구,0.0,0,7,2,1,10
8145,2018-11-22,용산구,0.0,0,2,0,0,2
8146,2018-11-22,은평구,0.0,0,1,1,0,2
8147,2018-11-22,종로구,0.0,0,1,0,0,1
8148,2018-11-22,중구,0.0,0,2,1,1,4
8149,2018-11-22,중랑구,0.0,0,1,0,0,1
8150,2018-11-23,강남구,0.0,0,22,2,4,28
8151,2018-11-23,강동구,0.0,0,4,1,1,6
8152,2018-11-23,강북구,0.0,0,4,0,1,5
8153,2018-11-23,강서구,0.0,0,1,0,0,1
8154,2018-11-23,관악구,0.0,0,2,0,0,2
8155,2018-11-23,광진구,0.0,0,3,0,1,4
8156,2018-11-23,구로구,0.0,0,7,2,2,11
8157,2018-11-23,금천구,0.0,0,0,0,0,0
8158,2018-11-23,노원구,0.0,0,2,0,1,3
8159,2018-11-23,도봉구,0.0,0,1,0,0,1
8160,2018-11-23,동대문구,0.0,0,5,1,3,9
8161,2018-11-23,동작구,0.0,0,0,0,0,0
8162,2018-11-23,마포구,0.0,0,0,0,4,4
8163,2018-11-23,서대문구,0.0,0,2,2,0,4
8164,2018-11-23,서초구,0.0,0,3,0,2,5
8165,2018-11-23,성동구,0.0,0,3,1,1,5
8166,2018-11-23,성북구,0.0,0,5,0,0,5
8167,2018-11-23,송파구,0.0,0,13,1,3,17
8168,2018-11-23,양천구,0.0,0,4,2,2,8
8169,2018-11-23,영등포구,0.0,0,11,1,0,12
8170,2018-11-23,용산구,0.0,0,4,0,1,5
8171,2018-11-23,은평구,0.0,0,4,0,3,7
8172,2018-11-23,종로구,0.0,0,0,0,0,0
8173,2018-11-23,중구,0.0,0,3,0,1,4
8174,2018-11-23,중랑구,0.0,1,6,2,1,10
8175,2018-11-24,강남구,11.0,0,6,0,5,11
8176,2018-11-24,강동구,7.0,1,3,3,2,9
8177,2018-11-24,강북구,11.0,0,5,0,1,6
8178,2018-11-24,강서구,12.0,0,4,1,0,5
8179,2018-11-24,관악구,9.25,0,3,0,0,3
8180,2018-11-24,광진구,2.5,0,2,0,0,2
8181,2018-11-24,구로구,13.5,0,6,2,2,10
8182,2018-11-24,금천구,8.5,0,3,0,1,4
8183,2018-11-24,노원구,10.0,0,6,0,2,8
8184,2018-11-24,도봉구,12.5,0,2,0,1,3
8185,2018-11-24,동대문구,7.0,0,4,0,1,5
8186,2018-11-24,동작구,10.5,0,7,0,1,8
8187,2018-11-24,마포구,11.0,0,4,0,1,5
8188,2018-11-24,서대문구,11.5,0,8,1,1,10
8189,2018-11-24,서초구,10.0,0,16,0,2,18
8190,2018-11-24,성동구,10.0,0,5,0,0,5
8191,2018-11-24,성북구,12.0,0,1,0,0,1
8192,2018-11-24,송파구,7.5,0,20,1,2,23
8193,2018-11-24,양천구,10.5,0,1,0,2,3
8194,2018-11-24,영등포구,4.75,0,17,2,0,19
8195,2018-11-24,용산구,13.5,0,0,0,3,3
8196,2018-11-24,은평구,13.5,0,1,0,0,1
8197,2018-11-24,종로구,10.9,0,9,0,4,13
8198,2018-11-24,중구,1.5,0,4,0,0,4
8199,2018-11-24,중랑구,13.5,0,1,1,0,2
8200,2018-11-25,강남구,0.0,0,10,1,2,13
8201,2018-11-25,강동구,0.0,0,0,0,0,0
8202,2018-11-25,강북구,0.0,0,0,0,0,0
8203,2018-11-25,강서구,0.0,0,4,1,3,8
8204,2018-11-25,관악구,0.0,0,3,0,1,4
8205,2018-11-25,광진구,0.0,0,4,0,0,4
8206,2018-11-25,구로구,0.0,0,4,0,0,4
8207,2018-11-25,금천구,0.0,0,6,1,0,7
8208,2018-11-25,노원구,0.0,0,4,0,1,5
8209,2018-11-25,도봉구,0.0,0,7,0,0,7
8210,2018-11-25,동대문구,0.0,0,0,0,0,0
8211,2018-11-25,동작구,0.0,0,0,1,0,1
8212,2018-11-25,마포구,0.0,0,8,1,3,12
8213,2018-11-25,서대문구,0.0,0,0,0,1,1
8214,2018-11-25,서초구,0.0,0,2,0,1,3
8215,2018-11-25,성동구,0.0,0,1,1,1,3
8216,2018-11-25,성북구,0.0,0,6,0,0,6
8217,2018-11-25,송파구,0.0,0,5,2,1,8
8218,2018-11-25,양천구,0.0,0,2,0,0,2
8219,2018-11-25,영등포구,0.0,0,3,0,2,5
8220,2018-11-25,용산구,0.0,0,3,0,0,3
8221,2018-11-25,은평구,0.0,0,7,0,2,9
8222,2018-11-25,종로구,0.0,0,1,0,1,2
8223,2018-11-25,중구,0.0,0,5,2,1,8
8224,2018-11-25,중랑구,0.0,0,8,4,5,17
8225,2018-11-26,강남구,0.0,0,3,1,1,5
8226,2018-11-26,강동구,0.0,0,1,1,0,2
8227,2018-11-26,강북구,0.0,0,2,0,0,2
8228,2018-11-26,강서구,0.0,0,4,0,2,6
8229,2018-11-26,관악구,0.0,0,0,0,0,0
8230,2018-11-26,광진구,0.0,0,4,0,1,5
8231,2018-11-26,구로구,0.0,0,3,0,0,3
8232,2018-11-26,금천구,0.0,0,2,0,3,5
8233,2018-11-26,노원구,0.0,0,8,0,1,9
8234,2018-11-26,도봉구,0.0,0,1,1,0,2
8235,2018-11-26,동대문구,0.0,0,4,0,3,7
8236,2018-11-26,동작구,0.0,0,2,2,3,7
8237,2018-11-26,마포구,0.0,0,7,0,3,10
8238,2018-11-26,서대문구,0.0,0,4,1,0,5
8239,2018-11-26,서초구,0.0,0,1,0,0,1
8240,2018-11-26,성동구,0.0,0,0,0,0,0
8241,2018-11-26,성북구,0.0,0,3,0,0,3
8242,2018-11-26,송파구,0.0,0,6,2,1,9
8243,2018-11-26,양천구,0.0,1,1,1,1,4
8244,2018-11-26,영등포구,0.0,0,9,1,3,13
8245,2018-11-26,용산구,0.0,0,5,0,1,6
8246,2018-11-26,은평구,0.0,0,2,1,0,3
8247,2018-11-26,종로구,0.0,0,2,0,1,3
8248,2018-11-26,중구,0.0,0,2,0,1,3
8249,2018-11-26,중랑구,0.0,0,1,0,3,4
8250,2018-11-27,강남구,0.0,0,10,0,0,10
8251,2018-11-27,강동구,0.0,0,2,2,0,4
8252,2018-11-27,강북구,0.0,0,3,0,1,4
8253,2018-11-27,강서구,0.0,0,2,0,1,3
8254,2018-11-27,관악구,0.0,0,0,0,1,1
8255,2018-11-27,광진구,0.0,0,4,0,0,4
8256,2018-11-27,구로구,0.0,0,3,2,1,6
8257,2018-11-27,금천구,0.0,0,6,0,0,6
8258,2018-11-27,노원구,0.0,0,4,0,0,4
8259,2018-11-27,도봉구,0.0,0,1,0,1,2
8260,2018-11-27,동대문구,0.0,0,0,3,3,6
8261,2018-11-27,동작구,0.0,0,3,0,1,4
8262,2018-11-27,마포구,0.0,0,5,0,0,5
8263,2018-11-27,서대문구,0.0,0,1,0,1,2
8264,2018-11-27,서초구,0.0,0,16,1,2,19
8265,2018-11-27,성동구,0.0,0,3,0,1,4
8266,2018-11-27,성북구,0.0,0,3,0,0,3
8267,2018-11-27,송파구,0.0,0,1,0,1,2
8268,2018-11-27,양천구,0.0,0,6,0,2,8
8269,2018-11-27,영등포구,0.0,0,2,1,0,3
8270,2018-11-27,용산구,0.0,0,0,0,0,0
8271,2018-11-27,은평구,0.0,0,2,1,0,3
8272,2018-11-27,종로구,0.0,1,1,0,1,3
8273,2018-11-27,중구,0.0,0,1,2,1,4
8274,2018-11-27,중랑구,0.0,0,6,0,2,8
8275,2018-11-28,강남구,0.0,0,11,0,3,14
8276,2018-11-28,강동구,0.0,0,7,0,1,8
8277,2018-11-28,강북구,0.0,0,2,0,2,4
8278,2018-11-28,강서구,0.0,0,4,0,5,9
8279,2018-11-28,관악구,0.0,0,3,1,1,5
8280,2018-11-28,광진구,0.0,0,4,0,4,8
8281,2018-11-28,구로구,0.0,0,2,0,2,4
8282,2018-11-28,금천구,0.0,1,0,0,0,1
8283,2018-11-28,노원구,0.0,0,2,0,0,2
8284,2018-11-28,도봉구,0.0,0,0,0,0,0
8285,2018-11-28,동대문구,0.0,0,1,0,2,3
8286,2018-11-28,동작구,0.0,0,2,0,2,4
8287,2018-11-28,마포구,0.0,0,5,1,3,9
8288,2018-11-28,서대문구,0.0,0,3,1,1,5
8289,2018-11-28,서초구,0.0,0,7,1,3,11
8290,2018-11-28,성동구,0.0,0,3,0,1,4
8291,2018-11-28,성북구,0.0,0,2,0,1,3
8292,2018-11-28,송파구,0.0,0,6,3,4,13
8293,2018-11-28,양천구,0.0,0,7,0,1,8
8294,2018-11-28,영등포구,0.0,0,7,1,0,8
8295,2018-11-28,용산구,0.0,0,4,0,3,7
8296,2018-11-28,은평구,0.0,0,5,0,1,6
8297,2018-11-28,종로구,0.0,0,5,0,0,5
8298,2018-11-28,중구,0.0,0,0,0,0,0
8299,2018-11-28,중랑구,0.0,0,5,0,0,5
8300,2018-11-29,강남구,0.0,0,9,1,1,11
8301,2018-11-29,강동구,0.0,0,2,2,1,5
8302,2018-11-29,강북구,0.0,0,1,0,0,1
8303,2018-11-29,강서구,0.0,0,6,0,2,8
8304,2018-11-29,관악구,0.0,0,5,0,1,6
8305,2018-11-29,광진구,0.0,0,1,0,2,3
8306,2018-11-29,구로구,0.0,0,0,1,0,1
8307,2018-11-29,금천구,0.0,0,3,0,0,3
8308,2018-11-29,노원구,0.0,0,5,0,0,5
8309,2018-11-29,도봉구,0.0,0,1,0,1,2
8310,2018-11-29,동대문구,0.0,0,5,0,2,7
8311,2018-11-29,동작구,0.0,0,4,0,2,6
8312,2018-11-29,마포구,0.0,0,5,0,0,5
8313,2018-11-29,서대문구,0.0,0,8,1,0,9
8314,2018-11-29,서초구,0.0,1,19,7,7,34
8315,2018-11-29,성동구,0.0,1,4,0,0,5
8316,2018-11-29,성북구,0.0,0,4,0,0,4
8317,2018-11-29,송파구,0.0,0,8,1,2,11
8318,2018-11-29,양천구,0.0,0,2,0,0,2
8319,2018-11-29,영등포구,0.0,0,4,1,3,8
8320,2018-11-29,용산구,0.0,0,3,0,0,3
8321,2018-11-29,은평구,0.0,0,1,0,2,3
8322,2018-11-29,종로구,0.0,0,0,0,0,0
8323,2018-11-29,중구,0.0,0,6,0,0,6
8324,2018-11-29,중랑구,0.0,1,5,1,2,9
8325,2018-11-30,강남구,0.0,0,11,1,2,14
8326,2018-11-30,강동구,0.0,0,0,0,1,1
8327,2018-11-30,강북구,0.0,0,2,1,0,3
8328,2018-11-30,강서구,0.0,0,5,0,1,6
8329,2018-11-30,관악구,0.0,0,1,0,0,1
8330,2018-11-30,광진구,0.0,0,10,0,1,11
8331,2018-11-30,구로구,0.0,0,8,0,1,9
8332,2018-11-30,금천구,0.0,0,2,0,1,3
8333,2018-11-30,노원구,0.0,0,3,0,1,4
8334,2018-11-30,도봉구,0.0,0,3,0,1,4
8335,2018-11-30,동대문구,0.0,0,5,1,0,6
8336,2018-11-30,동작구,0.0,0,7,2,4,13
8337,2018-11-30,마포구,0.0,0,8,1,4,13
8338,2018-11-30,서대문구,0.0,0,2,0,2,4
8339,2018-11-30,서초구,0.0,0,1,1,3,5
8340,2018-11-30,성동구,0.0,0,9,0,2,11
8341,2018-11-30,성북구,0.0,0,1,0,1,2
8342,2018-11-30,송파구,0.0,0,23,1,1,25
8343,2018-11-30,양천구,0.0,0,4,0,0,4
8344,2018-11-30,영등포구,0.0,0,11,3,0,14
8345,2018-11-30,용산구,0.0,0,5,2,3,10
8346,2018-11-30,은평구,0.0,0,1,0,3,4
8347,2018-11-30,종로구,0.0,0,0,1,1,2
8348,2018-11-30,중구,0.0,0,4,1,1,6
8349,2018-11-30,중랑구,0.0,0,4,2,2,8
8350,2018-12-01,강남구,0.0,0,10,2,1,13
8351,2018-12-01,강동구,0.0,0,3,0,2,5
8352,2018-12-01,강북구,0.0,0,3,0,0,3
8353,2018-12-01,강서구,0.0,0,6,0,1,7
8354,2018-12-01,관악구,0.0,1,5,2,3,11
8355,2018-12-01,광진구,0.0,1,0,0,2,3
8356,2018-12-01,구로구,0.0,0,3,0,0,3
8357,2018-12-01,금천구,0.0,0,2,0,0,2
8358,2018-12-01,노원구,0.0,0,10,0,1,11
8359,2018-12-01,도봉구,0.0,0,0,0,0,0
8360,2018-12-01,동대문구,0.0,0,4,1,1,6
8361,2018-12-01,동작구,0.0,0,10,0,3,13
8362,2018-12-01,마포구,0.0,0,4,0,4,8
8363,2018-12-01,서대문구,0.0,0,3,0,1,4
8364,2018-12-01,서초구,0.0,0,13,0,1,14
8365,2018-12-01,성동구,0.0,0,2,0,0,2
8366,2018-12-01,성북구,0.0,0,5,1,0,6
8367,2018-12-01,송파구,0.0,0,7,0,3,10
8368,2018-12-01,양천구,0.0,0,7,0,2,9
8369,2018-12-01,영등포구,0.0,0,8,0,1,9
8370,2018-12-01,용산구,0.0,0,11,0,2,13
8371,2018-12-01,은평구,0.0,0,13,0,5,18
8372,2018-12-01,종로구,0.0,0,2,1,2,5
8373,2018-12-01,중구,0.0,0,2,0,0,2
8374,2018-12-01,중랑구,0.0,0,4,0,1,5
8375,2018-12-02,강남구,0.0,0,3,1,1,5
8376,2018-12-02,강동구,0.0,0,4,2,0,6
8377,2018-12-02,강북구,0.0,0,1,0,0,1
8378,2018-12-02,강서구,0.0,0,1,1,1,3
8379,2018-12-02,관악구,0.0,0,1,0,1,2
8380,2018-12-02,광진구,0.0,0,1,0,0,1
8381,2018-12-02,구로구,0.0,0,1,0,0,1
8382,2018-12-02,금천구,0.0,0,3,1,0,4
8383,2018-12-02,노원구,0.0,0,3,0,1,4
8384,2018-12-02,도봉구,0.0,0,1,0,0,1
8385,2018-12-02,동대문구,0.0,0,6,0,1,7
8386,2018-12-02,동작구,0.0,0,3,2,3,8
8387,2018-12-02,마포구,0.0,0,2,0,0,2
8388,2018-12-02,서대문구,0.0,0,1,0,1,2
8389,2018-12-02,서초구,0.0,0,5,0,2,7
8390,2018-12-02,성동구,0.0,0,4,1,0,5
8391,2018-12-02,성북구,0.0,0,7,2,1,10
8392,2018-12-02,송파구,0.0,0,3,0,0,3
8393,2018-12-02,양천구,0.0,0,2,0,2,4
8394,2018-12-02,영등포구,0.0,0,4,0,0,4
8395,2018-12-02,용산구,0.0,0,3,0,0,3
8396,2018-12-02,은평구,0.0,0,3,0,1,4
8397,2018-12-02,종로구,0.0,0,1,0,1,2
8398,2018-12-02,중구,0.0,0,2,1,0,3
8399,2018-12-02,중랑구,0.0,0,0,0,2,2
8400,2018-12-03,강남구,8.5,0,5,4,0,9
8401,2018-12-03,강동구,7.5,0,2,1,2,5
8402,2018-12-03,강북구,10.0,0,3,0,5,8
8403,2018-12-03,강서구,7.5,0,3,1,6,10
8404,2018-12-03,관악구,10.75,0,2,1,0,3
8405,2018-12-03,광진구,8.0,0,6,0,1,7
8406,2018-12-03,구로구,9.0,0,7,0,0,7
8407,2018-12-03,금천구,5.0,0,1,0,2,3
8408,2018-12-03,노원구,11.0,0,12,0,1,13
8409,2018-12-03,도봉구,9.5,0,0,0,1,1
8410,2018-12-03,동대문구,9.5,0,2,1,1,4
8411,2018-12-03,동작구,8.0,0,5,1,0,6
8412,2018-12-03,마포구,9.0,0,4,0,1,5
8413,2018-12-03,서대문구,8.5,0,2,1,5,8
8414,2018-12-03,서초구,11.0,0,8,1,2,11
8415,2018-12-03,성동구,8.5,0,3,0,0,3
8416,2018-12-03,성북구,10.5,0,4,0,8,12
8417,2018-12-03,송파구,10.5,0,8,0,2,10
8418,2018-12-03,양천구,8.5,0,0,0,0,0
8419,2018-12-03,영등포구,8.25,0,5,0,3,8
8420,2018-12-03,용산구,8.5,0,3,0,0,3
8421,2018-12-03,은평구,5.5,0,1,1,0,2
8422,2018-12-03,종로구,9.5,0,4,2,1,7
8423,2018-12-03,중구,8.5,0,1,1,0,2
8424,2018-12-03,중랑구,10.5,0,6,0,1,7
8425,2018-12-04,강남구,7.0,0,12,0,3,15
8426,2018-12-04,강동구,8.0,0,3,0,0,3
8427,2018-12-04,강북구,3.0,0,0,0,0,0
8428,2018-12-04,강서구,5.0,1,1,0,1,3
8429,2018-12-04,관악구,8.0,0,1,0,1,2
8430,2018-12-04,광진구,7.0,0,3,0,0,3
8431,2018-12-04,구로구,5.5,0,7,1,2,10
8432,2018-12-04,금천구,7.0,0,1,0,0,1
8433,2018-12-04,노원구,6.0,0,7,0,0,7
8434,2018-12-04,도봉구,3.5,0,3,1,1,5
8435,2018-12-04,동대문구,6.5,0,4,0,5,9
8436,2018-12-04,동작구,6.5,0,4,1,3,8
8437,2018-12-04,마포구,5.5,0,6,1,2,9
8438,2018-12-04,서대문구,5.5,0,0,0,0,0
8439,2018-12-04,서초구,7.0,0,5,0,6,11
8440,2018-12-04,성동구,6.0,0,1,0,0,1
8441,2018-12-04,성북구,4.0,0,2,0,1,3
8442,2018-12-04,송파구,8.0,0,6,1,1,8
8443,2018-12-04,양천구,5.5,0,6,1,0,7
8444,2018-12-04,영등포구,6.0,0,15,0,1,16
8445,2018-12-04,용산구,6.5,0,2,1,0,3
8446,2018-12-04,은평구,6.0,0,2,0,4,6
8447,2018-12-04,종로구,5.0,0,1,0,2,3
8448,2018-12-04,중구,5.5,0,1,0,0,1
8449,2018-12-04,중랑구,7.0,0,0,1,0,1
8450,2018-12-05,강남구,0.0,0,8,1,0,9
8451,2018-12-05,강동구,0.0,0,3,5,1,9
8452,2018-12-05,강북구,0.0,0,2,0,0,2
8453,2018-12-05,강서구,0.0,0,4,0,1,5
8454,2018-12-05,관악구,0.0,0,5,0,0,5
8455,2018-12-05,광진구,0.0,0,3,0,0,3
8456,2018-12-05,구로구,0.0,0,5,0,2,7
8457,2018-12-05,금천구,0.0,0,1,0,0,1
8458,2018-12-05,노원구,0.0,0,4,0,1,5
8459,2018-12-05,도봉구,0.0,0,0,0,0,0
8460,2018-12-05,동대문구,0.0,0,5,0,1,6
8461,2018-12-05,동작구,0.0,0,3,1,1,5
8462,2018-12-05,마포구,0.0,0,2,0,1,3
8463,2018-12-05,서대문구,0.0,0,2,0,0,2
8464,2018-12-05,서초구,0.0,0,7,0,2,9
8465,2018-12-05,성동구,0.0,0,0,0,0,0
8466,2018-12-05,성북구,0.0,0,3,2,1,6
8467,2018-12-05,송파구,0.0,0,4,0,0,4
8468,2018-12-05,양천구,0.0,0,6,1,2,9
8469,2018-12-05,영등포구,0.0,0,8,0,1,9
8470,2018-12-05,용산구,0.0,0,1,0,0,1
8471,2018-12-05,은평구,0.0,0,1,0,0,1
8472,2018-12-05,종로구,0.0,0,3,0,0,3
8473,2018-12-05,중구,0.0,0,2,0,1,3
8474,2018-12-05,중랑구,0.0,0,7,0,3,10
8475,2018-12-06,강남구,0.0,0,13,3,0,16
8476,2018-12-06,강동구,0.0,0,7,0,2,9
8477,2018-12-06,강북구,0.0,0,3,0,0,3
8478,2018-12-06,강서구,0.0,0,0,0,1,1
8479,2018-12-06,관악구,0.0,0,1,0,0,1
8480,2018-12-06,광진구,0.0,1,3,2,0,6
8481,2018-12-06,구로구,0.0,1,4,0,2,7
8482,2018-12-06,금천구,0.0,0,3,3,2,8
8483,2018-12-06,노원구,0.0,0,5,0,1,6
8484,2018-12-06,도봉구,0.0,0,1,0,1,2
8485,2018-12-06,동대문구,0.0,0,9,1,6,16
8486,2018-12-06,동작구,0.0,0,2,0,2,4
8487,2018-12-06,마포구,0.0,0,5,0,1,6
8488,2018-12-06,서대문구,0.0,0,0,0,0,0
8489,2018-12-06,서초구,0.0,0,11,0,0,11
8490,2018-12-06,성동구,0.0,0,6,0,1,7
8491,2018-12-06,성북구,0.0,0,2,0,1,3
8492,2018-12-06,송파구,0.0,0,4,0,4,8
8493,2018-12-06,양천구,0.0,0,5,2,2,9
8494,2018-12-06,영등포구,0.0,0,2,2,2,6
8495,2018-12-06,용산구,0.0,0,4,2,2,8
8496,2018-12-06,은평구,0.0,0,7,1,2,10
8497,2018-12-06,종로구,0.0,0,1,0,1,2
8498,2018-12-06,중구,0.0,0,7,0,2,9
8499,2018-12-06,중랑구,0.0,0,0,0,0,0
8500,2018-12-07,강남구,0.0,0,12,1,3,16
8501,2018-12-07,강동구,0.0,0,6,0,2,8
8502,2018-12-07,강북구,0.0,0,3,0,0,3
8503,2018-12-07,강서구,0.0,0,4,1,0,5
8504,2018-12-07,관악구,0.0,0,3,1,1,5
8505,2018-12-07,광진구,0.0,0,4,0,0,4
8506,2018-12-07,구로구,0.0,0,5,0,2,7
8507,2018-12-07,금천구,0.0,0,4,0,0,4
8508,2018-12-07,노원구,0.0,0,8,0,0,8
8509,2018-12-07,도봉구,0.0,0,7,0,2,9
8510,2018-12-07,동대문구,0.0,0,9,0,1,10
8511,2018-12-07,동작구,0.0,0,5,0,0,5
8512,2018-12-07,마포구,0.0,0,1,0,2,3
8513,2018-12-07,서대문구,0.0,0,2,0,2,4
8514,2018-12-07,서초구,0.0,0,19,1,1,21
8515,2018-12-07,성동구,0.0,0,3,0,0,3
8516,2018-12-07,성북구,0.0,0,0,0,1,1
8517,2018-12-07,송파구,0.0,0,12,1,2,15
8518,2018-12-07,양천구,0.0,0,3,0,1,4
8519,2018-12-07,영등포구,0.0,0,10,1,3,14
8520,2018-12-07,용산구,0.0,0,3,1,1,5
8521,2018-12-07,은평구,0.0,0,1,1,0,2
8522,2018-12-07,종로구,0.0,0,1,0,3,4
8523,2018-12-07,중구,0.0,0,2,0,0,2
8524,2018-12-07,중랑구,0.0,0,3,0,2,5
8525,2018-12-08,강남구,0.0,1,7,0,1,9
8526,2018-12-08,강동구,0.0,0,6,0,2,8
8527,2018-12-08,강북구,0.0,0,2,1,0,3
8528,2018-12-08,강서구,0.0,0,3,0,4,7
8529,2018-12-08,관악구,0.0,0,12,1,0,13
8530,2018-12-08,광진구,0.0,1,3,0,1,5
8531,2018-12-08,구로구,0.0,0,4,1,3,8
8532,2018-12-08,금천구,0.0,0,2,0,3,5
8533,2018-12-08,노원구,0.0,0,9,0,1,10
8534,2018-12-08,도봉구,0.0,0,0,0,1,1
8535,2018-12-08,동대문구,0.0,0,5,0,2,7
8536,2018-12-08,동작구,0.0,0,1,1,4,6
8537,2018-12-08,마포구,0.0,0,1,2,1,4
8538,2018-12-08,서대문구,0.0,0,4,0,1,5
8539,2018-12-08,서초구,0.0,0,6,1,0,7
8540,2018-12-08,성동구,0.0,0,0,0,1,1
8541,2018-12-08,성북구,0.0,0,4,0,0,4
8542,2018-12-08,송파구,0.0,0,15,2,4,21
8543,2018-12-08,양천구,0.0,0,6,1,0,7
8544,2018-12-08,영등포구,0.0,0,16,1,1,18
8545,2018-12-08,용산구,0.0,0,0,0,1,1
8546,2018-12-08,은평구,0.0,0,5,0,2,7
8547,2018-12-08,종로구,0.0,0,2,1,1,4
8548,2018-12-08,중구,0.0,0,1,4,4,9
8549,2018-12-08,중랑구,0.0,0,6,0,0,6
8550,2018-12-09,강남구,0.0,0,24,0,1,25
8551,2018-12-09,강동구,0.0,0,7,0,2,9
8552,2018-12-09,강북구,0.0,0,3,1,1,5
8553,2018-12-09,강서구,0.0,0,7,1,0,8
8554,2018-12-09,관악구,0.0,0,4,1,1,6
8555,2018-12-09,광진구,0.0,0,7,0,1,8
8556,2018-12-09,구로구,0.0,0,4,0,1,5
8557,2018-12-09,금천구,0.0,0,1,0,1,2
8558,2018-12-09,노원구,0.0,0,3,1,3,7
8559,2018-12-09,도봉구,0.0,0,0,0,1,1
8560,2018-12-09,동대문구,0.0,0,0,0,1,1
8561,2018-12-09,동작구,0.0,0,5,0,0,5
8562,2018-12-09,마포구,0.0,0,3,0,2,5
8563,2018-12-09,서대문구,0.0,0,6,1,1,8
8564,2018-12-09,서초구,0.0,0,7,0,0,7
8565,2018-12-09,성동구,0.0,0,0,0,1,1
8566,2018-12-09,성북구,0.0,0,3,0,1,4
8567,2018-12-09,송파구,0.0,0,0,0,1,1
8568,2018-12-09,양천구,0.0,0,0,0,0,0
8569,2018-12-09,영등포구,0.0,0,3,2,2,7
8570,2018-12-09,용산구,0.0,0,1,0,1,2
8571,2018-12-09,은평구,0.0,0,0,0,1,1
8572,2018-12-09,종로구,0.0,0,1,0,0,1
8573,2018-12-09,중구,0.0,0,2,0,0,2
8574,2018-12-09,중랑구,0.0,0,6,1,0,7
8575,2018-12-10,강남구,0.0,0,9,1,1,11
8576,2018-12-10,강동구,0.0,0,1,0,2,3
8577,2018-12-10,강북구,0.0,0,6,0,0,6
8578,2018-12-10,강서구,0.0,0,7,2,0,9
8579,2018-12-10,관악구,0.0,0,4,0,1,5
8580,2018-12-10,광진구,0.0,0,1,0,1,2
8581,2018-12-10,구로구,0.0,0,0,0,2,2
8582,2018-12-10,금천구,0.0,0,0,0,0,0
8583,2018-12-10,노원구,0.0,0,8,0,0,8
8584,2018-12-10,도봉구,0.0,0,3,0,1,4
8585,2018-12-10,동대문구,0.0,0,3,0,2,5
8586,2018-12-10,동작구,0.0,0,7,1,1,9
8587,2018-12-10,마포구,0.0,0,4,2,1,7
8588,2018-12-10,서대문구,0.0,0,4,0,1,5
8589,2018-12-10,서초구,0.0,0,5,0,1,6
8590,2018-12-10,성동구,0.0,0,4,0,0,4
8591,2018-12-10,성북구,0.0,0,2,0,1,3
8592,2018-12-10,송파구,0.0,0,6,0,2,8
8593,2018-12-10,양천구,0.0,0,3,0,0,3
8594,2018-12-10,영등포구,0.0,0,2,1,1,4
8595,2018-12-10,용산구,0.0,0,3,0,1,4
8596,2018-12-10,은평구,0.0,0,10,0,2,12
8597,2018-12-10,종로구,0.0,0,2,0,0,2
8598,2018-12-10,중구,0.0,0,3,0,0,3
8599,2018-12-10,중랑구,0.0,0,2,0,1,3
8600,2018-12-11,강남구,0.0,0,8,1,3,12
8601,2018-12-11,강동구,0.0,0,1,1,1,3
8602,2018-12-11,강북구,0.0,0,4,0,0,4
8603,2018-12-11,강서구,0.0,0,5,1,0,6
8604,2018-12-11,관악구,0.0,0,4,5,0,9
8605,2018-12-11,광진구,0.0,0,3,0,1,4
8606,2018-12-11,구로구,0.0,0,4,1,1,6
8607,2018-12-11,금천구,0.0,0,5,0,1,6
8608,2018-12-11,노원구,0.0,0,2,0,0,2
8609,2018-12-11,도봉구,0.0,0,4,0,1,5
8610,2018-12-11,동대문구,0.0,1,3,0,0,4
8611,2018-12-11,동작구,0.0,0,2,0,3,5
8612,2018-12-11,마포구,0.0,0,4,1,1,6
8613,2018-12-11,서대문구,0.0,0,0,0,2,2
8614,2018-12-11,서초구,0.0,0,9,0,1,10
8615,2018-12-11,성동구,0.0,0,1,0,0,1
8616,2018-12-11,성북구,0.0,0,2,0,1,3
8617,2018-12-11,송파구,0.0,0,5,2,4,11
8618,2018-12-11,양천구,0.0,0,0,0,0,0
8619,2018-12-11,영등포구,0.0,0,6,15,2,23
8620,2018-12-11,용산구,0.0,0,3,0,1,4
8621,2018-12-11,은평구,0.0,1,3,0,1,5
8622,2018-12-11,종로구,0.0,0,3,0,0,3
8623,2018-12-11,중구,0.0,0,2,1,0,3
8624,2018-12-11,중랑구,0.0,0,4,1,1,6
8625,2018-12-12,강남구,0.0,0,8,0,2,10
8626,2018-12-12,강동구,0.0,0,3,0,1,4
8627,2018-12-12,강북구,0.0,0,3,0,1,4
8628,2018-12-12,강서구,0.0,0,2,0,1,3
8629,2018-12-12,관악구,0.0,0,3,0,1,4
8630,2018-12-12,광진구,0.0,0,6,0,2,8
8631,2018-12-12,구로구,0.0,0,3,0,0,3
8632,2018-12-12,금천구,0.0,0,0,0,1,1
8633,2018-12-12,노원구,0.0,0,4,0,1,5
8634,2018-12-12,도봉구,0.0,0,3,0,0,3
8635,2018-12-12,동대문구,0.0,0,7,0,1,8
8636,2018-12-12,동작구,0.0,0,2,0,0,2
8637,2018-12-12,마포구,0.0,0,5,1,0,6
8638,2018-12-12,서대문구,0.0,0,1,1,2,4
8639,2018-12-12,서초구,0.0,0,9,1,1,11
8640,2018-12-12,성동구,0.0,0,0,1,1,2
8641,2018-12-12,성북구,0.0,0,3,1,0,4
8642,2018-12-12,송파구,0.0,0,5,4,2,11
8643,2018-12-12,양천구,0.0,0,6,1,0,7
8644,2018-12-12,영등포구,0.0,0,2,0,3,5
8645,2018-12-12,용산구,0.0,0,6,0,0,6
8646,2018-12-12,은평구,0.0,0,0,0,0,0
8647,2018-12-12,종로구,0.0,0,8,0,1,9
8648,2018-12-12,중구,0.0,0,4,1,3,8
8649,2018-12-12,중랑구,0.0,0,4,0,1,5
8650,2018-12-13,강남구,1.0,0,10,0,4,14
8651,2018-12-13,강동구,0.5,0,5,1,1,7
8652,2018-12-13,강북구,1.0,0,1,0,2,3
8653,2018-12-13,강서구,1.0,0,3,1,2,6
8654,2018-12-13,관악구,1.25,0,3,0,1,4
8655,2018-12-13,광진구,0.0,0,3,0,0,3
8656,2018-12-13,구로구,1.5,0,6,0,0,6
8657,2018-12-13,금천구,2.0,0,3,0,0,3
8658,2018-12-13,노원구,0.5,0,9,2,4,15
8659,2018-12-13,도봉구,1.5,0,1,0,1,2
8660,2018-12-13,동대문구,0.0,0,3,0,1,4
8661,2018-12-13,동작구,1.25,0,6,3,4,13
8662,2018-12-13,마포구,1.0,0,5,0,2,7
8663,2018-12-13,서대문구,0.5,0,2,0,1,3
8664,2018-12-13,서초구,1.5,0,10,0,2,12
8665,2018-12-13,성동구,0.0,0,7,0,2,9
8666,2018-12-13,성북구,0.5,1,4,0,1,6
8667,2018-12-13,송파구,0.0,0,7,0,2,9
8668,2018-12-13,양천구,0.5,0,0,0,0,0
8669,2018-12-13,영등포구,0.25,0,7,0,2,9
8670,2018-12-13,용산구,0.5,0,0,0,0,0
8671,2018-12-13,은평구,0.0,0,4,0,2,6
8672,2018-12-13,종로구,1.3,0,3,0,1,4
8673,2018-12-13,중구,1.0,0,4,0,0,4
8674,2018-12-13,중랑구,0.0,0,4,0,1,5
8675,2018-12-14,강남구,0.0,0,8,1,1,10
8676,2018-12-14,강동구,0.0,0,2,1,1,4
8677,2018-12-14,강북구,0.0,0,2,1,2,5
8678,2018-12-14,강서구,0.0,0,4,0,6,10
8679,2018-12-14,관악구,0.0,0,1,1,2,4
8680,2018-12-14,광진구,0.0,0,0,1,2,3
8681,2018-12-14,구로구,0.0,0,4,0,1,5
8682,2018-12-14,금천구,0.0,0,3,2,1,6
8683,2018-12-14,노원구,0.0,0,5,1,1,7
8684,2018-12-14,도봉구,0.0,0,4,0,0,4
8685,2018-12-14,동대문구,0.0,0,4,0,1,5
8686,2018-12-14,동작구,0.0,0,3,0,2,5
8687,2018-12-14,마포구,0.0,0,8,0,3,11
8688,2018-12-14,서대문구,0.0,0,3,0,1,4
8689,2018-12-14,서초구,0.0,0,10,0,3,13
8690,2018-12-14,성동구,0.0,0,5,0,0,5
8691,2018-12-14,성북구,0.0,0,5,0,2,7
8692,2018-12-14,송파구,0.0,0,7,0,0,7
8693,2018-12-14,양천구,0.0,0,9,0,2,11
8694,2018-12-14,영등포구,0.0,0,18,0,3,21
8695,2018-12-14,용산구,0.0,0,12,0,0,12
8696,2018-12-14,은평구,0.0,0,3,0,0,3
8697,2018-12-14,종로구,0.0,0,4,0,1,5
8698,2018-12-14,중구,0.0,0,1,0,2,3
8699,2018-12-14,중랑구,0.0,0,2,0,2,4
8700,2018-12-15,강남구,0.0,0,20,3,3,26
8701,2018-12-15,강동구,0.0,0,4,2,4,10
8702,2018-12-15,강북구,0.0,0,7,0,1,8
8703,2018-12-15,강서구,0.0,1,5,0,1,7
8704,2018-12-15,관악구,0.0,0,3,0,2,5
8705,2018-12-15,광진구,0.0,0,2,0,1,3
8706,2018-12-15,구로구,0.0,0,4,0,0,4
8707,2018-12-15,금천구,0.0,0,1,0,1,2
8708,2018-12-15,노원구,0.0,0,6,1,0,7
8709,2018-12-15,도봉구,0.0,0,1,0,1,2
8710,2018-12-15,동대문구,0.0,0,11,1,1,13
8711,2018-12-15,동작구,0.0,0,3,0,0,3
8712,2018-12-15,마포구,0.0,0,1,0,3,4
8713,2018-12-15,서대문구,0.0,0,7,4,1,12
8714,2018-12-15,서초구,0.0,0,12,4,0,16
8715,2018-12-15,성동구,0.0,0,2,2,2,6
8716,2018-12-15,성북구,0.0,1,14,2,2,19
8717,2018-12-15,송파구,0.0,0,4,0,0,4
8718,2018-12-15,양천구,0.0,0,4,2,1,7
8719,2018-12-15,영등포구,0.0,0,6,0,6,12
8720,2018-12-15,용산구,0.0,0,7,0,2,9
8721,2018-12-15,은평구,0.0,0,1,2,1,4
8722,2018-12-15,종로구,0.0,0,3,1,0,4
8723,2018-12-15,중구,0.0,0,4,0,0,4
8724,2018-12-15,중랑구,0.0,0,6,0,1,7
8725,2018-12-16,강남구,0.0,0,8,0,7,15
8726,2018-12-16,강동구,0.0,0,5,0,1,6
8727,2018-12-16,강북구,0.0,0,3,0,0,3
8728,2018-12-16,강서구,0.0,0,8,2,2,12
8729,2018-12-16,관악구,0.0,0,3,0,0,3
8730,2018-12-16,광진구,0.0,0,1,0,0,1
8731,2018-12-16,구로구,0.0,0,3,0,1,4
8732,2018-12-16,금천구,0.0,0,0,0,0,0
8733,2018-12-16,노원구,0.0,0,3,0,1,4
8734,2018-12-16,도봉구,0.0,0,3,0,0,3
8735,2018-12-16,동대문구,0.5,0,2,0,0,2
8736,2018-12-16,동작구,0.0,0,2,2,1,5
8737,2018-12-16,마포구,0.0,0,1,0,1,2
8738,2018-12-16,서대문구,0.0,0,3,0,2,5
8739,2018-12-16,서초구,0.0,0,3,0,1,4
8740,2018-12-16,성동구,0.0,0,2,0,0,2
8741,2018-12-16,성북구,0.0,0,9,0,0,9
8742,2018-12-16,송파구,0.0,0,6,0,0,6
8743,2018-12-16,양천구,0.0,0,0,0,0,0
8744,2018-12-16,영등포구,0.0,0,8,0,0,8
8745,2018-12-16,용산구,0.0,0,1,0,0,1
8746,2018-12-16,은평구,0.5,0,1,0,0,1
8747,2018-12-16,종로구,0.3,0,0,1,0,1
8748,2018-12-16,중구,0.0,0,0,0,0,0
8749,2018-12-16,중랑구,0.0,0,7,2,2,11
8750,2018-12-17,강남구,0.0,0,10,0,5,15
8751,2018-12-17,강동구,0.0,0,8,0,2,10
8752,2018-12-17,강북구,0.0,0,3,0,2,5
8753,2018-12-17,강서구,0.0,0,6,0,4,10
8754,2018-12-17,관악구,0.0,0,2,0,1,3
8755,2018-12-17,광진구,0.0,0,2,0,0,2
8756,2018-12-17,구로구,0.0,0,4,0,0,4
8757,2018-12-17,금천구,0.0,0,1,0,1,2
8758,2018-12-17,노원구,0.0,0,4,2,2,8
8759,2018-12-17,도봉구,0.5,0,1,1,0,2
8760,2018-12-17,동대문구,0.0,0,8,1,1,10
8761,2018-12-17,동작구,0.0,0,2,0,0,2
8762,2018-12-17,마포구,0.0,0,5,0,1,6
8763,2018-12-17,서대문구,0.0,0,5,1,1,7
8764,2018-12-17,서초구,0.0,0,7,0,0,7
8765,2018-12-17,성동구,0.0,0,3,0,1,4
8766,2018-12-17,성북구,0.0,0,5,1,1,7
8767,2018-12-17,송파구,0.0,0,15,0,3,18
8768,2018-12-17,양천구,0.0,0,4,0,2,6
8769,2018-12-17,영등포구,0.0,0,10,1,0,11
8770,2018-12-17,용산구,0.0,0,1,0,1,2
8771,2018-12-17,은평구,0.5,0,0,2,1,3
8772,2018-12-17,종로구,0.3,0,0,1,1,2
8773,2018-12-17,중구,0.0,0,3,0,0,3
8774,2018-12-17,중랑구,0.0,0,5,1,2,8
8775,2018-12-18,강남구,0.0,0,7,0,1,8
8776,2018-12-18,강동구,0.0,0,3,0,1,4
8777,2018-12-18,강북구,0.0,0,12,0,2,14
8778,2018-12-18,강서구,0.0,0,3,0,0,3
8779,2018-12-18,관악구,0.0,0,4,0,1,5
8780,2018-12-18,광진구,0.0,0,1,1,0,2
8781,2018-12-18,구로구,0.0,1,2,0,1,4
8782,2018-12-18,금천구,0.0,0,5,0,3,8
8783,2018-12-18,노원구,0.0,0,2,0,3,5
8784,2018-12-18,도봉구,0.0,0,0,1,1,2
8785,2018-12-18,동대문구,0.0,0,7,1,1,9
8786,2018-12-18,동작구,0.0,0,2,2,0,4
8787,2018-12-18,마포구,0.0,0,3,0,1,4
8788,2018-12-18,서대문구,0.0,0,5,3,3,11
8789,2018-12-18,서초구,0.0,0,8,0,4,12
8790,2018-12-18,성동구,0.0,0,4,0,2,6
8791,2018-12-18,성북구,0.0,0,7,0,3,10
8792,2018-12-18,송파구,0.0,0,13,1,1,15
8793,2018-12-18,양천구,0.0,0,2,0,1,3
8794,2018-12-18,영등포구,0.0,0,6,1,2,9
8795,2018-12-18,용산구,0.0,0,4,0,0,4
8796,2018-12-18,은평구,0.0,1,3,0,0,4
8797,2018-12-18,종로구,0.0,0,5,1,2,8
8798,2018-12-18,중구,0.0,0,5,0,0,5
8799,2018-12-18,중랑구,0.0,0,2,1,0,3
8800,2018-12-19,강남구,0.0,0,14,1,0,15
8801,2018-12-19,강동구,0.0,0,4,2,1,7
8802,2018-12-19,강북구,0.0,0,4,0,3,7
8803,2018-12-19,강서구,0.0,0,5,0,0,5
8804,2018-12-19,관악구,0.0,0,3,1,0,4
8805,2018-12-19,광진구,0.0,0,4,0,1,5
8806,2018-12-19,구로구,0.0,0,4,1,2,7
8807,2018-12-19,금천구,0.0,0,1,0,1,2
8808,2018-12-19,노원구,0.0,0,3,0,2,5
8809,2018-12-19,도봉구,0.0,0,1,0,2,3
8810,2018-12-19,동대문구,0.0,0,2,0,5,7
8811,2018-12-19,동작구,0.0,0,4,1,1,6
8812,2018-12-19,마포구,0.0,0,2,0,0,2
8813,2018-12-19,서대문구,0.0,0,2,0,0,2
8814,2018-12-19,서초구,0.0,0,13,0,2,15
8815,2018-12-19,성동구,0.0,0,2,0,1,3
8816,2018-12-19,성북구,0.0,0,5,1,3,9
8817,2018-12-19,송파구,0.0,0,12,0,2,14
8818,2018-12-19,양천구,0.0,0,2,0,1,3
8819,2018-12-19,영등포구,0.0,0,2,0,3,5
8820,2018-12-19,용산구,0.0,0,6,0,1,7
8821,2018-12-19,은평구,0.0,0,3,0,1,4
8822,2018-12-19,종로구,0.0,0,5,0,1,6
8823,2018-12-19,중구,0.0,0,2,1,2,5
8824,2018-12-19,중랑구,0.0,0,7,0,1,8
8825,2018-12-20,강남구,0.0,0,11,2,4,17
8826,2018-12-20,강동구,0.0,0,1,2,0,3
8827,2018-12-20,강북구,0.0,0,2,0,1,3
8828,2018-12-20,강서구,0.0,0,3,0,1,4
8829,2018-12-20,관악구,0.0,0,0,0,0,0
8830,2018-12-20,광진구,0.0,0,2,0,0,2
8831,2018-12-20,구로구,0.0,1,12,0,0,13
8832,2018-12-20,금천구,0.0,0,1,0,1,2
8833,2018-12-20,노원구,0.0,0,12,1,4,17
8834,2018-12-20,도봉구,0.0,0,5,0,0,5
8835,2018-12-20,동대문구,0.0,0,0,0,2,2
8836,2018-12-20,동작구,0.0,0,4,2,2,8
8837,2018-12-20,마포구,0.0,0,5,0,2,7
8838,2018-12-20,서대문구,0.0,0,0,0,1,1
8839,2018-12-20,서초구,0.0,0,6,0,3,9
8840,2018-12-20,성동구,0.0,0,1,1,2,4
8841,2018-12-20,성북구,0.0,0,1,0,1,2
8842,2018-12-20,송파구,0.0,0,10,0,2,12
8843,2018-12-20,양천구,0.0,0,4,0,0,4
8844,2018-12-20,영등포구,0.0,0,8,0,3,11
8845,2018-12-20,용산구,0.0,0,6,0,0,6
8846,2018-12-20,은평구,0.0,0,0,0,2,2
8847,2018-12-20,종로구,0.0,0,3,0,0,3
8848,2018-12-20,중구,0.0,0,9,1,1,11
8849,2018-12-20,중랑구,0.0,0,0,0,3,3
8850,2018-12-21,강남구,0.0,1,16,2,4,23
8851,2018-12-21,강동구,0.0,0,5,1,0,6
8852,2018-12-21,강북구,0.0,0,0,1,2,3
8853,2018-12-21,강서구,0.0,0,6,0,1,7
8854,2018-12-21,관악구,0.0,0,2,0,2,4
8855,2018-12-21,광진구,0.0,0,2,0,2,4
8856,2018-12-21,구로구,0.0,0,3,0,0,3
8857,2018-12-21,금천구,0.0,0,4,0,1,5
8858,2018-12-21,노원구,0.0,0,4,0,2,6
8859,2018-12-21,도봉구,0.0,0,1,0,2,3
8860,2018-12-21,동대문구,0.0,0,3,1,0,4
8861,2018-12-21,동작구,0.0,0,4,0,1,5
8862,2018-12-21,마포구,0.0,0,4,2,1,7
8863,2018-12-21,서대문구,0.0,0,2,0,0,2
8864,2018-12-21,서초구,0.0,0,6,0,4,10
8865,2018-12-21,성동구,0.0,0,3,0,3,6
8866,2018-12-21,성북구,0.0,0,4,0,1,5
8867,2018-12-21,송파구,0.0,0,25,3,2,30
8868,2018-12-21,양천구,0.0,0,7,0,0,7
8869,2018-12-21,영등포구,0.0,0,9,0,2,11
8870,2018-12-21,용산구,0.0,0,4,0,2,6
8871,2018-12-21,은평구,0.0,0,4,0,1,5
8872,2018-12-21,종로구,0.0,0,1,0,1,2
8873,2018-12-21,중구,0.0,0,4,0,0,4
8874,2018-12-21,중랑구,0.0,0,2,0,1,3
8875,2018-12-22,강남구,0.0,0,16,1,1,18
8876,2018-12-22,강동구,0.0,0,1,1,2,4
8877,2018-12-22,강북구,0.0,0,9,0,0,9
8878,2018-12-22,강서구,0.0,0,1,1,0,2
8879,2018-12-22,관악구,0.0,0,3,0,2,5
8880,2018-12-22,광진구,0.0,0,0,0,0,0
8881,2018-12-22,구로구,0.0,0,1,0,0,1
8882,2018-12-22,금천구,0.0,0,1,0,0,1
8883,2018-12-22,노원구,0.0,0,5,0,1,6
8884,2018-12-22,도봉구,0.0,0,0,0,1,1
8885,2018-12-22,동대문구,0.0,0,9,0,1,10
8886,2018-12-22,동작구,0.0,0,9,0,2,11
8887,2018-12-22,마포구,0.0,0,5,1,1,7
8888,2018-12-22,서대문구,0.0,0,1,0,1,2
8889,2018-12-22,서초구,0.0,0,9,0,0,9
8890,2018-12-22,성동구,0.0,0,4,0,0,4
8891,2018-12-22,성북구,0.0,0,3,1,2,6
8892,2018-12-22,송파구,0.0,0,4,1,4,9
8893,2018-12-22,양천구,0.0,0,5,4,0,9
8894,2018-12-22,영등포구,0.0,0,6,1,2,9
8895,2018-12-22,용산구,0.0,0,8,1,0,9
8896,2018-12-22,은평구,0.0,0,3,0,1,4
8897,2018-12-22,종로구,0.0,0,3,1,1,5
8898,2018-12-22,중구,0.0,0,1,1,0,2
8899,2018-12-22,중랑구,0.0,0,3,2,2,7
8900,2018-12-23,강남구,0.0,1,2,1,0,4
8901,2018-12-23,강동구,0.0,0,7,0,4,11
8902,2018-12-23,강북구,0.0,0,3,0,2,5
8903,2018-12-23,강서구,0.0,0,4,1,0,5
8904,2018-12-23,관악구,0.0,0,4,1,2,7
8905,2018-12-23,광진구,0.0,0,0,0,1,1
8906,2018-12-23,구로구,0.0,0,6,0,0,6
8907,2018-12-23,금천구,0.0,0,0,0,0,0
8908,2018-12-23,노원구,0.0,0,3,0,1,4
8909,2018-12-23,도봉구,0.0,0,0,0,0,0
8910,2018-12-23,동대문구,0.0,0,0,0,3,3
8911,2018-12-23,동작구,0.0,0,2,0,1,3
8912,2018-12-23,마포구,0.0,0,10,0,1,11
8913,2018-12-23,서대문구,0.0,0,0,0,0,0
8914,2018-12-23,서초구,0.0,0,8,1,2,11
8915,2018-12-23,성동구,0.0,0,3,0,1,4
8916,2018-12-23,성북구,0.0,0,5,0,2,7
8917,2018-12-23,송파구,0.0,0,10,2,0,12
8918,2018-12-23,양천구,0.0,0,0,0,0,0
8919,2018-12-23,영등포구,0.0,0,3,2,1,6
8920,2018-12-23,용산구,0.0,0,3,0,0,3
8921,2018-12-23,은평구,0.0,0,1,0,0,1
8922,2018-12-23,종로구,0.0,0,0,0,0,0
8923,2018-12-23,중구,0.0,0,2,2,0,4
8924,2018-12-23,중랑구,0.0,0,3,0,0,3
8925,2018-12-24,강남구,0.0,0,10,0,1,11
8926,2018-12-24,강동구,0.0,0,4,1,3,8
8927,2018-12-24,강북구,0.0,0,2,0,1,3
8928,2018-12-24,강서구,0.0,0,1,0,0,1
8929,2018-12-24,관악구,0.0,0,4,1,0,5
8930,2018-12-24,광진구,0.0,0,2,0,0,2
8931,2018-12-24,구로구,0.0,0,2,2,0,4
8932,2018-12-24,금천구,0.0,0,0,0,0,0
8933,2018-12-24,노원구,0.0,0,4,0,1,5
8934,2018-12-24,도봉구,0.0,0,1,1,0,2
8935,2018-12-24,동대문구,0.0,0,2,0,1,3
8936,2018-12-24,동작구,0.0,0,3,0,0,3
8937,2018-12-24,마포구,0.0,0,3,0,1,4
8938,2018-12-24,서대문구,0.0,0,0,0,0,0
8939,2018-12-24,서초구,0.0,1,11,0,0,12
8940,2018-12-24,성동구,0.0,0,2,0,1,3
8941,2018-12-24,성북구,0.0,0,2,0,1,3
8942,2018-12-24,송파구,0.0,0,7,0,8,15
8943,2018-12-24,양천구,0.0,0,12,0,1,13
8944,2018-12-24,영등포구,0.0,0,16,1,4,21
8945,2018-12-24,용산구,0.0,0,5,1,1,7
8946,2018-12-24,은평구,0.0,0,6,0,3,9
8947,2018-12-24,종로구,0.0,1,4,1,1,7
8948,2018-12-24,중구,0.0,0,8,0,0,8
8949,2018-12-24,중랑구,0.0,0,2,0,1,3
8950,2018-12-25,강남구,0.0,0,9,0,2,11
8951,2018-12-25,강동구,0.0,0,0,0,0,0
8952,2018-12-25,강북구,0.0,0,1,0,1,2
8953,2018-12-25,강서구,0.0,0,1,0,1,2
8954,2018-12-25,관악구,0.0,0,5,0,0,5
8955,2018-12-25,광진구,0.0,0,1,0,1,2
8956,2018-12-25,구로구,0.0,0,3,1,1,5
8957,2018-12-25,금천구,0.0,0,3,0,2,5
8958,2018-12-25,노원구,0.0,0,8,0,0,8
8959,2018-12-25,도봉구,0.0,0,8,0,0,8
8960,2018-12-25,동대문구,0.0,0,3,0,1,4
8961,2018-12-25,동작구,0.0,0,5,0,1,6
8962,2018-12-25,마포구,0.0,0,4,0,0,4
8963,2018-12-25,서대문구,0.0,0,1,1,0,2
8964,2018-12-25,서초구,0.0,0,3,1,0,4
8965,2018-12-25,성동구,0.0,0,1,0,0,1
8966,2018-12-25,성북구,0.0,0,2,2,0,4
8967,2018-12-25,송파구,0.0,0,6,1,2,9
8968,2018-12-25,양천구,0.0,1,1,0,3,5
8969,2018-12-25,영등포구,0.0,0,2,0,0,2
8970,2018-12-25,용산구,0.0,0,2,0,1,3
8971,2018-12-25,은평구,0.0,0,2,0,0,2
8972,2018-12-25,종로구,0.0,0,4,0,0,4
8973,2018-12-25,중구,0.0,0,3,0,0,3
8974,2018-12-25,중랑구,0.0,0,3,0,2,5
8975,2018-12-26,강남구,0.0,0,17,3,3,23
8976,2018-12-26,강동구,0.0,0,4,0,1,5
8977,2018-12-26,강북구,0.0,0,3,1,1,5
8978,2018-12-26,강서구,0.0,0,5,0,0,5
8979,2018-12-26,관악구,0.0,0,0,0,0,0
8980,2018-12-26,광진구,0.0,0,2,0,1,3
8981,2018-12-26,구로구,0.0,0,8,0,2,10
8982,2018-12-26,금천구,0.0,0,2,0,0,2
8983,2018-12-26,노원구,0.0,0,6,0,2,8
8984,2018-12-26,도봉구,0.0,0,2,0,0,2
8985,2018-12-26,동대문구,0.0,0,2,0,2,4
8986,2018-12-26,동작구,0.0,0,0,0,0,0
8987,2018-12-26,마포구,0.0,0,1,0,0,1
8988,2018-12-26,서대문구,0.0,0,3,0,1,4
8989,2018-12-26,서초구,0.0,0,4,2,0,6
8990,2018-12-26,성동구,0.0,0,1,0,1,2
8991,2018-12-26,성북구,0.0,0,1,2,1,4
8992,2018-12-26,송파구,0.0,0,5,2,1,8
8993,2018-12-26,양천구,0.0,0,5,0,1,6
8994,2018-12-26,영등포구,0.0,0,2,0,4,6
8995,2018-12-26,용산구,0.0,0,5,0,1,6
8996,2018-12-26,은평구,0.0,0,1,1,0,2
8997,2018-12-26,종로구,0.0,0,1,0,2,3
8998,2018-12-26,중구,0.0,0,1,0,0,1
8999,2018-12-26,중랑구,0.0,0,4,0,0,4
9000,2018-12-27,강남구,0.0,0,6,0,4,10
9001,2018-12-27,강동구,0.0,0,5,3,1,9
9002,2018-12-27,강북구,0.0,0,2,0,0,2
9003,2018-12-27,강서구,0.0,0,2,1,1,4
9004,2018-12-27,관악구,0.0,0,3,0,0,3
9005,2018-12-27,광진구,0.0,0,0,0,0,0
9006,2018-12-27,구로구,0.0,0,8,0,1,9
9007,2018-12-27,금천구,0.0,0,1,0,2,3
9008,2018-12-27,노원구,0.0,0,9,0,2,11
9009,2018-12-27,도봉구,0.0,0,0,0,1,1
9010,2018-12-27,동대문구,0.0,0,8,0,0,8
9011,2018-12-27,동작구,0.0,0,4,0,0,4
9012,2018-12-27,마포구,0.0,0,1,1,0,2
9013,2018-12-27,서대문구,0.0,0,3,0,2,5
9014,2018-12-27,서초구,0.0,0,9,2,2,13
9015,2018-12-27,성동구,0.0,0,1,1,0,2
9016,2018-12-27,성북구,0.0,0,2,0,1,3
9017,2018-12-27,송파구,0.0,0,9,0,1,10
9018,2018-12-27,양천구,0.0,0,5,0,1,6
9019,2018-12-27,영등포구,0.0,0,7,1,2,10
9020,2018-12-27,용산구,0.0,0,3,0,0,3
9021,2018-12-27,은평구,0.0,0,13,4,2,19
9022,2018-12-27,종로구,0.0,0,7,1,1,9
9023,2018-12-27,중구,0.0,0,3,0,0,3
9024,2018-12-27,중랑구,0.0,0,5,1,0,6
9025,2018-12-28,강남구,0.0,0,10,0,1,11
9026,2018-12-28,강동구,0.0,0,10,2,0,12
9027,2018-12-28,강북구,0.0,0,1,0,0,1
9028,2018-12-28,강서구,0.0,0,4,0,1,5
9029,2018-12-28,관악구,0.0,0,1,0,0,1
9030,2018-12-28,광진구,0.0,0,0,0,0,0
9031,2018-12-28,구로구,0.0,0,7,0,1,8
9032,2018-12-28,금천구,0.0,0,5,0,1,6
9033,2018-12-28,노원구,0.0,0,7,0,1,8
9034,2018-12-28,도봉구,0.0,0,1,0,0,1
9035,2018-12-28,동대문구,0.0,0,6,0,1,7
9036,2018-12-28,동작구,0.0,0,4,1,0,5
9037,2018-12-28,마포구,0.0,0,5,0,0,5
9038,2018-12-28,서대문구,0.0,0,3,0,2,5
9039,2018-12-28,서초구,0.0,0,14,0,2,16
9040,2018-12-28,성동구,0.0,0,5,0,0,5
9041,2018-12-28,성북구,0.0,0,3,0,2,5
9042,2018-12-28,송파구,0.0,0,8,0,1,9
9043,2018-12-28,양천구,0.0,0,4,0,0,4
9044,2018-12-28,영등포구,0.0,0,11,1,0,12
9045,2018-12-28,용산구,0.0,0,3,0,0,3
9046,2018-12-28,은평구,0.0,0,5,2,2,9
9047,2018-12-28,종로구,0.0,0,6,0,1,7
9048,2018-12-28,중구,0.0,0,4,0,3,7
9049,2018-12-28,중랑구,0.0,0,5,1,1,7
9050,2018-12-29,강남구,0.0,0,10,0,4,14
9051,2018-12-29,강동구,0.0,0,1,0,1,2
9052,2018-12-29,강북구,0.0,0,1,0,0,1
9053,2018-12-29,강서구,0.0,0,4,0,1,5
9054,2018-12-29,관악구,0.0,0,2,0,0,2
9055,2018-12-29,광진구,0.0,0,3,0,0,3
9056,2018-12-29,구로구,0.0,0,3,0,0,3
9057,2018-12-29,금천구,0.0,0,1,0,1,2
9058,2018-12-29,노원구,0.0,0,1,1,1,3
9059,2018-12-29,도봉구,0.0,0,5,1,0,6
9060,2018-12-29,동대문구,0.0,0,2,1,1,4
9061,2018-12-29,동작구,0.0,0,2,0,1,3
9062,2018-12-29,마포구,0.0,0,4,0,1,5
9063,2018-12-29,서대문구,0.0,0,3,0,0,3
9064,2018-12-29,서초구,0.0,0,10,0,2,12
9065,2018-12-29,성동구,0.0,0,3,0,0,3
9066,2018-12-29,성북구,0.0,0,3,0,0,3
9067,2018-12-29,송파구,0.0,0,7,1,1,9
9068,2018-12-29,양천구,0.0,0,0,0,0,0
9069,2018-12-29,영등포구,0.0,0,12,0,7,19
9070,2018-12-29,용산구,0.0,0,1,0,0,1
9071,2018-12-29,은평구,0.0,0,4,0,1,5
9072,2018-12-29,종로구,0.0,0,2,0,1,3
9073,2018-12-29,중구,0.0,1,2,2,4,9
9074,2018-12-29,중랑구,0.0,0,7,0,2,9
9075,2018-12-30,강남구,0.0,0,19,6,0,25
9076,2018-12-30,강동구,0.0,0,2,0,0,2
9077,2018-12-30,강북구,0.0,1,7,1,7,16
9078,2018-12-30,강서구,0.0,0,8,2,0,10
9079,2018-12-30,관악구,0.0,0,2,0,3,5
9080,2018-12-30,광진구,0.0,0,0,0,0,0
9081,2018-12-30,구로구,0.0,0,2,0,0,2
9082,2018-12-30,금천구,0.0,0,5,0,1,6
9083,2018-12-30,노원구,0.0,0,5,0,1,6
9084,2018-12-30,도봉구,0.0,0,0,0,2,2
9085,2018-12-30,동대문구,0.0,0,1,0,1,2
9086,2018-12-30,동작구,0.0,0,1,0,0,1
9087,2018-12-30,마포구,0.0,0,6,2,1,9
9088,2018-12-30,서대문구,0.0,0,0,1,1,2
9089,2018-12-30,서초구,0.0,1,1,0,0,2
9090,2018-12-30,성동구,0.0,0,0,0,0,0
9091,2018-12-30,성북구,0.0,0,1,0,0,1
9092,2018-12-30,송파구,0.0,0,2,0,0,2
9093,2018-12-30,양천구,0.0,0,2,0,0,2
9094,2018-12-30,영등포구,0.0,0,1,2,1,4
9095,2018-12-30,용산구,0.0,0,5,0,3,8
9096,2018-12-30,은평구,0.0,0,5,0,6,11
9097,2018-12-30,종로구,0.0,0,1,0,0,1
9098,2018-12-30,중구,0.0,0,0,0,0,0
9099,2018-12-30,중랑구,0.0,0,1,1,1,3
9100,2018-12-31,강남구,0.0,0,8,0,2,10
9101,2018-12-31,강동구,0.0,0,7,1,3,11
9102,2018-12-31,강북구,0.0,0,2,0,0,2
9103,2018-12-31,강서구,0.0,0,1,1,3,5
9104,2018-12-31,관악구,0.0,0,3,0,2,5
9105,2018-12-31,광진구,0.0,0,0,0,0,0
9106,2018-12-31,구로구,0.0,0,6,0,0,6
9107,2018-12-31,금천구,0.0,0,0,0,0,0
9108,2018-12-31,노원구,0.0,0,5,1,1,7
9109,2018-12-31,도봉구,0.0,0,0,2,0,2
9110,2018-12-31,동대문구,0.0,0,4,0,1,5
9111,2018-12-31,동작구,0.0,0,6,0,2,8
9112,2018-12-31,마포구,0.0,0,6,2,1,9
9113,2018-12-31,서대문구,0.0,0,1,3,0,4
9114,2018-12-31,서초구,0.0,0,9,1,3,13
9115,2018-12-31,성동구,0.0,0,6,0,1,7
9116,2018-12-31,성북구,0.0,0,5,0,1,6
9117,2018-12-31,송파구,0.0,0,7,1,2,10
9118,2018-12-31,양천구,0.0,0,5,1,1,7
9119,2018-12-31,영등포구,0.0,0,3,2,2,7
9120,2018-12-31,용산구,0.0,1,2,1,3,7
9121,2018-12-31,은평구,0.0,0,3,2,0,5
9122,2018-12-31,종로구,0.0,0,0,0,1,1
9123,2018-12-31,중구,0.0,0,3,0,3,6
9124,2018-12-31,중랑구,0.0,0,2,0,0,2
9125,2019-01-01,강남구,0.0,0,7,0,2,9
9126,2019-01-01,강동구,0.0,0,0,0,2,2
9127,2019-01-01,강북구,0.0,0,0,0,0,0
9128,2019-01-01,강서구,0.0,0,5,0,1,6
9129,2019-01-01,관악구,0.0,0,2,1,0,3
9130,2019-01-01,광진구,0.0,0,2,0,0,2
9131,2019-01-01,구로구,0.0,0,2,1,0,3
9132,2019-01-01,금천구,0.0,0,0,0,1,1
9133,2019-01-01,노원구,0.0,0,14,1,1,16
9134,2019-01-01,도봉구,0.0,0,0,0,0,0
9135,2019-01-01,동대문구,0.0,0,2,0,0,2
9136,2019-01-01,동작구,0.0,0,0,1,0,1
9137,2019-01-01,마포구,0.0,0,2,0,0,2
9138,2019-01-01,서대문구,0.0,0,1,0,0,1
9139,2019-01-01,서초구,0.0,0,9,1,3,13
9140,2019-01-01,성동구,0.0,0,1,0,0,1
9141,2019-01-01,성북구,0.0,0,1,0,1,2
9142,2019-01-01,송파구,0.0,0,7,0,1,8
9143,2019-01-01,양천구,0.0,0,3,0,0,3
9144,2019-01-01,영등포구,0.0,0,6,2,0,8
9145,2019-01-01,용산구,0.0,0,1,0,1,2
9146,2019-01-01,은평구,0.0,0,0,1,1,2
9147,2019-01-01,종로구,0.0,0,0,0,1,1
9148,2019-01-01,중구,0.0,0,1,0,0,1
9149,2019-01-01,중랑구,0.0,0,3,0,2,5
9150,2019-01-02,강남구,0.0,0,6,0,3,9
9151,2019-01-02,강동구,0.0,0,1,0,2,3
9152,2019-01-02,강북구,0.0,0,4,0,0,4
9153,2019-01-02,강서구,0.0,0,5,0,1,6
9154,2019-01-02,관악구,0.0,0,4,0,2,6
9155,2019-01-02,광진구,0.0,0,0,0,1,1
9156,2019-01-02,구로구,0.0,0,4,0,0,4
9157,2019-01-02,금천구,0.0,0,0,0,0,0
9158,2019-01-02,노원구,0.0,0,5,0,0,5
9159,2019-01-02,도봉구,0.0,0,1,0,0,1
9160,2019-01-02,동대문구,0.0,0,1,0,0,1
9161,2019-01-02,동작구,0.0,0,6,0,0,6
9162,2019-01-02,마포구,0.0,0,4,1,1,6
9163,2019-01-02,서대문구,0.0,0,2,3,1,6
9164,2019-01-02,서초구,0.0,0,4,1,1,6
9165,2019-01-02,성동구,0.0,0,1,0,1,2
9166,2019-01-02,성북구,0.0,0,7,0,5,12
9167,2019-01-02,송파구,0.0,0,8,0,2,10
9168,2019-01-02,양천구,0.0,0,10,1,2,13
9169,2019-01-02,영등포구,0.0,0,10,0,4,14
9170,2019-01-02,용산구,0.0,0,0,0,0,0
9171,2019-01-02,은평구,0.0,0,2,1,2,5
9172,2019-01-02,종로구,0.0,0,4,0,0,4
9173,2019-01-02,중구,0.0,1,1,2,3,7
9174,2019-01-02,중랑구,0.0,0,2,0,2,4
9175,2019-01-03,강남구,0.0,0,16,1,3,20
9176,2019-01-03,강동구,0.0,0,1,0,0,1
9177,2019-01-03,강북구,0.0,0,4,0,1,5
9178,2019-01-03,강서구,0.0,0,0,0,3,3
9179,2019-01-03,관악구,0.0,0,2,0,1,3
9180,2019-01-03,광진구,0.0,0,0,0,1,1
9181,2019-01-03,구로구,0.0,0,12,0,2,14
9182,2019-01-03,금천구,0.0,0,0,0,0,0
9183,2019-01-03,노원구,0.0,1,3,0,0,4
9184,2019-01-03,도봉구,0.0,0,1,0,2,3
9185,2019-01-03,동대문구,0.0,0,1,0,6,7
9186,2019-01-03,동작구,0.0,0,3,0,0,3
9187,2019-01-03,마포구,0.0,0,5,0,1,6
9188,2019-01-03,서대문구,0.0,0,3,0,0,3
9189,2019-01-03,서초구,0.0,0,2,1,3,6
9190,2019-01-03,성동구,0.0,0,13,0,2,15
9191,2019-01-03,성북구,0.0,0,1,0,0,1
9192,2019-01-03,송파구,0.0,0,3,2,2,7
9193,2019-01-03,양천구,0.0,0,3,0,1,4
9194,2019-01-03,영등포구,0.0,0,7,1,2,10
9195,2019-01-03,용산구,0.0,0,0,1,1,2
9196,2019-01-03,은평구,0.0,0,3,0,3,6
9197,2019-01-03,종로구,0.0,0,2,1,1,4
9198,2019-01-03,중구,0.0,1,1,0,1,3
9199,2019-01-03,중랑구,0.0,0,3,0,2,5
9200,2019-01-04,강남구,0.0,0,12,0,2,14
9201,2019-01-04,강동구,0.0,0,0,1,1,2
9202,2019-01-04,강북구,0.0,0,8,1,0,9
9203,2019-01-04,강서구,0.0,0,9,0,1,10
9204,2019-01-04,관악구,0.0,0,3,0,3,6
9205,2019-01-04,광진구,0.0,0,0,0,0,0
9206,2019-01-04,구로구,0.0,0,3,0,1,4
9207,2019-01-04,금천구,0.0,0,0,0,4,4
9208,2019-01-04,노원구,0.0,0,4,0,0,4
9209,2019-01-04,도봉구,0.0,0,1,0,2,3
9210,2019-01-04,동대문구,0.0,0,5,0,1,6
9211,2019-01-04,동작구,0.0,0,2,0,2,4
9212,2019-01-04,마포구,0.0,0,3,0,0,3
9213,2019-01-04,서대문구,0.0,0,3,0,2,5
9214,2019-01-04,서초구,0.0,0,4,0,1,5
9215,2019-01-04,성동구,0.0,0,2,0,0,2
9216,2019-01-04,성북구,0.0,0,0,0,0,0
9217,2019-01-04,송파구,0.0,0,5,6,4,15
9218,2019-01-04,양천구,0.0,0,8,0,4,12
9219,2019-01-04,영등포구,0.0,0,4,0,2,6
9220,2019-01-04,용산구,0.0,0,2,0,1,3
9221,2019-01-04,은평구,0.0,0,3,2,2,7
9222,2019-01-04,종로구,0.0,0,2,0,1,3
9223,2019-01-04,중구,0.0,0,2,0,1,3
9224,2019-01-04,중랑구,0.0,0,3,1,0,4
9225,2019-01-05,강남구,0.0,0,13,6,3,22
9226,2019-01-05,강동구,0.0,0,3,0,0,3
9227,2019-01-05,강북구,0.0,0,2,0,0,2
9228,2019-01-05,강서구,0.0,0,7,1,1,9
9229,2019-01-05,관악구,0.0,0,0,1,0,1
9230,2019-01-05,광진구,0.0,0,3,0,0,3
9231,2019-01-05,구로구,0.0,0,8,2,3,13
9232,2019-01-05,금천구,0.0,0,5,0,0,5
9233,2019-01-05,노원구,0.0,0,6,0,1,7
9234,2019-01-05,도봉구,0.0,0,1,1,0,2
9235,2019-01-05,동대문구,0.0,0,5,0,2,7
9236,2019-01-05,동작구,0.0,0,1,1,1,3
9237,2019-01-05,마포구,0.0,0,1,0,0,1
9238,2019-01-05,서대문구,0.0,0,2,0,0,2
9239,2019-01-05,서초구,0.0,0,10,0,2,12
9240,2019-01-05,성동구,0.0,0,0,0,0,0
9241,2019-01-05,성북구,0.0,0,3,0,0,3
9242,2019-01-05,송파구,0.0,0,0,2,3,5
9243,2019-01-05,양천구,0.0,0,9,0,0,9
9244,2019-01-05,영등포구,0.0,0,5,0,2,7
9245,2019-01-05,용산구,0.0,0,5,0,2,7
9246,2019-01-05,은평구,0.0,0,8,0,1,9
9247,2019-01-05,종로구,0.0,0,9,1,2,12
9248,2019-01-05,중구,0.0,0,0,0,0,0
9249,2019-01-05,중랑구,0.0,0,3,2,0,5
9250,2019-01-06,강남구,0.0,0,4,0,1,5
9251,2019-01-06,강동구,0.0,0,2,1,0,3
9252,2019-01-06,강북구,0.0,0,3,0,0,3
9253,2019-01-06,강서구,0.0,0,4,1,0,5
9254,2019-01-06,관악구,0.0,0,5,0,0,5
9255,2019-01-06,광진구,0.0,0,1,0,0,1
9256,2019-01-06,구로구,0.0,0,7,0,3,10
9257,2019-01-06,금천구,0.0,0,0,0,0,0
9258,2019-01-06,노원구,0.0,0,1,0,0,1
9259,2019-01-06,도봉구,0.0,0,0,0,0,0
9260,2019-01-06,동대문구,0.0,0,6,0,1,7
9261,2019-01-06,동작구,0.0,0,4,0,2,6
9262,2019-01-06,마포구,0.0,0,2,0,1,3
9263,2019-01-06,서대문구,0.0,0,0,0,0,0
9264,2019-01-06,서초구,0.0,0,0,0,0,0
9265,2019-01-06,성동구,0.0,0,3,0,0,3
9266,2019-01-06,성북구,0.0,0,2,1,3,6
9267,2019-01-06,송파구,0.0,0,1,0,0,1
9268,2019-01-06,양천구,0.0,0,4,0,1,5
9269,2019-01-06,영등포구,0.0,0,0,0,1,1
9270,2019-01-06,용산구,0.0,0,4,0,1,5
9271,2019-01-06,은평구,0.0,0,1,1,0,2
9272,2019-01-06,종로구,0.0,0,2,0,0,2
9273,2019-01-06,중구,0.0,0,1,0,0,1
9274,2019-01-06,중랑구,0.0,0,1,0,0,1
9275,2019-01-07,강남구,0.0,0,11,2,3,16
9276,2019-01-07,강동구,0.0,0,4,0,0,4
9277,2019-01-07,강북구,0.0,0,1,0,3,4
9278,2019-01-07,강서구,0.0,0,3,0,0,3
9279,2019-01-07,관악구,0.0,0,3,0,1,4
9280,2019-01-07,광진구,0.0,0,1,0,1,2
9281,2019-01-07,구로구,0.0,0,2,1,0,3
9282,2019-01-07,금천구,0.0,0,0,0,2,2
9283,2019-01-07,노원구,0.0,0,2,0,1,3
9284,2019-01-07,도봉구,0.0,0,0,0,1,1
9285,2019-01-07,동대문구,0.0,0,2,0,3,5
9286,2019-01-07,동작구,0.0,0,0,0,0,0
9287,2019-01-07,마포구,0.0,0,7,0,6,13
9288,2019-01-07,서대문구,0.0,0,1,0,2,3
9289,2019-01-07,서초구,0.0,0,2,2,1,5
9290,2019-01-07,성동구,0.0,0,3,1,0,4
9291,2019-01-07,성북구,0.0,0,8,0,2,10
9292,2019-01-07,송파구,0.0,0,7,0,0,7
9293,2019-01-07,양천구,0.0,0,8,1,0,9
9294,2019-01-07,영등포구,0.0,0,12,1,2,15
9295,2019-01-07,용산구,0.0,0,2,0,0,2
9296,2019-01-07,은평구,0.0,0,3,1,0,4
9297,2019-01-07,종로구,0.0,0,0,3,2,5
9298,2019-01-07,중구,0.0,0,1,0,0,1
9299,2019-01-07,중랑구,0.0,0,4,2,0,6
9300,2019-01-08,강남구,0.0,0,14,1,4,19
9301,2019-01-08,강동구,0.0,0,1,0,0,1
9302,2019-01-08,강북구,0.0,0,3,0,0,3
9303,2019-01-08,강서구,0.0,1,4,0,0,5
9304,2019-01-08,관악구,0.0,0,4,0,0,4
9305,2019-01-08,광진구,0.0,0,0,0,0,0
9306,2019-01-08,구로구,0.0,0,6,0,1,7
9307,2019-01-08,금천구,0.0,0,0,0,0,0
9308,2019-01-08,노원구,0.0,0,8,1,4,13
9309,2019-01-08,도봉구,0.0,0,2,1,4,7
9310,2019-01-08,동대문구,0.0,0,3,2,3,8
9311,2019-01-08,동작구,0.0,0,1,0,1,2
9312,2019-01-08,마포구,0.0,0,10,0,1,11
9313,2019-01-08,서대문구,0.0,0,3,0,1,4
9314,2019-01-08,서초구,0.0,0,5,1,1,7
9315,2019-01-08,성동구,0.0,0,3,1,3,7
9316,2019-01-08,성북구,0.0,0,4,0,0,4
9317,2019-01-08,송파구,0.0,0,18,1,2,21
9318,2019-01-08,양천구,0.0,0,3,0,1,4
9319,2019-01-08,영등포구,0.0,0,7,0,2,9
9320,2019-01-08,용산구,0.0,0,7,3,1,11
9321,2019-01-08,은평구,0.0,0,1,0,1,2
9322,2019-01-08,종로구,0.0,0,1,0,2,3
9323,2019-01-08,중구,0.0,0,0,0,2,2
9324,2019-01-08,중랑구,0.0,0,7,1,2,10
9325,2019-01-09,강남구,0.0,0,6,1,2,9
9326,2019-01-09,강동구,0.0,0,5,1,0,6
9327,2019-01-09,강북구,0.0,0,3,0,3,6
9328,2019-01-09,강서구,0.0,0,7,0,1,8
9329,2019-01-09,관악구,0.0,0,6,0,0,6
9330,2019-01-09,광진구,0.0,0,1,0,2,3
9331,2019-01-09,구로구,0.0,0,5,1,2,8
9332,2019-01-09,금천구,0.0,0,0,0,0,0
9333,2019-01-09,노원구,0.0,0,2,0,1,3
9334,2019-01-09,도봉구,0.0,0,0,1,3,4
9335,2019-01-09,동대문구,0.0,0,5,1,1,7
9336,2019-01-09,동작구,0.0,0,3,0,0,3
9337,2019-01-09,마포구,0.0,0,5,0,0,5
9338,2019-01-09,서대문구,0.0,0,0,0,1,1
9339,2019-01-09,서초구,0.0,0,6,1,3,10
9340,2019-01-09,성동구,0.0,0,3,0,0,3
9341,2019-01-09,성북구,0.0,0,2,0,1,3
9342,2019-01-09,송파구,0.0,0,2,2,2,6
9343,2019-01-09,양천구,0.0,0,6,1,3,10
9344,2019-01-09,영등포구,0.0,0,8,0,2,10
9345,2019-01-09,용산구,0.0,0,2,0,1,3
9346,2019-01-09,은평구,0.0,0,0,1,0,1
9347,2019-01-09,종로구,0.0,0,5,2,1,8
9348,2019-01-09,중구,0.0,0,5,1,3,9
9349,2019-01-09,중랑구,0.0,0,3,0,4,7
9350,2019-01-10,강남구,0.0,0,6,0,2,8
9351,2019-01-10,강동구,0.0,0,1,1,0,2
9352,2019-01-10,강북구,0.0,0,3,0,1,4
9353,2019-01-10,강서구,0.0,0,3,2,2,7
9354,2019-01-10,관악구,0.0,0,3,0,0,3
9355,2019-01-10,광진구,0.0,0,1,0,1,2
9356,2019-01-10,구로구,0.0,0,5,0,2,7
9357,2019-01-10,금천구,0.0,0,1,0,1,2
9358,2019-01-10,노원구,0.0,0,6,2,3,11
9359,2019-01-10,도봉구,0.0,0,1,0,0,1
9360,2019-01-10,동대문구,0.0,0,4,0,5,9
9361,2019-01-10,동작구,0.0,0,4,4,0,8
9362,2019-01-10,마포구,0.0,0,2,0,0,2
9363,2019-01-10,서대문구,0.0,0,2,1,0,3
9364,2019-01-10,서초구,0.0,0,1,2,1,4
9365,2019-01-10,성동구,0.0,0,2,0,1,3
9366,2019-01-10,성북구,0.0,0,4,0,1,5
9367,2019-01-10,송파구,0.0,0,10,1,2,13
9368,2019-01-10,양천구,0.0,0,5,0,3,8
9369,2019-01-10,영등포구,0.0,0,5,0,2,7
9370,2019-01-10,용산구,0.0,0,8,0,0,8
9371,2019-01-10,은평구,0.0,0,2,0,1,3
9372,2019-01-10,종로구,0.0,0,3,0,0,3
9373,2019-01-10,중구,0.0,0,2,1,0,3
9374,2019-01-10,중랑구,0.0,0,6,1,2,9
9375,2019-01-11,강남구,0.0,0,12,2,3,17
9376,2019-01-11,강동구,0.0,0,8,0,1,9
9377,2019-01-11,강북구,0.0,0,1,0,1,2
9378,2019-01-11,강서구,0.0,0,1,0,1,2
9379,2019-01-11,관악구,0.0,0,2,1,1,4
9380,2019-01-11,광진구,0.0,0,3,0,0,3
9381,2019-01-11,구로구,0.0,0,5,1,0,6
9382,2019-01-11,금천구,0.0,0,4,0,0,4
9383,2019-01-11,노원구,0.0,0,8,3,1,12
9384,2019-01-11,도봉구,0.0,0,1,0,0,1
9385,2019-01-11,동대문구,0.0,0,6,0,0,6
9386,2019-01-11,동작구,0.0,0,3,0,1,4
9387,2019-01-11,마포구,0.0,0,1,0,2,3
9388,2019-01-11,서대문구,0.0,0,3,1,0,4
9389,2019-01-11,서초구,0.0,0,5,2,1,8
9390,2019-01-11,성동구,0.0,0,2,0,1,3
9391,2019-01-11,성북구,0.0,0,11,0,2,13
9392,2019-01-11,송파구,0.0,0,9,2,3,14
9393,2019-01-11,양천구,0.0,0,4,0,0,4
9394,2019-01-11,영등포구,0.0,0,3,1,1,5
9395,2019-01-11,용산구,0.0,0,3,0,4,7
9396,2019-01-11,은평구,0.0,0,2,0,1,3
9397,2019-01-11,종로구,0.0,0,3,0,3,6
9398,2019-01-11,중구,0.0,0,1,0,1,2
9399,2019-01-11,중랑구,0.0,0,2,0,2,4
9400,2019-01-12,강남구,0.0,0,11,1,2,14
9401,2019-01-12,강동구,0.0,0,2,0,0,2
9402,2019-01-12,강북구,0.0,0,1,0,1,2
9403,2019-01-12,강서구,0.0,0,2,0,1,3
9404,2019-01-12,관악구,0.0,0,4,0,1,5
9405,2019-01-12,광진구,0.0,0,3,0,2,5
9406,2019-01-12,구로구,0.0,0,6,0,0,6
9407,2019-01-12,금천구,0.0,0,4,0,0,4
9408,2019-01-12,노원구,0.0,0,9,2,6,17
9409,2019-01-12,도봉구,0.0,0,8,0,1,9
9410,2019-01-12,동대문구,0.0,0,0,0,7,7
9411,2019-01-12,동작구,0.0,0,0,0,0,0
9412,2019-01-12,마포구,0.0,0,2,1,2,5
9413,2019-01-12,서대문구,0.0,0,4,1,1,6
9414,2019-01-12,서초구,0.0,0,4,0,0,4
9415,2019-01-12,성동구,0.0,0,1,0,1,2
9416,2019-01-12,성북구,0.0,0,4,0,2,6
9417,2019-01-12,송파구,0.0,0,4,0,3,7
9418,2019-01-12,양천구,0.0,0,2,3,0,5
9419,2019-01-12,영등포구,0.0,0,10,1,1,12
9420,2019-01-12,용산구,0.0,0,5,0,2,7
9421,2019-01-12,은평구,0.0,0,4,0,3,7
9422,2019-01-12,종로구,0.0,0,5,0,0,5
9423,2019-01-12,중구,0.0,0,2,0,0,2
9424,2019-01-12,중랑구,0.0,0,1,0,1,2
9425,2019-01-13,강남구,0.0,0,1,0,0,1
9426,2019-01-13,강동구,0.0,0,1,0,0,1
9427,2019-01-13,강북구,0.0,0,2,0,0,2
9428,2019-01-13,강서구,0.0,0,4,1,1,6
9429,2019-01-13,관악구,0.0,0,5,1,1,7
9430,2019-01-13,광진구,0.0,0,8,0,1,9
9431,2019-01-13,구로구,0.0,0,2,0,2,4
9432,2019-01-13,금천구,0.0,0,3,0,1,4
9433,2019-01-13,노원구,0.0,0,6,0,2,8
9434,2019-01-13,도봉구,0.0,0,1,0,0,1
9435,2019-01-13,동대문구,0.0,0,3,0,1,4
9436,2019-01-13,동작구,0.0,0,3,1,1,5
9437,2019-01-13,마포구,0.0,0,4,1,1,6
9438,2019-01-13,서대문구,0.0,0,1,0,0,1
9439,2019-01-13,서초구,0.0,0,4,0,1,5
9440,2019-01-13,성동구,0.0,0,2,0,0,2
9441,2019-01-13,성북구,0.0,0,0,1,0,1
9442,2019-01-13,송파구,0.0,0,8,1,0,9
9443,2019-01-13,양천구,0.0,0,5,0,2,7
9444,2019-01-13,영등포구,0.0,0,7,0,0,7
9445,2019-01-13,용산구,0.0,0,0,0,0,0
9446,2019-01-13,은평구,0.0,0,1,0,0,1
9447,2019-01-13,종로구,0.0,0,5,0,1,6
9448,2019-01-13,중구,0.0,0,0,0,0,0
9449,2019-01-13,중랑구,0.0,0,3,0,1,4
9450,2019-01-14,강남구,0.0,0,9,1,4,14
9451,2019-01-14,강동구,0.0,0,1,0,0,1
9452,2019-01-14,강북구,0.0,0,1,0,3,4
9453,2019-01-14,강서구,0.0,0,4,2,0,6
9454,2019-01-14,관악구,0.0,0,1,1,2,4
9455,2019-01-14,광진구,0.0,0,1,0,0,1
9456,2019-01-14,구로구,0.0,1,1,0,1,3
9457,2019-01-14,금천구,0.0,0,0,0,2,2
9458,2019-01-14,노원구,0.0,0,2,0,0,2
9459,2019-01-14,도봉구,0.0,0,2,1,1,4
9460,2019-01-14,동대문구,0.0,0,3,0,0,3
9461,2019-01-14,동작구,0.0,0,2,0,2,4
9462,2019-01-14,마포구,0.0,0,5,0,0,5
9463,2019-01-14,서대문구,0.0,0,4,1,2,7
9464,2019-01-14,서초구,0.0,0,4,1,0,5
9465,2019-01-14,성동구,0.0,0,2,0,2,4
9466,2019-01-14,성북구,0.0,0,5,0,2,7
9467,2019-01-14,송파구,0.0,0,7,2,2,11
9468,2019-01-14,양천구,0.0,0,2,1,0,3
9469,2019-01-14,영등포구,0.0,0,4,1,3,8
9470,2019-01-14,용산구,0.0,0,5,0,1,6
9471,2019-01-14,은평구,0.0,0,3,0,1,4
9472,2019-01-14,종로구,0.0,0,3,0,1,4
9473,2019-01-14,중구,0.0,0,6,0,1,7
9474,2019-01-14,중랑구,0.0,0,3,4,2,9
9475,2019-01-15,강남구,0.0,0,7,0,1,8
9476,2019-01-15,강동구,0.0,0,3,0,1,4
9477,2019-01-15,강북구,0.0,0,0,0,1,1
9478,2019-01-15,강서구,0.0,0,4,0,2,6
9479,2019-01-15,관악구,0.0,0,4,0,0,4
9480,2019-01-15,광진구,0.0,0,8,0,2,10
9481,2019-01-15,구로구,0.0,0,7,0,0,7
9482,2019-01-15,금천구,0.0,0,2,0,0,2
9483,2019-01-15,노원구,0.0,0,3,0,1,4
9484,2019-01-15,도봉구,0.0,0,7,0,0,7
9485,2019-01-15,동대문구,0.0,0,2,0,2,4
9486,2019-01-15,동작구,0.0,0,4,0,2,6
9487,2019-01-15,마포구,0.0,0,11,3,2,16
9488,2019-01-15,서대문구,0.0,0,6,1,0,7
9489,2019-01-15,서초구,0.0,0,4,0,2,6
9490,2019-01-15,성동구,0.0,0,4,0,3,7
9491,2019-01-15,성북구,0.0,0,0,0,1,1
9492,2019-01-15,송파구,0.0,0,5,0,2,7
9493,2019-01-15,양천구,0.0,0,1,0,2,3
9494,2019-01-15,영등포구,0.0,0,4,2,3,9
9495,2019-01-15,용산구,0.0,0,5,0,2,7
9496,2019-01-15,은평구,0.0,0,1,0,0,1
9497,2019-01-15,종로구,0.0,0,6,0,1,7
9498,2019-01-15,중구,0.0,0,3,1,1,5
9499,2019-01-15,중랑구,0.0,0,2,1,1,4
9500,2019-01-16,강남구,0.0,1,15,0,2,18
9501,2019-01-16,강동구,0.0,0,0,0,1,1
9502,2019-01-16,강북구,0.0,0,2,1,1,4
9503,2019-01-16,강서구,0.0,0,2,0,1,3
9504,2019-01-16,관악구,0.0,0,7,2,1,10
9505,2019-01-16,광진구,0.0,0,3,0,0,3
9506,2019-01-16,구로구,0.0,0,11,0,2,13
9507,2019-01-16,금천구,0.0,0,3,1,0,4
9508,2019-01-16,노원구,0.0,0,3,1,3,7
9509,2019-01-16,도봉구,0.0,0,6,1,2,9
9510,2019-01-16,동대문구,0.0,0,2,0,0,2
9511,2019-01-16,동작구,0.0,0,2,0,0,2
9512,2019-01-16,마포구,0.0,0,5,1,0,6
9513,2019-01-16,서대문구,0.0,0,0,0,1,1
9514,2019-01-16,서초구,0.0,0,4,0,0,4
9515,2019-01-16,성동구,0.0,1,3,0,0,4
9516,2019-01-16,성북구,0.0,0,2,0,0,2
9517,2019-01-16,송파구,0.0,0,4,0,2,6
9518,2019-01-16,양천구,0.0,0,3,0,0,3
9519,2019-01-16,영등포구,0.0,0,9,1,0,10
9520,2019-01-16,용산구,0.0,0,2,0,1,3
9521,2019-01-16,은평구,0.0,0,8,0,2,10
9522,2019-01-16,종로구,0.0,0,2,1,1,4
9523,2019-01-16,중구,0.0,0,5,0,0,5
9524,2019-01-16,중랑구,0.0,0,1,0,0,1
9525,2019-01-17,강남구,0.0,0,6,1,3,10
9526,2019-01-17,강동구,0.0,1,1,1,2,5
9527,2019-01-17,강북구,0.0,0,4,0,2,6
9528,2019-01-17,강서구,0.0,0,5,0,2,7
9529,2019-01-17,관악구,0.0,0,1,0,2,3
9530,2019-01-17,광진구,0.0,0,0,0,0,0
9531,2019-01-17,구로구,0.0,0,10,0,2,12
9532,2019-01-17,금천구,0.0,0,2,0,0,2
9533,2019-01-17,노원구,0.0,0,6,0,2,8
9534,2019-01-17,도봉구,0.0,0,2,0,2,4
9535,2019-01-17,동대문구,0.0,0,3,1,2,6
9536,2019-01-17,동작구,0.0,1,4,0,3,8
9537,2019-01-17,마포구,0.0,0,4,0,0,4
9538,2019-01-17,서대문구,0.0,0,4,1,1,6
9539,2019-01-17,서초구,0.0,0,7,1,0,8
9540,2019-01-17,성동구,0.0,0,0,1,0,1
9541,2019-01-17,성북구,0.0,0,1,0,0,1
9542,2019-01-17,송파구,0.0,0,2,1,3,6
9543,2019-01-17,양천구,0.0,0,2,0,2,4
9544,2019-01-17,영등포구,0.0,0,7,0,1,8
9545,2019-01-17,용산구,0.0,0,2,0,0,2
9546,2019-01-17,은평구,0.0,0,5,0,0,5
9547,2019-01-17,종로구,0.0,0,1,0,3,4
9548,2019-01-17,중구,0.0,0,2,0,0,2
9549,2019-01-17,중랑구,0.0,0,3,1,1,5
9550,2019-01-18,강남구,0.0,0,13,1,1,15
9551,2019-01-18,강동구,0.0,0,5,1,1,7
9552,2019-01-18,강북구,0.0,0,2,0,2,4
9553,2019-01-18,강서구,0.0,0,10,0,1,11
9554,2019-01-18,관악구,0.0,0,3,0,4,7
9555,2019-01-18,광진구,0.0,0,5,1,0,6
9556,2019-01-18,구로구,0.0,1,7,1,2,11
9557,2019-01-18,금천구,0.0,0,5,0,0,5
9558,2019-01-18,노원구,0.0,0,3,0,0,3
9559,2019-01-18,도봉구,0.0,1,4,0,0,5
9560,2019-01-18,동대문구,0.0,0,4,0,1,5
9561,2019-01-18,동작구,0.0,0,3,0,1,4
9562,2019-01-18,마포구,0.0,0,4,2,0,6
9563,2019-01-18,서대문구,0.0,0,1,0,0,1
9564,2019-01-18,서초구,0.0,0,6,0,2,8
9565,2019-01-18,성동구,0.0,0,4,0,0,4
9566,2019-01-18,성북구,0.0,0,6,0,0,6
9567,2019-01-18,송파구,0.0,0,7,0,2,9
9568,2019-01-18,양천구,0.0,0,6,0,0,6
9569,2019-01-18,영등포구,0.0,0,5,0,2,7
9570,2019-01-18,용산구,0.0,0,2,0,3,5
9571,2019-01-18,은평구,0.0,0,0,0,0,0
9572,2019-01-18,종로구,0.0,0,1,0,2,3
9573,2019-01-18,중구,0.0,0,2,0,2,4
9574,2019-01-18,중랑구,0.0,0,2,0,0,2
9575,2019-01-19,강남구,0.0,0,8,0,2,10
9576,2019-01-19,강동구,0.0,0,5,0,0,5
9577,2019-01-19,강북구,0.0,0,3,0,1,4
9578,2019-01-19,강서구,0.0,0,5,0,1,6
9579,2019-01-19,관악구,0.0,0,0,0,2,2
9580,2019-01-19,광진구,0.0,0,4,0,0,4
9581,2019-01-19,구로구,0.0,1,4,0,1,6
9582,2019-01-19,금천구,0.0,0,0,0,1,1
9583,2019-01-19,노원구,0.0,0,3,1,1,5
9584,2019-01-19,도봉구,0.0,0,1,0,1,2
9585,2019-01-19,동대문구,0.0,0,7,1,0,8
9586,2019-01-19,동작구,0.0,0,6,0,2,8
9587,2019-01-19,마포구,0.0,0,6,0,0,6
9588,2019-01-19,서대문구,0.0,0,2,0,0,2
9589,2019-01-19,서초구,0.0,0,9,2,2,13
9590,2019-01-19,성동구,0.0,0,1,0,0,1
9591,2019-01-19,성북구,0.0,0,9,1,2,12
9592,2019-01-19,송파구,0.0,0,6,0,3,9
9593,2019-01-19,양천구,0.0,0,4,0,3,7
9594,2019-01-19,영등포구,0.0,0,11,0,3,14
9595,2019-01-19,용산구,0.0,0,5,0,0,5
9596,2019-01-19,은평구,0.0,0,2,0,3,5
9597,2019-01-19,종로구,0.0,0,6,1,1,8
9598,2019-01-19,중구,0.0,0,1,0,0,1
9599,2019-01-19,중랑구,0.0,0,4,0,3,7
9600,2019-01-20,강남구,0.0,0,6,1,3,10
9601,2019-01-20,강동구,0.0,0,0,0,1,1
9602,2019-01-20,강북구,0.0,0,7,0,5,12
9603,2019-01-20,강서구,0.0,0,6,0,2,8
9604,2019-01-20,관악구,0.0,0,2,1,3,6
9605,2019-01-20,광진구,0.0,0,0,1,0,1
9606,2019-01-20,구로구,0.0,0,5,0,2,7
9607,2019-01-20,금천구,0.0,0,1,0,0,1
9608,2019-01-20,노원구,0.0,0,4,0,2,6
9609,2019-01-20,도봉구,0.0,0,3,0,0,3
9610,2019-01-20,동대문구,0.0,0,0,0,0,0
9611,2019-01-20,동작구,0.0,0,2,0,0,2
9612,2019-01-20,마포구,0.0,0,5,1,1,7
9613,2019-01-20,서대문구,0.0,0,3,1,2,6
9614,2019-01-20,서초구,0.0,0,8,0,5,13
9615,2019-01-20,성동구,0.0,0,0,0,0,0
9616,2019-01-20,성북구,0.0,0,2,0,1,3
9617,2019-01-20,송파구,0.0,0,5,0,0,5
9618,2019-01-20,양천구,0.0,0,3,0,3,6
9619,2019-01-20,영등포구,0.0,0,4,2,1,7
9620,2019-01-20,용산구,0.0,0,8,0,1,9
9621,2019-01-20,은평구,0.0,0,4,0,2,6
9622,2019-01-20,종로구,0.0,0,0,0,0,0
9623,2019-01-20,중구,0.0,0,5,1,0,6
9624,2019-01-20,중랑구,0.0,0,3,0,0,3
9625,2019-01-21,강남구,0.0,0,5,0,2,7
9626,2019-01-21,강동구,0.0,0,9,0,2,11
9627,2019-01-21,강북구,0.0,0,2,0,3,5
9628,2019-01-21,강서구,0.0,0,3,0,0,3
9629,2019-01-21,관악구,0.0,0,1,0,0,1
9630,2019-01-21,광진구,0.0,0,1,0,0,1
9631,2019-01-21,구로구,0.0,1,5,0,1,7
9632,2019-01-21,금천구,0.0,1,0,0,0,1
9633,2019-01-21,노원구,0.0,0,1,0,2,3
9634,2019-01-21,도봉구,0.0,0,5,3,0,8
9635,2019-01-21,동대문구,0.0,0,2,0,0,2
9636,2019-01-21,동작구,0.0,0,0,0,0,0
9637,2019-01-21,마포구,0.0,0,4,0,0,4
9638,2019-01-21,서대문구,0.0,0,1,0,0,1
9639,2019-01-21,서초구,0.0,0,11,1,5,17
9640,2019-01-21,성동구,0.0,0,0,0,0,0
9641,2019-01-21,성북구,0.0,0,1,0,1,2
9642,2019-01-21,송파구,0.0,0,8,2,1,11
9643,2019-01-21,양천구,0.0,0,1,0,1,2
9644,2019-01-21,영등포구,0.0,0,7,0,6,13
9645,2019-01-21,용산구,0.0,0,3,0,1,4
9646,2019-01-21,은평구,0.0,0,2,0,0,2
9647,2019-01-21,종로구,0.0,0,3,0,0,3
9648,2019-01-21,중구,0.0,0,2,1,1,4
9649,2019-01-21,중랑구,0.0,0,1,1,0,2
9650,2019-01-22,강남구,0.0,1,10,2,3,16
9651,2019-01-22,강동구,0.0,0,5,0,2,7
9652,2019-01-22,강북구,0.0,0,3,0,0,3
9653,2019-01-22,강서구,0.0,0,5,1,1,7
9654,2019-01-22,관악구,0.0,0,0,0,2,2
9655,2019-01-22,광진구,0.0,0,0,0,2,2
9656,2019-01-22,구로구,0.0,0,3,1,2,6
9657,2019-01-22,금천구,0.0,1,0,0,0,1
9658,2019-01-22,노원구,0.0,0,2,0,0,2
9659,2019-01-22,도봉구,0.0,0,3,0,1,4
9660,2019-01-22,동대문구,0.0,0,0,0,2,2
9661,2019-01-22,동작구,0.0,0,1,0,0,1
9662,2019-01-22,마포구,0.0,0,2,1,2,5
9663,2019-01-22,서대문구,0.0,0,0,1,2,3
9664,2019-01-22,서초구,0.0,0,16,2,4,22
9665,2019-01-22,성동구,0.0,0,2,0,2,4
9666,2019-01-22,성북구,0.0,0,2,2,0,4
9667,2019-01-22,송파구,0.0,0,3,1,3,7
9668,2019-01-22,양천구,0.0,0,11,0,2,13
9669,2019-01-22,영등포구,0.0,0,3,1,2,6
9670,2019-01-22,용산구,0.0,0,5,0,1,6
9671,2019-01-22,은평구,0.0,0,2,0,0,2
9672,2019-01-22,종로구,0.0,0,10,0,1,11
9673,2019-01-22,중구,0.0,0,0,0,0,0
9674,2019-01-22,중랑구,0.0,0,2,0,2,4
9675,2019-01-23,강남구,0.0,0,13,5,0,18
9676,2019-01-23,강동구,0.0,0,3,0,2,5
9677,2019-01-23,강북구,0.0,0,3,0,2,5
9678,2019-01-23,강서구,0.0,0,1,1,0,2
9679,2019-01-23,관악구,0.0,0,3,1,0,4
9680,2019-01-23,광진구,0.0,0,0,0,0,0
9681,2019-01-23,구로구,0.0,0,0,0,0,0
9682,2019-01-23,금천구,0.0,0,1,1,0,2
9683,2019-01-23,노원구,0.0,0,6,0,2,8
9684,2019-01-23,도봉구,0.0,0,0,0,1,1
9685,2019-01-23,동대문구,0.0,0,1,0,0,1
9686,2019-01-23,동작구,0.0,0,2,0,1,3
9687,2019-01-23,마포구,0.0,0,0,1,1,2
9688,2019-01-23,서대문구,0.0,0,2,0,3,5
9689,2019-01-23,서초구,0.0,0,6,1,4,11
9690,2019-01-23,성동구,0.0,0,2,0,0,2
9691,2019-01-23,성북구,0.0,0,2,0,0,2
9692,2019-01-23,송파구,0.0,0,14,1,3,18
9693,2019-01-23,양천구,0.0,0,3,0,2,5
9694,2019-01-23,영등포구,0.0,0,5,3,3,11
9695,2019-01-23,용산구,0.0,0,5,0,0,5
9696,2019-01-23,은평구,0.0,0,1,0,0,1
9697,2019-01-23,종로구,0.0,1,0,0,0,1
9698,2019-01-23,중구,0.0,0,9,1,3,13
9699,2019-01-23,중랑구,0.0,0,1,1,2,4
9700,2019-01-24,강남구,0.0,0,17,7,2,26
9701,2019-01-24,강동구,0.0,0,5,0,1,6
9702,2019-01-24,강북구,0.0,0,1,0,0,1
9703,2019-01-24,강서구,0.0,0,9,0,2,11
9704,2019-01-24,관악구,0.0,0,4,1,1,6
9705,2019-01-24,광진구,0.0,0,2,0,0,2
9706,2019-01-24,구로구,0.0,0,2,0,2,4
9707,2019-01-24,금천구,0.0,0,1,0,0,1
9708,2019-01-24,노원구,0.0,0,3,0,5,8
9709,2019-01-24,도봉구,0.0,0,1,0,0,1
9710,2019-01-24,동대문구,0.0,0,0,0,5,5
9711,2019-01-24,동작구,0.0,0,1,1,4,6
9712,2019-01-24,마포구,0.0,0,3,0,0,3
9713,2019-01-24,서대문구,0.0,0,0,0,2,2
9714,2019-01-24,서초구,0.0,0,8,0,1,9
9715,2019-01-24,성동구,0.0,1,4,0,1,6
9716,2019-01-24,성북구,0.0,0,2,1,0,3
9717,2019-01-24,송파구,0.0,0,12,1,2,15
9718,2019-01-24,양천구,0.0,0,6,0,0,6
9719,2019-01-24,영등포구,0.0,0,10,1,1,12
9720,2019-01-24,용산구,0.0,0,4,0,0,4
9721,2019-01-24,은평구,0.0,0,1,0,0,1
9722,2019-01-24,종로구,0.0,0,0,0,0,0
9723,2019-01-24,중구,0.0,0,3,1,1,5
9724,2019-01-24,중랑구,0.0,0,6,0,0,6
9725,2019-01-25,강남구,0.0,0,21,0,1,22
9726,2019-01-25,강동구,0.0,0,3,0,0,3
9727,2019-01-25,강북구,0.0,0,3,0,0,3
9728,2019-01-25,강서구,0.0,0,3,0,2,5
9729,2019-01-25,관악구,0.0,0,2,0,0,2
9730,2019-01-25,광진구,0.0,0,0,0,0,0
9731,2019-01-25,구로구,0.0,0,1,0,0,1
9732,2019-01-25,금천구,0.0,0,5,0,0,5
9733,2019-01-25,노원구,0.0,0,6,0,1,7
9734,2019-01-25,도봉구,0.0,2,1,1,2,6
9735,2019-01-25,동대문구,0.0,0,3,0,1,4
9736,2019-01-25,동작구,0.0,0,5,0,0,5
9737,2019-01-25,마포구,0.0,0,3,0,2,5
9738,2019-01-25,서대문구,0.0,0,5,1,0,6
9739,2019-01-25,서초구,0.0,0,6,2,1,9
9740,2019-01-25,성동구,0.0,0,10,1,3,14
9741,2019-01-25,성북구,0.0,0,3,0,0,3
9742,2019-01-25,송파구,0.0,0,27,1,5,33
9743,2019-01-25,양천구,0.0,0,3,0,0,3
9744,2019-01-25,영등포구,0.0,0,7,1,2,10
9745,2019-01-25,용산구,0.0,0,1,0,2,3
9746,2019-01-25,은평구,0.0,0,3,1,3,7
9747,2019-01-25,종로구,0.0,0,2,0,0,2
9748,2019-01-25,중구,0.0,0,6,0,1,7
9749,2019-01-25,중랑구,0.0,0,5,1,2,8
9750,2019-01-26,강남구,0.0,0,11,1,1,13
9751,2019-01-26,강동구,0.0,0,7,1,2,10
9752,2019-01-26,강북구,0.0,0,0,0,0,0
9753,2019-01-26,강서구,0.0,0,6,0,0,6
9754,2019-01-26,관악구,0.0,0,1,0,0,1
9755,2019-01-26,광진구,0.0,0,1,0,0,1
9756,2019-01-26,구로구,0.0,0,1,0,2,3
9757,2019-01-26,금천구,0.0,0,1,1,0,2
9758,2019-01-26,노원구,0.0,0,4,1,3,8
9759,2019-01-26,도봉구,0.0,0,2,0,0,2
9760,2019-01-26,동대문구,0.0,0,4,0,1,5
9761,2019-01-26,동작구,0.0,0,5,0,0,5
9762,2019-01-26,마포구,0.0,0,4,0,1,5
9763,2019-01-26,서대문구,0.0,0,4,1,1,6
9764,2019-01-26,서초구,0.0,0,22,0,5,27
9765,2019-01-26,성동구,0.0,0,2,0,1,3
9766,2019-01-26,성북구,0.0,0,6,0,1,7
9767,2019-01-26,송파구,0.0,0,3,2,1,6
9768,2019-01-26,양천구,0.0,0,2,0,0,2
9769,2019-01-26,영등포구,0.0,0,4,1,1,6
9770,2019-01-26,용산구,0.0,0,3,0,1,4
9771,2019-01-26,은평구,0.0,0,2,0,0,2
9772,2019-01-26,종로구,0.0,0,1,0,0,1
9773,2019-01-26,중구,0.0,0,3,0,2,5
9774,2019-01-26,중랑구,0.0,0,2,0,0,2
9775,2019-01-27,강남구,0.0,0,9,2,1,12
9776,2019-01-27,강동구,0.0,0,2,0,0,2
9777,2019-01-27,강북구,0.0,0,3,0,0,3
9778,2019-01-27,강서구,0.0,0,1,1,2,4
9779,2019-01-27,관악구,0.0,0,1,0,1,2
9780,2019-01-27,광진구,0.0,0,2,0,0,2
9781,2019-01-27,구로구,0.0,0,3,0,2,5
9782,2019-01-27,금천구,0.0,0,3,0,0,3
9783,2019-01-27,노원구,0.0,0,4,0,1,5
9784,2019-01-27,도봉구,0.0,0,2,0,0,2
9785,2019-01-27,동대문구,0.0,0,1,0,4,5
9786,2019-01-27,동작구,0.0,0,0,0,1,1
9787,2019-01-27,마포구,0.0,0,3,0,0,3
9788,2019-01-27,서대문구,0.0,0,0,0,0,0
9789,2019-01-27,서초구,0.0,0,2,0,0,2
9790,2019-01-27,성동구,0.0,0,2,1,1,4
9791,2019-01-27,성북구,0.0,0,5,1,1,7
9792,2019-01-27,송파구,0.0,0,5,2,1,8
9793,2019-01-27,양천구,0.0,0,2,0,0,2
9794,2019-01-27,영등포구,0.0,0,2,1,3,6
9795,2019-01-27,용산구,0.0,0,4,0,3,7
9796,2019-01-27,은평구,0.0,0,1,0,3,4
9797,2019-01-27,종로구,0.0,0,0,0,0,0
9798,2019-01-27,중구,0.0,0,0,0,2,2
9799,2019-01-27,중랑구,0.0,0,0,0,0,0
9800,2019-01-28,강남구,0.0,0,10,0,2,12
9801,2019-01-28,강동구,0.0,0,2,0,0,2
9802,2019-01-28,강북구,0.0,0,3,0,0,3
9803,2019-01-28,강서구,0.0,0,2,1,0,3
9804,2019-01-28,관악구,0.0,0,7,2,1,10
9805,2019-01-28,광진구,0.0,0,1,0,1,2
9806,2019-01-28,구로구,0.0,0,2,0,1,3
9807,2019-01-28,금천구,0.0,0,14,0,1,15
9808,2019-01-28,노원구,0.0,0,8,0,1,9
9809,2019-01-28,도봉구,0.0,0,2,2,0,4
9810,2019-01-28,동대문구,0.0,0,1,0,1,2
9811,2019-01-28,동작구,0.0,0,1,0,1,2
9812,2019-01-28,마포구,0.0,0,1,0,1,2
9813,2019-01-28,서대문구,0.0,0,4,0,3,7
9814,2019-01-28,서초구,0.0,0,7,1,2,10
9815,2019-01-28,성동구,0.0,0,4,0,1,5
9816,2019-01-28,성북구,0.0,0,4,0,4,8
9817,2019-01-28,송파구,0.0,0,9,2,5,16
9818,2019-01-28,양천구,0.0,0,4,0,1,5
9819,2019-01-28,영등포구,0.25,0,4,2,0,6
9820,2019-01-28,용산구,0.0,0,1,0,1,2
9821,2019-01-28,은평구,0.0,0,3,0,2,5
9822,2019-01-28,종로구,0.0,0,4,0,0,4
9823,2019-01-28,중구,0.0,0,9,0,2,11
9824,2019-01-28,중랑구,0.0,0,3,1,2,6
9825,2019-01-29,강남구,0.0,0,8,2,2,12
9826,2019-01-29,강동구,0.0,0,2,0,0,2
9827,2019-01-29,강북구,0.0,0,5,0,1,6
9828,2019-01-29,강서구,0.0,0,2,0,0,2
9829,2019-01-29,관악구,0.0,0,1,0,3,4
9830,2019-01-29,광진구,0.0,0,3,0,0,3
9831,2019-01-29,구로구,0.0,0,2,0,3,5
9832,2019-01-29,금천구,0.0,0,3,0,0,3
9833,2019-01-29,노원구,0.0,0,2,0,0,2
9834,2019-01-29,도봉구,0.0,0,5,0,0,5
9835,2019-01-29,동대문구,0.0,0,0,1,1,2
9836,2019-01-29,동작구,0.0,0,3,0,0,3
9837,2019-01-29,마포구,0.0,0,4,0,1,5
9838,2019-01-29,서대문구,0.0,0,2,0,1,3
9839,2019-01-29,서초구,0.0,0,12,1,2,15
9840,2019-01-29,성동구,0.0,0,3,0,4,7
9841,2019-01-29,성북구,0.0,0,4,0,1,5
9842,2019-01-29,송파구,0.0,0,8,0,2,10
9843,2019-01-29,양천구,0.0,0,5,1,1,7
9844,2019-01-29,영등포구,0.0,0,9,0,0,9
9845,2019-01-29,용산구,0.0,0,6,0,1,7
9846,2019-01-29,은평구,0.0,0,1,0,0,1
9847,2019-01-29,종로구,0.0,0,1,2,0,3
9848,2019-01-29,중구,0.0,1,2,1,0,4
9849,2019-01-29,중랑구,0.0,0,4,1,1,6
9850,2019-01-30,강남구,0.0,0,10,0,1,11
9851,2019-01-30,강동구,0.0,0,1,1,0,2
9852,2019-01-30,강북구,0.0,0,1,0,2,3
9853,2019-01-30,강서구,0.0,0,8,0,2,10
9854,2019-01-30,관악구,0.0,0,10,0,1,11
9855,2019-01-30,광진구,0.0,0,0,0,0,0
9856,2019-01-30,구로구,0.0,0,1,0,0,1
9857,2019-01-30,금천구,0.0,0,0,0,1,1
9858,2019-01-30,노원구,0.0,0,6,0,2,8
9859,2019-01-30,도봉구,0.0,0,0,0,2,2
9860,2019-01-30,동대문구,0.0,0,2,0,2,4
9861,2019-01-30,동작구,0.0,0,4,1,3,8
9862,2019-01-30,마포구,0.0,0,8,0,1,9
9863,2019-01-30,서대문구,0.0,0,2,0,1,3
9864,2019-01-30,서초구,0.0,0,15,0,1,16
9865,2019-01-30,성동구,0.0,0,5,2,0,7
9866,2019-01-30,성북구,0.0,0,5,0,3,8
9867,2019-01-30,송파구,0.0,0,4,1,1,6
9868,2019-01-30,양천구,0.0,1,5,2,2,10
9869,2019-01-30,영등포구,0.0,0,7,0,1,8
9870,2019-01-30,용산구,0.0,1,1,0,1,3
9871,2019-01-30,은평구,0.0,1,2,0,2,5
9872,2019-01-30,종로구,0.0,0,1,0,1,2
9873,2019-01-30,중구,0.0,0,4,0,3,7
9874,2019-01-30,중랑구,0.0,0,7,1,2,10
9875,2019-01-31,강남구,0.0,0,8,3,6,17
9876,2019-01-31,강동구,0.0,0,2,0,1,3
9877,2019-01-31,강북구,0.0,0,1,0,0,1
9878,2019-01-31,강서구,0.0,0,5,0,2,7
9879,2019-01-31,관악구,0.0,0,7,3,2,12
9880,2019-01-31,광진구,0.0,0,0,0,0,0
9881,2019-01-31,구로구,0.0,1,6,0,4,11
9882,2019-01-31,금천구,0.0,0,5,0,1,6
9883,2019-01-31,노원구,0.0,0,3,0,0,3
9884,2019-01-31,도봉구,0.0,0,1,0,0,1
9885,2019-01-31,동대문구,0.0,0,8,0,4,12
9886,2019-01-31,동작구,0.0,0,2,2,2,6
9887,2019-01-31,마포구,0.0,0,1,0,0,1
9888,2019-01-31,서대문구,0.0,0,3,0,0,3
9889,2019-01-31,서초구,0.0,0,7,1,5,13
9890,2019-01-31,성동구,0.0,0,0,0,1,1
9891,2019-01-31,성북구,0.0,0,1,0,3,4
9892,2019-01-31,송파구,0.0,0,11,0,2,13
9893,2019-01-31,양천구,0.0,0,1,0,2,3
9894,2019-01-31,영등포구,0.0,0,6,0,1,7
9895,2019-01-31,용산구,0.0,0,3,1,0,4
9896,2019-01-31,은평구,0.0,0,1,1,1,3
9897,2019-01-31,종로구,0.0,0,6,1,0,7
9898,2019-01-31,중구,0.0,0,5,0,0,5
9899,2019-01-31,중랑구,0.0,0,5,1,2,8
9900,2019-02-01,강남구,0.0,0,5,0,1,6
9901,2019-02-01,강동구,0.0,0,4,1,3,8
9902,2019-02-01,강북구,0.0,0,0,0,1,1
9903,2019-02-01,강서구,0.0,0,2,0,2,4
9904,2019-02-01,관악구,0.0,0,2,0,1,3
9905,2019-02-01,광진구,0.0,0,0,0,1,1
9906,2019-02-01,구로구,0.0,0,10,0,5,15
9907,2019-02-01,금천구,0.0,0,1,0,1,2
9908,2019-02-01,노원구,0.0,0,6,2,1,9
9909,2019-02-01,도봉구,0.0,0,2,0,1,3
9910,2019-02-01,동대문구,0.0,0,5,0,2,7
9911,2019-02-01,동작구,0.0,0,9,1,0,10
9912,2019-02-01,마포구,0.0,0,4,1,1,6
9913,2019-02-01,서대문구,0.0,0,6,0,1,7
9914,2019-02-01,서초구,0.0,0,17,2,4,23
9915,2019-02-01,성동구,0.0,0,4,2,1,7
9916,2019-02-01,성북구,0.0,0,5,0,0,5
9917,2019-02-01,송파구,0.0,0,9,2,0,11
9918,2019-02-01,양천구,0.0,0,0,2,0,2
9919,2019-02-01,영등포구,0.0,0,4,0,3,7
9920,2019-02-01,용산구,0.0,0,4,0,1,5
9921,2019-02-01,은평구,0.0,0,0,0,1,1
9922,2019-02-01,종로구,0.3,0,3,0,0,3
9923,2019-02-01,중구,0.0,0,1,0,0,1
9924,2019-02-01,중랑구,0.0,0,4,1,1,6
9925,2019-02-02,강남구,0.0,0,4,1,1,6
9926,2019-02-02,강동구,0.0,0,2,0,0,2
9927,2019-02-02,강북구,0.0,0,3,1,0,4
9928,2019-02-02,강서구,0.0,0,2,0,0,2
9929,2019-02-02,관악구,0.0,0,0,0,2,2
9930,2019-02-02,광진구,0.0,0,5,0,1,6
9931,2019-02-02,구로구,0.0,0,2,0,2,4
9932,2019-02-02,금천구,0.0,0,1,0,0,1
9933,2019-02-02,노원구,0.0,0,2,1,0,3
9934,2019-02-02,도봉구,0.0,0,4,0,1,5
9935,2019-02-02,동대문구,0.0,0,1,1,1,3
9936,2019-02-02,동작구,0.0,0,2,0,0,2
9937,2019-02-02,마포구,0.0,0,0,0,0,0
9938,2019-02-02,서대문구,0.0,0,0,0,0,0
9939,2019-02-02,서초구,0.0,0,4,0,1,5
9940,2019-02-02,성동구,0.0,0,1,0,0,1
9941,2019-02-02,성북구,0.0,0,1,0,0,1
9942,2019-02-02,송파구,0.0,0,5,2,2,9
9943,2019-02-02,양천구,0.0,0,2,0,0,2
9944,2019-02-02,영등포구,0.0,0,8,0,1,9
9945,2019-02-02,용산구,0.0,0,1,0,0,1
9946,2019-02-02,은평구,0.0,0,3,0,6,9
9947,2019-02-02,종로구,0.0,0,0,1,0,1
9948,2019-02-02,중구,0.0,0,0,0,1,1
9949,2019-02-02,중랑구,0.0,0,8,3,1,12
9950,2019-02-03,강남구,21.0,0,13,1,0,14
9951,2019-02-03,강동구,19.5,0,12,0,3,15
9952,2019-02-03,강북구,18.5,0,2,0,1,3
9953,2019-02-03,강서구,19.0,0,2,1,1,4
9954,2019-02-03,관악구,24.5,0,1,1,2,4
9955,2019-02-03,광진구,25.5,0,2,0,0,2
9956,2019-02-03,구로구,19.0,0,5,1,2,8
9957,2019-02-03,금천구,16.0,0,2,0,0,2
9958,2019-02-03,노원구,18.5,0,9,0,1,10
9959,2019-02-03,도봉구,24.0,0,2,1,0,3
9960,2019-02-03,동대문구,21.5,0,2,0,0,2
9961,2019-02-03,동작구,21.5,0,2,0,2,4
9962,2019-02-03,마포구,16.5,0,7,1,2,10
9963,2019-02-03,서대문구,17.0,0,0,0,4,4
9964,2019-02-03,서초구,23.0,0,3,0,3,6
9965,2019-02-03,성동구,23.5,0,0,0,0,0
9966,2019-02-03,성북구,20.0,0,3,0,0,3
9967,2019-02-03,송파구,0.0,0,8,1,1,10
9968,2019-02-03,양천구,18.5,0,6,1,1,8
9969,2019-02-03,영등포구,8.75,1,1,0,3,5
9970,2019-02-03,용산구,21.0,0,5,0,0,5
9971,2019-02-03,은평구,18.5,0,2,0,0,2
9972,2019-02-03,종로구,16.0,0,0,0,0,0
9973,2019-02-03,중구,10.5,0,1,0,0,1
9974,2019-02-03,중랑구,21.5,0,2,0,1,3
9975,2019-02-04,강남구,0.0,0,3,0,0,3
9976,2019-02-04,강동구,0.0,0,0,0,0,0
9977,2019-02-04,강북구,0.0,0,0,1,0,1
9978,2019-02-04,강서구,0.0,0,8,0,0,8
9979,2019-02-04,관악구,0.0,0,6,0,0,6
9980,2019-02-04,광진구,0.0,0,1,0,2,3
9981,2019-02-04,구로구,0.0,0,1,0,1,2
9982,2019-02-04,금천구,0.0,0,2,0,0,2
9983,2019-02-04,노원구,0.0,0,6,0,0,6
9984,2019-02-04,도봉구,0.0,0,1,0,2,3
9985,2019-02-04,동대문구,0.0,0,4,0,1,5
9986,2019-02-04,동작구,0.0,0,0,0,0,0
9987,2019-02-04,마포구,0.0,0,1,0,0,1
9988,2019-02-04,서대문구,0.0,0,0,0,0,0
9989,2019-02-04,서초구,0.0,0,4,0,3,7
9990,2019-02-04,성동구,0.0,0,0,0,0,0
9991,2019-02-04,성북구,0.0,0,1,0,0,1
9992,2019-02-04,송파구,0.0,0,5,1,0,6
9993,2019-02-04,양천구,0.0,0,3,0,1,4
9994,2019-02-04,영등포구,0.0,0,2,0,2,4
9995,2019-02-04,용산구,0.0,0,0,0,3,3
9996,2019-02-04,은평구,0.0,0,2,1,1,4
9997,2019-02-04,종로구,0.0,0,2,1,1,4
9998,2019-02-04,중구,0.0,0,0,0,0,0
9999,2019-02-04,중랑구,0.0,0,1,0,0,1
10000,2019-02-05,강남구,0.0,0,1,1,2,4
10001,2019-02-05,강동구,0.0,0,2,1,0,3
10002,2019-02-05,강북구,0.0,0,0,0,1,1
10003,2019-02-05,강서구,0.0,0,3,0,0,3
10004,2019-02-05,관악구,0.0,0,3,0,0,3
10005,2019-02-05,광진구,0.0,0,0,1,1,2
10006,2019-02-05,구로구,0.0,0,1,0,0,1
10007,2019-02-05,금천구,0.0,0,1,1,0,2
10008,2019-02-05,노원구,0.0,0,0,0,0,0
10009,2019-02-05,도봉구,0.0,0,2,1,1,4
10010,2019-02-05,동대문구,0.0,0,4,0,0,4
10011,2019-02-05,동작구,0.0,0,2,2,1,5
10012,2019-02-05,마포구,0.0,0,1,0,1,2
10013,2019-02-05,서대문구,0.0,0,0,0,1,1
10014,2019-02-05,서초구,0.0,0,4,0,0,4
10015,2019-02-05,성동구,0.0,0,2,0,0,2
10016,2019-02-05,성북구,0.0,0,0,0,0,0
10017,2019-02-05,송파구,0.0,0,1,0,1,2
10018,2019-02-05,양천구,0.0,0,0,0,0,0
10019,2019-02-05,영등포구,0.0,0,4,0,0,4
10020,2019-02-05,용산구,0.0,0,2,0,1,3
10021,2019-02-05,은평구,0.0,0,0,0,0,0
10022,2019-02-05,종로구,0.0,0,1,1,0,2
10023,2019-02-05,중구,0.0,0,0,0,1,1
10024,2019-02-05,중랑구,0.0,0,0,0,1,1
10025,2019-02-06,강남구,0.0,0,1,1,0,2
10026,2019-02-06,강동구,0.0,0,3,0,1,4
10027,2019-02-06,강북구,0.0,0,10,1,2,13
10028,2019-02-06,강서구,0.0,0,3,0,0,3
10029,2019-02-06,관악구,0.0,0,4,0,1,5
10030,2019-02-06,광진구,0.0,0,2,0,0,2
10031,2019-02-06,구로구,0.0,0,1,0,2,3
10032,2019-02-06,금천구,0.0,0,4,0,0,4
10033,2019-02-06,노원구,0.0,0,1,0,0,1
10034,2019-02-06,도봉구,0.0,0,0,0,0,0
10035,2019-02-06,동대문구,0.0,0,2,0,0,2
10036,2019-02-06,동작구,0.0,0,0,0,0,0
10037,2019-02-06,마포구,0.0,0,1,0,0,1
10038,2019-02-06,서대문구,0.0,0,0,0,1,1
10039,2019-02-06,서초구,0.0,0,0,0,0,0
10040,2019-02-06,성동구,0.0,0,1,0,0,1
10041,2019-02-06,성북구,0.0,0,0,0,0,0
10042,2019-02-06,송파구,0.0,1,3,0,1,5
10043,2019-02-06,양천구,0.0,0,5,1,1,7
10044,2019-02-06,영등포구,0.0,0,1,1,1,3
10045,2019-02-06,용산구,0.0,0,2,0,0,2
10046,2019-02-06,은평구,0.0,0,0,0,0,0
10047,2019-02-06,종로구,0.0,0,2,0,1,3
10048,2019-02-06,중구,0.0,0,1,0,3,4
10049,2019-02-06,중랑구,0.0,0,4,0,1,5
10050,2019-02-07,강남구,0.0,0,7,1,2,10
10051,2019-02-07,강동구,0.5,0,3,0,0,3
10052,2019-02-07,강북구,0.0,0,1,0,0,1
10053,2019-02-07,강서구,0.0,0,6,0,0,6
10054,2019-02-07,관악구,0.0,0,5,0,0,5
10055,2019-02-07,광진구,0.0,0,3,0,3,6
10056,2019-02-07,구로구,0.0,1,3,0,0,4
10057,2019-02-07,금천구,0.0,0,0,0,1,1
10058,2019-02-07,노원구,0.0,0,2,0,3,5
10059,2019-02-07,도봉구,0.0,0,0,0,2,2
10060,2019-02-07,동대문구,0.5,0,5,0,1,6
10061,2019-02-07,동작구,0.25,0,0,0,0,0
10062,2019-02-07,마포구,0.0,0,11,0,0,11
10063,2019-02-07,서대문구,0.0,0,4,1,1,6
10064,2019-02-07,서초구,0.0,0,1,0,2,3
10065,2019-02-07,성동구,0.5,0,1,0,0,1
10066,2019-02-07,성북구,0.0,0,4,0,1,5
10067,2019-02-07,송파구,0.0,0,10,1,2,13
10068,2019-02-07,양천구,0.0,0,3,0,0,3
10069,2019-02-07,영등포구,0.0,0,2,1,2,5
10070,2019-02-07,용산구,0.0,0,5,0,0,5
10071,2019-02-07,은평구,0.0,0,6,1,0,7
10072,2019-02-07,종로구,0.5,0,1,1,1,3
10073,2019-02-07,중구,0.0,0,0,0,0,0
10074,2019-02-07,중랑구,0.0,0,4,0,2,6
10075,2019-02-08,강남구,0.0,0,10,1,2,13
10076,2019-02-08,강동구,0.0,0,2,1,1,4
10077,2019-02-08,강북구,0.0,0,1,0,1,2
10078,2019-02-08,강서구,0.0,0,4,0,0,4
10079,2019-02-08,관악구,0.0,0,7,0,0,7
10080,2019-02-08,광진구,0.0,0,0,0,0,0
10081,2019-02-08,구로구,0.0,0,4,0,2,6
10082,2019-02-08,금천구,0.0,0,0,0,0,0
10083,2019-02-08,노원구,0.0,0,2,2,1,5
10084,2019-02-08,도봉구,0.0,0,0,0,1,1
10085,2019-02-08,동대문구,0.0,0,5,0,2,7
10086,2019-02-08,동작구,0.0,0,2,0,4,6
10087,2019-02-08,마포구,0.0,1,7,1,0,9
10088,2019-02-08,서대문구,0.0,0,1,0,0,1
10089,2019-02-08,서초구,0.0,0,14,2,2,18
10090,2019-02-08,성동구,0.0,0,2,0,1,3
10091,2019-02-08,성북구,0.0,0,4,1,0,5
10092,2019-02-08,송파구,0.0,0,2,0,4,6
10093,2019-02-08,양천구,0.0,0,4,1,2,7
10094,2019-02-08,영등포구,0.0,0,4,0,2,6
10095,2019-02-08,용산구,0.0,0,0,0,2,2
10096,2019-02-08,은평구,0.0,0,4,0,2,6
10097,2019-02-08,종로구,0.0,0,0,0,1,1
10098,2019-02-08,중구,0.0,0,2,0,0,2
10099,2019-02-08,중랑구,0.0,0,0,0,1,1
10100,2019-02-09,강남구,0.0,0,9,3,1,13
10101,2019-02-09,강동구,0.0,0,1,0,1,2
10102,2019-02-09,강북구,0.0,0,6,0,0,6
10103,2019-02-09,강서구,0.0,0,3,1,2,6
10104,2019-02-09,관악구,0.0,0,1,0,1,2
10105,2019-02-09,광진구,0.0,0,0,1,0,1
10106,2019-02-09,구로구,0.0,0,6,0,2,8
10107,2019-02-09,금천구,0.0,0,1,0,0,1
10108,2019-02-09,노원구,0.0,0,4,0,1,5
10109,2019-02-09,도봉구,0.0,0,0,0,0,0
10110,2019-02-09,동대문구,0.0,0,3,0,0,3
10111,2019-02-09,동작구,0.0,0,0,0,0,0
10112,2019-02-09,마포구,0.0,0,4,2,1,7
10113,2019-02-09,서대문구,0.0,0,0,0,0,0
10114,2019-02-09,서초구,0.0,0,3,0,0,3
10115,2019-02-09,성동구,0.0,0,3,0,0,3
10116,2019-02-09,성북구,0.0,0,3,1,0,4
10117,2019-02-09,송파구,0.0,0,3,2,2,7
10118,2019-02-09,양천구,0.0,0,4,0,0,4
10119,2019-02-09,영등포구,0.0,0,3,1,0,4
10120,2019-02-09,용산구,0.0,0,5,0,2,7
10121,2019-02-09,은평구,0.0,0,2,0,0,2
10122,2019-02-09,종로구,0.0,0,0,0,0,0
10123,2019-02-09,중구,0.0,0,0,0,1,1
10124,2019-02-09,중랑구,0.0,0,3,0,0,3
10125,2019-02-10,강남구,0.0,0,3,1,0,4
10126,2019-02-10,강동구,0.0,0,3,0,2,5
10127,2019-02-10,강북구,0.0,0,4,0,1,5
10128,2019-02-10,강서구,0.0,0,2,0,1,3
10129,2019-02-10,관악구,0.0,0,1,0,2,3
10130,2019-02-10,광진구,0.0,0,7,0,0,7
10131,2019-02-10,구로구,0.0,0,3,0,0,3
10132,2019-02-10,금천구,0.0,0,0,0,0,0
10133,2019-02-10,노원구,0.0,0,4,0,1,5
10134,2019-02-10,도봉구,0.0,0,0,0,0,0
10135,2019-02-10,동대문구,0.0,0,2,0,3,5
10136,2019-02-10,동작구,0.0,0,4,1,0,5
10137,2019-02-10,마포구,0.0,0,3,1,1,5
10138,2019-02-10,서대문구,0.0,0,2,1,0,3
10139,2019-02-10,서초구,0.0,0,2,0,1,3
10140,2019-02-10,성동구,0.0,0,5,0,0,5
10141,2019-02-10,성북구,0.0,0,2,0,0,2
10142,2019-02-10,송파구,0.0,0,5,1,1,7
10143,2019-02-10,양천구,0.0,0,0,0,0,0
10144,2019-02-10,영등포구,0.0,0,5,0,1,6
10145,2019-02-10,용산구,0.0,0,0,0,0,0
10146,2019-02-10,은평구,0.0,0,3,0,0,3
10147,2019-02-10,종로구,0.0,0,3,1,3,7
10148,2019-02-10,중구,0.0,0,1,1,3,5
10149,2019-02-10,중랑구,0.0,0,2,0,1,3
10150,2019-02-11,강남구,0.0,0,17,3,0,20
10151,2019-02-11,강동구,0.0,0,2,0,1,3
10152,2019-02-11,강북구,0.0,0,0,0,0,0
10153,2019-02-11,강서구,0.0,0,4,0,1,5
10154,2019-02-11,관악구,0.0,0,3,0,2,5
10155,2019-02-11,광진구,0.0,0,0,0,1,1
10156,2019-02-11,구로구,0.0,0,4,0,1,5
10157,2019-02-11,금천구,0.0,0,1,0,0,1
10158,2019-02-11,노원구,0.0,0,7,1,1,9
10159,2019-02-11,도봉구,0.0,0,1,0,1,2
10160,2019-02-11,동대문구,0.0,0,2,0,1,3
10161,2019-02-11,동작구,0.0,0,4,0,0,4
10162,2019-02-11,마포구,0.0,0,3,0,1,4
10163,2019-02-11,서대문구,0.0,0,4,0,0,4
10164,2019-02-11,서초구,0.0,0,9,0,1,10
10165,2019-02-11,성동구,0.0,0,1,0,0,1
10166,2019-02-11,성북구,0.0,0,3,0,0,3
10167,2019-02-11,송파구,0.0,0,3,0,1,4
10168,2019-02-11,양천구,0.0,0,4,3,0,7
10169,2019-02-11,영등포구,0.0,0,8,0,1,9
10170,2019-02-11,용산구,0.0,0,1,0,0,1
10171,2019-02-11,은평구,0.0,0,0,0,0,0
10172,2019-02-11,종로구,0.0,1,1,0,0,2
10173,2019-02-11,중구,0.0,0,1,0,0,1
10174,2019-02-11,중랑구,0.0,0,4,0,0,4
10175,2019-02-12,강남구,0.0,2,6,1,6,15
10176,2019-02-12,강동구,0.0,0,1,0,1,2
10177,2019-02-12,강북구,0.0,0,3,0,0,3
10178,2019-02-12,강서구,0.0,0,4,1,1,6
10179,2019-02-12,관악구,0.0,0,2,0,0,2
10180,2019-02-12,광진구,0.0,0,0,0,0,0
10181,2019-02-12,구로구,0.0,0,1,0,0,1
10182,2019-02-12,금천구,0.0,0,2,0,0,2
10183,2019-02-12,노원구,0.0,0,5,0,1,6
10184,2019-02-12,도봉구,0.0,0,0,0,0,0
10185,2019-02-12,동대문구,0.0,0,5,0,3,8
10186,2019-02-12,동작구,0.0,0,11,0,1,12
10187,2019-02-12,마포구,0.0,0,3,0,0,3
10188,2019-02-12,서대문구,0.0,0,0,0,4,4
10189,2019-02-12,서초구,0.0,0,6,0,0,6
10190,2019-02-12,성동구,0.0,0,4,0,4,8
10191,2019-02-12,성북구,0.0,0,2,1,0,3
10192,2019-02-12,송파구,0.0,0,8,0,1,9
10193,2019-02-12,양천구,0.0,0,7,0,0,7
10194,2019-02-12,영등포구,0.0,0,6,0,0,6
10195,2019-02-12,용산구,0.0,0,5,0,1,6
10196,2019-02-12,은평구,0.0,0,2,1,0,3
10197,2019-02-12,종로구,0.0,0,2,0,2,4
10198,2019-02-12,중구,0.0,0,0,0,2,2
10199,2019-02-12,중랑구,0.0,0,2,0,2,4
10200,2019-02-13,강남구,0.0,1,10,1,4,16
10201,2019-02-13,강동구,0.0,0,2,1,1,4
10202,2019-02-13,강북구,0.0,0,10,1,1,12
10203,2019-02-13,강서구,0.0,0,7,0,3,10
10204,2019-02-13,관악구,0.0,0,2,0,0,2
10205,2019-02-13,광진구,0.0,0,5,0,1,6
10206,2019-02-13,구로구,0.0,0,8,1,2,11
10207,2019-02-13,금천구,0.0,0,2,0,0,2
10208,2019-02-13,노원구,0.0,0,1,0,1,2
10209,2019-02-13,도봉구,0.0,0,2,2,0,4
10210,2019-02-13,동대문구,0.0,0,2,0,3,5
10211,2019-02-13,동작구,0.0,0,0,0,0,0
10212,2019-02-13,마포구,0.0,0,7,3,1,11
10213,2019-02-13,서대문구,0.0,0,1,0,3,4
10214,2019-02-13,서초구,0.0,0,13,0,0,13
10215,2019-02-13,성동구,0.0,0,5,0,1,6
10216,2019-02-13,성북구,0.0,0,7,0,0,7
10217,2019-02-13,송파구,0.0,0,4,0,1,5
10218,2019-02-13,양천구,0.0,0,2,2,0,4
10219,2019-02-13,영등포구,0.0,0,4,0,0,4
10220,2019-02-13,용산구,0.0,0,5,0,0,5
10221,2019-02-13,은평구,0.0,0,2,0,1,3
10222,2019-02-13,종로구,0.0,0,2,0,0,2
10223,2019-02-13,중구,0.0,0,3,0,3,6
10224,2019-02-13,중랑구,0.0,0,1,0,1,2
10225,2019-02-14,강남구,0.0,0,12,1,0,13
10226,2019-02-14,강동구,0.0,0,2,0,1,3
10227,2019-02-14,강북구,0.0,0,2,0,0,2
10228,2019-02-14,강서구,0.0,0,6,1,0,7
10229,2019-02-14,관악구,0.0,0,3,0,0,3
10230,2019-02-14,광진구,0.0,0,6,0,2,8
10231,2019-02-14,구로구,0.0,0,0,0,2,2
10232,2019-02-14,금천구,0.0,0,4,0,1,5
10233,2019-02-14,노원구,0.0,0,3,0,1,4
10234,2019-02-14,도봉구,0.0,0,2,0,1,3
10235,2019-02-14,동대문구,0.0,0,9,0,2,11
10236,2019-02-14,동작구,0.0,0,3,2,2,7
10237,2019-02-14,마포구,0.0,0,3,0,1,4
10238,2019-02-14,서대문구,0.0,0,3,1,4,8
10239,2019-02-14,서초구,0.0,0,10,0,1,11
10240,2019-02-14,성동구,0.0,0,1,2,2,5
10241,2019-02-14,성북구,0.0,0,4,0,0,4
10242,2019-02-14,송파구,0.0,0,8,3,3,14
10243,2019-02-14,양천구,0.0,0,4,1,3,8
10244,2019-02-14,영등포구,0.0,0,7,0,1,8
10245,2019-02-14,용산구,0.0,0,5,0,2,7
10246,2019-02-14,은평구,0.0,0,0,0,0,0
10247,2019-02-14,종로구,0.0,0,2,0,1,3
10248,2019-02-14,중구,0.0,0,0,0,1,1
10249,2019-02-14,중랑구,0.0,0,9,0,0,9
10250,2019-02-15,강남구,0.5,0,12,0,2,14
10251,2019-02-15,강동구,1.0,0,7,0,4,11
10252,2019-02-15,강북구,0.5,0,8,0,0,8
10253,2019-02-15,강서구,1.5,0,13,0,0,13
10254,2019-02-15,관악구,0.75,0,5,0,0,5
10255,2019-02-15,광진구,0.5,0,3,0,3,6
10256,2019-02-15,구로구,1.0,0,3,0,0,3
10257,2019-02-15,금천구,0.5,0,5,0,3,8
10258,2019-02-15,노원구,0.0,0,9,1,2,12
10259,2019-02-15,도봉구,0.0,0,2,0,1,3
10260,2019-02-15,동대문구,1.0,0,4,0,0,4
10261,2019-02-15,동작구,1.0,0,3,0,1,4
10262,2019-02-15,마포구,0.5,0,6,3,1,10
10263,2019-02-15,서대문구,0.5,0,6,0,1,7
10264,2019-02-15,서초구,0.0,0,5,0,3,8
10265,2019-02-15,성동구,1.0,0,2,0,1,3
10266,2019-02-15,성북구,0.0,1,3,0,0,4
10267,2019-02-15,송파구,0.0,0,5,0,4,9
10268,2019-02-15,양천구,1.0,0,2,0,0,2
10269,2019-02-15,영등포구,0.5,0,9,0,5,14
10270,2019-02-15,용산구,1.0,0,3,0,1,4
10271,2019-02-15,은평구,1.0,0,2,2,0,4
10272,2019-02-15,종로구,2.2,0,2,0,1,3
10273,2019-02-15,중구,1.0,0,1,0,0,1
10274,2019-02-15,중랑구,0.5,0,1,0,5,6
10275,2019-02-16,강남구,0.0,0,19,1,1,21
10276,2019-02-16,강동구,0.0,0,0,2,1,3
10277,2019-02-16,강북구,0.0,0,5,0,1,6
10278,2019-02-16,강서구,0.0,0,6,0,2,8
10279,2019-02-16,관악구,0.0,0,0,0,1,1
10280,2019-02-16,광진구,0.0,0,4,1,2,7
10281,2019-02-16,구로구,0.0,0,4,0,1,5
10282,2019-02-16,금천구,0.0,0,2,0,0,2
10283,2019-02-16,노원구,0.0,0,6,0,1,7
10284,2019-02-16,도봉구,0.0,0,1,0,0,1
10285,2019-02-16,동대문구,0.0,0,2,1,0,3
10286,2019-02-16,동작구,0.0,0,7,1,6,14
10287,2019-02-16,마포구,0.0,0,2,1,1,4
10288,2019-02-16,서대문구,0.0,0,1,0,1,2
10289,2019-02-16,서초구,0.0,0,21,0,0,21
10290,2019-02-16,성동구,0.0,0,6,0,0,6
10291,2019-02-16,성북구,0.0,0,2,2,0,4
10292,2019-02-16,송파구,0.0,0,6,0,1,7
10293,2019-02-16,양천구,0.0,0,0,0,0,0
10294,2019-02-16,영등포구,0.0,0,0,0,2,2
10295,2019-02-16,용산구,0.0,0,4,1,4,9
10296,2019-02-16,은평구,0.0,0,4,0,2,6
10297,2019-02-16,종로구,0.2,0,3,0,2,5
10298,2019-02-16,중구,0.0,0,4,0,2,6
10299,2019-02-16,중랑구,0.0,0,4,1,2,7
10300,2019-02-17,강남구,0.0,0,10,0,2,12
10301,2019-02-17,강동구,0.0,0,4,0,0,4
10302,2019-02-17,강북구,0.0,0,0,0,0,0
10303,2019-02-17,강서구,0.0,0,6,1,3,10
10304,2019-02-17,관악구,0.0,0,7,0,1,8
10305,2019-02-17,광진구,0.0,0,6,0,0,6
10306,2019-02-17,구로구,0.0,0,3,0,0,3
10307,2019-02-17,금천구,0.0,0,0,0,0,0
10308,2019-02-17,노원구,0.0,0,3,0,3,6
10309,2019-02-17,도봉구,0.0,0,1,1,0,2
10310,2019-02-17,동대문구,0.0,0,4,0,0,4
10311,2019-02-17,동작구,0.0,0,3,1,0,4
10312,2019-02-17,마포구,0.0,0,3,0,4,7
10313,2019-02-17,서대문구,0.0,0,1,1,1,3
10314,2019-02-17,서초구,0.0,0,7,1,1,9
10315,2019-02-17,성동구,0.0,0,1,0,3,4
10316,2019-02-17,성북구,0.0,0,10,0,2,12
10317,2019-02-17,송파구,0.0,0,4,1,2,7
10318,2019-02-17,양천구,0.0,0,4,0,0,4
10319,2019-02-17,영등포구,0.0,0,5,0,2,7
10320,2019-02-17,용산구,0.0,0,8,0,1,9
10321,2019-02-17,은평구,0.0,0,1,0,1,2
10322,2019-02-17,종로구,0.0,0,4,0,3,7
10323,2019-02-17,중구,0.0,0,9,0,0,9
10324,2019-02-17,중랑구,0.0,0,4,1,4,9
10325,2019-02-18,강남구,0.0,0,4,2,1,7
10326,2019-02-18,강동구,0.0,0,6,0,2,8
10327,2019-02-18,강북구,0.0,0,1,0,2,3
10328,2019-02-18,강서구,0.0,0,4,1,1,6
10329,2019-02-18,관악구,0.0,0,3,0,0,3
10330,2019-02-18,광진구,0.0,0,5,0,2,7
10331,2019-02-18,구로구,0.0,0,0,0,1,1
10332,2019-02-18,금천구,0.0,0,3,0,1,4
10333,2019-02-18,노원구,0.0,0,6,1,2,9
10334,2019-02-18,도봉구,0.0,0,0,0,0,0
10335,2019-02-18,동대문구,0.0,0,3,0,0,3
10336,2019-02-18,동작구,0.0,0,3,1,1,5
10337,2019-02-18,마포구,0.0,0,1,0,1,2
10338,2019-02-18,서대문구,0.0,0,2,0,2,4
10339,2019-02-18,서초구,0.0,0,4,0,1,5
10340,2019-02-18,성동구,0.0,0,9,1,0,10
10341,2019-02-18,성북구,0.0,0,1,0,1,2
10342,2019-02-18,송파구,3.0,0,8,2,0,10
10343,2019-02-18,양천구,0.0,0,5,0,2,7
10344,2019-02-18,영등포구,1.0,0,5,1,1,7
10345,2019-02-18,용산구,0.0,0,1,0,3,4
10346,2019-02-18,은평구,0.0,0,3,0,1,4
10347,2019-02-18,종로구,0.0,0,2,0,0,2
10348,2019-02-18,중구,0.0,0,3,1,0,4
10349,2019-02-18,중랑구,0.0,0,3,3,1,7
10350,2019-02-19,강남구,4.5,0,9,1,1,11
10351,2019-02-19,강동구,4.0,0,1,0,1,2
10352,2019-02-19,강북구,2.0,0,0,0,0,0
10353,2019-02-19,강서구,3.5,0,5,1,2,8
10354,2019-02-19,관악구,5.0,0,1,5,3,9
10355,2019-02-19,광진구,4.0,0,3,0,0,3
10356,2019-02-19,구로구,4.0,0,2,0,1,3
10357,2019-02-19,금천구,3.5,0,0,0,0,0
10358,2019-02-19,노원구,2.0,0,3,0,1,4
10359,2019-02-19,도봉구,2.0,0,3,0,2,5
10360,2019-02-19,동대문구,4.0,0,2,0,0,2
10361,2019-02-19,동작구,4.25,0,5,0,0,5
10362,2019-02-19,마포구,3.0,0,4,0,1,5
10363,2019-02-19,서대문구,3.0,0,1,0,0,1
10364,2019-02-19,서초구,5.0,0,6,0,1,7
10365,2019-02-19,성동구,5.0,0,7,1,0,8
10366,2019-02-19,성북구,2.5,0,2,0,1,3
10367,2019-02-19,송파구,0.0,0,3,0,2,5
10368,2019-02-19,양천구,3.5,0,0,0,0,0
10369,2019-02-19,영등포구,1.75,1,5,0,0,6
10370,2019-02-19,용산구,4.0,0,4,0,1,5
10371,2019-02-19,은평구,3.0,0,4,1,1,6
10372,2019-02-19,종로구,4.6,0,1,0,0,1
10373,2019-02-19,중구,1.5,0,0,0,0,0
10374,2019-02-19,중랑구,3.5,0,1,0,1,2
10375,2019-02-20,강남구,0.0,0,10,1,1,12
10376,2019-02-20,강동구,0.0,0,4,0,1,5
10377,2019-02-20,강북구,0.0,0,3,0,1,4
10378,2019-02-20,강서구,0.0,0,7,1,0,8
10379,2019-02-20,관악구,0.0,0,1,0,1,2
10380,2019-02-20,광진구,0.0,0,0,0,2,2
10381,2019-02-20,구로구,0.0,0,5,0,1,6
10382,2019-02-20,금천구,0.0,0,5,1,0,6
10383,2019-02-20,노원구,0.0,0,0,0,0,0
10384,2019-02-20,도봉구,0.0,0,5,0,1,6
10385,2019-02-20,동대문구,0.0,0,2,0,1,3
10386,2019-02-20,동작구,0.0,0,1,0,2,3
10387,2019-02-20,마포구,0.0,0,8,1,2,11
10388,2019-02-20,서대문구,0.0,0,1,0,1,2
10389,2019-02-20,서초구,0.0,0,3,0,0,3
10390,2019-02-20,성동구,0.0,0,5,0,0,5
10391,2019-02-20,성북구,0.0,0,4,0,0,4
10392,2019-02-20,송파구,0.0,0,6,0,1,7
10393,2019-02-20,양천구,0.0,0,6,1,2,9
10394,2019-02-20,영등포구,0.0,0,2,2,0,4
10395,2019-02-20,용산구,0.0,0,0,0,0,0
10396,2019-02-20,은평구,0.0,0,0,0,1,1
10397,2019-02-20,종로구,0.0,0,1,0,1,2
10398,2019-02-20,중구,0.0,0,2,0,2,4
10399,2019-02-20,중랑구,0.0,0,4,1,1,6
10400,2019-02-21,강남구,0.0,0,19,0,3,22
10401,2019-02-21,강동구,0.0,0,1,0,3,4
10402,2019-02-21,강북구,0.0,0,3,0,1,4
10403,2019-02-21,강서구,0.0,0,5,0,4,9
10404,2019-02-21,관악구,0.0,0,4,1,0,5
10405,2019-02-21,광진구,0.0,0,1,1,1,3
10406,2019-02-21,구로구,0.0,0,4,1,0,5
10407,2019-02-21,금천구,0.0,0,0,0,2,2
10408,2019-02-21,노원구,0.0,0,3,1,1,5
10409,2019-02-21,도봉구,0.0,0,4,0,0,4
10410,2019-02-21,동대문구,0.0,0,1,0,0,1
10411,2019-02-21,동작구,0.0,0,0,0,0,0
10412,2019-02-21,마포구,0.0,0,4,0,3,7
10413,2019-02-21,서대문구,0.0,0,2,0,1,3
10414,2019-02-21,서초구,0.0,0,8,0,2,10
10415,2019-02-21,성동구,0.0,0,2,0,0,2
10416,2019-02-21,성북구,0.0,0,6,0,1,7
10417,2019-02-21,송파구,0.0,0,10,0,1,11
10418,2019-02-21,양천구,0.0,0,1,0,0,1
10419,2019-02-21,영등포구,0.0,0,8,0,1,9
10420,2019-02-21,용산구,0.0,0,2,0,1,3
10421,2019-02-21,은평구,0.0,0,6,1,1,8
10422,2019-02-21,종로구,0.0,0,5,0,2,7
10423,2019-02-21,중구,0.0,0,0,0,0,0
10424,2019-02-21,중랑구,0.0,0,2,1,1,4
10425,2019-02-22,강남구,0.0,0,4,0,2,6
10426,2019-02-22,강동구,0.0,0,10,1,2,13
10427,2019-02-22,강북구,0.0,0,6,0,0,6
10428,2019-02-22,강서구,0.0,0,6,0,0,6
10429,2019-02-22,관악구,0.0,0,4,0,0,4
10430,2019-02-22,광진구,0.0,0,2,0,1,3
10431,2019-02-22,구로구,0.0,0,1,0,1,2
10432,2019-02-22,금천구,0.0,0,7,1,0,8
10433,2019-02-22,노원구,0.0,0,4,0,3,7
10434,2019-02-22,도봉구,0.0,0,1,0,0,1
10435,2019-02-22,동대문구,0.0,0,7,1,4,12
10436,2019-02-22,동작구,0.0,0,0,1,3,4
10437,2019-02-22,마포구,0.0,0,5,1,1,7
10438,2019-02-22,서대문구,0.0,0,1,0,1,2
10439,2019-02-22,서초구,0.0,0,3,0,0,3
10440,2019-02-22,성동구,0.0,0,6,1,0,7
10441,2019-02-22,성북구,0.0,0,16,1,2,19
10442,2019-02-22,송파구,0.0,0,7,1,2,10
10443,2019-02-22,양천구,0.0,0,9,1,1,11
10444,2019-02-22,영등포구,0.0,0,11,2,0,13
10445,2019-02-22,용산구,0.0,0,6,1,1,8
10446,2019-02-22,은평구,0.0,0,3,0,2,5
10447,2019-02-22,종로구,0.0,0,4,0,0,4
10448,2019-02-22,중구,0.0,0,8,2,1,11
10449,2019-02-22,중랑구,0.0,0,1,0,2,3
10450,2019-02-23,강남구,0.0,0,13,2,4,19
10451,2019-02-23,강동구,0.0,0,3,0,0,3
10452,2019-02-23,강북구,0.0,0,0,0,0,0
10453,2019-02-23,강서구,0.0,0,5,0,1,6
10454,2019-02-23,관악구,0.0,0,0,0,3,3
10455,2019-02-23,광진구,0.0,0,2,0,1,3
10456,2019-02-23,구로구,0.0,0,4,0,0,4
10457,2019-02-23,금천구,0.0,0,2,0,1,3
10458,2019-02-23,노원구,0.0,0,3,1,1,5
10459,2019-02-23,도봉구,0.0,0,3,0,0,3
10460,2019-02-23,동대문구,0.0,0,8,0,2,10
10461,2019-02-23,동작구,0.0,0,4,3,4,11
10462,2019-02-23,마포구,0.0,0,4,1,2,7
10463,2019-02-23,서대문구,0.0,0,7,2,0,9
10464,2019-02-23,서초구,0.0,0,13,1,0,14
10465,2019-02-23,성동구,0.0,0,6,0,2,8
10466,2019-02-23,성북구,0.0,0,5,0,3,8
10467,2019-02-23,송파구,0.0,0,6,2,4,12
10468,2019-02-23,양천구,0.0,0,2,0,0,2
10469,2019-02-23,영등포구,0.0,0,7,1,2,10
10470,2019-02-23,용산구,0.0,0,2,0,1,3
10471,2019-02-23,은평구,0.0,0,3,0,2,5
10472,2019-02-23,종로구,0.0,0,1,4,0,5
10473,2019-02-23,중구,0.0,0,1,1,0,2
10474,2019-02-23,중랑구,0.0,0,3,0,3,6
10475,2019-02-24,강남구,0.0,0,4,1,2,7
10476,2019-02-24,강동구,0.0,0,5,3,2,10
10477,2019-02-24,강북구,0.0,0,1,0,2,3
10478,2019-02-24,강서구,0.0,0,3,0,2,5
10479,2019-02-24,관악구,0.0,0,5,0,3,8
10480,2019-02-24,광진구,0.0,0,0,0,0,0
10481,2019-02-24,구로구,0.0,1,1,0,0,2
10482,2019-02-24,금천구,0.0,0,0,0,2,2
10483,2019-02-24,노원구,0.0,0,0,0,0,0
10484,2019-02-24,도봉구,0.0,0,1,0,0,1
10485,2019-02-24,동대문구,0.0,0,1,0,1,2
10486,2019-02-24,동작구,0.0,0,1,1,0,2
10487,2019-02-24,마포구,0.0,0,4,2,1,7
10488,2019-02-24,서대문구,0.0,0,1,1,0,2
10489,2019-02-24,서초구,0.0,0,10,0,3,13
10490,2019-02-24,성동구,0.0,0,3,0,1,4
10491,2019-02-24,성북구,0.0,0,7,0,1,8
10492,2019-02-24,송파구,0.0,0,6,2,3,11
10493,2019-02-24,양천구,0.0,0,1,0,0,1
10494,2019-02-24,영등포구,0.0,0,9,0,4,13
10495,2019-02-24,용산구,0.0,0,0,0,1,1
10496,2019-02-24,은평구,0.0,0,1,0,0,1
10497,2019-02-24,종로구,0.0,0,2,1,0,3
10498,2019-02-24,중구,0.0,0,0,0,1,1
10499,2019-02-24,중랑구,0.0,0,3,1,1,5
10500,2019-02-25,강남구,0.0,0,12,1,3,16
10501,2019-02-25,강동구,0.0,0,5,0,2,7
10502,2019-02-25,강북구,0.0,0,0,0,0,0
10503,2019-02-25,강서구,0.0,0,5,0,1,6
10504,2019-02-25,관악구,0.0,0,4,0,1,5
10505,2019-02-25,광진구,0.0,0,2,0,0,2
10506,2019-02-25,구로구,0.0,0,3,0,1,4
10507,2019-02-25,금천구,0.0,0,1,0,1,2
10508,2019-02-25,노원구,0.0,0,1,0,2,3
10509,2019-02-25,도봉구,0.0,0,1,0,0,1
10510,2019-02-25,동대문구,0.0,0,4,2,4,10
10511,2019-02-25,동작구,0.0,0,5,1,0,6
10512,2019-02-25,마포구,0.0,0,7,0,2,9
10513,2019-02-25,서대문구,0.0,0,2,3,0,5
10514,2019-02-25,서초구,0.0,0,7,1,5,13
10515,2019-02-25,성동구,0.0,0,0,0,1,1
10516,2019-02-25,성북구,0.0,1,5,0,3,9
10517,2019-02-25,송파구,0.0,0,7,2,2,11
10518,2019-02-25,양천구,0.0,0,3,1,1,5
10519,2019-02-25,영등포구,0.0,0,7,0,1,8
10520,2019-02-25,용산구,0.0,0,1,0,0,1
10521,2019-02-25,은평구,0.0,0,0,0,1,1
10522,2019-02-25,종로구,0.0,0,0,1,0,1
10523,2019-02-25,중구,0.0,0,1,1,1,3
10524,2019-02-25,중랑구,0.0,0,2,0,2,4
10525,2019-02-26,강남구,0.0,0,8,0,3,11
10526,2019-02-26,강동구,0.0,0,0,0,0,0
10527,2019-02-26,강북구,0.0,0,5,0,1,6
10528,2019-02-26,강서구,0.0,0,1,0,1,2
10529,2019-02-26,관악구,0.0,0,1,1,0,2
10530,2019-02-26,광진구,0.0,0,1,0,0,1
10531,2019-02-26,구로구,0.0,0,6,0,0,6
10532,2019-02-26,금천구,0.0,0,2,0,0,2
10533,2019-02-26,노원구,0.0,0,2,0,2,4
10534,2019-02-26,도봉구,0.0,0,1,0,0,1
10535,2019-02-26,동대문구,0.0,0,2,0,1,3
10536,2019-02-26,동작구,0.0,0,2,1,1,4
10537,2019-02-26,마포구,0.0,0,5,0,0,5
10538,2019-02-26,서대문구,0.0,0,2,1,0,3
10539,2019-02-26,서초구,0.0,0,8,0,0,8
10540,2019-02-26,성동구,0.0,0,2,0,2,4
10541,2019-02-26,성북구,0.0,0,2,0,2,4
10542,2019-02-26,송파구,0.0,0,14,3,2,19
10543,2019-02-26,양천구,0.0,0,3,0,0,3
10544,2019-02-26,영등포구,0.0,0,6,0,2,8
10545,2019-02-26,용산구,0.0,0,0,0,1,1
10546,2019-02-26,은평구,0.0,0,0,0,0,0
10547,2019-02-26,종로구,0.0,0,1,1,2,4
10548,2019-02-26,중구,0.0,0,4,0,0,4
10549,2019-02-26,중랑구,0.0,0,8,1,0,9
10550,2019-02-27,강남구,0.0,0,5,1,2,8
10551,2019-02-27,강동구,0.0,0,0,0,0,0
10552,2019-02-27,강북구,0.0,0,3,0,0,3
10553,2019-02-27,강서구,0.0,0,1,1,1,3
10554,2019-02-27,관악구,0.0,0,3,0,0,3
10555,2019-02-27,광진구,0.0,0,2,0,0,2
10556,2019-02-27,구로구,0.0,0,3,0,0,3
10557,2019-02-27,금천구,0.0,0,0,0,1,1
10558,2019-02-27,노원구,0.0,0,1,0,1,2
10559,2019-02-27,도봉구,0.0,0,1,0,0,1
10560,2019-02-27,동대문구,0.0,0,2,0,0,2
10561,2019-02-27,동작구,0.0,0,0,0,0,0
10562,2019-02-27,마포구,0.0,0,0,0,0,0
10563,2019-02-27,서대문구,0.0,0,2,1,1,4
10564,2019-02-27,서초구,0.0,0,1,1,2,4
10565,2019-02-27,성동구,0.0,0,2,0,0,2
10566,2019-02-27,성북구,0.0,0,2,0,3,5
10567,2019-02-27,송파구,0.0,1,9,2,1,13
10568,2019-02-27,양천구,0.0,0,2,0,2,4
10569,2019-02-27,영등포구,0.0,0,1,0,0,1
10570,2019-02-27,용산구,0.0,0,2,0,2,4
10571,2019-02-27,은평구,0.0,0,2,1,2,5
10572,2019-02-27,종로구,0.0,0,3,0,1,4
10573,2019-02-27,중구,0.0,0,6,0,3,9
10574,2019-02-27,중랑구,0.0,0,1,1,3,5
10575,2019-02-28,강남구,0.0,0,9,0,4,13
10576,2019-02-28,강동구,0.0,0,5,0,0,5
10577,2019-02-28,강북구,0.0,0,8,0,2,10
10578,2019-02-28,강서구,0.0,0,2,0,2,4
10579,2019-02-28,관악구,0.0,0,5,0,1,6
10580,2019-02-28,광진구,0.0,0,2,0,0,2
10581,2019-02-28,구로구,0.0,0,8,1,0,9
10582,2019-02-28,금천구,0.0,0,1,0,3,4
10583,2019-02-28,노원구,0.0,0,2,0,0,2
10584,2019-02-28,도봉구,0.0,0,0,0,1,1
10585,2019-02-28,동대문구,0.0,0,3,0,0,3
10586,2019-02-28,동작구,0.0,0,1,0,1,2
10587,2019-02-28,마포구,0.0,0,3,0,3,6
10588,2019-02-28,서대문구,0.0,0,2,0,0,2
10589,2019-02-28,서초구,0.0,0,6,0,1,7
10590,2019-02-28,성동구,0.0,0,6,0,0,6
10591,2019-02-28,성북구,0.0,0,4,0,1,5
10592,2019-02-28,송파구,0.0,0,14,0,1,15
10593,2019-02-28,양천구,0.0,0,1,1,1,3
10594,2019-02-28,영등포구,0.0,0,6,0,0,6
10595,2019-02-28,용산구,0.0,0,1,0,0,1
10596,2019-02-28,은평구,0.0,0,4,1,1,6
10597,2019-02-28,종로구,0.0,0,2,0,0,2
10598,2019-02-28,중구,0.0,0,0,0,0,0
10599,2019-02-28,중랑구,0.0,0,6,1,2,9
10600,2019-03-01,강남구,0.0,0,8,0,3,11
10601,2019-03-01,강동구,0.0,0,0,2,1,3
10602,2019-03-01,강북구,0.0,0,6,0,2,8
10603,2019-03-01,강서구,0.0,0,1,0,2,3
10604,2019-03-01,관악구,0.0,0,7,0,0,7
10605,2019-03-01,광진구,0.0,0,1,0,0,1
10606,2019-03-01,구로구,0.0,0,3,0,3,6
10607,2019-03-01,금천구,0.0,0,3,0,0,3
10608,2019-03-01,노원구,0.0,0,0,1,1,2
10609,2019-03-01,도봉구,0.0,0,2,0,0,2
10610,2019-03-01,동대문구,0.0,0,1,0,0,1
10611,2019-03-01,동작구,0.0,0,2,1,3,6
10612,2019-03-01,마포구,0.0,0,3,0,1,4
10613,2019-03-01,서대문구,0.0,0,1,0,0,1
10614,2019-03-01,서초구,0.0,0,7,1,0,8
10615,2019-03-01,성동구,0.0,0,0,0,1,1
10616,2019-03-01,성북구,0.0,0,5,0,0,5
10617,2019-03-01,송파구,0.0,0,9,2,0,11
10618,2019-03-01,양천구,0.0,0,2,0,1,3
10619,2019-03-01,영등포구,0.0,1,8,3,2,14
10620,2019-03-01,용산구,0.0,0,5,1,0,6
10621,2019-03-01,은평구,0.0,0,3,2,1,6
10622,2019-03-01,종로구,0.0,0,2,0,0,2
10623,2019-03-01,중구,0.0,0,1,0,0,1
10624,2019-03-01,중랑구,0.0,0,3,0,0,3
10625,2019-03-02,강남구,0.0,0,4,2,1,7
10626,2019-03-02,강동구,0.0,0,4,0,1,5
10627,2019-03-02,강북구,0.0,0,6,0,0,6
10628,2019-03-02,강서구,0.0,0,6,0,0,6
10629,2019-03-02,관악구,0.0,0,5,0,0,5
10630,2019-03-02,광진구,0.0,0,2,0,0,2
10631,2019-03-02,구로구,0.0,0,1,0,1,2
10632,2019-03-02,금천구,0.0,0,3,0,0,3
10633,2019-03-02,노원구,0.0,0,5,0,1,6
10634,2019-03-02,도봉구,0.0,0,1,2,2,5
10635,2019-03-02,동대문구,0.0,0,6,0,1,7
10636,2019-03-02,동작구,0.0,0,4,0,1,5
10637,2019-03-02,마포구,0.0,0,1,0,0,1
10638,2019-03-02,서대문구,0.0,0,2,1,0,3
10639,2019-03-02,서초구,0.0,0,6,0,2,8
10640,2019-03-02,성동구,0.0,0,4,1,0,5
10641,2019-03-02,성북구,0.0,0,2,0,1,3
10642,2019-03-02,송파구,0.0,0,3,0,4,7
10643,2019-03-02,양천구,0.0,0,3,0,0,3
10644,2019-03-02,영등포구,0.0,0,6,1,0,7
10645,2019-03-02,용산구,0.0,0,3,0,3,6
10646,2019-03-02,은평구,0.0,0,5,0,1,6
10647,2019-03-02,종로구,0.0,0,5,2,1,8
10648,2019-03-02,중구,0.0,0,0,1,0,1
10649,2019-03-02,중랑구,0.0,0,1,0,0,1
10650,2019-03-03,강남구,0.0,0,5,0,2,7
10651,2019-03-03,강동구,0.0,0,9,0,3,12
10652,2019-03-03,강북구,0.0,0,2,0,0,2
10653,2019-03-03,강서구,0.0,0,1,0,0,1
10654,2019-03-03,관악구,0.0,0,3,0,0,3
10655,2019-03-03,광진구,0.0,0,1,0,0,1
10656,2019-03-03,구로구,0.0,0,2,0,1,3
10657,2019-03-03,금천구,0.0,0,6,0,4,10
10658,2019-03-03,노원구,0.0,0,6,0,1,7
10659,2019-03-03,도봉구,0.0,0,0,0,0,0
10660,2019-03-03,동대문구,0.0,0,0,0,0,0
10661,2019-03-03,동작구,0.0,0,5,0,3,8
10662,2019-03-03,마포구,0.0,0,2,0,0,2
10663,2019-03-03,서대문구,0.0,0,0,0,0,0
10664,2019-03-03,서초구,0.0,0,4,1,1,6
10665,2019-03-03,성동구,0.0,0,0,0,0,0
10666,2019-03-03,성북구,0.0,0,6,0,1,7
10667,2019-03-03,송파구,0.0,0,2,2,0,4
10668,2019-03-03,양천구,0.0,0,1,0,0,1
10669,2019-03-03,영등포구,0.0,0,0,0,2,2
10670,2019-03-03,용산구,0.0,0,5,0,3,8
10671,2019-03-03,은평구,0.0,0,3,0,2,5
10672,2019-03-03,종로구,0.0,1,7,0,1,9
10673,2019-03-03,중구,0.0,0,0,0,0,0
10674,2019-03-03,중랑구,0.0,0,1,0,2,3
10675,2019-03-04,강남구,0.0,0,6,0,5,11
10676,2019-03-04,강동구,0.0,0,2,0,0,2
10677,2019-03-04,강북구,0.0,0,5,0,2,7
10678,2019-03-04,강서구,0.0,0,1,0,0,1
10679,2019-03-04,관악구,0.0,0,0,0,0,0
10680,2019-03-04,광진구,0.0,1,3,0,0,4
10681,2019-03-04,구로구,0.0,0,2,0,0,2
10682,2019-03-04,금천구,0.0,0,4,0,1,5
10683,2019-03-04,노원구,0.0,0,3,0,2,5
10684,2019-03-04,도봉구,0.0,0,3,0,0,3
10685,2019-03-04,동대문구,0.0,0,2,0,1,3
10686,2019-03-04,동작구,0.0,0,2,1,0,3
10687,2019-03-04,마포구,0.0,0,1,0,0,1
10688,2019-03-04,서대문구,0.0,0,0,1,0,1
10689,2019-03-04,서초구,0.0,0,5,0,1,6
10690,2019-03-04,성동구,0.0,0,2,1,0,3
10691,2019-03-04,성북구,0.0,0,3,0,0,3
10692,2019-03-04,송파구,0.0,0,17,0,2,19
10693,2019-03-04,양천구,0.0,0,1,1,0,2
10694,2019-03-04,영등포구,0.0,0,5,2,0,7
10695,2019-03-04,용산구,0.0,0,2,0,0,2
10696,2019-03-04,은평구,0.0,0,1,0,0,1
10697,2019-03-04,종로구,0.0,0,2,1,0,3
10698,2019-03-04,중구,0.0,0,1,0,1,2
10699,2019-03-04,중랑구,0.0,0,2,0,0,2
10700,2019-03-05,강남구,0.0,0,4,0,5,9
10701,2019-03-05,강동구,0.0,0,3,0,0,3
10702,2019-03-05,강북구,0.0,0,1,0,0,1
10703,2019-03-05,강서구,0.0,0,6,0,0,6
10704,2019-03-05,관악구,0.0,0,1,0,1,2
10705,2019-03-05,광진구,0.0,0,5,0,1,6
10706,2019-03-05,구로구,0.0,0,2,0,1,3
10707,2019-03-05,금천구,0.0,0,2,0,1,3
10708,2019-03-05,노원구,0.0,0,0,0,2,2
10709,2019-03-05,도봉구,0.0,0,0,0,0,0
10710,2019-03-05,동대문구,0.0,0,1,0,3,4
10711,2019-03-05,동작구,0.0,0,3,1,0,4
10712,2019-03-05,마포구,0.0,0,3,0,2,5
10713,2019-03-05,서대문구,0.0,0,2,0,2,4
10714,2019-03-05,서초구,0.0,0,8,0,0,8
10715,2019-03-05,성동구,0.0,0,3,0,1,4
10716,2019-03-05,성북구,0.0,0,4,0,4,8
10717,2019-03-05,송파구,0.0,0,7,0,1,8
10718,2019-03-05,양천구,0.0,0,2,0,0,2
10719,2019-03-05,영등포구,0.0,0,8,1,0,9
10720,2019-03-05,용산구,0.0,0,2,0,0,2
10721,2019-03-05,은평구,0.0,0,1,0,0,1
10722,2019-03-05,종로구,0.0,0,0,0,0,0
10723,2019-03-05,중구,0.0,0,1,0,0,1
10724,2019-03-05,중랑구,0.0,0,2,0,0,2
10725,2019-03-06,강남구,0.0,0,12,2,2,16
10726,2019-03-06,강동구,0.0,0,5,0,0,5
10727,2019-03-06,강북구,0.0,0,10,0,1,11
10728,2019-03-06,강서구,0.0,0,4,0,1,5
10729,2019-03-06,관악구,0.0,1,1,1,0,3
10730,2019-03-06,광진구,0.0,0,3,0,0,3
10731,2019-03-06,구로구,0.0,0,3,0,1,4
10732,2019-03-06,금천구,0.0,0,1,0,0,1
10733,2019-03-06,노원구,0.0,0,4,0,3,7
10734,2019-03-06,도봉구,0.0,0,0,0,0,0
10735,2019-03-06,동대문구,0.0,0,7,1,2,10
10736,2019-03-06,동작구,0.0,0,7,0,1,8
10737,2019-03-06,마포구,0.0,0,1,1,2,4
10738,2019-03-06,서대문구,0.0,0,3,1,0,4
10739,2019-03-06,서초구,0.0,0,2,0,2,4
10740,2019-03-06,성동구,0.0,0,1,0,0,1
10741,2019-03-06,성북구,0.0,0,9,0,2,11
10742,2019-03-06,송파구,0.0,0,3,0,0,3
10743,2019-03-06,양천구,0.0,0,4,1,0,5
10744,2019-03-06,영등포구,0.0,0,5,0,1,6
10745,2019-03-06,용산구,0.0,0,2,0,2,4
10746,2019-03-06,은평구,0.0,0,2,0,0,2
10747,2019-03-06,종로구,0.0,0,3,1,1,5
10748,2019-03-06,중구,0.0,0,1,1,1,3
10749,2019-03-06,중랑구,0.0,0,1,0,2,3
10750,2019-03-07,강남구,0.0,0,10,1,2,13
10751,2019-03-07,강동구,0.0,0,4,0,2,6
10752,2019-03-07,강북구,0.0,0,6,0,1,7
10753,2019-03-07,강서구,0.0,0,4,0,0,4
10754,2019-03-07,관악구,0.0,0,2,0,0,2
10755,2019-03-07,광진구,0.0,0,5,0,1,6
10756,2019-03-07,구로구,0.0,0,11,1,2,14
10757,2019-03-07,금천구,0.0,0,2,0,0,2
10758,2019-03-07,노원구,0.0,0,5,0,1,6
10759,2019-03-07,도봉구,0.0,0,0,0,1,1
10760,2019-03-07,동대문구,0.0,0,2,0,2,4
10761,2019-03-07,동작구,0.0,0,5,2,1,8
10762,2019-03-07,마포구,0.0,0,5,0,1,6
10763,2019-03-07,서대문구,0.0,0,2,1,0,3
10764,2019-03-07,서초구,0.0,0,2,0,2,4
10765,2019-03-07,성동구,0.0,0,4,0,0,4
10766,2019-03-07,성북구,0.0,0,0,1,1,2
10767,2019-03-07,송파구,0.0,0,11,1,4,16
10768,2019-03-07,양천구,0.0,0,1,0,0,1
10769,2019-03-07,영등포구,0.0,0,9,0,3,12
10770,2019-03-07,용산구,0.0,0,2,1,0,3
10771,2019-03-07,은평구,0.0,0,8,1,1,10
10772,2019-03-07,종로구,0.0,0,4,0,1,5
10773,2019-03-07,중구,0.0,0,2,0,0,2
10774,2019-03-07,중랑구,0.0,0,2,0,1,3
10775,2019-03-08,강남구,0.0,0,15,0,5,20
10776,2019-03-08,강동구,0.0,0,5,2,2,9
10777,2019-03-08,강북구,0.0,0,2,0,1,3
10778,2019-03-08,강서구,0.0,0,9,1,2,12
10779,2019-03-08,관악구,0.0,0,3,0,0,3
10780,2019-03-08,광진구,0.0,0,1,1,1,3
10781,2019-03-08,구로구,0.0,0,4,1,5,10
10782,2019-03-08,금천구,0.0,0,3,0,0,3
10783,2019-03-08,노원구,0.0,0,3,0,4,7
10784,2019-03-08,도봉구,0.0,0,3,1,1,5
10785,2019-03-08,동대문구,0.0,0,4,1,0,5
10786,2019-03-08,동작구,0.0,0,6,3,3,12
10787,2019-03-08,마포구,0.0,0,4,1,0,5
10788,2019-03-08,서대문구,0.0,0,2,1,0,3
10789,2019-03-08,서초구,0.0,0,6,0,2,8
10790,2019-03-08,성동구,0.0,0,1,0,0,1
10791,2019-03-08,성북구,0.0,0,5,1,2,8
10792,2019-03-08,송파구,0.0,0,9,2,5,16
10793,2019-03-08,양천구,0.0,0,4,0,0,4
10794,2019-03-08,영등포구,0.0,0,2,1,3,6
10795,2019-03-08,용산구,0.0,0,2,0,1,3
10796,2019-03-08,은평구,0.0,0,4,1,0,5
10797,2019-03-08,종로구,0.0,0,1,0,1,2
10798,2019-03-08,중구,0.0,0,7,1,2,10
10799,2019-03-08,중랑구,0.0,0,3,2,1,6
10800,2019-03-09,강남구,0.0,0,5,0,2,7
10801,2019-03-09,강동구,0.0,0,1,1,1,3
10802,2019-03-09,강북구,0.0,0,7,0,2,9
10803,2019-03-09,강서구,0.0,0,5,0,2,7
10804,2019-03-09,관악구,0.0,0,2,1,1,4
10805,2019-03-09,광진구,0.0,0,8,0,0,8
10806,2019-03-09,구로구,0.0,0,3,0,0,3
10807,2019-03-09,금천구,0.0,0,6,0,1,7
10808,2019-03-09,노원구,0.0,0,7,1,3,11
10809,2019-03-09,도봉구,0.0,0,3,0,1,4
10810,2019-03-09,동대문구,0.0,0,4,0,0,4
10811,2019-03-09,동작구,0.0,0,8,1,1,10
10812,2019-03-09,마포구,0.0,0,2,0,0,2
10813,2019-03-09,서대문구,0.0,0,2,0,0,2
10814,2019-03-09,서초구,0.0,0,10,3,0,13
10815,2019-03-09,성동구,0.0,0,5,0,1,6
10816,2019-03-09,성북구,0.0,0,1,0,2,3
10817,2019-03-09,송파구,0.0,0,11,2,4,17
10818,2019-03-09,양천구,0.0,0,7,1,2,10
10819,2019-03-09,영등포구,0.0,0,6,1,3,10
10820,2019-03-09,용산구,0.0,1,3,2,1,7
10821,2019-03-09,은평구,0.0,0,3,1,1,5
10822,2019-03-09,종로구,0.0,0,5,0,0,5
10823,2019-03-09,중구,0.0,0,1,0,1,2
10824,2019-03-09,중랑구,0.0,0,4,0,1,5
10825,2019-03-10,강남구,0.0,0,5,0,1,6
10826,2019-03-10,강동구,0.0,0,2,0,1,3
10827,2019-03-10,강북구,0.0,0,1,0,0,1
10828,2019-03-10,강서구,0.0,0,9,0,1,10
10829,2019-03-10,관악구,0.0,0,5,0,2,7
10830,2019-03-10,광진구,0.0,0,4,0,0,4
10831,2019-03-10,구로구,0.0,0,1,0,1,2
10832,2019-03-10,금천구,0.0,0,1,0,2,3
10833,2019-03-10,노원구,0.0,0,2,0,0,2
10834,2019-03-10,도봉구,0.0,0,4,2,1,7
10835,2019-03-10,동대문구,0.0,0,1,0,0,1
10836,2019-03-10,동작구,0.0,1,3,0,0,4
10837,2019-03-10,마포구,0.0,0,4,1,0,5
10838,2019-03-10,서대문구,0.0,0,1,0,0,1
10839,2019-03-10,서초구,0.0,0,3,0,0,3
10840,2019-03-10,성동구,0.0,0,0,0,0,0
10841,2019-03-10,성북구,0.0,0,6,0,3,9
10842,2019-03-10,송파구,0.0,0,0,1,3,4
10843,2019-03-10,양천구,0.0,0,0,1,0,1
10844,2019-03-10,영등포구,0.0,0,6,0,0,6
10845,2019-03-10,용산구,0.0,0,2,2,3,7
10846,2019-03-10,은평구,0.0,0,0,0,1,1
10847,2019-03-10,종로구,0.0,0,0,2,0,2
10848,2019-03-10,중구,0.0,0,5,0,1,6
10849,2019-03-10,중랑구,0.0,0,1,0,1,2
10850,2019-03-11,강남구,0.0,0,11,2,2,15
10851,2019-03-11,강동구,0.0,0,2,0,2,4
10852,2019-03-11,강북구,0.0,0,5,1,2,8
10853,2019-03-11,강서구,0.0,0,3,0,1,4
10854,2019-03-11,관악구,0.0,0,5,0,0,5
10855,2019-03-11,광진구,0.0,0,2,1,0,3
10856,2019-03-11,구로구,0.0,0,3,0,0,3
10857,2019-03-11,금천구,0.0,0,1,0,1,2
10858,2019-03-11,노원구,0.0,0,3,1,1,5
10859,2019-03-11,도봉구,0.0,0,7,1,2,10
10860,2019-03-11,동대문구,0.0,0,1,0,3,4
10861,2019-03-11,동작구,0.0,0,7,0,2,9
10862,2019-03-11,마포구,0.0,0,0,0,0,0
10863,2019-03-11,서대문구,0.0,0,4,1,1,6
10864,2019-03-11,서초구,0.0,0,1,0,0,1
10865,2019-03-11,성동구,0.0,0,0,1,3,4
10866,2019-03-11,성북구,0.0,0,3,0,1,4
10867,2019-03-11,송파구,0.0,0,5,0,1,6
10868,2019-03-11,양천구,0.0,0,4,0,2,6
10869,2019-03-11,영등포구,0.0,0,3,0,2,5
10870,2019-03-11,용산구,0.0,0,1,0,1,2
10871,2019-03-11,은평구,0.0,0,5,1,2,8
10872,2019-03-11,종로구,0.0,0,1,0,2,3
10873,2019-03-11,중구,0.0,0,1,2,1,4
10874,2019-03-11,중랑구,0.0,0,1,0,1,2
10875,2019-03-12,강남구,0.0,0,18,0,1,19
10876,2019-03-12,강동구,0.0,0,1,0,0,1
10877,2019-03-12,강북구,0.0,0,4,1,0,5
10878,2019-03-12,강서구,0.0,0,4,1,1,6
10879,2019-03-12,관악구,0.0,0,3,0,0,3
10880,2019-03-12,광진구,0.5,0,1,0,0,1
10881,2019-03-12,구로구,0.0,0,10,0,2,12
10882,2019-03-12,금천구,0.0,0,3,0,1,4
10883,2019-03-12,노원구,0.0,0,2,0,0,2
10884,2019-03-12,도봉구,0.5,0,1,0,1,2
10885,2019-03-12,동대문구,0.0,0,3,1,1,5
10886,2019-03-12,동작구,0.0,0,2,1,0,3
10887,2019-03-12,마포구,0.0,0,3,0,0,3
10888,2019-03-12,서대문구,0.0,0,3,2,1,6
10889,2019-03-12,서초구,0.0,0,11,0,3,14
10890,2019-03-12,성동구,0.0,0,2,0,1,3
10891,2019-03-12,성북구,0.0,0,4,0,3,7
10892,2019-03-12,송파구,0.0,0,6,1,1,8
10893,2019-03-12,양천구,0.0,0,5,0,0,5
10894,2019-03-12,영등포구,0.0,0,4,0,2,6
10895,2019-03-12,용산구,0.0,0,2,0,0,2
10896,2019-03-12,은평구,1.0,1,2,4,4,11
10897,2019-03-12,종로구,0.0,0,0,2,0,2
10898,2019-03-12,중구,0.0,0,1,0,2,3
10899,2019-03-12,중랑구,0.0,0,4,0,2,6
10900,2019-03-13,강남구,0.0,0,4,1,0,5
10901,2019-03-13,강동구,0.0,0,5,0,2,7
10902,2019-03-13,강북구,0.0,0,2,1,2,5
10903,2019-03-13,강서구,0.0,0,5,1,5,11
10904,2019-03-13,관악구,0.0,0,1,0,2,3
10905,2019-03-13,광진구,0.0,0,4,0,2,6
10906,2019-03-13,구로구,0.0,0,4,0,2,6
10907,2019-03-13,금천구,0.0,0,4,0,0,4
10908,2019-03-13,노원구,0.0,0,2,0,1,3
10909,2019-03-13,도봉구,0.0,0,5,2,0,7
10910,2019-03-13,동대문구,0.0,0,1,1,1,3
10911,2019-03-13,동작구,0.0,0,6,0,1,7
10912,2019-03-13,마포구,0.0,0,3,0,2,5
10913,2019-03-13,서대문구,0.0,0,1,0,0,1
10914,2019-03-13,서초구,0.0,0,12,0,3,15
10915,2019-03-13,성동구,0.0,1,1,0,1,3
10916,2019-03-13,성북구,0.0,0,1,0,3,4
10917,2019-03-13,송파구,0.0,0,7,0,3,10
10918,2019-03-13,양천구,0.0,0,5,0,2,7
10919,2019-03-13,영등포구,0.0,0,19,0,2,21
10920,2019-03-13,용산구,0.0,0,6,0,1,7
10921,2019-03-13,은평구,0.0,0,0,0,0,0
10922,2019-03-13,종로구,0.0,0,1,1,2,4
10923,2019-03-13,중구,0.0,0,1,1,1,3
10924,2019-03-13,중랑구,0.0,0,2,0,1,3
10925,2019-03-14,강남구,0.0,0,10,0,2,12
10926,2019-03-14,강동구,0.0,0,6,0,0,6
10927,2019-03-14,강북구,0.0,0,1,0,3,4
10928,2019-03-14,강서구,0.0,0,2,0,1,3
10929,2019-03-14,관악구,0.0,0,0,0,1,1
10930,2019-03-14,광진구,0.0,0,1,0,0,1
10931,2019-03-14,구로구,0.0,0,6,2,2,10
10932,2019-03-14,금천구,0.0,1,2,0,0,3
10933,2019-03-14,노원구,0.0,0,5,0,3,8
10934,2019-03-14,도봉구,0.0,0,0,1,1,2
10935,2019-03-14,동대문구,0.0,0,3,0,3,6
10936,2019-03-14,동작구,0.0,0,3,0,4,7
10937,2019-03-14,마포구,0.0,0,5,0,1,6
10938,2019-03-14,서대문구,0.0,1,1,0,0,2
10939,2019-03-14,서초구,0.0,0,4,0,2,6
10940,2019-03-14,성동구,0.0,0,3,0,1,4
10941,2019-03-14,성북구,0.0,0,3,0,0,3
10942,2019-03-14,송파구,0.0,0,10,2,2,14
10943,2019-03-14,양천구,0.0,0,1,0,0,1
10944,2019-03-14,영등포구,0.0,0,8,2,5,15
10945,2019-03-14,용산구,0.0,0,1,0,1,2
10946,2019-03-14,은평구,0.0,0,4,0,1,5
10947,2019-03-14,종로구,0.0,0,2,0,2,4
10948,2019-03-14,중구,0.0,0,1,1,0,2
10949,2019-03-14,중랑구,0.0,0,1,0,3,4
10950,2019-03-15,강남구,7.0,0,12,1,2,15
10951,2019-03-15,강동구,6.5,0,8,0,2,10
10952,2019-03-15,강북구,4.0,0,6,0,1,7
10953,2019-03-15,강서구,0.0,1,9,0,3,13
10954,2019-03-15,관악구,5.0,0,3,0,1,4
10955,2019-03-15,광진구,7.5,0,1,0,0,1
10956,2019-03-15,구로구,1.5,0,9,0,5,14
10957,2019-03-15,금천구,1.5,0,5,0,0,5
10958,2019-03-15,노원구,4.5,0,9,1,1,11
10959,2019-03-15,도봉구,4.5,0,4,0,0,4
10960,2019-03-15,동대문구,3.5,0,1,1,1,3
10961,2019-03-15,동작구,6.5,0,7,0,1,8
10962,2019-03-15,마포구,3.0,0,5,3,1,9
10963,2019-03-15,서대문구,2.0,0,2,1,0,3
10964,2019-03-15,서초구,12.5,0,11,0,1,12
10965,2019-03-15,성동구,5.0,0,4,0,0,4
10966,2019-03-15,성북구,4.0,0,4,1,1,6
10967,2019-03-15,송파구,8.5,0,10,0,3,13
10968,2019-03-15,양천구,1.0,0,4,2,0,6
10969,2019-03-15,영등포구,4.0,0,9,3,1,13
10970,2019-03-15,용산구,8.5,0,5,0,1,6
10971,2019-03-15,은평구,3.0,0,5,0,1,6
10972,2019-03-15,종로구,3.5,0,1,0,1,2
10973,2019-03-15,중구,2.0,0,1,0,3,4
10974,2019-03-15,중랑구,4.0,1,2,2,3,8
10975,2019-03-16,강남구,0.0,0,6,0,1,7
10976,2019-03-16,강동구,0.0,0,8,1,1,10
10977,2019-03-16,강북구,0.0,0,1,1,0,2
10978,2019-03-16,강서구,0.0,0,4,1,0,5
10979,2019-03-16,관악구,0.0,0,6,0,1,7
10980,2019-03-16,광진구,0.0,0,0,0,1,1
10981,2019-03-16,구로구,0.0,0,4,0,0,4
10982,2019-03-16,금천구,0.0,0,2,0,0,2
10983,2019-03-16,노원구,0.0,0,6,1,1,8
10984,2019-03-16,도봉구,0.0,0,0,0,0,0
10985,2019-03-16,동대문구,0.0,0,7,0,0,7
10986,2019-03-16,동작구,0.0,0,5,2,1,8
10987,2019-03-16,마포구,0.0,0,8,0,1,9
10988,2019-03-16,서대문구,0.0,0,2,2,0,4
10989,2019-03-16,서초구,0.0,0,8,1,3,12
10990,2019-03-16,성동구,0.0,0,2,0,0,2
10991,2019-03-16,성북구,0.0,0,4,0,2,6
10992,2019-03-16,송파구,0.0,0,5,1,1,7
10993,2019-03-16,양천구,0.0,0,4,2,1,7
10994,2019-03-16,영등포구,0.0,0,8,1,1,10
10995,2019-03-16,용산구,0.0,0,8,0,1,9
10996,2019-03-16,은평구,0.0,0,0,0,1,1
10997,2019-03-16,종로구,0.0,0,0,1,0,1
10998,2019-03-16,중구,0.0,0,5,0,0,5
10999,2019-03-16,중랑구,0.0,0,9,2,0,11
11000,2019-03-17,강남구,0.0,0,10,0,3,13
11001,2019-03-17,강동구,0.0,0,2,1,0,3
11002,2019-03-17,강북구,0.0,0,1,1,1,3
11003,2019-03-17,강서구,0.0,0,3,0,0,3
11004,2019-03-17,관악구,0.0,0,3,0,3,6
11005,2019-03-17,광진구,0.0,0,5,0,0,5
11006,2019-03-17,구로구,0.0,0,8,0,2,10
11007,2019-03-17,금천구,0.0,0,4,0,1,5
11008,2019-03-17,노원구,0.0,0,2,0,0,2
11009,2019-03-17,도봉구,0.0,0,0,1,0,1
11010,2019-03-17,동대문구,0.0,0,1,0,0,1
11011,2019-03-17,동작구,0.0,0,6,1,0,7
11012,2019-03-17,마포구,0.0,0,6,1,2,9
11013,2019-03-17,서대문구,0.0,0,0,0,1,1
11014,2019-03-17,서초구,0.0,0,1,1,1,3
11015,2019-03-17,성동구,0.0,0,3,0,1,4
11016,2019-03-17,성북구,0.0,0,4,0,1,5
11017,2019-03-17,송파구,0.0,0,5,1,2,8
11018,2019-03-17,양천구,0.0,0,3,2,0,5
11019,2019-03-17,영등포구,0.0,0,4,2,1,7
11020,2019-03-17,용산구,0.0,0,2,0,1,3
11021,2019-03-17,은평구,0.0,0,0,0,0,0
11022,2019-03-17,종로구,0.0,0,2,0,2,4
11023,2019-03-17,중구,0.0,0,2,0,2,4
11024,2019-03-17,중랑구,0.0,0,4,1,3,8
11025,2019-03-18,강남구,0.0,0,7,0,4,11
11026,2019-03-18,강동구,0.0,0,7,0,1,8
11027,2019-03-18,강북구,0.0,0,0,0,0,0
11028,2019-03-18,강서구,0.0,0,0,0,0,0
11029,2019-03-18,관악구,0.0,0,3,0,1,4
11030,2019-03-18,광진구,0.0,0,1,0,1,2
11031,2019-03-18,구로구,0.0,0,3,0,0,3
11032,2019-03-18,금천구,0.0,0,2,0,2,4
11033,2019-03-18,노원구,0.0,1,3,0,1,5
11034,2019-03-18,도봉구,0.0,0,3,0,1,4
11035,2019-03-18,동대문구,0.0,0,1,0,1,2
11036,2019-03-18,동작구,0.0,0,3,1,1,5
11037,2019-03-18,마포구,0.0,0,4,0,3,7
11038,2019-03-18,서대문구,0.0,0,2,0,0,2
11039,2019-03-18,서초구,0.0,0,6,1,1,8
11040,2019-03-18,성동구,0.0,0,3,0,1,4
11041,2019-03-18,성북구,0.0,0,14,1,1,16
11042,2019-03-18,송파구,0.0,0,10,0,5,15
11043,2019-03-18,양천구,0.0,0,7,0,1,8
11044,2019-03-18,영등포구,0.0,0,3,2,0,5
11045,2019-03-18,용산구,0.0,0,2,0,0,2
11046,2019-03-18,은평구,0.0,0,1,0,2,3
11047,2019-03-18,종로구,0.0,0,2,1,2,5
11048,2019-03-18,중구,0.0,0,4,0,3,7
11049,2019-03-18,중랑구,0.0,0,1,0,1,2
11050,2019-03-19,강남구,0.0,0,10,1,1,12
11051,2019-03-19,강동구,0.0,0,2,1,1,4
11052,2019-03-19,강북구,0.0,0,2,0,3,5
11053,2019-03-19,강서구,0.0,0,4,0,5,9
11054,2019-03-19,관악구,0.0,1,2,0,1,4
11055,2019-03-19,광진구,0.0,0,0,0,1,1
11056,2019-03-19,구로구,0.0,0,9,2,0,11
11057,2019-03-19,금천구,0.0,0,9,0,2,11
11058,2019-03-19,노원구,0.0,0,9,0,2,11
11059,2019-03-19,도봉구,0.0,0,0,0,0,0
11060,2019-03-19,동대문구,0.0,0,3,0,1,4
11061,2019-03-19,동작구,0.0,0,4,1,0,5
11062,2019-03-19,마포구,0.0,0,4,2,1,7
11063,2019-03-19,서대문구,0.0,0,1,2,0,3
11064,2019-03-19,서초구,0.0,0,2,0,0,2
11065,2019-03-19,성동구,0.0,0,4,2,0,6
11066,2019-03-19,성북구,0.0,0,5,0,0,5
11067,2019-03-19,송파구,0.0,0,13,1,3,17
11068,2019-03-19,양천구,0.0,0,1,0,1,2
11069,2019-03-19,영등포구,0.0,0,5,0,1,6
11070,2019-03-19,용산구,0.0,0,2,0,1,3
11071,2019-03-19,은평구,0.0,0,5,0,0,5
11072,2019-03-19,종로구,0.0,0,0,0,0,0
11073,2019-03-19,중구,0.0,0,0,0,1,1
11074,2019-03-19,중랑구,0.0,0,3,0,1,4
11075,2019-03-20,강남구,19.5,0,12,0,4,16
11076,2019-03-20,강동구,16.5,0,3,0,0,3
11077,2019-03-20,강북구,15.5,0,8,0,1,9
11078,2019-03-20,강서구,17.5,1,10,1,3,15
11079,2019-03-20,관악구,21.5,0,1,0,2,3
11080,2019-03-20,광진구,18.0,0,3,0,1,4
11081,2019-03-20,구로구,20.0,0,2,0,1,3
11082,2019-03-20,금천구,21.0,0,3,0,0,3
11083,2019-03-20,노원구,15.0,0,2,1,1,4
11084,2019-03-20,도봉구,16.0,0,0,0,0,0
11085,2019-03-20,동대문구,15.0,0,6,0,0,6
11086,2019-03-20,동작구,11.75,0,6,4,2,12
11087,2019-03-20,마포구,19.5,0,2,1,1,4
11088,2019-03-20,서대문구,18.5,0,4,0,1,5
11089,2019-03-20,서초구,19.5,0,6,0,1,7
11090,2019-03-20,성동구,18.5,0,10,0,1,11
11091,2019-03-20,성북구,16.5,0,6,0,3,9
11092,2019-03-20,송파구,17.0,0,15,1,1,17
11093,2019-03-20,양천구,20.0,0,7,0,4,11
11094,2019-03-20,영등포구,17.25,0,5,1,0,6
11095,2019-03-20,용산구,19.0,0,6,3,1,10
11096,2019-03-20,은평구,12.5,0,2,0,0,2
11097,2019-03-20,종로구,16.5,0,1,0,0,1
11098,2019-03-20,중구,13.0,0,5,0,2,7
11099,2019-03-20,중랑구,18.0,1,8,2,0,11
11100,2019-03-21,강남구,4.0,1,17,2,6,26
11101,2019-03-21,강동구,5.5,0,0,1,2,3
11102,2019-03-21,강북구,3.5,0,0,0,0,0
11103,2019-03-21,강서구,3.0,0,1,0,1,2
11104,2019-03-21,관악구,4.75,0,4,0,1,5
11105,2019-03-21,광진구,4.0,0,3,0,1,4
11106,2019-03-21,구로구,4.0,0,4,0,1,5
11107,2019-03-21,금천구,5.0,0,1,1,0,2
11108,2019-03-21,노원구,3.5,0,2,0,1,3
11109,2019-03-21,도봉구,3.5,0,8,1,0,9
11110,2019-03-21,동대문구,4.5,0,0,0,4,4
11111,2019-03-21,동작구,2.0,0,1,0,1,2
11112,2019-03-21,마포구,3.5,0,6,0,2,8
11113,2019-03-21,서대문구,4.0,0,1,0,0,1
11114,2019-03-21,서초구,4.0,0,13,0,5,18
11115,2019-03-21,성동구,4.5,0,2,0,0,2
11116,2019-03-21,성북구,4.0,0,5,0,3,8
11117,2019-03-21,송파구,4.0,0,7,0,2,9
11118,2019-03-21,양천구,3.5,0,6,1,2,9
11119,2019-03-21,영등포구,3.75,0,4,1,2,7
11120,2019-03-21,용산구,4.5,0,6,1,2,9
11121,2019-03-21,은평구,3.0,0,2,0,0,2
11122,2019-03-21,종로구,3.3,0,1,0,0,1
11123,2019-03-21,중구,3.5,0,0,0,0,0
11124,2019-03-21,중랑구,4.0,0,8,1,0,9
11125,2019-03-22,강남구,0.0,0,12,0,1,13
11126,2019-03-22,강동구,0.0,0,5,0,1,6
11127,2019-03-22,강북구,0.0,0,2,0,2,4
11128,2019-03-22,강서구,0.0,0,4,0,0,4
11129,2019-03-22,관악구,0.0,0,4,0,0,4
11130,2019-03-22,광진구,0.0,0,2,0,0,2
11131,2019-03-22,구로구,0.0,0,2,0,1,3
11132,2019-03-22,금천구,0.0,0,0,0,0,0
11133,2019-03-22,노원구,0.0,0,3,1,1,5
11134,2019-03-22,도봉구,0.0,0,2,2,1,5
11135,2019-03-22,동대문구,0.0,0,6,0,0,6
11136,2019-03-22,동작구,0.0,0,7,1,0,8
11137,2019-03-22,마포구,0.0,0,1,0,0,1
11138,2019-03-22,서대문구,0.0,0,1,0,1,2
11139,2019-03-22,서초구,0.0,0,8,3,2,13
11140,2019-03-22,성동구,0.0,0,2,1,0,3
11141,2019-03-22,성북구,0.0,0,1,1,1,3
11142,2019-03-22,송파구,0.0,0,14,3,3,20
11143,2019-03-22,양천구,0.0,0,2,1,3,6
11144,2019-03-22,영등포구,0.0,0,4,2,0,6
11145,2019-03-22,용산구,0.0,0,2,0,1,3
11146,2019-03-22,은평구,0.0,0,0,0,0,0
11147,2019-03-22,종로구,0.0,0,2,0,0,2
11148,2019-03-22,중구,0.0,0,1,0,1,2
11149,2019-03-22,중랑구,0.0,0,2,0,2,4
11150,2019-03-23,강남구,3.0,0,11,0,2,13
11151,2019-03-23,강동구,3.0,0,6,0,4,10
11152,2019-03-23,강북구,1.0,1,5,3,1,10
11153,2019-03-23,강서구,2.0,0,9,1,1,11
11154,2019-03-23,관악구,1.5,0,5,4,0,9
11155,2019-03-23,광진구,3.0,0,4,0,3,7
11156,2019-03-23,구로구,3.0,0,12,5,3,20
11157,2019-03-23,금천구,2.5,0,3,0,0,3
11158,2019-03-23,노원구,1.0,0,2,0,2,4
11159,2019-03-23,도봉구,0.5,0,4,0,0,4
11160,2019-03-23,동대문구,2.5,0,4,0,2,6
11161,2019-03-23,동작구,1.75,0,4,2,3,9
11162,2019-03-23,마포구,0.0,0,4,0,1,5
11163,2019-03-23,서대문구,1.5,0,6,1,0,7
11164,2019-03-23,서초구,2.0,0,8,1,0,9
11165,2019-03-23,성동구,2.0,0,4,0,1,5
11166,2019-03-23,성북구,1.5,0,3,0,2,5
11167,2019-03-23,송파구,2.5,0,11,0,2,13
11168,2019-03-23,양천구,1.5,0,2,4,0,6
11169,2019-03-23,영등포구,1.75,0,7,1,0,8
11170,2019-03-23,용산구,2.0,0,6,1,0,7
11171,2019-03-23,은평구,0.5,0,1,0,1,2
11172,2019-03-23,종로구,1.7,0,8,0,0,8
11173,2019-03-23,중구,1.5,0,0,0,0,0
11174,2019-03-23,중랑구,2.5,0,4,0,1,5
11175,2019-03-24,강남구,0.0,0,4,1,2,7
11176,2019-03-24,강동구,0.0,0,4,0,2,6
11177,2019-03-24,강북구,0.0,0,15,0,2,17
11178,2019-03-24,강서구,0.0,0,6,1,1,8
11179,2019-03-24,관악구,0.0,0,1,1,2,4
11180,2019-03-24,광진구,0.0,0,3,0,0,3
11181,2019-03-24,구로구,0.0,0,2,0,0,2
11182,2019-03-24,금천구,0.0,0,3,0,1,4
11183,2019-03-24,노원구,0.0,0,1,0,0,1
11184,2019-03-24,도봉구,0.0,0,2,0,1,3
11185,2019-03-24,동대문구,0.0,0,5,1,0,6
11186,2019-03-24,동작구,0.0,0,3,1,0,4
11187,2019-03-24,마포구,0.0,0,5,0,1,6
11188,2019-03-24,서대문구,0.0,0,1,1,0,2
11189,2019-03-24,서초구,0.0,0,3,0,0,3
11190,2019-03-24,성동구,0.0,0,2,0,1,3
11191,2019-03-24,성북구,0.0,0,5,0,2,7
11192,2019-03-24,송파구,0.0,0,8,1,3,12
11193,2019-03-24,양천구,0.0,0,2,2,1,5
11194,2019-03-24,영등포구,0.0,0,6,4,2,12
11195,2019-03-24,용산구,0.0,0,3,0,0,3
11196,2019-03-24,은평구,0.0,0,2,1,3,6
11197,2019-03-24,종로구,0.0,0,3,4,1,8
11198,2019-03-24,중구,0.0,0,6,1,0,7
11199,2019-03-24,중랑구,0.0,0,11,1,2,14
11200,2019-03-25,강남구,0.0,0,13,1,3,17
11201,2019-03-25,강동구,0.0,0,0,0,0,0
11202,2019-03-25,강북구,0.0,0,0,0,2,2
11203,2019-03-25,강서구,0.0,0,5,2,1,8
11204,2019-03-25,관악구,0.0,0,1,0,2,3
11205,2019-03-25,광진구,0.0,0,4,0,1,5
11206,2019-03-25,구로구,0.0,0,5,0,0,5
11207,2019-03-25,금천구,0.0,0,0,0,1,1
11208,2019-03-25,노원구,0.0,0,3,1,0,4
11209,2019-03-25,도봉구,0.0,0,2,0,1,3
11210,2019-03-25,동대문구,0.0,1,4,0,2,7
11211,2019-03-25,동작구,0.0,0,3,0,0,3
11212,2019-03-25,마포구,0.0,0,1,2,1,4
11213,2019-03-25,서대문구,0.0,0,1,0,1,2
11214,2019-03-25,서초구,0.0,0,7,0,2,9
11215,2019-03-25,성동구,0.0,0,1,0,0,1
11216,2019-03-25,성북구,0.0,0,5,0,0,5
11217,2019-03-25,송파구,0.0,0,12,1,2,15
11218,2019-03-25,양천구,0.0,0,2,0,1,3
11219,2019-03-25,영등포구,0.0,0,4,1,1,6
11220,2019-03-25,용산구,0.0,0,8,0,1,9
11221,2019-03-25,은평구,0.0,0,3,0,0,3
11222,2019-03-25,종로구,0.0,0,6,0,2,8
11223,2019-03-25,중구,0.0,0,6,0,0,6
11224,2019-03-25,중랑구,0.0,0,2,1,1,4
11225,2019-03-26,강남구,0.0,0,14,1,3,18
11226,2019-03-26,강동구,0.0,0,4,1,1,6
11227,2019-03-26,강북구,0.0,0,3,0,0,3
11228,2019-03-26,강서구,0.0,0,3,0,1,4
11229,2019-03-26,관악구,0.0,0,3,0,0,3
11230,2019-03-26,광진구,0.0,0,3,0,0,3
11231,2019-03-26,구로구,0.0,0,3,0,1,4
11232,2019-03-26,금천구,0.0,0,1,0,1,2
11233,2019-03-26,노원구,0.0,0,8,0,0,8
11234,2019-03-26,도봉구,0.0,0,2,0,1,3
11235,2019-03-26,동대문구,0.0,0,2,0,0,2
11236,2019-03-26,동작구,0.0,0,1,0,1,2
11237,2019-03-26,마포구,0.0,0,1,0,1,2
11238,2019-03-26,서대문구,0.0,0,2,1,3,6
11239,2019-03-26,서초구,0.0,0,4,0,1,5
11240,2019-03-26,성동구,0.0,0,0,0,1,1
11241,2019-03-26,성북구,0.0,0,4,1,0,5
11242,2019-03-26,송파구,0.0,0,9,1,3,13
11243,2019-03-26,양천구,0.0,0,1,1,1,3
11244,2019-03-26,영등포구,0.0,0,6,0,3,9
11245,2019-03-26,용산구,0.0,0,1,0,0,1
11246,2019-03-26,은평구,0.0,0,1,0,1,2
11247,2019-03-26,종로구,0.0,1,3,0,1,5
11248,2019-03-26,중구,0.0,0,9,1,2,12
11249,2019-03-26,중랑구,0.0,0,7,1,2,10
11250,2019-03-27,강남구,0.0,1,12,1,1,15
11251,2019-03-27,강동구,0.0,0,2,0,1,3
11252,2019-03-27,강북구,0.0,0,2,0,1,3
11253,2019-03-27,강서구,0.0,0,2,0,1,3
11254,2019-03-27,관악구,0.0,0,1,0,1,2
11255,2019-03-27,광진구,0.0,0,2,0,0,2
11256,2019-03-27,구로구,0.0,0,3,0,1,4
11257,2019-03-27,금천구,0.0,0,2,0,1,3
11258,2019-03-27,노원구,0.0,0,1,0,1,2
11259,2019-03-27,도봉구,0.0,0,1,0,0,1
11260,2019-03-27,동대문구,0.0,0,3,0,2,5
11261,2019-03-27,동작구,0.0,0,0,0,3,3
11262,2019-03-27,마포구,0.0,0,2,0,0,2
11263,2019-03-27,서대문구,0.0,0,3,0,0,3
11264,2019-03-27,서초구,0.0,0,8,0,2,10
11265,2019-03-27,성동구,0.0,0,1,0,0,1
11266,2019-03-27,성북구,0.0,0,1,2,0,3
11267,2019-03-27,송파구,0.0,0,8,0,1,9
11268,2019-03-27,양천구,0.0,0,1,1,1,3
11269,2019-03-27,영등포구,0.0,0,0,2,0,2
11270,2019-03-27,용산구,0.0,0,3,0,0,3
11271,2019-03-27,은평구,0.0,0,1,0,3,4
11272,2019-03-27,종로구,0.0,0,4,2,1,7
11273,2019-03-27,중구,0.0,0,1,0,0,1
11274,2019-03-27,중랑구,0.0,0,4,1,0,5
11275,2019-03-28,강남구,0.0,0,8,2,3,13
11276,2019-03-28,강동구,0.0,0,4,0,2,6
11277,2019-03-28,강북구,0.0,0,1,0,0,1
11278,2019-03-28,강서구,0.0,0,10,0,3,13
11279,2019-03-28,관악구,0.0,0,3,0,2,5
11280,2019-03-28,광진구,0.0,0,2,0,1,3
11281,2019-03-28,구로구,0.0,0,3,0,1,4
11282,2019-03-28,금천구,0.0,0,5,0,0,5
11283,2019-03-28,노원구,0.0,0,2,1,1,4
11284,2019-03-28,도봉구,0.0,0,0,0,2,2
11285,2019-03-28,동대문구,0.0,0,5,2,3,10
11286,2019-03-28,동작구,0.0,0,1,0,0,1
11287,2019-03-28,마포구,0.0,0,8,1,1,10
11288,2019-03-28,서대문구,0.0,0,0,0,0,0
11289,2019-03-28,서초구,0.0,0,10,0,1,11
11290,2019-03-28,성동구,0.0,0,3,0,0,3
11291,2019-03-28,성북구,0.0,0,4,0,1,5
11292,2019-03-28,송파구,0.0,0,4,0,1,5
11293,2019-03-28,양천구,0.0,0,16,0,3,19
11294,2019-03-28,영등포구,0.0,0,8,0,2,10
11295,2019-03-28,용산구,0.0,0,2,0,0,2
11296,2019-03-28,은평구,0.0,0,1,0,1,2
11297,2019-03-28,종로구,0.0,0,1,1,1,3
11298,2019-03-28,중구,0.0,0,5,0,1,6
11299,2019-03-28,중랑구,0.0,0,1,0,0,1
11300,2019-03-29,강남구,0.0,0,14,1,1,16
11301,2019-03-29,강동구,0.0,0,3,0,0,3
11302,2019-03-29,강북구,0.0,0,7,0,2,9
11303,2019-03-29,강서구,0.0,0,3,0,2,5
11304,2019-03-29,관악구,0.0,0,14,0,2,16
11305,2019-03-29,광진구,0.0,0,1,0,0,1
11306,2019-03-29,구로구,0.0,0,4,0,1,5
11307,2019-03-29,금천구,0.0,0,0,1,0,1
11308,2019-03-29,노원구,0.0,0,7,1,3,11
11309,2019-03-29,도봉구,0.0,0,3,0,2,5
11310,2019-03-29,동대문구,0.0,0,8,0,3,11
11311,2019-03-29,동작구,0.0,0,3,0,1,4
11312,2019-03-29,마포구,0.0,0,9,0,2,11
11313,2019-03-29,서대문구,0.0,0,2,0,1,3
11314,2019-03-29,서초구,0.0,0,3,1,0,4
11315,2019-03-29,성동구,0.0,0,10,0,1,11
11316,2019-03-29,성북구,0.0,0,6,1,1,8
11317,2019-03-29,송파구,0.0,0,4,0,0,4
11318,2019-03-29,양천구,0.0,0,3,0,3,6
11319,2019-03-29,영등포구,0.0,0,8,1,1,10
11320,2019-03-29,용산구,0.0,0,6,0,2,8
11321,2019-03-29,은평구,0.0,0,8,0,0,8
11322,2019-03-29,종로구,0.0,0,4,0,0,4
11323,2019-03-29,중구,0.0,0,2,0,0,2
11324,2019-03-29,중랑구,0.0,0,0,0,1,1
11325,2019-03-30,강남구,3.0,0,6,3,2,11
11326,2019-03-30,강동구,3.0,0,7,0,4,11
11327,2019-03-30,강북구,4.0,0,1,0,1,2
11328,2019-03-30,강서구,2.5,0,6,0,3,9
11329,2019-03-30,관악구,1.75,0,2,0,2,4
11330,2019-03-30,광진구,3.0,0,3,1,1,5
11331,2019-03-30,구로구,3.5,0,6,1,2,9
11332,2019-03-30,금천구,3.0,0,3,0,1,4
11333,2019-03-30,노원구,2.0,0,8,0,0,8
11334,2019-03-30,도봉구,5.5,0,6,0,0,6
11335,2019-03-30,동대문구,2.5,0,5,0,3,8
11336,2019-03-30,동작구,3.5,0,3,0,0,3
11337,2019-03-30,마포구,2.0,0,5,0,0,5
11338,2019-03-30,서대문구,2.0,0,3,0,0,3
11339,2019-03-30,서초구,3.0,0,8,0,3,11
11340,2019-03-30,성동구,4.5,0,0,0,0,0
11341,2019-03-30,성북구,2.5,0,0,0,0,0
11342,2019-03-30,송파구,2.0,0,10,0,2,12
11343,2019-03-30,양천구,3.0,0,11,3,0,14
11344,2019-03-30,영등포구,3.0,0,4,1,1,6
11345,2019-03-30,용산구,3.0,0,10,0,0,10
11346,2019-03-30,은평구,3.5,0,6,2,3,11
11347,2019-03-30,종로구,1.8,0,6,0,0,6
11348,2019-03-30,중구,2.5,0,7,1,0,8
11349,2019-03-30,중랑구,2.5,0,3,1,2,6
11350,2019-03-31,강남구,0.0,0,18,0,4,22
11351,2019-03-31,강동구,0.0,0,2,0,0,2
11352,2019-03-31,강북구,0.0,0,2,1,0,3
11353,2019-03-31,강서구,0.0,0,4,0,1,5
11354,2019-03-31,관악구,0.0,0,0,1,1,2
11355,2019-03-31,광진구,0.0,0,2,0,0,2
11356,2019-03-31,구로구,0.0,0,3,0,0,3
11357,2019-03-31,금천구,0.0,0,3,0,0,3
11358,2019-03-31,노원구,0.0,0,4,0,2,6
11359,2019-03-31,도봉구,0.0,0,2,0,0,2
11360,2019-03-31,동대문구,0.0,0,3,0,0,3
11361,2019-03-31,동작구,0.0,0,7,0,0,7
11362,2019-03-31,마포구,0.0,0,2,0,0,2
11363,2019-03-31,서대문구,0.0,0,0,0,0,0
11364,2019-03-31,서초구,0.0,0,1,0,1,2
11365,2019-03-31,성동구,0.0,0,1,0,0,1
11366,2019-03-31,성북구,0.0,0,4,1,3,8
11367,2019-03-31,송파구,0.0,0,3,1,0,4
11368,2019-03-31,양천구,0.0,0,0,0,0,0
11369,2019-03-31,영등포구,0.0,0,3,0,1,4
11370,2019-03-31,용산구,0.0,1,8,3,4,16
11371,2019-03-31,은평구,0.0,0,0,0,0,0
11372,2019-03-31,종로구,0.0,0,2,0,3,5
11373,2019-03-31,중구,0.0,0,1,0,0,1
11374,2019-03-31,중랑구,0.0,0,4,1,0,5
11375,2019-04-01,강남구,0.0,0,17,1,2,20
11376,2019-04-01,강동구,0.0,0,1,0,2,3
11377,2019-04-01,강북구,0.0,0,8,0,2,10
11378,2019-04-01,강서구,0.0,0,17,1,3,21
11379,2019-04-01,관악구,0.0,0,5,0,1,6
11380,2019-04-01,광진구,0.0,0,0,0,0,0
11381,2019-04-01,구로구,0.0,0,8,0,4,12
11382,2019-04-01,금천구,0.0,0,2,0,2,4
11383,2019-04-01,노원구,0.0,0,4,0,2,6
11384,2019-04-01,도봉구,0.0,0,3,0,0,3
11385,2019-04-01,동대문구,0.0,0,7,1,0,8
11386,2019-04-01,동작구,0.0,0,2,0,3,5
11387,2019-04-01,마포구,0.0,0,5,1,1,7
11388,2019-04-01,서대문구,0.0,0,0,0,1,1
11389,2019-04-01,서초구,0.0,0,4,1,1,6
11390,2019-04-01,성동구,0.0,0,2,0,1,3
11391,2019-04-01,성북구,0.0,0,3,0,1,4
11392,2019-04-01,송파구,0.0,0,9,0,2,11
11393,2019-04-01,양천구,0.0,1,5,1,0,7
11394,2019-04-01,영등포구,0.0,0,8,0,4,12
11395,2019-04-01,용산구,0.0,0,0,0,0,0
11396,2019-04-01,은평구,0.0,0,0,0,1,1
11397,2019-04-01,종로구,0.0,0,0,0,1,1
11398,2019-04-01,중구,0.0,1,7,0,2,10
11399,2019-04-01,중랑구,0.0,0,5,2,1,8
11400,2019-04-02,강남구,0.0,0,14,2,2,18
11401,2019-04-02,강동구,0.0,0,4,1,3,8
11402,2019-04-02,강북구,0.0,0,3,0,1,4
11403,2019-04-02,강서구,0.0,0,4,0,0,4
11404,2019-04-02,관악구,0.0,0,2,0,1,3
11405,2019-04-02,광진구,0.0,0,3,0,1,4
11406,2019-04-02,구로구,0.0,0,6,0,0,6
11407,2019-04-02,금천구,0.0,0,1,2,3,6
11408,2019-04-02,노원구,0.0,0,7,2,2,11
11409,2019-04-02,도봉구,0.0,0,2,0,1,3
11410,2019-04-02,동대문구,0.0,0,3,1,2,6
11411,2019-04-02,동작구,0.0,0,2,0,2,4
11412,2019-04-02,마포구,0.0,0,0,0,0,0
11413,2019-04-02,서대문구,0.0,0,1,0,0,1
11414,2019-04-02,서초구,0.0,0,9,0,1,10
11415,2019-04-02,성동구,0.0,0,3,0,0,3
11416,2019-04-02,성북구,0.0,0,6,0,0,6
11417,2019-04-02,송파구,0.0,0,7,1,4,12
11418,2019-04-02,양천구,0.0,0,7,1,0,8
11419,2019-04-02,영등포구,0.0,0,6,0,1,7
11420,2019-04-02,용산구,0.0,0,1,0,1,2
11421,2019-04-02,은평구,0.0,0,1,0,2,3
11422,2019-04-02,종로구,0.0,0,8,0,4,12
11423,2019-04-02,중구,0.0,0,4,0,1,5
11424,2019-04-02,중랑구,0.0,0,3,1,2,6
11425,2019-04-03,강남구,0.0,0,9,2,2,13
11426,2019-04-03,강동구,0.0,0,2,1,3,6
11427,2019-04-03,강북구,0.0,0,8,0,1,9
11428,2019-04-03,강서구,0.0,0,2,0,0,2
11429,2019-04-03,관악구,0.0,0,3,0,0,3
11430,2019-04-03,광진구,0.0,0,2,0,2,4
11431,2019-04-03,구로구,0.0,0,5,0,2,7
11432,2019-04-03,금천구,0.0,0,6,0,3,9
11433,2019-04-03,노원구,0.0,0,1,0,1,2
11434,2019-04-03,도봉구,0.0,0,3,0,0,3
11435,2019-04-03,동대문구,0.0,0,5,0,2,7
11436,2019-04-03,동작구,0.0,0,2,1,1,4
11437,2019-04-03,마포구,0.0,0,3,0,1,4
11438,2019-04-03,서대문구,0.0,0,1,1,0,2
11439,2019-04-03,서초구,0.0,0,3,1,0,4
11440,2019-04-03,성동구,0.0,0,2,0,0,2
11441,2019-04-03,성북구,0.0,0,2,0,1,3
11442,2019-04-03,송파구,0.0,0,8,0,1,9
11443,2019-04-03,양천구,0.0,0,4,2,1,7
11444,2019-04-03,영등포구,0.0,0,6,0,1,7
11445,2019-04-03,용산구,0.0,0,6,3,1,10
11446,2019-04-03,은평구,0.0,0,2,0,0,2
11447,2019-04-03,종로구,0.0,0,6,2,1,9
11448,2019-04-03,중구,0.0,0,4,1,2,7
11449,2019-04-03,중랑구,0.0,0,1,1,1,3
11450,2019-04-04,강남구,0.0,0,6,1,0,7
11451,2019-04-04,강동구,0.0,0,2,0,5,7
11452,2019-04-04,강북구,0.0,0,9,0,1,10
11453,2019-04-04,강서구,0.0,0,4,0,1,5
11454,2019-04-04,관악구,0.0,0,4,0,1,5
11455,2019-04-04,광진구,0.0,0,6,0,1,7
11456,2019-04-04,구로구,0.0,0,0,0,2,2
11457,2019-04-04,금천구,0.0,0,0,0,0,0
11458,2019-04-04,노원구,0.0,0,2,0,0,2
11459,2019-04-04,도봉구,0.0,0,1,0,1,2
11460,2019-04-04,동대문구,0.0,0,3,1,5,9
11461,2019-04-04,동작구,0.0,0,2,0,0,2
11462,2019-04-04,마포구,0.0,0,4,1,1,6
11463,2019-04-04,서대문구,0.0,0,0,0,2,2
11464,2019-04-04,서초구,0.0,0,13,0,0,13
11465,2019-04-04,성동구,0.0,0,9,1,1,11
11466,2019-04-04,성북구,0.0,0,4,0,2,6
11467,2019-04-04,송파구,0.0,0,15,0,1,16
11468,2019-04-04,양천구,0.0,0,3,0,0,3
11469,2019-04-04,영등포구,0.0,0,5,1,2,8
11470,2019-04-04,용산구,0.0,0,5,2,1,8
11471,2019-04-04,은평구,0.0,0,1,0,0,1
11472,2019-04-04,종로구,0.0,0,4,0,0,4
11473,2019-04-04,중구,0.0,0,1,1,1,3
11474,2019-04-04,중랑구,0.0,0,10,1,1,12
11475,2019-04-05,강남구,0.0,0,9,0,0,9
11476,2019-04-05,강동구,0.0,0,2,1,1,4
11477,2019-04-05,강북구,0.0,0,7,0,0,7
11478,2019-04-05,강서구,0.0,0,7,0,2,9
11479,2019-04-05,관악구,0.0,0,3,0,1,4
11480,2019-04-05,광진구,0.0,0,1,0,2,3
11481,2019-04-05,구로구,0.0,0,7,0,1,8
11482,2019-04-05,금천구,0.0,0,6,1,1,8
11483,2019-04-05,노원구,0.0,0,8,0,2,10
11484,2019-04-05,도봉구,0.0,0,3,1,0,4
11485,2019-04-05,동대문구,0.0,0,1,1,3,5
11486,2019-04-05,동작구,0.0,0,2,2,0,4
11487,2019-04-05,마포구,0.0,0,4,0,0,4
11488,2019-04-05,서대문구,0.0,0,2,0,0,2
11489,2019-04-05,서초구,0.0,0,6,1,2,9
11490,2019-04-05,성동구,0.0,0,6,3,1,10
11491,2019-04-05,성북구,0.0,0,4,1,0,5
11492,2019-04-05,송파구,0.0,0,5,2,1,8
11493,2019-04-05,양천구,0.0,0,7,1,2,10
11494,2019-04-05,영등포구,0.0,0,17,2,6,25
11495,2019-04-05,용산구,0.0,0,2,0,0,2
11496,2019-04-05,은평구,0.0,0,6,0,1,7
11497,2019-04-05,종로구,0.0,0,2,0,0,2
11498,2019-04-05,중구,0.0,0,4,0,1,5
11499,2019-04-05,중랑구,0.0,0,6,0,4,10
11500,2019-04-06,강남구,0.0,0,20,3,1,24
11501,2019-04-06,강동구,0.0,0,3,0,2,5
11502,2019-04-06,강북구,2.0,0,1,1,0,2
11503,2019-04-06,강서구,1.0,0,4,0,0,4
11504,2019-04-06,관악구,0.0,0,10,0,3,13
11505,2019-04-06,광진구,0.5,0,1,0,2,3
11506,2019-04-06,구로구,0.0,0,1,0,0,1
11507,2019-04-06,금천구,0.0,0,4,0,0,4
11508,2019-04-06,노원구,2.5,0,1,0,0,1
11509,2019-04-06,도봉구,1.0,0,5,0,0,5
11510,2019-04-06,동대문구,1.0,0,2,1,1,4
11511,2019-04-06,동작구,0.0,0,3,0,0,3
11512,2019-04-06,마포구,0.5,0,5,1,0,6
11513,2019-04-06,서대문구,0.5,0,1,1,1,3
11514,2019-04-06,서초구,0.0,0,17,0,2,19
11515,2019-04-06,성동구,0.5,0,1,0,0,1
11516,2019-04-06,성북구,1.0,0,5,0,0,5
11517,2019-04-06,송파구,0.0,0,12,1,3,16
11518,2019-04-06,양천구,0.5,0,7,0,1,8
11519,2019-04-06,영등포구,0.5,0,4,0,3,7
11520,2019-04-06,용산구,0.0,0,8,0,1,9
11521,2019-04-06,은평구,2.5,0,1,0,1,2
11522,2019-04-06,종로구,0.8,0,4,0,1,5
11523,2019-04-06,중구,0.0,0,1,1,2,4
11524,2019-04-06,중랑구,0.5,0,4,0,2,6
11525,2019-04-07,강남구,0.0,0,6,2,4,12
11526,2019-04-07,강동구,0.0,0,3,0,1,4
11527,2019-04-07,강북구,0.0,0,6,0,0,6
11528,2019-04-07,강서구,0.0,1,2,0,0,3
11529,2019-04-07,관악구,0.0,0,4,0,2,6
11530,2019-04-07,광진구,0.0,0,3,0,0,3
11531,2019-04-07,구로구,0.0,0,1,0,4,5
11532,2019-04-07,금천구,0.0,0,6,0,1,7
11533,2019-04-07,노원구,0.0,0,8,0,2,10
11534,2019-04-07,도봉구,0.0,0,8,0,2,10
11535,2019-04-07,동대문구,0.0,0,2,0,1,3
11536,2019-04-07,동작구,0.0,0,5,1,1,7
11537,2019-04-07,마포구,0.0,0,1,0,1,2
11538,2019-04-07,서대문구,0.0,0,2,0,0,2
11539,2019-04-07,서초구,0.0,0,10,0,2,12
11540,2019-04-07,성동구,0.0,0,1,0,0,1
11541,2019-04-07,성북구,0.0,1,3,0,1,5
11542,2019-04-07,송파구,0.0,0,9,2,0,11
11543,2019-04-07,양천구,0.0,2,3,0,0,5
11544,2019-04-07,영등포구,0.0,0,11,3,2,16
11545,2019-04-07,용산구,0.0,0,5,1,0,6
11546,2019-04-07,은평구,0.0,0,1,0,0,1
11547,2019-04-07,종로구,0.0,0,2,1,0,3
11548,2019-04-07,중구,0.0,0,9,1,0,10
11549,2019-04-07,중랑구,0.0,0,1,0,1,2
11550,2019-04-08,강남구,0.0,0,12,0,4,16
11551,2019-04-08,강동구,0.0,0,0,0,1,1
11552,2019-04-08,강북구,0.0,0,4,0,0,4
11553,2019-04-08,강서구,0.0,0,2,0,3,5
11554,2019-04-08,관악구,0.0,0,3,0,0,3
11555,2019-04-08,광진구,0.0,0,2,0,0,2
11556,2019-04-08,구로구,0.0,0,2,1,3,6
11557,2019-04-08,금천구,0.0,0,5,0,1,6
11558,2019-04-08,노원구,0.0,0,2,0,3,5
11559,2019-04-08,도봉구,0.0,0,4,0,1,5
11560,2019-04-08,동대문구,0.0,0,1,1,0,2
11561,2019-04-08,동작구,0.0,0,0,0,0,0
11562,2019-04-08,마포구,0.0,0,5,0,1,6
11563,2019-04-08,서대문구,0.0,0,3,0,1,4
11564,2019-04-08,서초구,0.0,0,4,2,5,11
11565,2019-04-08,성동구,0.0,0,2,0,0,2
11566,2019-04-08,성북구,0.0,0,6,0,2,8
11567,2019-04-08,송파구,0.0,0,9,0,1,10
11568,2019-04-08,양천구,0.0,0,7,0,2,9
11569,2019-04-08,영등포구,0.0,0,8,0,5,13
11570,2019-04-08,용산구,0.0,0,3,0,2,5
11571,2019-04-08,은평구,0.0,0,0,0,1,1
11572,2019-04-08,종로구,0.0,0,1,0,0,1
11573,2019-04-08,중구,0.0,0,3,2,2,7
11574,2019-04-08,중랑구,0.0,0,1,0,3,4
11575,2019-04-09,강남구,20.0,0,5,0,1,6
11576,2019-04-09,강동구,18.5,0,1,1,1,3
11577,2019-04-09,강북구,13.0,0,3,0,0,3
11578,2019-04-09,강서구,13.5,0,7,1,2,10
11579,2019-04-09,관악구,15.0,1,10,1,1,13
11580,2019-04-09,광진구,19.5,0,3,1,0,4
11581,2019-04-09,구로구,15.5,0,5,2,5,12
11582,2019-04-09,금천구,16.0,0,7,0,0,7
11583,2019-04-09,노원구,13.5,0,10,0,0,10
11584,2019-04-09,도봉구,15.5,0,2,0,3,5
11585,2019-04-09,동대문구,22.0,0,6,0,2,8
11586,2019-04-09,동작구,16.75,1,4,2,1,8
11587,2019-04-09,마포구,13.5,0,9,2,1,12
11588,2019-04-09,서대문구,15.0,0,1,0,0,1
11589,2019-04-09,서초구,19.0,0,9,0,0,9
11590,2019-04-09,성동구,19.0,0,2,0,0,2
11591,2019-04-09,성북구,17.0,0,5,0,1,6
11592,2019-04-09,송파구,11.5,0,6,2,0,8
11593,2019-04-09,양천구,13.5,0,2,0,2,4
11594,2019-04-09,영등포구,13.0,0,22,1,4,27
11595,2019-04-09,용산구,16.0,0,2,0,0,2
11596,2019-04-09,은평구,23.5,0,1,0,0,1
11597,2019-04-09,종로구,17.4,0,1,1,0,2
11598,2019-04-09,중구,8.5,0,4,1,0,5
11599,2019-04-09,중랑구,17.0,0,4,0,0,4
11600,2019-04-10,강남구,4.0,0,7,3,2,12
11601,2019-04-10,강동구,3.5,0,2,0,0,2
11602,2019-04-10,강북구,2.5,0,9,0,0,9
11603,2019-04-10,강서구,5.5,0,5,1,0,6
11604,2019-04-10,관악구,4.5,0,6,0,2,8
11605,2019-04-10,광진구,4.5,0,5,0,0,5
11606,2019-04-10,구로구,3.5,0,6,0,1,7
11607,2019-04-10,금천구,3.0,0,2,0,0,2
11608,2019-04-10,노원구,3.0,0,2,1,0,3
11609,2019-04-10,도봉구,2.5,0,0,0,0,0
11610,2019-04-10,동대문구,5.0,0,1,1,2,4
11611,2019-04-10,동작구,4.25,0,2,0,2,4
11612,2019-04-10,마포구,4.0,0,2,0,2,4
11613,2019-04-10,서대문구,5.5,0,2,0,1,3
11614,2019-04-10,서초구,3.5,0,7,1,6,14
11615,2019-04-10,성동구,4.5,0,9,0,2,11
11616,2019-04-10,성북구,4.0,0,13,0,0,13
11617,2019-04-10,송파구,3.0,0,6,1,1,8
11618,2019-04-10,양천구,3.5,0,11,0,1,12
11619,2019-04-10,영등포구,3.25,0,7,0,3,10
11620,2019-04-10,용산구,4.5,0,4,0,3,7
11621,2019-04-10,은평구,6.5,0,9,2,2,13
11622,2019-04-10,종로구,5.6,0,2,0,1,3
11623,2019-04-10,중구,1.0,0,3,0,2,5
11624,2019-04-10,중랑구,4.5,0,3,0,1,4
11625,2019-04-11,강남구,0.0,0,18,1,5,24
11626,2019-04-11,강동구,0.0,0,5,0,1,6
11627,2019-04-11,강북구,0.0,0,7,1,1,9
11628,2019-04-11,강서구,0.0,0,2,0,0,2
11629,2019-04-11,관악구,0.0,0,5,0,2,7
11630,2019-04-11,광진구,0.0,0,5,0,2,7
11631,2019-04-11,구로구,0.0,0,3,0,1,4
11632,2019-04-11,금천구,0.0,0,2,0,1,3
11633,2019-04-11,노원구,0.0,0,7,1,1,9
11634,2019-04-11,도봉구,0.0,0,3,0,2,5
11635,2019-04-11,동대문구,0.0,0,1,0,1,2
11636,2019-04-11,동작구,0.0,0,2,1,0,3
11637,2019-04-11,마포구,0.0,0,13,0,1,14
11638,2019-04-11,서대문구,0.0,1,0,1,0,2
11639,2019-04-11,서초구,0.0,0,16,0,2,18
11640,2019-04-11,성동구,0.0,0,2,0,1,3
11641,2019-04-11,성북구,0.0,0,2,0,2,4
11642,2019-04-11,송파구,0.0,0,7,0,3,10
11643,2019-04-11,양천구,0.0,0,1,1,1,3
11644,2019-04-11,영등포구,0.0,0,4,2,0,6
11645,2019-04-11,용산구,0.0,0,1,0,0,1
11646,2019-04-11,은평구,0.0,0,0,0,3,3
11647,2019-04-11,종로구,0.0,0,8,0,0,8
11648,2019-04-11,중구,0.0,0,4,1,1,6
11649,2019-04-11,중랑구,0.0,0,3,0,1,4
11650,2019-04-12,강남구,0.0,0,11,1,3,15
11651,2019-04-12,강동구,0.0,0,5,1,1,7
11652,2019-04-12,강북구,0.0,0,4,0,0,4
11653,2019-04-12,강서구,0.0,1,6,0,0,7
11654,2019-04-12,관악구,0.0,0,9,0,1,10
11655,2019-04-12,광진구,0.0,0,4,0,2,6
11656,2019-04-12,구로구,0.0,0,5,0,2,7
11657,2019-04-12,금천구,0.0,0,1,0,0,1
11658,2019-04-12,노원구,0.0,0,1,0,1,2
11659,2019-04-12,도봉구,0.0,0,4,0,1,5
11660,2019-04-12,동대문구,0.0,0,1,0,2,3
11661,2019-04-12,동작구,0.0,0,4,0,0,4
11662,2019-04-12,마포구,0.0,0,5,0,1,6
11663,2019-04-12,서대문구,0.0,0,2,0,0,2
11664,2019-04-12,서초구,0.0,0,5,1,4,10
11665,2019-04-12,성동구,0.0,0,2,1,1,4
11666,2019-04-12,성북구,0.0,0,4,0,1,5
11667,2019-04-12,송파구,0.0,0,6,1,1,8
11668,2019-04-12,양천구,0.0,0,4,0,0,4
11669,2019-04-12,영등포구,0.0,0,8,1,2,11
11670,2019-04-12,용산구,0.0,0,4,0,0,4
11671,2019-04-12,은평구,0.0,0,1,0,1,2
11672,2019-04-12,종로구,0.0,0,5,2,2,9
11673,2019-04-12,중구,0.0,0,0,0,0,0
11674,2019-04-12,중랑구,0.0,0,0,0,2,2
11675,2019-04-13,강남구,0.0,0,17,1,2,20
11676,2019-04-13,강동구,0.0,0,4,0,0,4
11677,2019-04-13,강북구,0.0,0,3,0,1,4
11678,2019-04-13,강서구,0.0,0,11,0,3,14
11679,2019-04-13,관악구,0.0,0,4,0,2,6
11680,2019-04-13,광진구,0.0,0,0,0,1,1
11681,2019-04-13,구로구,0.0,0,7,1,1,9
11682,2019-04-13,금천구,0.0,0,2,0,0,2
11683,2019-04-13,노원구,0.0,0,5,0,1,6
11684,2019-04-13,도봉구,0.0,0,2,0,1,3
11685,2019-04-13,동대문구,0.0,0,1,0,1,2
11686,2019-04-13,동작구,0.0,0,7,2,1,10
11687,2019-04-13,마포구,0.0,0,4,1,1,6
11688,2019-04-13,서대문구,0.0,0,1,0,0,1
11689,2019-04-13,서초구,0.0,0,12,1,0,13
11690,2019-04-13,성동구,0.0,0,0,1,1,2
11691,2019-04-13,성북구,0.0,0,6,0,2,8
11692,2019-04-13,송파구,0.0,0,12,2,4,18
11693,2019-04-13,양천구,0.0,0,7,2,2,11
11694,2019-04-13,영등포구,0.0,0,8,0,1,9
11695,2019-04-13,용산구,0.0,0,2,0,0,2
11696,2019-04-13,은평구,0.0,0,4,0,2,6
11697,2019-04-13,종로구,0.0,0,6,0,2,8
11698,2019-04-13,중구,0.0,0,7,2,2,11
11699,2019-04-13,중랑구,0.0,0,10,1,1,12
11700,2019-04-14,강남구,1.5,0,6,0,0,6
11701,2019-04-14,강동구,1.5,0,7,0,2,9
11702,2019-04-14,강북구,2.0,1,3,1,3,8
11703,2019-04-14,강서구,1.5,0,7,0,0,7
11704,2019-04-14,관악구,1.25,0,1,0,0,1
11705,2019-04-14,광진구,1.5,0,3,1,0,4
11706,2019-04-14,구로구,1.5,0,4,4,0,8
11707,2019-04-14,금천구,1.0,0,3,0,0,3
11708,2019-04-14,노원구,1.0,0,10,0,2,12
11709,2019-04-14,도봉구,2.0,0,0,3,0,3
11710,2019-04-14,동대문구,1.0,0,3,0,2,5
11711,2019-04-14,동작구,1.5,0,2,0,0,2
11712,2019-04-14,마포구,1.5,0,1,0,0,1
11713,2019-04-14,서대문구,1.5,0,2,0,2,4
11714,2019-04-14,서초구,1.0,0,1,0,0,1
11715,2019-04-14,성동구,1.5,0,4,1,1,6
11716,2019-04-14,성북구,1.0,0,1,0,0,1
11717,2019-04-14,송파구,1.5,0,6,1,2,9
11718,2019-04-14,양천구,1.5,0,3,0,1,4
11719,2019-04-14,영등포구,1.5,0,3,0,0,3
11720,2019-04-14,용산구,1.5,0,2,0,0,2
11721,2019-04-14,은평구,2.0,0,1,0,0,1
11722,2019-04-14,종로구,1.7,0,1,0,0,1
11723,2019-04-14,중구,2.0,0,2,0,0,2
11724,2019-04-14,중랑구,1.5,0,2,2,0,4
11725,2019-04-15,강남구,0.0,0,7,0,3,10
11726,2019-04-15,강동구,0.0,0,1,0,3,4
11727,2019-04-15,강북구,0.0,0,2,0,0,2
11728,2019-04-15,강서구,0.0,0,4,0,0,4
11729,2019-04-15,관악구,0.0,0,3,0,3,6
11730,2019-04-15,광진구,0.0,0,3,1,5,9
11731,2019-04-15,구로구,0.0,0,7,0,1,8
11732,2019-04-15,금천구,0.0,0,3,1,2,6
11733,2019-04-15,노원구,0.0,0,3,0,3,6
11734,2019-04-15,도봉구,0.0,0,4,0,0,4
11735,2019-04-15,동대문구,0.0,0,2,0,3,5
11736,2019-04-15,동작구,0.0,0,5,2,1,8
11737,2019-04-15,마포구,0.0,0,0,0,0,0
11738,2019-04-15,서대문구,0.0,0,2,0,0,2
11739,2019-04-15,서초구,0.0,0,10,2,3,15
11740,2019-04-15,성동구,0.0,0,1,0,0,1
11741,2019-04-15,성북구,0.0,0,2,0,0,2
11742,2019-04-15,송파구,0.0,0,10,1,4,15
11743,2019-04-15,양천구,0.0,0,4,0,0,4
11744,2019-04-15,영등포구,0.0,0,3,0,2,5
11745,2019-04-15,용산구,0.0,0,4,0,0,4
11746,2019-04-15,은평구,0.0,0,1,0,1,2
11747,2019-04-15,종로구,0.0,0,2,1,0,3
11748,2019-04-15,중구,0.0,0,1,1,1,3
11749,2019-04-15,중랑구,0.0,0,7,0,1,8
11750,2019-04-16,강남구,0.0,0,7,0,2,9
11751,2019-04-16,강동구,0.0,0,4,1,5,10
11752,2019-04-16,강북구,0.0,0,2,0,1,3
11753,2019-04-16,강서구,0.0,0,6,1,2,9
11754,2019-04-16,관악구,0.0,0,1,0,0,1
11755,2019-04-16,광진구,0.0,0,7,1,0,8
11756,2019-04-16,구로구,0.0,0,4,0,0,4
11757,2019-04-16,금천구,0.0,0,2,3,1,6
11758,2019-04-16,노원구,0.0,0,5,0,1,6
11759,2019-04-16,도봉구,0.0,0,2,0,2,4
11760,2019-04-16,동대문구,0.0,0,3,3,2,8
11761,2019-04-16,동작구,0.0,0,4,3,3,10
11762,2019-04-16,마포구,0.0,0,2,1,0,3
11763,2019-04-16,서대문구,0.0,0,2,0,0,2
11764,2019-04-16,서초구,0.0,0,6,0,2,8
11765,2019-04-16,성동구,0.0,0,3,2,0,5
11766,2019-04-16,성북구,0.0,0,3,0,0,3
11767,2019-04-16,송파구,0.0,0,13,1,2,16
11768,2019-04-16,양천구,0.0,0,3,1,3,7
11769,2019-04-16,영등포구,0.0,0,5,2,2,9
11770,2019-04-16,용산구,0.0,0,0,0,0,0
11771,2019-04-16,은평구,0.0,0,3,1,4,8
11772,2019-04-16,종로구,0.0,0,4,1,1,6
11773,2019-04-16,중구,0.0,0,2,0,1,3
11774,2019-04-16,중랑구,0.0,0,7,0,4,11
11775,2019-04-17,강남구,0.0,0,8,1,3,12
11776,2019-04-17,강동구,0.0,0,2,1,1,4
11777,2019-04-17,강북구,0.0,0,1,0,0,1
11778,2019-04-17,강서구,0.0,0,2,0,2,4
11779,2019-04-17,관악구,0.0,0,2,0,0,2
11780,2019-04-17,광진구,0.0,0,8,0,0,8
11781,2019-04-17,구로구,0.0,0,10,2,0,12
11782,2019-04-17,금천구,0.0,0,2,0,1,3
11783,2019-04-17,노원구,0.0,0,3,1,1,5
11784,2019-04-17,도봉구,0.0,0,0,0,0,0
11785,2019-04-17,동대문구,0.0,0,6,0,1,7
11786,2019-04-17,동작구,0.0,0,2,0,0,2
11787,2019-04-17,마포구,0.0,0,10,0,5,15
11788,2019-04-17,서대문구,0.0,0,2,2,0,4
11789,2019-04-17,서초구,0.0,0,14,3,1,18
11790,2019-04-17,성동구,0.0,0,3,1,0,4
11791,2019-04-17,성북구,0.0,0,3,0,1,4
11792,2019-04-17,송파구,0.0,0,4,1,0,5
11793,2019-04-17,양천구,0.0,0,3,1,2,6
11794,2019-04-17,영등포구,0.0,0,9,0,1,10
11795,2019-04-17,용산구,0.0,0,4,0,1,5
11796,2019-04-17,은평구,0.0,0,1,0,0,1
11797,2019-04-17,종로구,0.0,0,0,0,1,1
11798,2019-04-17,중구,0.0,0,1,0,3,4
11799,2019-04-17,중랑구,0.0,0,3,0,1,4
11800,2019-04-18,강남구,0.0,0,7,1,2,10
11801,2019-04-18,강동구,0.0,0,4,0,3,7
11802,2019-04-18,강북구,0.0,0,2,0,1,3
11803,2019-04-18,강서구,0.0,0,0,0,0,0
11804,2019-04-18,관악구,0.0,0,1,0,2,3
11805,2019-04-18,광진구,0.0,0,2,0,1,3
11806,2019-04-18,구로구,0.0,0,6,0,0,6
11807,2019-04-18,금천구,0.0,0,1,0,0,1
11808,2019-04-18,노원구,0.0,0,3,0,1,4
11809,2019-04-18,도봉구,0.0,0,1,1,0,2
11810,2019-04-18,동대문구,0.0,0,4,0,0,4
11811,2019-04-18,동작구,0.0,0,5,1,2,8
11812,2019-04-18,마포구,0.0,0,4,0,1,5
11813,2019-04-18,서대문구,0.0,0,2,0,0,2
11814,2019-04-18,서초구,0.0,0,12,1,0,13
11815,2019-04-18,성동구,0.0,0,2,0,0,2
11816,2019-04-18,성북구,0.0,0,6,0,2,8
11817,2019-04-18,송파구,0.0,0,10,1,4,15
11818,2019-04-18,양천구,0.0,0,4,0,0,4
11819,2019-04-18,영등포구,0.0,0,2,1,0,3
11820,2019-04-18,용산구,0.0,0,1,0,0,1
11821,2019-04-18,은평구,0.0,0,5,0,1,6
11822,2019-04-18,종로구,0.0,0,0,0,0,0
11823,2019-04-18,중구,0.0,0,6,1,0,7
11824,2019-04-18,중랑구,0.0,0,0,0,0,0
11825,2019-04-19,강남구,0.0,0,15,2,6,23
11826,2019-04-19,강동구,0.0,0,6,1,0,7
11827,2019-04-19,강북구,0.0,0,4,1,1,6
11828,2019-04-19,강서구,0.0,0,6,0,1,7
11829,2019-04-19,관악구,0.0,0,4,1,2,7
11830,2019-04-19,광진구,0.0,0,6,0,0,6
11831,2019-04-19,구로구,0.0,0,0,1,1,2
11832,2019-04-19,금천구,0.0,0,0,0,0,0
11833,2019-04-19,노원구,0.0,0,2,1,0,3
11834,2019-04-19,도봉구,0.0,0,4,1,1,6
11835,2019-04-19,동대문구,0.0,0,5,1,2,8
11836,2019-04-19,동작구,0.0,0,1,1,1,3
11837,2019-04-19,마포구,0.0,0,2,1,0,3
11838,2019-04-19,서대문구,0.0,0,5,0,1,6
11839,2019-04-19,서초구,0.0,0,4,0,1,5
11840,2019-04-19,성동구,0.0,0,3,1,0,4
11841,2019-04-19,성북구,0.0,0,10,2,3,15
11842,2019-04-19,송파구,0.0,0,5,2,3,10
11843,2019-04-19,양천구,0.0,0,3,0,1,4
11844,2019-04-19,영등포구,0.0,0,15,2,2,19
11845,2019-04-19,용산구,0.0,0,7,0,2,9
11846,2019-04-19,은평구,0.0,0,0,1,4,5
11847,2019-04-19,종로구,0.0,0,1,1,1,3
11848,2019-04-19,중구,0.0,0,2,0,4,6
11849,2019-04-19,중랑구,0.0,0,3,0,3,6
11850,2019-04-20,강남구,0.0,0,12,1,2,15
11851,2019-04-20,강동구,0.0,0,0,0,0,0
11852,2019-04-20,강북구,0.0,0,6,0,1,7
11853,2019-04-20,강서구,1.5,0,8,0,1,9
11854,2019-04-20,관악구,0.5,0,3,0,2,5
11855,2019-04-20,광진구,0.0,0,0,0,0,0
11856,2019-04-20,구로구,1.0,0,1,0,0,1
11857,2019-04-20,금천구,0.5,0,0,0,1,1
11858,2019-04-20,노원구,0.0,0,6,0,1,7
11859,2019-04-20,도봉구,0.0,0,1,0,0,1
11860,2019-04-20,동대문구,0.0,0,6,1,3,10
11861,2019-04-20,동작구,0.5,0,2,0,2,4
11862,2019-04-20,마포구,0.5,0,1,0,2,3
11863,2019-04-20,서대문구,1.0,0,3,1,0,4
11864,2019-04-20,서초구,0.0,0,5,1,1,7
11865,2019-04-20,성동구,0.5,1,3,0,1,5
11866,2019-04-20,성북구,0.0,0,4,1,1,6
11867,2019-04-20,송파구,0.0,0,4,0,2,6
11868,2019-04-20,양천구,1.0,0,8,0,3,11
11869,2019-04-20,영등포구,0.5,0,9,2,1,12
11870,2019-04-20,용산구,0.5,0,1,0,1,2
11871,2019-04-20,은평구,0.5,0,1,1,0,2
11872,2019-04-20,종로구,1.2,0,5,0,2,7
11873,2019-04-20,중구,1.0,0,4,0,1,5
11874,2019-04-20,중랑구,0.0,0,2,0,1,3
11875,2019-04-21,강남구,0.5,0,7,1,3,11
11876,2019-04-21,강동구,0.5,0,4,0,0,4
11877,2019-04-21,강북구,0.0,0,1,0,1,2
11878,2019-04-21,강서구,0.0,0,6,0,2,8
11879,2019-04-21,관악구,0.25,0,4,0,0,4
11880,2019-04-21,광진구,0.5,0,6,1,2,9
11881,2019-04-21,구로구,0.5,0,4,0,1,5
11882,2019-04-21,금천구,0.0,0,6,0,2,8
11883,2019-04-21,노원구,0.0,0,3,1,0,4
11884,2019-04-21,도봉구,0.0,0,2,0,0,2
11885,2019-04-21,동대문구,0.5,0,2,1,0,3
11886,2019-04-21,동작구,0.0,0,5,0,2,7
11887,2019-04-21,마포구,0.5,0,1,0,0,1
11888,2019-04-21,서대문구,0.5,0,0,0,0,0
11889,2019-04-21,서초구,0.5,0,5,1,0,6
11890,2019-04-21,성동구,0.0,0,2,0,0,2
11891,2019-04-21,성북구,0.0,0,5,0,2,7
11892,2019-04-21,송파구,0.5,0,9,0,7,16
11893,2019-04-21,양천구,0.0,0,4,0,0,4
11894,2019-04-21,영등포구,0.5,1,37,4,9,51
11895,2019-04-21,용산구,0.5,0,5,0,4,9
11896,2019-04-21,은평구,0.0,0,1,0,1,2
11897,2019-04-21,종로구,0.3,0,1,0,1,2
11898,2019-04-21,중구,0.5,0,5,0,0,5
11899,2019-04-21,중랑구,0.0,0,5,1,2,8
11900,2019-04-22,강남구,0.0,0,8,3,4,15
11901,2019-04-22,강동구,0.0,0,0,2,0,2
11902,2019-04-22,강북구,0.0,0,1,0,4,5
11903,2019-04-22,강서구,0.0,0,5,0,0,5
11904,2019-04-22,관악구,0.0,0,0,0,0,0
11905,2019-04-22,광진구,0.0,0,1,0,0,1
11906,2019-04-22,구로구,0.0,0,10,0,3,13
11907,2019-04-22,금천구,0.0,0,2,0,4,6
11908,2019-04-22,노원구,0.0,0,5,0,2,7
11909,2019-04-22,도봉구,0.0,0,2,0,0,2
11910,2019-04-22,동대문구,0.0,0,2,0,4,6
11911,2019-04-22,동작구,0.0,0,1,0,0,1
11912,2019-04-22,마포구,0.0,0,6,0,0,6
11913,2019-04-22,서대문구,0.0,0,2,1,2,5
11914,2019-04-22,서초구,0.0,0,14,0,0,14
11915,2019-04-22,성동구,0.0,0,1,0,2,3
11916,2019-04-22,성북구,0.0,0,5,0,1,6
11917,2019-04-22,송파구,0.0,0,5,2,5,12
11918,2019-04-22,양천구,0.0,0,3,0,1,4
11919,2019-04-22,영등포구,0.0,0,1,2,3,6
11920,2019-04-22,용산구,0.0,0,4,0,0,4
11921,2019-04-22,은평구,0.0,0,0,0,0,0
11922,2019-04-22,종로구,0.0,0,1,1,0,2
11923,2019-04-22,중구,0.0,0,3,0,1,4
11924,2019-04-22,중랑구,0.0,0,9,0,2,11
11925,2019-04-23,강남구,0.0,0,8,0,1,9
11926,2019-04-23,강동구,0.0,0,2,0,1,3
11927,2019-04-23,강북구,0.0,0,5,1,0,6
11928,2019-04-23,강서구,0.0,0,7,0,2,9
11929,2019-04-23,관악구,0.0,0,8,0,0,8
11930,2019-04-23,광진구,0.0,0,9,0,3,12
11931,2019-04-23,구로구,0.0,0,6,0,3,9
11932,2019-04-23,금천구,0.0,0,5,0,0,5
11933,2019-04-23,노원구,0.0,0,2,0,0,2
11934,2019-04-23,도봉구,0.0,0,1,0,1,2
11935,2019-04-23,동대문구,0.0,0,7,0,0,7
11936,2019-04-23,동작구,0.0,0,2,0,1,3
11937,2019-04-23,마포구,0.0,0,2,0,1,3
11938,2019-04-23,서대문구,0.0,0,8,0,3,11
11939,2019-04-23,서초구,0.0,0,3,1,2,6
11940,2019-04-23,성동구,0.0,0,7,1,1,9
11941,2019-04-23,성북구,0.0,0,1,0,0,1
11942,2019-04-23,송파구,0.0,0,1,0,1,2
11943,2019-04-23,양천구,0.0,0,3,1,1,5
11944,2019-04-23,영등포구,0.0,0,8,3,2,13
11945,2019-04-23,용산구,0.0,0,0,2,0,2
11946,2019-04-23,은평구,0.0,0,1,1,2,4
11947,2019-04-23,종로구,0.0,0,0,0,0,0
11948,2019-04-23,중구,0.0,0,2,0,0,2
11949,2019-04-23,중랑구,0.0,0,3,0,1,4
11950,2019-04-24,강남구,6.5,0,15,0,1,16
11951,2019-04-24,강동구,5.5,0,1,0,1,2
11952,2019-04-24,강북구,2.5,0,4,0,3,7
11953,2019-04-24,강서구,3.5,0,12,0,0,12
11954,2019-04-24,관악구,8.0,0,4,0,1,5
11955,2019-04-24,광진구,6.5,0,1,1,0,2
11956,2019-04-24,구로구,5.0,0,3,1,0,4
11957,2019-04-24,금천구,6.5,0,0,0,0,0
11958,2019-04-24,노원구,4.0,0,4,0,0,4
11959,2019-04-24,도봉구,3.0,0,1,0,0,1
11960,2019-04-24,동대문구,3.5,0,2,1,1,4
11961,2019-04-24,동작구,6.0,0,2,2,0,4
11962,2019-04-24,마포구,4.0,0,4,1,1,6
11963,2019-04-24,서대문구,3.5,0,4,0,0,4
11964,2019-04-24,서초구,7.5,0,5,1,1,7
11965,2019-04-24,성동구,5.5,0,4,0,0,4
11966,2019-04-24,성북구,3.5,0,5,0,0,5
11967,2019-04-24,송파구,7.0,0,5,3,1,9
11968,2019-04-24,양천구,4.0,0,6,1,1,8
11969,2019-04-24,영등포구,4.75,0,10,1,2,13
11970,2019-04-24,용산구,5.5,0,4,0,4,8
11971,2019-04-24,은평구,3.0,0,4,0,2,6
11972,2019-04-24,종로구,4.1,0,2,0,1,3
11973,2019-04-24,중구,4.5,0,8,1,1,10
11974,2019-04-24,중랑구,4.5,1,3,1,3,8
11975,2019-04-25,강남구,11.0,0,8,5,4,17
11976,2019-04-25,강동구,11.5,0,4,2,0,6
11977,2019-04-25,강북구,14.5,0,3,0,0,3
11978,2019-04-25,강서구,7.5,0,2,1,1,4
11979,2019-04-25,관악구,10.5,0,1,0,3,4
11980,2019-04-25,광진구,12.0,0,1,2,2,5
11981,2019-04-25,구로구,9.5,0,6,0,1,7
11982,2019-04-25,금천구,12.0,0,2,0,1,3
11983,2019-04-25,노원구,12.0,0,4,0,4,8
11984,2019-04-25,도봉구,15.0,0,5,1,1,7
11985,2019-04-25,동대문구,12.0,0,3,1,0,4
11986,2019-04-25,동작구,9.0,0,2,0,0,2
11987,2019-04-25,마포구,8.5,0,1,0,0,1
11988,2019-04-25,서대문구,9.0,0,5,0,0,5
11989,2019-04-25,서초구,10.5,0,10,4,1,15
11990,2019-04-25,성동구,11.0,0,3,0,0,3
11991,2019-04-25,성북구,12.5,0,2,0,1,3
11992,2019-04-25,송파구,11.0,0,13,2,4,19
11993,2019-04-25,양천구,8.5,0,3,0,0,3
11994,2019-04-25,영등포구,6.75,0,13,1,3,17
11995,2019-04-25,용산구,7.5,0,8,0,2,10
11996,2019-04-25,은평구,9.0,0,3,0,2,5
11997,2019-04-25,종로구,11.3,0,2,1,0,3
11998,2019-04-25,중구,7.0,0,1,0,1,2
11999,2019-04-25,중랑구,0.0,0,5,0,2,7
12000,2019-04-26,강남구,4.0,0,7,0,1,8
12001,2019-04-26,강동구,8.0,0,7,4,1,12
12002,2019-04-26,강북구,10.5,0,5,0,0,5
12003,2019-04-26,강서구,2.0,0,4,0,0,4
12004,2019-04-26,관악구,3.0,0,9,0,3,12
12005,2019-04-26,광진구,4.0,0,3,0,2,5
12006,2019-04-26,구로구,1.5,0,4,2,2,8
12007,2019-04-26,금천구,2.0,0,0,0,0,0
12008,2019-04-26,노원구,7.0,0,11,3,0,14
12009,2019-04-26,도봉구,8.5,0,2,0,1,3
12010,2019-04-26,동대문구,6.0,0,0,1,1,2
12011,2019-04-26,동작구,2.5,0,2,2,3,7
12012,2019-04-26,마포구,4.5,0,1,0,1,2
12013,2019-04-26,서대문구,5.0,0,10,3,0,13
12014,2019-04-26,서초구,2.0,0,4,0,2,6
12015,2019-04-26,성동구,4.5,0,0,0,1,1
12016,2019-04-26,성북구,4.5,0,7,0,1,8
12017,2019-04-26,송파구,2.5,0,6,0,1,7
12018,2019-04-26,양천구,3.0,0,1,0,1,2
12019,2019-04-26,영등포구,3.0,0,9,1,1,11
12020,2019-04-26,용산구,3.0,0,7,0,1,8
12021,2019-04-26,은평구,5.5,0,4,0,2,6
12022,2019-04-26,종로구,4.9,0,7,2,3,12
12023,2019-04-26,중구,3.5,0,7,0,1,8
12024,2019-04-26,중랑구,0.0,0,4,2,0,6
12025,2019-04-27,강남구,0.0,0,8,1,0,9
12026,2019-04-27,강동구,0.0,0,3,1,1,5
12027,2019-04-27,강북구,0.0,0,4,0,2,6
12028,2019-04-27,강서구,0.0,0,4,3,1,8
12029,2019-04-27,관악구,0.0,0,3,1,0,4
12030,2019-04-27,광진구,0.0,0,6,0,2,8
12031,2019-04-27,구로구,0.0,0,7,0,3,10
12032,2019-04-27,금천구,0.0,0,3,0,0,3
12033,2019-04-27,노원구,0.0,0,5,0,0,5
12034,2019-04-27,도봉구,0.0,0,2,0,0,2
12035,2019-04-27,동대문구,0.0,0,1,0,0,1
12036,2019-04-27,동작구,0.0,0,2,3,2,7
12037,2019-04-27,마포구,0.0,0,4,1,1,6
12038,2019-04-27,서대문구,0.0,0,2,3,0,5
12039,2019-04-27,서초구,0.0,0,6,0,0,6
12040,2019-04-27,성동구,0.0,0,5,1,0,6
12041,2019-04-27,성북구,0.0,0,7,0,0,7
12042,2019-04-27,송파구,0.0,0,6,0,4,10
12043,2019-04-27,양천구,0.0,0,4,0,0,4
12044,2019-04-27,영등포구,0.0,0,6,0,2,8
12045,2019-04-27,용산구,0.0,0,2,1,1,4
12046,2019-04-27,은평구,0.0,0,3,0,2,5
12047,2019-04-27,종로구,0.0,0,1,0,0,1
12048,2019-04-27,중구,0.0,0,3,0,1,4
12049,2019-04-27,중랑구,0.0,0,9,1,0,10
12050,2019-04-28,강남구,0.0,0,1,0,2,3
12051,2019-04-28,강동구,0.0,0,1,0,1,2
12052,2019-04-28,강북구,0.0,0,2,1,0,3
12053,2019-04-28,강서구,0.0,0,2,0,1,3
12054,2019-04-28,관악구,0.0,0,5,1,4,10
12055,2019-04-28,광진구,0.0,0,1,1,0,2
12056,2019-04-28,구로구,0.0,0,5,2,1,8
12057,2019-04-28,금천구,0.0,0,6,0,0,6
12058,2019-04-28,노원구,0.0,0,7,1,3,11
12059,2019-04-28,도봉구,0.0,0,0,0,0,0
12060,2019-04-28,동대문구,0.0,0,3,0,2,5
12061,2019-04-28,동작구,0.0,0,0,0,0,0
12062,2019-04-28,마포구,0.0,0,1,0,0,1
12063,2019-04-28,서대문구,0.0,0,4,0,0,4
12064,2019-04-28,서초구,0.0,0,8,4,4,16
12065,2019-04-28,성동구,0.0,0,10,0,1,11
12066,2019-04-28,성북구,0.0,0,4,0,1,5
12067,2019-04-28,송파구,0.0,0,3,1,1,5
12068,2019-04-28,양천구,0.0,0,7,2,3,12
12069,2019-04-28,영등포구,0.0,0,3,2,0,5
12070,2019-04-28,용산구,0.0,0,4,2,0,6
12071,2019-04-28,은평구,0.0,0,2,0,1,3
12072,2019-04-28,종로구,0.0,0,3,0,0,3
12073,2019-04-28,중구,0.0,0,2,0,2,4
12074,2019-04-28,중랑구,0.0,0,0,2,0,2
12075,2019-04-29,강남구,0.0,0,8,3,0,11
12076,2019-04-29,강동구,0.0,0,3,0,2,5
12077,2019-04-29,강북구,0.0,0,1,0,1,2
12078,2019-04-29,강서구,0.0,0,3,0,0,3
12079,2019-04-29,관악구,0.0,0,1,0,1,2
12080,2019-04-29,광진구,0.0,0,4,3,1,8
12081,2019-04-29,구로구,0.0,0,6,0,0,6
12082,2019-04-29,금천구,0.0,0,1,0,1,2
12083,2019-04-29,노원구,0.0,0,5,0,0,5
12084,2019-04-29,도봉구,0.0,0,0,0,1,1
12085,2019-04-29,동대문구,0.0,0,5,1,3,9
12086,2019-04-29,동작구,0.0,0,4,0,0,4
12087,2019-04-29,마포구,0.0,0,3,0,0,3
12088,2019-04-29,서대문구,0.0,0,5,0,0,5
12089,2019-04-29,서초구,0.0,0,3,1,0,4
12090,2019-04-29,성동구,0.0,0,2,0,2,4
12091,2019-04-29,성북구,0.0,0,1,0,1,2
12092,2019-04-29,송파구,0.0,0,2,0,0,2
12093,2019-04-29,양천구,0.0,0,1,1,1,3
12094,2019-04-29,영등포구,0.0,0,6,1,1,8
12095,2019-04-29,용산구,0.0,0,2,0,0,2
12096,2019-04-29,은평구,0.0,0,4,2,1,7
12097,2019-04-29,종로구,0.0,0,0,1,1,2
12098,2019-04-29,중구,0.0,0,2,1,3,6
12099,2019-04-29,중랑구,0.0,0,4,0,1,5
12100,2019-04-30,강남구,0.0,0,8,0,1,9
12101,2019-04-30,강동구,0.0,0,8,2,1,11
12102,2019-04-30,강북구,0.0,0,1,0,1,2
12103,2019-04-30,강서구,0.0,0,1,0,2,3
12104,2019-04-30,관악구,0.0,0,3,0,0,3
12105,2019-04-30,광진구,0.0,0,1,0,2,3
12106,2019-04-30,구로구,0.0,0,5,0,2,7
12107,2019-04-30,금천구,0.0,0,4,1,2,7
12108,2019-04-30,노원구,0.0,0,5,0,6,11
12109,2019-04-30,도봉구,0.0,0,1,0,1,2
12110,2019-04-30,동대문구,0.0,0,1,0,1,2
12111,2019-04-30,동작구,0.0,0,6,1,0,7
12112,2019-04-30,마포구,0.0,0,5,1,0,6
12113,2019-04-30,서대문구,0.0,0,3,0,1,4
12114,2019-04-30,서초구,0.0,0,15,1,0,16
12115,2019-04-30,성동구,0.0,0,2,0,3,5
12116,2019-04-30,성북구,0.0,0,5,1,2,8
12117,2019-04-30,송파구,0.0,0,13,1,0,14
12118,2019-04-30,양천구,0.0,0,1,0,0,1
12119,2019-04-30,영등포구,0.0,0,7,0,3,10
12120,2019-04-30,용산구,0.0,0,4,0,0,4
12121,2019-04-30,은평구,0.0,0,1,0,1,2
12122,2019-04-30,종로구,0.0,0,12,1,2,15
12123,2019-04-30,중구,0.0,0,0,0,2,2
12124,2019-04-30,중랑구,0.0,0,3,1,1,5
12125,2019-05-01,강남구,0.0,0,8,0,0,8
12126,2019-05-01,강동구,0.0,0,1,1,2,4
12127,2019-05-01,강북구,0.0,0,6,0,0,6
12128,2019-05-01,강서구,0.0,0,2,0,0,2
12129,2019-05-01,관악구,0.0,0,2,0,1,3
12130,2019-05-01,광진구,0.0,0,4,0,1,5
12131,2019-05-01,구로구,0.0,0,3,0,1,4
12132,2019-05-01,금천구,0.0,0,2,0,2,4
12133,2019-05-01,노원구,0.0,0,9,0,3,12
12134,2019-05-01,도봉구,0.0,0,0,0,0,0
12135,2019-05-01,동대문구,0.0,0,1,0,2,3
12136,2019-05-01,동작구,0.0,0,1,0,0,1
12137,2019-05-01,마포구,0.0,0,0,0,0,0
12138,2019-05-01,서대문구,0.0,0,4,2,0,6
12139,2019-05-01,서초구,0.0,0,4,1,0,5
12140,2019-05-01,성동구,0.0,1,4,0,2,7
12141,2019-05-01,성북구,0.0,0,0,0,0,0
12142,2019-05-01,송파구,0.0,0,10,2,1,13
12143,2019-05-01,양천구,0.0,0,13,0,4,17
12144,2019-05-01,영등포구,0.0,0,6,1,2,9
12145,2019-05-01,용산구,0.0,0,1,0,0,1
12146,2019-05-01,은평구,0.0,0,4,0,0,4
12147,2019-05-01,종로구,0.0,0,3,0,0,3
12148,2019-05-01,중구,0.0,0,4,0,1,5
12149,2019-05-01,중랑구,0.0,0,3,0,0,3
12150,2019-05-02,강남구,0.0,0,13,0,7,20
12151,2019-05-02,강동구,0.0,0,3,1,3,7
12152,2019-05-02,강북구,0.0,0,9,0,5,14
12153,2019-05-02,강서구,0.0,0,4,0,1,5
12154,2019-05-02,관악구,0.0,0,4,0,1,5
12155,2019-05-02,광진구,0.0,0,5,0,0,5
12156,2019-05-02,구로구,0.0,0,7,0,3,10
12157,2019-05-02,금천구,0.0,0,3,0,0,3
12158,2019-05-02,노원구,0.0,0,6,0,2,8
12159,2019-05-02,도봉구,0.0,0,1,1,2,4
12160,2019-05-02,동대문구,0.0,0,2,1,1,4
12161,2019-05-02,동작구,0.0,0,4,0,1,5
12162,2019-05-02,마포구,0.0,0,7,0,0,7
12163,2019-05-02,서대문구,0.0,1,1,1,1,4
12164,2019-05-02,서초구,0.0,0,4,0,2,6
12165,2019-05-02,성동구,0.0,0,2,2,3,7
12166,2019-05-02,성북구,0.0,0,5,1,1,7
12167,2019-05-02,송파구,0.0,0,7,2,2,11
12168,2019-05-02,양천구,0.0,0,7,1,0,8
12169,2019-05-02,영등포구,0.0,0,3,3,0,6
12170,2019-05-02,용산구,0.0,0,3,1,3,7
12171,2019-05-02,은평구,0.0,0,1,0,0,1
12172,2019-05-02,종로구,0.0,0,1,0,2,3
12173,2019-05-02,중구,0.0,0,5,1,2,8
12174,2019-05-02,중랑구,0.0,0,2,2,1,5
12175,2019-05-03,강남구,0.0,0,11,2,3,16
12176,2019-05-03,강동구,0.0,0,4,0,2,6
12177,2019-05-03,강북구,0.0,0,2,0,1,3
12178,2019-05-03,강서구,0.0,0,5,1,0,6
12179,2019-05-03,관악구,0.0,0,1,0,1,2
12180,2019-05-03,광진구,0.0,1,4,0,1,6
12181,2019-05-03,구로구,0.0,0,1,0,1,2
12182,2019-05-03,금천구,0.0,0,6,0,1,7
12183,2019-05-03,노원구,0.0,0,4,0,0,4
12184,2019-05-03,도봉구,0.0,0,3,1,0,4
12185,2019-05-03,동대문구,0.0,0,0,0,2,2
12186,2019-05-03,동작구,0.0,0,3,0,1,4
12187,2019-05-03,마포구,0.0,0,5,3,5,13
12188,2019-05-03,서대문구,0.0,0,2,0,0,2
12189,2019-05-03,서초구,0.0,0,5,1,2,8
12190,2019-05-03,성동구,0.0,0,1,0,0,1
12191,2019-05-03,성북구,0.0,0,1,0,2,3
12192,2019-05-03,송파구,0.0,0,8,1,5,14
12193,2019-05-03,양천구,0.0,0,6,0,0,6
12194,2019-05-03,영등포구,0.0,0,7,3,2,12
12195,2019-05-03,용산구,0.0,0,4,0,2,6
12196,2019-05-03,은평구,0.0,0,1,1,2,4
12197,2019-05-03,종로구,0.0,0,7,2,1,10
12198,2019-05-03,중구,0.0,0,3,1,2,6
12199,2019-05-03,중랑구,0.0,0,6,0,0,6
12200,2019-05-04,강남구,0.0,0,4,0,0,4
12201,2019-05-04,강동구,0.0,0,3,0,2,5
12202,2019-05-04,강북구,0.0,0,0,0,1,1
12203,2019-05-04,강서구,0.0,0,5,1,0,6
12204,2019-05-04,관악구,0.0,0,2,0,2,4
12205,2019-05-04,광진구,0.0,0,5,1,0,6
12206,2019-05-04,구로구,0.0,0,6,0,3,9
12207,2019-05-04,금천구,0.0,0,0,1,1,2
12208,2019-05-04,노원구,0.0,0,2,0,0,2
12209,2019-05-04,도봉구,0.0,0,3,2,3,8
12210,2019-05-04,동대문구,0.0,0,4,0,1,5
12211,2019-05-04,동작구,0.0,0,4,1,1,6
12212,2019-05-04,마포구,0.0,0,2,2,1,5
12213,2019-05-04,서대문구,0.0,0,3,0,2,5
12214,2019-05-04,서초구,0.0,0,3,0,0,3
12215,2019-05-04,성동구,0.0,0,2,0,1,3
12216,2019-05-04,성북구,0.0,0,6,0,2,8
12217,2019-05-04,송파구,0.0,0,11,0,1,12
12218,2019-05-04,양천구,0.0,1,3,0,1,5
12219,2019-05-04,영등포구,0.0,0,7,1,2,10
12220,2019-05-04,용산구,0.0,0,8,0,0,8
12221,2019-05-04,은평구,0.0,0,8,0,3,11
12222,2019-05-04,종로구,0.0,0,5,0,2,7
12223,2019-05-04,중구,0.0,0,4,1,1,6
12224,2019-05-04,중랑구,0.0,0,2,0,0,2
12225,2019-05-05,강남구,0.0,0,1,1,1,3
12226,2019-05-05,강동구,0.0,1,0,0,3,4
12227,2019-05-05,강북구,0.0,0,1,1,0,2
12228,2019-05-05,강서구,0.0,0,2,0,1,3
12229,2019-05-05,관악구,0.0,0,3,0,0,3
12230,2019-05-05,광진구,0.0,0,2,0,2,4
12231,2019-05-05,구로구,0.0,0,9,0,4,13
12232,2019-05-05,금천구,0.0,0,1,0,2,3
12233,2019-05-05,노원구,0.0,0,8,3,0,11
12234,2019-05-05,도봉구,0.0,0,1,1,0,2
12235,2019-05-05,동대문구,0.0,0,3,0,3,6
12236,2019-05-05,동작구,0.0,0,7,1,6,14
12237,2019-05-05,마포구,0.0,0,1,0,0,1
12238,2019-05-05,서대문구,0.0,0,3,1,4,8
12239,2019-05-05,서초구,0.0,0,7,1,2,10
12240,2019-05-05,성동구,0.0,0,4,0,2,6
12241,2019-05-05,성북구,0.0,0,4,0,2,6
12242,2019-05-05,송파구,0.0,0,5,2,2,9
12243,2019-05-05,양천구,0.0,0,3,2,0,5
12244,2019-05-05,영등포구,0.0,0,3,0,2,5
12245,2019-05-05,용산구,0.0,0,5,1,0,6
12246,2019-05-05,은평구,0.0,0,5,0,1,6
12247,2019-05-05,종로구,0.0,0,2,0,0,2
12248,2019-05-05,중구,0.0,0,0,0,0,0
12249,2019-05-05,중랑구,0.0,0,2,1,1,4
12250,2019-05-06,강남구,0.0,0,1,2,0,3
12251,2019-05-06,강동구,0.0,0,2,1,1,4
12252,2019-05-06,강북구,0.0,0,1,1,2,4
12253,2019-05-06,강서구,0.0,2,3,1,3,9
12254,2019-05-06,관악구,0.0,0,2,1,1,4
12255,2019-05-06,광진구,0.0,0,2,1,3,6
12256,2019-05-06,구로구,0.0,0,1,1,0,2
12257,2019-05-06,금천구,0.0,0,7,1,0,8
12258,2019-05-06,노원구,0.0,0,2,0,3,5
12259,2019-05-06,도봉구,0.0,0,2,1,1,4
12260,2019-05-06,동대문구,0.0,0,2,0,0,2
12261,2019-05-06,동작구,0.0,0,4,0,0,4
12262,2019-05-06,마포구,0.0,0,1,0,0,1
12263,2019-05-06,서대문구,0.0,0,1,1,1,3
12264,2019-05-06,서초구,0.0,0,1,3,1,5
12265,2019-05-06,성동구,0.0,0,0,0,0,0
12266,2019-05-06,성북구,0.0,0,2,0,3,5
12267,2019-05-06,송파구,0.0,0,12,2,2,16
12268,2019-05-06,양천구,0.0,0,7,0,1,8
12269,2019-05-06,영등포구,0.0,0,2,1,0,3
12270,2019-05-06,용산구,0.0,0,6,2,1,9
12271,2019-05-06,은평구,0.0,0,0,2,0,2
12272,2019-05-06,종로구,0.0,0,3,0,0,3
12273,2019-05-06,중구,0.0,0,2,0,0,2
12274,2019-05-06,중랑구,0.0,0,8,0,0,8
12275,2019-05-07,강남구,0.0,0,12,2,4,18
12276,2019-05-07,강동구,0.0,0,2,2,0,4
12277,2019-05-07,강북구,0.0,0,4,0,0,4
12278,2019-05-07,강서구,0.0,2,2,0,0,4
12279,2019-05-07,관악구,0.0,0,1,0,0,1
12280,2019-05-07,광진구,0.0,0,5,0,1,6
12281,2019-05-07,구로구,0.0,0,2,0,0,2
12282,2019-05-07,금천구,0.0,0,4,1,0,5
12283,2019-05-07,노원구,0.0,0,3,0,1,4
12284,2019-05-07,도봉구,0.0,0,2,0,0,2
12285,2019-05-07,동대문구,0.0,0,1,0,0,1
12286,2019-05-07,동작구,0.0,0,5,0,0,5
12287,2019-05-07,마포구,0.0,2,9,2,1,14
12288,2019-05-07,서대문구,0.0,0,4,0,1,5
12289,2019-05-07,서초구,0.0,0,1,0,3,4
12290,2019-05-07,성동구,0.0,2,4,1,4,11
12291,2019-05-07,성북구,0.0,0,7,1,1,9
12292,2019-05-07,송파구,0.0,0,7,1,3,11
12293,2019-05-07,양천구,0.0,0,5,0,4,9
12294,2019-05-07,영등포구,0.0,0,4,0,0,4
12295,2019-05-07,용산구,0.0,0,1,1,0,2
12296,2019-05-07,은평구,0.0,0,1,1,1,3
12297,2019-05-07,종로구,0.0,1,5,1,0,7
12298,2019-05-07,중구,0.0,0,5,0,2,7
12299,2019-05-07,중랑구,0.0,0,5,1,0,6
12300,2019-05-08,강남구,0.0,0,16,0,0,16
12301,2019-05-08,강동구,0.0,0,6,2,0,8
12302,2019-05-08,강북구,0.0,0,3,0,2,5
12303,2019-05-08,강서구,0.0,0,7,0,2,9
12304,2019-05-08,관악구,0.0,0,7,0,1,8
12305,2019-05-08,광진구,0.0,0,4,0,1,5
12306,2019-05-08,구로구,0.0,0,7,0,2,9
12307,2019-05-08,금천구,0.0,0,2,0,0,2
12308,2019-05-08,노원구,0.0,0,2,0,0,2
12309,2019-05-08,도봉구,0.0,0,1,0,0,1
12310,2019-05-08,동대문구,0.0,0,3,0,0,3
12311,2019-05-08,동작구,0.0,0,2,3,1,6
12312,2019-05-08,마포구,0.0,0,3,0,2,5
12313,2019-05-08,서대문구,0.0,0,2,0,0,2
12314,2019-05-08,서초구,0.0,0,3,1,1,5
12315,2019-05-08,성동구,0.0,0,4,0,1,5
12316,2019-05-08,성북구,0.0,0,6,0,2,8
12317,2019-05-08,송파구,0.0,0,15,0,9,24
12318,2019-05-08,양천구,0.0,0,9,0,1,10
12319,2019-05-08,영등포구,0.0,0,9,0,2,11
12320,2019-05-08,용산구,0.0,0,5,0,2,7
12321,2019-05-08,은평구,0.0,0,2,1,0,3
12322,2019-05-08,종로구,0.0,0,6,2,1,9
12323,2019-05-08,중구,0.0,0,0,0,0,0
12324,2019-05-08,중랑구,0.0,0,0,0,1,1
12325,2019-05-09,강남구,0.0,0,10,0,1,11
12326,2019-05-09,강동구,0.0,0,3,0,0,3
12327,2019-05-09,강북구,0.0,0,3,0,2,5
12328,2019-05-09,강서구,0.0,0,6,0,0,6
12329,2019-05-09,관악구,0.0,0,0,0,0,0
12330,2019-05-09,광진구,0.0,0,2,0,0,2
12331,2019-05-09,구로구,0.0,0,1,0,0,1
12332,2019-05-09,금천구,0.0,0,1,0,0,1
12333,2019-05-09,노원구,0.0,0,8,0,2,10
12334,2019-05-09,도봉구,0.0,0,0,1,3,4
12335,2019-05-09,동대문구,0.0,0,0,0,2,2
12336,2019-05-09,동작구,0.0,0,16,8,4,28
12337,2019-05-09,마포구,0.0,0,3,0,0,3
12338,2019-05-09,서대문구,0.0,0,8,1,0,9
12339,2019-05-09,서초구,0.0,0,3,0,1,4
12340,2019-05-09,성동구,0.0,0,3,0,1,4
12341,2019-05-09,성북구,0.0,0,1,1,0,2
12342,2019-05-09,송파구,0.0,0,3,1,4,8
12343,2019-05-09,양천구,0.0,0,4,1,0,5
12344,2019-05-09,영등포구,0.0,0,5,1,3,9
12345,2019-05-09,용산구,0.0,0,5,1,1,7
12346,2019-05-09,은평구,0.0,1,4,0,2,7
12347,2019-05-09,종로구,0.0,0,13,0,0,13
12348,2019-05-09,중구,0.0,0,2,0,1,3
12349,2019-05-09,중랑구,0.0,0,6,1,3,10
12350,2019-05-10,강남구,0.0,0,14,2,7,23
12351,2019-05-10,강동구,0.0,0,6,0,0,6
12352,2019-05-10,강북구,0.0,0,2,1,2,5
12353,2019-05-10,강서구,0.0,0,3,0,2,5
12354,2019-05-10,관악구,0.0,0,8,0,2,10
12355,2019-05-10,광진구,0.0,0,9,0,0,9
12356,2019-05-10,구로구,0.0,0,1,0,0,1
12357,2019-05-10,금천구,0.0,0,4,0,0,4
12358,2019-05-10,노원구,0.0,0,8,1,0,9
12359,2019-05-10,도봉구,0.0,0,4,0,4,8
12360,2019-05-10,동대문구,0.0,0,6,0,0,6
12361,2019-05-10,동작구,0.0,0,1,0,3,4
12362,2019-05-10,마포구,0.0,0,6,1,0,7
12363,2019-05-10,서대문구,0.0,0,1,0,0,1
12364,2019-05-10,서초구,0.0,0,13,0,3,16
12365,2019-05-10,성동구,0.0,0,7,0,1,8
12366,2019-05-10,성북구,0.0,0,4,0,1,5
12367,2019-05-10,송파구,0.0,0,11,0,4,15
12368,2019-05-10,양천구,0.0,0,5,6,3,14
12369,2019-05-10,영등포구,0.0,0,11,1,2,14
12370,2019-05-10,용산구,0.0,0,3,0,0,3
12371,2019-05-10,은평구,0.0,0,3,0,1,4
12372,2019-05-10,종로구,0.0,0,4,1,1,6
12373,2019-05-10,중구,0.0,0,5,0,4,9
12374,2019-05-10,중랑구,0.0,0,1,0,0,1
12375,2019-05-11,강남구,0.0,0,45,9,4,58
12376,2019-05-11,강동구,0.0,0,5,0,4,9
12377,2019-05-11,강북구,0.0,0,6,0,0,6
12378,2019-05-11,강서구,0.0,0,8,1,1,10
12379,2019-05-11,관악구,0.0,0,0,0,2,2
12380,2019-05-11,광진구,0.0,0,3,0,0,3
12381,2019-05-11,구로구,0.0,0,5,0,2,7
12382,2019-05-11,금천구,0.0,0,0,0,0,0
12383,2019-05-11,노원구,0.0,0,10,0,0,10
12384,2019-05-11,도봉구,0.0,0,0,1,0,1
12385,2019-05-11,동대문구,0.0,0,0,1,1,2
12386,2019-05-11,동작구,0.0,0,14,3,5,22
12387,2019-05-11,마포구,0.0,0,7,2,1,10
12388,2019-05-11,서대문구,0.0,0,4,0,1,5
12389,2019-05-11,서초구,0.0,1,5,0,0,6
12390,2019-05-11,성동구,0.0,0,5,1,1,7
12391,2019-05-11,성북구,0.0,0,4,0,0,4
12392,2019-05-11,송파구,0.0,0,2,1,1,4
12393,2019-05-11,양천구,0.0,0,9,0,0,9
12394,2019-05-11,영등포구,0.0,0,9,0,3,12
12395,2019-05-11,용산구,0.0,0,6,0,1,7
12396,2019-05-11,은평구,0.0,0,4,1,0,5
12397,2019-05-11,종로구,0.0,0,6,1,3,10
12398,2019-05-11,중구,0.0,0,2,0,1,3
12399,2019-05-11,중랑구,0.0,0,7,1,1,9
12400,2019-05-12,강남구,0.0,0,8,2,1,11
12401,2019-05-12,강동구,0.0,0,2,0,3,5
12402,2019-05-12,강북구,0.0,0,4,0,0,4
12403,2019-05-12,강서구,0.0,0,4,1,0,5
12404,2019-05-12,관악구,0.0,0,2,0,4,6
12405,2019-05-12,광진구,0.0,0,5,1,3,9
12406,2019-05-12,구로구,0.0,0,2,0,1,3
12407,2019-05-12,금천구,0.0,0,4,1,0,5
12408,2019-05-12,노원구,0.0,0,0,1,4,5
12409,2019-05-12,도봉구,0.0,0,3,3,1,7
12410,2019-05-12,동대문구,0.0,0,3,0,0,3
12411,2019-05-12,동작구,0.0,0,6,2,0,8
12412,2019-05-12,마포구,0.0,0,4,0,1,5
12413,2019-05-12,서대문구,0.0,0,3,2,2,7
12414,2019-05-12,서초구,0.0,0,9,1,0,10
12415,2019-05-12,성동구,0.0,0,0,0,0,0
12416,2019-05-12,성북구,0.0,0,2,0,1,3
12417,2019-05-12,송파구,0.0,0,4,2,1,7
12418,2019-05-12,양천구,0.0,0,2,0,1,3
12419,2019-05-12,영등포구,0.0,0,8,4,8,20
12420,2019-05-12,용산구,0.0,0,5,0,1,6
12421,2019-05-12,은평구,0.0,0,5,1,1,7
12422,2019-05-12,종로구,0.0,0,5,3,1,9
12423,2019-05-12,중구,0.0,0,0,0,0,0
12424,2019-05-12,중랑구,0.0,0,2,0,0,2
12425,2019-05-13,강남구,0.0,0,9,1,1,11
12426,2019-05-13,강동구,0.0,0,1,0,1,2
12427,2019-05-13,강북구,0.0,0,2,0,1,3
12428,2019-05-13,강서구,0.0,0,7,0,1,8
12429,2019-05-13,관악구,0.0,0,2,0,1,3
12430,2019-05-13,광진구,0.0,0,3,0,3,6
12431,2019-05-13,구로구,0.0,0,3,0,2,5
12432,2019-05-13,금천구,0.0,0,2,0,0,2
12433,2019-05-13,노원구,0.0,0,8,0,2,10
12434,2019-05-13,도봉구,0.0,0,3,0,0,3
12435,2019-05-13,동대문구,0.0,0,3,0,1,4
12436,2019-05-13,동작구,0.0,0,2,0,4,6
12437,2019-05-13,마포구,0.0,0,2,0,0,2
12438,2019-05-13,서대문구,0.0,0,0,1,0,1
12439,2019-05-13,서초구,0.0,0,3,0,0,3
12440,2019-05-13,성동구,0.0,0,4,1,0,5
12441,2019-05-13,성북구,0.0,0,3,0,4,7
12442,2019-05-13,송파구,0.0,0,10,2,6,18
12443,2019-05-13,양천구,0.0,0,2,0,0,2
12444,2019-05-13,영등포구,0.0,0,11,1,0,12
12445,2019-05-13,용산구,0.0,0,2,0,1,3
12446,2019-05-13,은평구,0.0,0,0,0,0,0
12447,2019-05-13,종로구,0.0,0,4,1,1,6
12448,2019-05-13,중구,0.0,0,2,0,1,3
12449,2019-05-13,중랑구,0.0,0,4,0,0,4
12450,2019-05-14,강남구,0.0,0,12,3,2,17
12451,2019-05-14,강동구,0.0,0,6,0,2,8
12452,2019-05-14,강북구,0.0,0,3,0,0,3
12453,2019-05-14,강서구,0.0,1,2,0,1,4
12454,2019-05-14,관악구,0.0,0,4,0,2,6
12455,2019-05-14,광진구,0.0,0,0,0,0,0
12456,2019-05-14,구로구,0.0,0,8,0,1,9
12457,2019-05-14,금천구,0.0,0,3,0,1,4
12458,2019-05-14,노원구,0.0,0,9,1,3,13
12459,2019-05-14,도봉구,0.0,0,0,0,1,1
12460,2019-05-14,동대문구,0.0,0,4,2,1,7
12461,2019-05-14,동작구,0.0,0,3,1,1,5
12462,2019-05-14,마포구,0.0,0,8,0,3,11
12463,2019-05-14,서대문구,0.0,0,6,0,0,6
12464,2019-05-14,서초구,0.0,0,5,0,4,9
12465,2019-05-14,성동구,0.0,0,0,0,0,0
12466,2019-05-14,성북구,0.0,0,9,0,2,11
12467,2019-05-14,송파구,0.0,2,10,0,1,13
12468,2019-05-14,양천구,0.0,0,3,0,0,3
12469,2019-05-14,영등포구,0.0,0,1,0,0,1
12470,2019-05-14,용산구,0.0,0,4,0,1,5
12471,2019-05-14,은평구,0.0,0,1,0,1,2
12472,2019-05-14,종로구,0.0,0,1,0,2,3
12473,2019-05-14,중구,0.0,0,1,1,3,5
12474,2019-05-14,중랑구,0.0,0,6,3,1,10
12475,2019-05-15,강남구,0.0,0,12,0,1,13
12476,2019-05-15,강동구,0.0,0,6,0,0,6
12477,2019-05-15,강북구,0.0,0,3,0,1,4
12478,2019-05-15,강서구,0.0,0,8,0,2,10
12479,2019-05-15,관악구,0.0,0,2,0,0,2
12480,2019-05-15,광진구,0.0,0,4,0,1,5
12481,2019-05-15,구로구,0.0,0,2,0,0,2
12482,2019-05-15,금천구,0.0,0,1,0,0,1
12483,2019-05-15,노원구,0.0,0,1,0,0,1
12484,2019-05-15,도봉구,0.0,0,3,0,0,3
12485,2019-05-15,동대문구,0.0,0,0,0,1,1
12486,2019-05-15,동작구,0.0,0,6,3,1,10
12487,2019-05-15,마포구,0.0,0,3,1,0,4
12488,2019-05-15,서대문구,0.0,0,3,0,0,3
12489,2019-05-15,서초구,0.0,0,3,2,0,5
12490,2019-05-15,성동구,0.0,0,7,0,2,9
12491,2019-05-15,성북구,0.0,0,3,1,0,4
12492,2019-05-15,송파구,0.0,0,5,0,1,6
12493,2019-05-15,양천구,0.0,0,6,1,2,9
12494,2019-05-15,영등포구,0.0,0,7,0,2,9
12495,2019-05-15,용산구,0.0,0,6,0,0,6
12496,2019-05-15,은평구,0.0,0,2,0,0,2
12497,2019-05-15,종로구,0.0,0,1,0,0,1
12498,2019-05-15,중구,0.0,0,3,0,1,4
12499,2019-05-15,중랑구,0.0,0,4,0,1,5
12500,2019-05-16,강남구,0.0,0,4,3,5,12
12501,2019-05-16,강동구,0.0,0,3,0,0,3
12502,2019-05-16,강북구,0.0,0,3,0,0,3
12503,2019-05-16,강서구,0.0,0,8,1,0,9
12504,2019-05-16,관악구,0.0,0,2,0,1,3
12505,2019-05-16,광진구,0.0,0,5,0,2,7
12506,2019-05-16,구로구,0.0,0,4,0,3,7
12507,2019-05-16,금천구,0.0,0,0,1,0,1
12508,2019-05-16,노원구,0.0,0,2,0,1,3
12509,2019-05-16,도봉구,0.0,0,3,0,0,3
12510,2019-05-16,동대문구,0.0,0,7,2,2,11
12511,2019-05-16,동작구,0.0,0,4,1,2,7
12512,2019-05-16,마포구,0.0,0,2,1,2,5
12513,2019-05-16,서대문구,0.0,0,3,0,1,4
12514,2019-05-16,서초구,0.0,0,6,1,3,10
12515,2019-05-16,성동구,0.0,0,3,0,2,5
12516,2019-05-16,성북구,0.0,0,4,0,0,4
12517,2019-05-16,송파구,0.0,1,19,1,4,25
12518,2019-05-16,양천구,0.0,0,6,1,0,7
12519,2019-05-16,영등포구,0.0,0,9,2,4,15
12520,2019-05-16,용산구,0.0,0,6,0,3,9
12521,2019-05-16,은평구,0.0,0,2,0,1,3
12522,2019-05-16,종로구,0.0,0,3,1,0,4
12523,2019-05-16,중구,0.0,0,3,0,0,3
12524,2019-05-16,중랑구,0.0,0,18,1,4,23
12525,2019-05-17,강남구,0.0,0,16,1,1,18
12526,2019-05-17,강동구,0.0,0,7,0,1,8
12527,2019-05-17,강북구,0.0,0,8,1,0,9
12528,2019-05-17,강서구,0.0,0,2,1,0,3
12529,2019-05-17,관악구,0.0,0,3,0,2,5
12530,2019-05-17,광진구,0.0,0,1,2,0,3
12531,2019-05-17,구로구,0.0,0,5,0,0,5
12532,2019-05-17,금천구,0.0,0,0,0,1,1
12533,2019-05-17,노원구,0.0,0,7,0,3,10
12534,2019-05-17,도봉구,0.0,0,1,1,1,3
12535,2019-05-17,동대문구,0.0,0,4,0,0,4
12536,2019-05-17,동작구,0.0,0,3,0,1,4
12537,2019-05-17,마포구,0.0,0,2,0,1,3
12538,2019-05-17,서대문구,0.0,0,1,1,0,2
12539,2019-05-17,서초구,0.0,0,9,0,3,12
12540,2019-05-17,성동구,0.0,0,4,0,0,4
12541,2019-05-17,성북구,0.0,0,2,0,0,2
12542,2019-05-17,송파구,0.0,0,15,0,1,16
12543,2019-05-17,양천구,0.0,0,1,0,1,2
12544,2019-05-17,영등포구,0.0,0,7,1,1,9
12545,2019-05-17,용산구,0.0,0,3,0,0,3
12546,2019-05-17,은평구,0.0,0,4,0,1,5
12547,2019-05-17,종로구,0.0,0,3,0,1,4
12548,2019-05-17,중구,0.0,0,3,0,0,3
12549,2019-05-17,중랑구,0.0,0,2,0,1,3
12550,2019-05-18,강남구,0.0,0,17,1,3,21
12551,2019-05-18,강동구,0.0,0,8,1,0,9
12552,2019-05-18,강북구,0.0,0,2,1,0,3
12553,2019-05-18,강서구,0.0,0,3,0,5,8
12554,2019-05-18,관악구,0.0,0,4,0,1,5
12555,2019-05-18,광진구,0.0,0,10,0,0,10
12556,2019-05-18,구로구,0.0,0,3,1,1,5
12557,2019-05-18,금천구,0.0,0,10,1,0,11
12558,2019-05-18,노원구,0.0,0,3,0,0,3
12559,2019-05-18,도봉구,0.0,0,1,2,1,4
12560,2019-05-18,동대문구,0.0,0,2,0,3,5
12561,2019-05-18,동작구,0.0,0,5,0,3,8
12562,2019-05-18,마포구,0.0,0,3,1,0,4
12563,2019-05-18,서대문구,0.0,0,3,0,2,5
12564,2019-05-18,서초구,0.0,0,2,2,5,9
12565,2019-05-18,성동구,0.0,0,8,1,1,10
12566,2019-05-18,성북구,0.0,0,2,0,2,4
12567,2019-05-18,송파구,0.0,0,11,1,2,14
12568,2019-05-18,양천구,0.0,0,6,0,1,7
12569,2019-05-18,영등포구,0.0,0,6,2,3,11
12570,2019-05-18,용산구,0.0,0,1,0,0,1
12571,2019-05-18,은평구,0.0,0,3,0,1,4
12572,2019-05-18,종로구,0.0,0,0,0,1,1
12573,2019-05-18,중구,0.0,0,3,0,0,3
12574,2019-05-18,중랑구,0.0,0,6,2,0,8
12575,2019-05-19,강남구,15.5,0,11,2,2,15
12576,2019-05-19,강동구,15.5,0,1,0,1,2
12577,2019-05-19,강북구,23.0,0,2,0,2,4
12578,2019-05-19,강서구,12.0,0,8,0,1,9
12579,2019-05-19,관악구,20.25,0,10,0,4,14
12580,2019-05-19,광진구,17.5,0,3,0,2,5
12581,2019-05-19,구로구,16.0,0,0,0,0,0
12582,2019-05-19,금천구,16.5,0,4,0,1,5
12583,2019-05-19,노원구,18.5,0,2,0,2,4
12584,2019-05-19,도봉구,27.5,0,1,0,1,2
12585,2019-05-19,동대문구,17.5,0,2,0,1,3
12586,2019-05-19,동작구,18.5,0,3,0,0,3
12587,2019-05-19,마포구,17.0,0,6,0,0,6
12588,2019-05-19,서대문구,16.5,0,14,7,1,22
12589,2019-05-19,서초구,15.5,0,16,2,2,20
12590,2019-05-19,성동구,18.0,0,0,0,1,1
12591,2019-05-19,성북구,23.5,0,2,0,0,2
12592,2019-05-19,송파구,16.5,0,12,2,1,15
12593,2019-05-19,양천구,17.0,0,1,4,1,6
12594,2019-05-19,영등포구,16.5,0,13,0,1,14
12595,2019-05-19,용산구,20.0,0,4,1,0,5
12596,2019-05-19,은평구,10.0,0,4,0,1,5
12597,2019-05-19,종로구,22.0,0,1,0,2,3
12598,2019-05-19,중구,17.0,0,1,0,0,1
12599,2019-05-19,중랑구,16.5,0,2,1,1,4
12600,2019-05-20,강남구,4.5,0,14,1,1,16
12601,2019-05-20,강동구,3.5,0,4,2,2,8
12602,2019-05-20,강북구,9.0,0,1,0,0,1
12603,2019-05-20,강서구,10.0,0,8,0,0,8
12604,2019-05-20,관악구,5.75,0,4,0,1,5
12605,2019-05-20,광진구,4.0,0,3,1,1,5
12606,2019-05-20,구로구,7.0,0,2,1,3,6
12607,2019-05-20,금천구,5.5,0,2,0,0,2
12608,2019-05-20,노원구,6.0,0,7,0,2,9
12609,2019-05-20,도봉구,12.5,0,3,1,0,4
12610,2019-05-20,동대문구,5.0,0,1,0,0,1
12611,2019-05-20,동작구,4.5,0,3,0,1,4
12612,2019-05-20,마포구,6.5,0,2,2,0,4
12613,2019-05-20,서대문구,7.5,0,1,0,1,2
12614,2019-05-20,서초구,3.5,0,6,0,3,9
12615,2019-05-20,성동구,6.0,0,1,1,1,3
12616,2019-05-20,성북구,8.5,1,1,0,3,5
12617,2019-05-20,송파구,2.5,0,6,0,2,8
12618,2019-05-20,양천구,7.0,0,3,1,0,4
12619,2019-05-20,영등포구,5.5,0,9,0,0,9
12620,2019-05-20,용산구,4.5,0,4,0,0,4
12621,2019-05-20,은평구,16.5,0,3,1,2,6
12622,2019-05-20,종로구,8.7,0,1,0,0,1
12623,2019-05-20,중구,5.0,0,0,0,0,0
12624,2019-05-20,중랑구,5.5,0,2,0,1,3
12625,2019-05-21,강남구,0.0,0,14,0,4,18
12626,2019-05-21,강동구,0.0,0,7,0,1,8
12627,2019-05-21,강북구,0.0,0,6,0,0,6
12628,2019-05-21,강서구,0.0,0,6,0,0,6
12629,2019-05-21,관악구,0.0,0,4,0,1,5
12630,2019-05-21,광진구,0.0,0,1,0,1,2
12631,2019-05-21,구로구,0.0,0,4,1,2,7
12632,2019-05-21,금천구,0.0,0,2,1,0,3
12633,2019-05-21,노원구,0.0,0,1,0,1,2
12634,2019-05-21,도봉구,0.0,0,0,0,3,3
12635,2019-05-21,동대문구,0.0,0,4,0,1,5
12636,2019-05-21,동작구,0.0,0,1,0,0,1
12637,2019-05-21,마포구,0.0,0,3,0,1,4
12638,2019-05-21,서대문구,0.0,0,3,0,1,4
12639,2019-05-21,서초구,0.0,0,12,0,3,15
12640,2019-05-21,성동구,0.0,0,1,0,2,3
12641,2019-05-21,성북구,0.0,0,6,1,2,9
12642,2019-05-21,송파구,0.0,0,19,0,2,21
12643,2019-05-21,양천구,0.0,0,5,1,0,6
12644,2019-05-21,영등포구,0.0,0,21,2,3,26
12645,2019-05-21,용산구,0.0,0,0,0,0,0
12646,2019-05-21,은평구,0.0,0,2,0,0,2
12647,2019-05-21,종로구,0.0,0,3,1,0,4
12648,2019-05-21,중구,0.0,0,1,0,1,2
12649,2019-05-21,중랑구,0.0,0,1,0,1,2
12650,2019-05-22,강남구,0.0,0,7,3,3,13
12651,2019-05-22,강동구,0.0,0,7,0,0,7
12652,2019-05-22,강북구,0.0,0,7,0,1,8
12653,2019-05-22,강서구,0.0,0,4,0,0,4
12654,2019-05-22,관악구,0.0,0,2,0,1,3
12655,2019-05-22,광진구,0.0,0,2,0,0,2
12656,2019-05-22,구로구,0.0,0,4,0,3,7
12657,2019-05-22,금천구,0.0,0,0,0,0,0
12658,2019-05-22,노원구,0.0,0,7,1,1,9
12659,2019-05-22,도봉구,0.0,0,1,0,1,2
12660,2019-05-22,동대문구,0.0,0,4,1,2,7
12661,2019-05-22,동작구,0.0,0,1,0,3,4
12662,2019-05-22,마포구,0.0,0,6,0,2,8
12663,2019-05-22,서대문구,0.0,0,3,2,2,7
12664,2019-05-22,서초구,0.0,0,4,1,2,7
12665,2019-05-22,성동구,0.0,0,1,1,2,4
12666,2019-05-22,성북구,0.0,0,3,0,0,3
12667,2019-05-22,송파구,0.0,0,9,1,0,10
12668,2019-05-22,양천구,0.0,0,3,0,3,6
12669,2019-05-22,영등포구,0.0,0,17,3,2,22
12670,2019-05-22,용산구,0.0,0,5,0,2,7
12671,2019-05-22,은평구,0.0,0,0,0,2,2
12672,2019-05-22,종로구,0.0,0,6,1,0,7
12673,2019-05-22,중구,0.0,0,1,0,1,2
12674,2019-05-22,중랑구,0.0,0,2,2,0,4
12675,2019-05-23,강남구,0.0,0,15,0,1,16
12676,2019-05-23,강동구,0.0,0,5,1,1,7
12677,2019-05-23,강북구,0.0,0,10,0,1,11
12678,2019-05-23,강서구,0.0,0,8,1,0,9
12679,2019-05-23,관악구,0.0,0,3,0,2,5
12680,2019-05-23,광진구,0.0,0,2,0,1,3
12681,2019-05-23,구로구,0.0,0,3,0,1,4
12682,2019-05-23,금천구,0.0,0,3,1,0,4
12683,2019-05-23,노원구,0.0,0,5,0,2,7
12684,2019-05-23,도봉구,0.0,0,1,0,1,2
12685,2019-05-23,동대문구,0.0,0,6,0,0,6
12686,2019-05-23,동작구,0.0,0,7,1,2,10
12687,2019-05-23,마포구,0.0,0,2,0,0,2
12688,2019-05-23,서대문구,0.0,0,4,6,0,10
12689,2019-05-23,서초구,0.0,0,17,0,0,17
12690,2019-05-23,성동구,0.0,0,2,0,0,2
12691,2019-05-23,성북구,0.0,0,3,1,1,5
12692,2019-05-23,송파구,0.0,0,10,1,1,12
12693,2019-05-23,양천구,0.0,0,1,0,2,3
12694,2019-05-23,영등포구,0.0,0,5,1,0,6
12695,2019-05-23,용산구,0.0,0,4,0,1,5
12696,2019-05-23,은평구,0.0,0,5,2,1,8
12697,2019-05-23,종로구,0.0,0,2,0,0,2
12698,2019-05-23,중구,0.0,0,5,3,2,10
12699,2019-05-23,중랑구,0.0,0,3,0,0,3
12700,2019-05-24,강남구,0.0,0,6,3,7,16
12701,2019-05-24,강동구,0.0,0,7,6,2,15
12702,2019-05-24,강북구,0.0,0,6,0,0,6
12703,2019-05-24,강서구,0.0,0,7,0,4,11
12704,2019-05-24,관악구,0.0,0,4,0,0,4
12705,2019-05-24,광진구,0.0,0,3,0,0,3
12706,2019-05-24,구로구,0.0,0,6,1,1,8
12707,2019-05-24,금천구,0.0,0,11,0,0,11
12708,2019-05-24,노원구,0.0,1,8,1,0,10
12709,2019-05-24,도봉구,0.0,0,2,0,0,2
12710,2019-05-24,동대문구,0.0,0,7,0,2,9
12711,2019-05-24,동작구,0.0,0,7,1,2,10
12712,2019-05-24,마포구,0.0,0,6,0,0,6
12713,2019-05-24,서대문구,0.0,0,2,2,4,8
12714,2019-05-24,서초구,0.0,0,16,2,3,21
12715,2019-05-24,성동구,0.0,0,1,0,2,3
12716,2019-05-24,성북구,0.0,0,3,0,1,4
12717,2019-05-24,송파구,0.0,0,8,1,1,10
12718,2019-05-24,양천구,0.0,0,4,2,0,6
12719,2019-05-24,영등포구,0.0,0,8,0,1,9
12720,2019-05-24,용산구,0.0,0,1,2,1,4
12721,2019-05-24,은평구,0.0,0,3,1,0,4
12722,2019-05-24,종로구,0.0,0,5,1,3,9
12723,2019-05-24,중구,0.0,0,7,0,1,8
12724,2019-05-24,중랑구,0.0,0,14,0,1,15
12725,2019-05-25,강남구,0.0,0,12,0,0,12
12726,2019-05-25,강동구,0.0,0,6,0,2,8
12727,2019-05-25,강북구,0.0,0,2,0,0,2
12728,2019-05-25,강서구,0.0,0,14,9,0,23
12729,2019-05-25,관악구,0.0,0,5,0,1,6
12730,2019-05-25,광진구,0.0,0,0,1,1,2
12731,2019-05-25,구로구,0.0,0,11,0,2,13
12732,2019-05-25,금천구,0.0,0,0,1,1,2
12733,2019-05-25,노원구,0.0,0,3,2,1,6
12734,2019-05-25,도봉구,0.0,0,8,1,1,10
12735,2019-05-25,동대문구,0.0,0,2,0,1,3
12736,2019-05-25,동작구,0.0,0,7,2,0,9
12737,2019-05-25,마포구,0.0,0,8,0,0,8
12738,2019-05-25,서대문구,0.0,0,2,0,2,4
12739,2019-05-25,서초구,0.0,1,7,3,1,12
12740,2019-05-25,성동구,0.0,0,4,0,1,5
12741,2019-05-25,성북구,0.0,0,9,0,0,9
12742,2019-05-25,송파구,0.0,0,8,1,0,9
12743,2019-05-25,양천구,0.0,0,3,1,0,4
12744,2019-05-25,영등포구,0.0,0,6,1,3,10
12745,2019-05-25,용산구,0.0,0,1,0,1,2
12746,2019-05-25,은평구,0.0,0,2,0,2,4
12747,2019-05-25,종로구,0.0,0,2,1,0,3
12748,2019-05-25,중구,0.0,0,5,1,0,6
12749,2019-05-25,중랑구,0.0,0,4,0,0,4
12750,2019-05-26,강남구,0.0,0,3,2,0,5
12751,2019-05-26,강동구,0.0,0,4,0,2,6
12752,2019-05-26,강북구,0.0,0,1,0,1,2
12753,2019-05-26,강서구,0.0,0,5,1,0,6
12754,2019-05-26,관악구,0.0,0,6,0,1,7
12755,2019-05-26,광진구,0.0,0,2,0,0,2
12756,2019-05-26,구로구,0.0,0,4,0,1,5
12757,2019-05-26,금천구,0.0,0,0,0,0,0
12758,2019-05-26,노원구,0.0,0,1,1,2,4
12759,2019-05-26,도봉구,0.0,0,3,0,0,3
12760,2019-05-26,동대문구,0.0,0,6,0,2,8
12761,2019-05-26,동작구,0.0,0,4,0,0,4
12762,2019-05-26,마포구,0.0,0,8,2,1,11
12763,2019-05-26,서대문구,0.0,0,1,1,0,2
12764,2019-05-26,서초구,0.0,0,4,0,0,4
12765,2019-05-26,성동구,0.0,0,0,0,1,1
12766,2019-05-26,성북구,0.0,0,5,1,0,6
12767,2019-05-26,송파구,0.0,0,4,1,1,6
12768,2019-05-26,양천구,0.0,0,1,0,0,1
12769,2019-05-26,영등포구,0.0,0,5,1,0,6
12770,2019-05-26,용산구,0.0,0,4,0,2,6
12771,2019-05-26,은평구,0.0,0,1,1,0,2
12772,2019-05-26,종로구,0.0,0,3,0,0,3
12773,2019-05-26,중구,0.0,0,1,2,0,3
12774,2019-05-26,중랑구,0.0,0,3,1,0,4
12775,2019-05-27,강남구,4.5,0,10,0,2,12
12776,2019-05-27,강동구,4.5,0,5,0,3,8
12777,2019-05-27,강북구,12.5,0,3,0,0,3
12778,2019-05-27,강서구,9.5,0,14,2,0,16
12779,2019-05-27,관악구,6.75,0,2,0,0,2
12780,2019-05-27,광진구,5.5,0,2,0,0,2
12781,2019-05-27,구로구,5.0,0,5,3,0,8
12782,2019-05-27,금천구,3.5,0,1,0,1,2
12783,2019-05-27,노원구,7.5,0,2,0,1,3
12784,2019-05-27,도봉구,18.0,0,4,1,0,5
12785,2019-05-27,동대문구,6.5,0,4,0,1,5
12786,2019-05-27,동작구,4.5,0,5,1,0,6
12787,2019-05-27,마포구,5.0,0,13,0,1,14
12788,2019-05-27,서대문구,6.0,0,2,1,2,5
12789,2019-05-27,서초구,4.5,0,12,1,1,14
12790,2019-05-27,성동구,5.5,0,0,0,0,0
12791,2019-05-27,성북구,10.5,0,5,0,0,5
12792,2019-05-27,송파구,5.5,0,9,0,6,15
12793,2019-05-27,양천구,5.0,0,3,0,0,3
12794,2019-05-27,영등포구,3.25,0,6,1,0,7
12795,2019-05-27,용산구,5.5,0,5,0,0,5
12796,2019-05-27,은평구,10.5,0,6,0,2,8
12797,2019-05-27,종로구,7.1,0,6,0,0,6
12798,2019-05-27,중구,7.0,0,4,0,0,4
12799,2019-05-27,중랑구,6.5,0,1,1,1,3
12800,2019-05-28,강남구,0.0,0,11,3,2,16
12801,2019-05-28,강동구,0.0,0,3,0,3,6
12802,2019-05-28,강북구,0.0,0,7,0,2,9
12803,2019-05-28,강서구,0.0,0,2,0,3,5
12804,2019-05-28,관악구,0.0,0,5,0,2,7
12805,2019-05-28,광진구,0.0,0,2,0,0,2
12806,2019-05-28,구로구,0.0,0,2,1,0,3
12807,2019-05-28,금천구,0.0,0,4,0,1,5
12808,2019-05-28,노원구,0.0,0,5,1,2,8
12809,2019-05-28,도봉구,0.0,0,1,0,1,2
12810,2019-05-28,동대문구,0.0,0,10,1,0,11
12811,2019-05-28,동작구,0.0,0,9,1,1,11
12812,2019-05-28,마포구,0.0,0,4,0,0,4
12813,2019-05-28,서대문구,0.0,0,2,0,0,2
12814,2019-05-28,서초구,0.0,0,7,0,3,10
12815,2019-05-28,성동구,0.0,0,0,1,2,3
12816,2019-05-28,성북구,0.0,0,2,1,1,4
12817,2019-05-28,송파구,0.0,0,6,3,3,12
12818,2019-05-28,양천구,0.0,0,2,1,0,3
12819,2019-05-28,영등포구,0.0,0,11,1,2,14
12820,2019-05-28,용산구,0.0,0,0,0,1,1
12821,2019-05-28,은평구,0.0,0,6,0,0,6
12822,2019-05-28,종로구,0.0,0,1,0,0,1
12823,2019-05-28,중구,0.0,0,7,2,0,9
12824,2019-05-28,중랑구,0.0,1,2,0,3,6
12825,2019-05-29,강남구,0.0,0,12,2,5,19
12826,2019-05-29,강동구,0.0,0,4,0,1,5
12827,2019-05-29,강북구,0.0,0,2,0,1,3
12828,2019-05-29,강서구,0.0,0,3,1,1,5
12829,2019-05-29,관악구,0.0,0,4,0,0,4
12830,2019-05-29,광진구,0.0,0,3,0,0,3
12831,2019-05-29,구로구,0.0,0,5,0,1,6
12832,2019-05-29,금천구,0.0,0,3,1,1,5
12833,2019-05-29,노원구,0.0,0,3,0,1,4
12834,2019-05-29,도봉구,0.0,0,7,0,0,7
12835,2019-05-29,동대문구,0.0,0,1,0,0,1
12836,2019-05-29,동작구,0.0,0,4,1,3,8
12837,2019-05-29,마포구,0.0,0,1,0,4,5
12838,2019-05-29,서대문구,0.0,0,3,2,0,5
12839,2019-05-29,서초구,0.0,0,4,2,2,8
12840,2019-05-29,성동구,0.0,0,7,0,2,9
12841,2019-05-29,성북구,0.0,0,3,1,0,4
12842,2019-05-29,송파구,0.0,0,9,2,3,14
12843,2019-05-29,양천구,0.0,0,6,1,0,7
12844,2019-05-29,영등포구,0.0,0,6,0,2,8
12845,2019-05-29,용산구,0.0,0,0,0,4,4
12846,2019-05-29,은평구,0.0,0,6,1,2,9
12847,2019-05-29,종로구,0.0,0,1,0,1,2
12848,2019-05-29,중구,0.0,0,0,1,0,1
12849,2019-05-29,중랑구,0.0,0,5,1,3,9
12850,2019-05-30,강남구,0.0,0,12,3,2,17
12851,2019-05-30,강동구,0.0,0,0,0,0,0
12852,2019-05-30,강북구,0.0,0,1,0,0,1
12853,2019-05-30,강서구,0.0,0,10,2,1,13
12854,2019-05-30,관악구,0.0,0,2,1,1,4
12855,2019-05-30,광진구,0.0,0,0,0,0,0
12856,2019-05-30,구로구,0.0,0,7,0,1,8
12857,2019-05-30,금천구,0.0,0,1,0,2,3
12858,2019-05-30,노원구,0.0,0,5,0,2,7
12859,2019-05-30,도봉구,0.0,0,7,0,0,7
12860,2019-05-30,동대문구,0.0,0,3,0,1,4
12861,2019-05-30,동작구,0.0,0,3,0,0,3
12862,2019-05-30,마포구,0.0,0,9,1,6,16
12863,2019-05-30,서대문구,0.0,0,2,1,1,4
12864,2019-05-30,서초구,0.0,0,2,1,0,3
12865,2019-05-30,성동구,0.0,0,2,0,0,2
12866,2019-05-30,성북구,0.0,0,0,0,0,0
12867,2019-05-30,송파구,0.0,0,15,1,3,19
12868,2019-05-30,양천구,0.0,0,9,0,0,9
12869,2019-05-30,영등포구,0.0,0,9,0,2,11
12870,2019-05-30,용산구,0.0,0,4,0,0,4
12871,2019-05-30,은평구,0.0,0,0,0,0,0
12872,2019-05-30,종로구,0.0,0,4,2,3,9
12873,2019-05-30,중구,0.0,0,10,1,2,13
12874,2019-05-30,중랑구,0.0,0,6,2,0,8
12875,2019-05-31,강남구,0.0,0,20,3,3,26
12876,2019-05-31,강동구,0.0,0,9,2,1,12
12877,2019-05-31,강북구,0.0,0,10,0,3,13
12878,2019-05-31,강서구,0.0,0,6,1,1,8
12879,2019-05-31,관악구,0.0,0,5,0,1,6
12880,2019-05-31,광진구,0.0,0,0,0,1,1
12881,2019-05-31,구로구,0.0,0,3,0,3,6
12882,2019-05-31,금천구,0.0,0,4,0,1,5
12883,2019-05-31,노원구,0.0,0,6,1,2,9
12884,2019-05-31,도봉구,0.0,0,2,0,0,2
12885,2019-05-31,동대문구,0.0,0,4,0,3,7
12886,2019-05-31,동작구,0.0,0,7,4,0,11
12887,2019-05-31,마포구,0.0,0,5,0,2,7
12888,2019-05-31,서대문구,0.0,0,3,2,2,7
12889,2019-05-31,서초구,0.0,0,7,0,2,9
12890,2019-05-31,성동구,0.0,0,1,0,1,2
12891,2019-05-31,성북구,0.0,0,6,0,4,10
12892,2019-05-31,송파구,0.0,0,8,1,5,14
12893,2019-05-31,양천구,0.0,0,5,1,2,8
12894,2019-05-31,영등포구,0.0,0,10,1,0,11
12895,2019-05-31,용산구,0.0,0,0,0,0,0
12896,2019-05-31,은평구,0.0,0,3,2,1,6
12897,2019-05-31,종로구,0.0,0,8,0,0,8
12898,2019-05-31,중구,0.0,0,2,2,2,6
12899,2019-05-31,중랑구,0.0,0,4,1,0,5
12900,2019-06-01,강남구,0.0,1,9,1,1,12
12901,2019-06-01,강동구,0.0,0,4,1,5,10
12902,2019-06-01,강북구,0.0,0,3,0,1,4
12903,2019-06-01,강서구,0.0,0,4,0,1,5
12904,2019-06-01,관악구,0.0,0,8,2,0,10
12905,2019-06-01,광진구,0.0,0,0,0,0,0
12906,2019-06-01,구로구,0.0,0,4,0,3,7
12907,2019-06-01,금천구,0.0,0,2,0,1,3
12908,2019-06-01,노원구,0.0,0,1,3,1,5
12909,2019-06-01,도봉구,0.0,0,3,0,1,4
12910,2019-06-01,동대문구,0.0,0,2,0,4,6
12911,2019-06-01,동작구,0.0,0,8,2,0,10
12912,2019-06-01,마포구,0.0,0,7,4,0,11
12913,2019-06-01,서대문구,0.0,0,4,0,1,5
12914,2019-06-01,서초구,0.0,0,11,1,3,15
12915,2019-06-01,성동구,0.0,0,6,0,0,6
12916,2019-06-01,성북구,0.0,0,4,2,1,7
12917,2019-06-01,송파구,0.0,0,4,1,2,7
12918,2019-06-01,양천구,0.0,0,4,0,0,4
12919,2019-06-01,영등포구,0.0,0,7,1,1,9
12920,2019-06-01,용산구,0.0,0,1,0,2,3
12921,2019-06-01,은평구,0.0,0,2,0,1,3
12922,2019-06-01,종로구,0.0,0,0,0,1,1
12923,2019-06-01,중구,0.0,0,4,2,2,8
12924,2019-06-01,중랑구,0.0,0,4,0,1,5
12925,2019-06-02,강남구,0.0,0,6,1,0,7
12926,2019-06-02,강동구,0.0,0,4,1,1,6
12927,2019-06-02,강북구,0.0,0,1,0,0,1
12928,2019-06-02,강서구,0.0,0,5,1,1,7
12929,2019-06-02,관악구,0.0,0,2,0,0,2
12930,2019-06-02,광진구,0.0,0,3,0,1,4
12931,2019-06-02,구로구,0.0,0,3,0,1,4
12932,2019-06-02,금천구,0.0,0,1,0,0,1
12933,2019-06-02,노원구,0.0,0,6,0,2,8
12934,2019-06-02,도봉구,0.0,0,6,1,1,8
12935,2019-06-02,동대문구,0.0,0,6,2,0,8
12936,2019-06-02,동작구,0.0,0,7,2,0,9
12937,2019-06-02,마포구,0.0,0,1,0,0,1
12938,2019-06-02,서대문구,0.0,0,12,11,1,24
12939,2019-06-02,서초구,0.0,0,4,1,0,5
12940,2019-06-02,성동구,0.0,0,4,0,1,5
12941,2019-06-02,성북구,0.0,0,0,0,0,0
12942,2019-06-02,송파구,0.0,0,4,1,0,5
12943,2019-06-02,양천구,0.0,0,1,2,0,3
12944,2019-06-02,영등포구,0.0,0,6,2,2,10
12945,2019-06-02,용산구,0.0,0,6,0,3,9
12946,2019-06-02,은평구,0.0,0,3,0,1,4
12947,2019-06-02,종로구,0.0,0,1,0,1,2
12948,2019-06-02,중구,0.0,0,4,0,0,4
12949,2019-06-02,중랑구,0.0,0,2,0,0,2
12950,2019-06-03,강남구,0.0,0,14,0,3,17
12951,2019-06-03,강동구,0.0,0,1,0,4,5
12952,2019-06-03,강북구,0.0,0,2,0,0,2
12953,2019-06-03,강서구,0.0,0,3,0,1,4
12954,2019-06-03,관악구,0.0,0,1,1,1,3
12955,2019-06-03,광진구,0.0,0,1,0,1,2
12956,2019-06-03,구로구,0.0,1,4,0,1,6
12957,2019-06-03,금천구,0.0,0,1,0,0,1
12958,2019-06-03,노원구,0.0,0,8,1,1,10
12959,2019-06-03,도봉구,0.0,0,8,0,0,8
12960,2019-06-03,동대문구,0.0,0,6,0,0,6
12961,2019-06-03,동작구,0.0,0,3,1,1,5
12962,2019-06-03,마포구,0.0,0,1,0,2,3
12963,2019-06-03,서대문구,0.0,0,4,2,2,8
12964,2019-06-03,서초구,0.0,0,4,1,2,7
12965,2019-06-03,성동구,0.0,0,4,0,0,4
12966,2019-06-03,성북구,0.0,0,3,1,1,5
12967,2019-06-03,송파구,0.0,0,3,0,0,3
12968,2019-06-03,양천구,0.0,0,4,0,0,4
12969,2019-06-03,영등포구,0.0,0,3,1,2,6
12970,2019-06-03,용산구,0.0,0,4,0,2,6
12971,2019-06-03,은평구,0.0,0,3,0,2,5
12972,2019-06-03,종로구,0.0,0,3,0,1,4
12973,2019-06-03,중구,0.0,0,1,0,2,3
12974,2019-06-03,중랑구,0.0,0,7,1,0,8
12975,2019-06-04,강남구,0.0,0,13,1,2,16
12976,2019-06-04,강동구,0.0,0,1,0,2,3
12977,2019-06-04,강북구,0.0,0,2,0,3,5
12978,2019-06-04,강서구,0.0,0,5,0,1,6
12979,2019-06-04,관악구,0.0,0,3,0,0,3
12980,2019-06-04,광진구,0.0,0,2,0,0,2
12981,2019-06-04,구로구,0.0,0,3,0,3,6
12982,2019-06-04,금천구,0.0,0,7,1,0,8
12983,2019-06-04,노원구,0.0,0,6,0,3,9
12984,2019-06-04,도봉구,0.0,0,3,1,2,6
12985,2019-06-04,동대문구,0.0,0,3,0,0,3
12986,2019-06-04,동작구,0.0,0,5,0,2,7
12987,2019-06-04,마포구,0.0,0,2,0,0,2
12988,2019-06-04,서대문구,0.0,0,1,2,0,3
12989,2019-06-04,서초구,0.0,0,6,0,2,8
12990,2019-06-04,성동구,0.0,0,4,0,2,6
12991,2019-06-04,성북구,0.0,0,1,0,1,2
12992,2019-06-04,송파구,0.0,0,11,1,0,12
12993,2019-06-04,양천구,0.0,0,2,0,1,3
12994,2019-06-04,영등포구,0.0,0,5,0,2,7
12995,2019-06-04,용산구,0.0,0,5,0,2,7
12996,2019-06-04,은평구,0.0,0,4,0,0,4
12997,2019-06-04,종로구,0.0,0,4,1,1,6
12998,2019-06-04,중구,0.0,0,1,0,0,1
12999,2019-06-04,중랑구,0.0,0,7,3,2,12
13000,2019-06-05,강남구,0.0,0,8,2,0,10
13001,2019-06-05,강동구,0.0,0,5,0,0,5
13002,2019-06-05,강북구,0.0,0,6,2,1,9
13003,2019-06-05,강서구,0.0,0,0,2,1,3
13004,2019-06-05,관악구,0.0,0,3,0,2,5
13005,2019-06-05,광진구,0.0,0,1,1,1,3
13006,2019-06-05,구로구,0.0,0,7,1,0,8
13007,2019-06-05,금천구,0.0,0,0,1,0,1
13008,2019-06-05,노원구,0.0,0,2,0,0,2
13009,2019-06-05,도봉구,0.0,0,6,0,1,7
13010,2019-06-05,동대문구,0.0,0,4,1,3,8
13011,2019-06-05,동작구,0.0,0,6,0,0,6
13012,2019-06-05,마포구,0.0,0,4,0,3,7
13013,2019-06-05,서대문구,0.0,0,2,0,1,3
13014,2019-06-05,서초구,0.0,0,8,1,6,15
13015,2019-06-05,성동구,0.0,0,1,0,2,3
13016,2019-06-05,성북구,0.0,0,3,0,2,5
13017,2019-06-05,송파구,0.0,0,7,2,2,11
13018,2019-06-05,양천구,0.0,1,11,0,2,14
13019,2019-06-05,영등포구,0.0,1,11,1,2,15
13020,2019-06-05,용산구,0.0,0,4,0,3,7
13021,2019-06-05,은평구,0.0,0,3,3,4,10
13022,2019-06-05,종로구,0.0,0,4,1,1,6
13023,2019-06-05,중구,0.0,0,3,0,2,5
13024,2019-06-05,중랑구,0.0,0,4,0,0,4
13025,2019-06-06,강남구,5.5,0,8,0,1,9
13026,2019-06-06,강동구,5.5,1,3,0,1,5
13027,2019-06-06,강북구,4.5,0,5,0,0,5
13028,2019-06-06,강서구,3.5,0,2,1,0,3
13029,2019-06-06,관악구,8.25,0,9,0,0,9
13030,2019-06-06,광진구,5.5,0,5,0,0,5
13031,2019-06-06,구로구,5.5,0,7,0,0,7
13032,2019-06-06,금천구,7.5,0,3,0,0,3
13033,2019-06-06,노원구,4.5,0,1,0,1,2
13034,2019-06-06,도봉구,5.0,0,0,0,0,0
13035,2019-06-06,동대문구,4.0,0,2,1,1,4
13036,2019-06-06,동작구,6.75,0,4,1,2,7
13037,2019-06-06,마포구,5.5,0,8,0,4,12
13038,2019-06-06,서대문구,6.0,0,0,0,1,1
13039,2019-06-06,서초구,7.5,0,8,0,0,8
13040,2019-06-06,성동구,5.0,0,2,2,1,5
13041,2019-06-06,성북구,6.0,0,4,0,1,5
13042,2019-06-06,송파구,6.0,0,16,2,1,19
13043,2019-06-06,양천구,5.0,0,2,1,1,4
13044,2019-06-06,영등포구,5.0,0,11,1,3,15
13045,2019-06-06,용산구,6.5,0,0,0,2,2
13046,2019-06-06,은평구,7.5,0,2,0,1,3
13047,2019-06-06,종로구,7.5,0,1,1,1,3
13048,2019-06-06,중구,4.0,0,2,1,1,4
13049,2019-06-06,중랑구,5.0,0,1,0,2,3
13050,2019-06-07,강남구,40.0,0,18,2,6,26
13051,2019-06-07,강동구,37.0,0,4,0,1,5
13052,2019-06-07,강북구,31.0,0,4,0,0,4
13053,2019-06-07,강서구,32.5,0,10,7,2,19
13054,2019-06-07,관악구,48.5,0,3,0,0,3
13055,2019-06-07,광진구,43.5,0,2,1,1,4
13056,2019-06-07,구로구,43.5,0,9,0,0,9
13057,2019-06-07,금천구,44.0,0,5,0,0,5
13058,2019-06-07,노원구,46.5,0,10,0,1,11
13059,2019-06-07,도봉구,30.5,0,1,1,0,2
13060,2019-06-07,동대문구,42.5,0,8,1,0,9
13061,2019-06-07,동작구,43.5,0,4,1,0,5
13062,2019-06-07,마포구,32.5,0,12,0,5,17
13063,2019-06-07,서대문구,32.0,0,9,3,1,13
13064,2019-06-07,서초구,48.5,0,5,1,1,7
13065,2019-06-07,성동구,45.5,0,3,0,2,5
13066,2019-06-07,성북구,34.0,1,2,0,0,3
13067,2019-06-07,송파구,37.0,0,8,2,2,12
13068,2019-06-07,양천구,39.5,0,2,1,1,4
13069,2019-06-07,영등포구,32.25,0,6,0,2,8
13070,2019-06-07,용산구,42.5,0,2,0,2,4
13071,2019-06-07,은평구,37.0,0,0,0,0,0
13072,2019-06-07,종로구,35.3,0,0,0,0,0
13073,2019-06-07,중구,14.0,0,4,0,5,9
13074,2019-06-07,중랑구,44.0,0,9,2,3,14
13075,2019-06-08,강남구,0.0,0,17,1,0,18
13076,2019-06-08,강동구,0.0,0,8,1,1,10
13077,2019-06-08,강북구,0.0,0,4,0,1,5
13078,2019-06-08,강서구,0.0,0,4,0,1,5
13079,2019-06-08,관악구,0.0,0,6,0,3,9
13080,2019-06-08,광진구,0.0,0,7,0,0,7
13081,2019-06-08,구로구,0.0,0,0,1,1,2
13082,2019-06-08,금천구,0.0,0,1,1,1,3
13083,2019-06-08,노원구,0.0,0,2,0,1,3
13084,2019-06-08,도봉구,0.0,0,2,0,0,2
13085,2019-06-08,동대문구,0.0,0,5,1,2,8
13086,2019-06-08,동작구,0.0,0,7,4,3,14
13087,2019-06-08,마포구,0.0,0,3,2,2,7
13088,2019-06-08,서대문구,0.0,0,1,1,1,3
13089,2019-06-08,서초구,0.0,0,1,0,0,1
13090,2019-06-08,성동구,0.0,0,2,0,0,2
13091,2019-06-08,성북구,0.0,0,1,0,0,1
13092,2019-06-08,송파구,0.0,0,5,0,1,6
13093,2019-06-08,양천구,0.0,0,2,0,0,2
13094,2019-06-08,영등포구,0.0,0,9,2,1,12
13095,2019-06-08,용산구,0.0,0,1,0,1,2
13096,2019-06-08,은평구,0.0,0,1,0,3,4
13097,2019-06-08,종로구,0.0,0,1,0,0,1
13098,2019-06-08,중구,0.0,0,0,1,3,4
13099,2019-06-08,중랑구,0.0,0,2,1,1,4
13100,2019-06-09,강남구,0.0,0,7,1,1,9
13101,2019-06-09,강동구,0.0,0,5,0,0,5
13102,2019-06-09,강북구,0.5,0,8,0,1,9
13103,2019-06-09,강서구,4.0,1,3,0,1,5
13104,2019-06-09,관악구,1.0,0,4,0,1,5
13105,2019-06-09,광진구,0.0,0,0,0,0,0
13106,2019-06-09,구로구,6.5,0,1,0,0,1
13107,2019-06-09,금천구,2.0,0,2,0,0,2
13108,2019-06-09,노원구,1.5,0,5,0,3,8
13109,2019-06-09,도봉구,0.0,0,0,0,0,0
13110,2019-06-09,동대문구,0.0,0,2,0,4,6
13111,2019-06-09,동작구,1.0,0,2,0,1,3
13112,2019-06-09,마포구,0.0,0,4,0,0,4
13113,2019-06-09,서대문구,5.0,0,1,0,0,1
13114,2019-06-09,서초구,0.5,0,3,1,2,6
13115,2019-06-09,성동구,0.0,0,0,0,0,0
13116,2019-06-09,성북구,2.5,0,0,1,0,1
13117,2019-06-09,송파구,0.0,0,6,0,1,7
13118,2019-06-09,양천구,3.0,0,1,0,2,3
13119,2019-06-09,영등포구,1.0,0,5,2,0,7
13120,2019-06-09,용산구,2.0,0,3,0,2,5
13121,2019-06-09,은평구,3.0,0,2,0,1,3
13122,2019-06-09,종로구,2.5,0,5,0,2,7
13123,2019-06-09,중구,0.0,0,1,0,0,1
13124,2019-06-09,중랑구,0.0,0,3,0,0,3
13125,2019-06-10,강남구,7.5,0,7,0,5,12
13126,2019-06-10,강동구,12.0,0,1,1,1,3
13127,2019-06-10,강북구,9.0,0,3,0,0,3
13128,2019-06-10,강서구,13.0,0,6,0,2,8
13129,2019-06-10,관악구,6.0,0,4,0,3,7
13130,2019-06-10,광진구,9.0,0,7,0,1,8
13131,2019-06-10,구로구,12.5,0,2,0,0,2
13132,2019-06-10,금천구,13.0,0,1,0,0,1
13133,2019-06-10,노원구,4.5,0,6,0,0,6
13134,2019-06-10,도봉구,9.0,0,0,1,2,3
13135,2019-06-10,동대문구,6.5,1,4,3,2,10
13136,2019-06-10,동작구,13.0,0,5,4,2,11
13137,2019-06-10,마포구,10.5,0,3,0,0,3
13138,2019-06-10,서대문구,8.5,0,2,0,1,3
13139,2019-06-10,서초구,4.5,0,5,0,4,9
13140,2019-06-10,성동구,10.0,0,6,0,1,7
13141,2019-06-10,성북구,10.0,0,7,1,0,8
13142,2019-06-10,송파구,11.0,0,9,2,5,16
13143,2019-06-10,양천구,14.5,0,2,0,1,3
13144,2019-06-10,영등포구,11.0,0,6,0,1,7
13145,2019-06-10,용산구,13.5,0,3,0,1,4
13146,2019-06-10,은평구,16.0,0,5,1,2,8
13147,2019-06-10,종로구,9.5,0,4,0,0,4
13148,2019-06-10,중구,7.5,0,2,0,1,3
13149,2019-06-10,중랑구,5.5,0,1,1,3,5
13150,2019-06-11,강남구,0.0,0,9,1,0,10
13151,2019-06-11,강동구,0.0,0,2,2,1,5
13152,2019-06-11,강북구,0.0,0,4,0,1,5
13153,2019-06-11,강서구,0.0,0,5,2,0,7
13154,2019-06-11,관악구,0.0,0,3,0,0,3
13155,2019-06-11,광진구,0.0,0,0,1,0,1
13156,2019-06-11,구로구,0.0,0,1,1,2,4
13157,2019-06-11,금천구,0.0,0,3,0,2,5
13158,2019-06-11,노원구,0.0,0,3,0,0,3
13159,2019-06-11,도봉구,0.0,0,0,1,1,2
13160,2019-06-11,동대문구,0.0,0,2,2,0,4
13161,2019-06-11,동작구,0.0,0,2,0,2,4
13162,2019-06-11,마포구,0.0,0,0,0,1,1
13163,2019-06-11,서대문구,0.0,0,3,0,0,3
13164,2019-06-11,서초구,0.0,0,5,1,0,6
13165,2019-06-11,성동구,0.0,0,5,0,0,5
13166,2019-06-11,성북구,0.0,0,2,0,3,5
13167,2019-06-11,송파구,0.0,0,7,2,3,12
13168,2019-06-11,양천구,0.0,0,2,0,0,2
13169,2019-06-11,영등포구,0.0,0,6,2,2,10
13170,2019-06-11,용산구,0.0,0,0,0,1,1
13171,2019-06-11,은평구,0.0,0,3,1,0,4
13172,2019-06-11,종로구,0.0,0,11,2,4,17
13173,2019-06-11,중구,0.0,0,12,1,2,15
13174,2019-06-11,중랑구,0.0,0,1,0,1,2
13175,2019-06-12,강남구,0.0,0,2,0,0,2
13176,2019-06-12,강동구,0.0,0,3,0,1,4
13177,2019-06-12,강북구,0.0,0,3,0,1,4
13178,2019-06-12,강서구,0.0,0,4,0,0,4
13179,2019-06-12,관악구,0.0,0,2,0,1,3
13180,2019-06-12,광진구,0.0,0,9,0,2,11
13181,2019-06-12,구로구,0.0,0,6,0,1,7
13182,2019-06-12,금천구,0.0,0,7,0,0,7
13183,2019-06-12,노원구,0.0,0,3,2,0,5
13184,2019-06-12,도봉구,0.0,0,2,0,1,3
13185,2019-06-12,동대문구,0.0,0,1,0,5,6
13186,2019-06-12,동작구,0.0,0,0,0,0,0
13187,2019-06-12,마포구,0.0,0,2,2,1,5
13188,2019-06-12,서대문구,0.0,1,2,0,0,3
13189,2019-06-12,서초구,0.0,0,17,0,3,20
13190,2019-06-12,성동구,0.0,0,1,0,0,1
13191,2019-06-12,성북구,0.0,0,2,0,2,4
13192,2019-06-12,송파구,0.0,0,7,4,2,13
13193,2019-06-12,양천구,0.0,0,4,0,0,4
13194,2019-06-12,영등포구,0.0,0,6,4,0,10
13195,2019-06-12,용산구,0.0,0,2,0,0,2
13196,2019-06-12,은평구,0.0,0,3,0,0,3
13197,2019-06-12,종로구,0.0,0,3,0,0,3
13198,2019-06-12,중구,0.0,0,0,0,0,0
13199,2019-06-12,중랑구,0.0,0,2,0,1,3
13200,2019-06-13,강남구,0.0,0,14,2,4,20
13201,2019-06-13,강동구,0.0,0,1,2,0,3
13202,2019-06-13,강북구,0.0,0,2,0,0,2
13203,2019-06-13,강서구,0.0,0,3,0,1,4
13204,2019-06-13,관악구,0.0,0,3,0,0,3
13205,2019-06-13,광진구,0.0,0,2,0,0,2
13206,2019-06-13,구로구,0.0,0,2,0,1,3
13207,2019-06-13,금천구,0.0,0,4,0,1,5
13208,2019-06-13,노원구,0.0,0,5,0,1,6
13209,2019-06-13,도봉구,0.0,0,0,0,1,1
13210,2019-06-13,동대문구,0.0,0,1,1,0,2
13211,2019-06-13,동작구,0.0,0,0,0,0,0
13212,2019-06-13,마포구,0.0,0,1,0,0,1
13213,2019-06-13,서대문구,0.0,0,10,0,0,10
13214,2019-06-13,서초구,0.0,0,9,3,0,12
13215,2019-06-13,성동구,0.0,0,9,0,3,12
13216,2019-06-13,성북구,0.0,0,2,1,3,6
13217,2019-06-13,송파구,0.0,0,4,0,3,7
13218,2019-06-13,양천구,0.0,0,2,0,2,4
13219,2019-06-13,영등포구,0.0,0,4,0,1,5
13220,2019-06-13,용산구,0.0,0,2,0,0,2
13221,2019-06-13,은평구,0.0,0,0,0,1,1
13222,2019-06-13,종로구,0.0,0,4,0,0,4
13223,2019-06-13,중구,0.0,0,3,2,3,8
13224,2019-06-13,중랑구,0.0,0,0,1,0,1
13225,2019-06-14,강남구,0.0,0,15,0,1,16
13226,2019-06-14,강동구,0.0,0,5,1,0,6
13227,2019-06-14,강북구,0.0,0,7,0,0,7
13228,2019-06-14,강서구,0.0,0,5,0,1,6
13229,2019-06-14,관악구,0.0,0,7,0,3,10
13230,2019-06-14,광진구,0.0,0,5,0,0,5
13231,2019-06-14,구로구,0.0,1,17,0,3,21
13232,2019-06-14,금천구,0.0,0,3,1,0,4
13233,2019-06-14,노원구,0.0,0,5,3,1,9
13234,2019-06-14,도봉구,0.0,0,0,0,1,1
13235,2019-06-14,동대문구,0.0,0,3,0,0,3
13236,2019-06-14,동작구,0.0,0,5,0,1,6
13237,2019-06-14,마포구,0.0,0,2,1,2,5
13238,2019-06-14,서대문구,0.0,0,3,0,3,6
13239,2019-06-14,서초구,0.0,0,8,0,3,11
13240,2019-06-14,성동구,0.0,1,0,0,0,1
13241,2019-06-14,성북구,0.0,0,6,0,1,7
13242,2019-06-14,송파구,0.0,0,4,1,2,7
13243,2019-06-14,양천구,0.0,0,1,1,1,3
13244,2019-06-14,영등포구,0.0,0,14,2,1,17
13245,2019-06-14,용산구,0.0,0,5,0,0,5
13246,2019-06-14,은평구,0.0,0,3,0,0,3
13247,2019-06-14,종로구,0.0,0,0,0,1,1
13248,2019-06-14,중구,0.0,0,4,0,4,8
13249,2019-06-14,중랑구,0.0,0,1,1,1,3
13250,2019-06-15,강남구,5.5,0,15,5,6,26
13251,2019-06-15,강동구,0.0,0,4,1,2,7
13252,2019-06-15,강북구,1.0,0,6,1,3,10
13253,2019-06-15,강서구,0.0,0,6,0,1,7
13254,2019-06-15,관악구,0.0,0,3,0,0,3
13255,2019-06-15,광진구,4.0,0,2,2,1,5
13256,2019-06-15,구로구,0.0,0,5,0,0,5
13257,2019-06-15,금천구,0.0,0,0,0,0,0
13258,2019-06-15,노원구,0.5,0,3,0,4,7
13259,2019-06-15,도봉구,0.5,0,0,0,5,5
13260,2019-06-15,동대문구,5.0,1,6,0,1,8
13261,2019-06-15,동작구,0.5,0,7,1,4,12
13262,2019-06-15,마포구,2.0,0,2,1,1,4
13263,2019-06-15,서대문구,5.5,0,5,0,1,6
13264,2019-06-15,서초구,2.0,0,10,1,2,13
13265,2019-06-15,성동구,3.0,0,0,0,2,2
13266,2019-06-15,성북구,5.0,0,7,3,0,10
13267,2019-06-15,송파구,2.5,0,10,3,5,18
13268,2019-06-15,양천구,0.0,0,2,0,3,5
13269,2019-06-15,영등포구,1.25,0,9,1,5,15
13270,2019-06-15,용산구,0.5,0,8,0,4,12
13271,2019-06-15,은평구,4.0,0,3,2,2,7
13272,2019-06-15,종로구,2.1,0,7,0,3,10
13273,2019-06-15,중구,0.5,0,1,0,2,3
13274,2019-06-15,중랑구,2.5,0,7,0,0,7
13275,2019-06-16,강남구,0.0,0,9,3,0,12
13276,2019-06-16,강동구,0.0,0,1,0,3,4
13277,2019-06-16,강북구,0.0,0,10,1,1,12
13278,2019-06-16,강서구,0.0,0,1,1,1,3
13279,2019-06-16,관악구,0.0,0,1,1,0,2
13280,2019-06-16,광진구,0.0,0,0,0,0,0
13281,2019-06-16,구로구,0.0,0,3,0,0,3
13282,2019-06-16,금천구,0.0,0,0,0,0,0
13283,2019-06-16,노원구,0.0,0,4,1,2,7
13284,2019-06-16,도봉구,0.0,0,0,0,1,1
13285,2019-06-16,동대문구,0.0,0,2,2,1,5
13286,2019-06-16,동작구,0.0,0,3,5,0,8
13287,2019-06-16,마포구,0.0,0,2,1,2,5
13288,2019-06-16,서대문구,0.0,0,1,0,0,1
13289,2019-06-16,서초구,0.0,0,10,1,5,16
13290,2019-06-16,성동구,0.0,0,8,0,2,10
13291,2019-06-16,성북구,0.0,0,5,0,1,6
13292,2019-06-16,송파구,0.0,0,6,2,1,9
13293,2019-06-16,양천구,0.0,0,0,1,0,1
13294,2019-06-16,영등포구,0.0,0,6,1,1,8
13295,2019-06-16,용산구,0.0,0,6,1,2,9
13296,2019-06-16,은평구,0.0,0,3,1,0,4
13297,2019-06-16,종로구,0.0,0,2,0,1,3
13298,2019-06-16,중구,0.0,0,2,0,0,2
13299,2019-06-16,중랑구,0.0,0,9,3,1,13
13300,2019-06-17,강남구,0.0,0,14,3,4,21
13301,2019-06-17,강동구,0.0,0,1,0,0,1
13302,2019-06-17,강북구,0.0,0,5,0,0,5
13303,2019-06-17,강서구,0.0,0,3,0,2,5
13304,2019-06-17,관악구,0.0,0,3,1,1,5
13305,2019-06-17,광진구,0.0,0,3,0,0,3
13306,2019-06-17,구로구,0.0,0,3,1,0,4
13307,2019-06-17,금천구,0.0,0,4,0,1,5
13308,2019-06-17,노원구,0.0,0,1,0,1,2
13309,2019-06-17,도봉구,0.0,0,5,0,1,6
13310,2019-06-17,동대문구,0.0,0,1,0,2,3
13311,2019-06-17,동작구,0.0,0,4,0,0,4
13312,2019-06-17,마포구,0.0,0,2,0,1,3
13313,2019-06-17,서대문구,0.0,0,2,2,0,4
13314,2019-06-17,서초구,0.0,0,6,0,2,8
13315,2019-06-17,성동구,0.0,0,2,0,1,3
13316,2019-06-17,성북구,0.0,0,6,1,2,9
13317,2019-06-17,송파구,0.0,0,7,2,5,14
13318,2019-06-17,양천구,0.0,0,3,1,1,5
13319,2019-06-17,영등포구,0.0,0,3,3,0,6
13320,2019-06-17,용산구,0.0,0,4,0,0,4
13321,2019-06-17,은평구,0.0,0,5,0,2,7
13322,2019-06-17,종로구,0.0,1,3,0,0,4
13323,2019-06-17,중구,0.0,0,4,0,1,5
13324,2019-06-17,중랑구,0.0,1,7,1,1,10
13325,2019-06-18,강남구,10.0,0,8,0,1,9
13326,2019-06-18,강동구,8.5,0,5,0,2,7
13327,2019-06-18,강북구,14.5,0,6,1,1,8
13328,2019-06-18,강서구,28.0,0,4,0,1,5
13329,2019-06-18,관악구,14.5,0,3,0,3,6
13330,2019-06-18,광진구,10.5,0,2,1,3,6
13331,2019-06-18,구로구,5.5,0,3,1,1,5
13332,2019-06-18,금천구,8.5,0,1,0,0,1
13333,2019-06-18,노원구,17.5,0,4,1,1,6
13334,2019-06-18,도봉구,19.0,0,5,1,0,6
13335,2019-06-18,동대문구,7.5,0,3,0,2,5
13336,2019-06-18,동작구,17.5,0,4,0,1,5
13337,2019-06-18,마포구,10.0,0,10,0,0,10
13338,2019-06-18,서대문구,13.5,0,2,1,1,4
13339,2019-06-18,서초구,17.5,0,10,1,2,13
13340,2019-06-18,성동구,10.0,0,2,0,2,4
13341,2019-06-18,성북구,15.0,0,2,1,1,4
13342,2019-06-18,송파구,8.0,0,6,2,2,10
13343,2019-06-18,양천구,18.5,0,4,0,1,5
13344,2019-06-18,영등포구,25.75,0,14,1,3,18
13345,2019-06-18,용산구,9.0,0,8,0,1,9
13346,2019-06-18,은평구,15.0,0,2,0,0,2
13347,2019-06-18,종로구,13.8,0,2,0,2,4
13348,2019-06-18,중구,11.5,0,1,1,0,2
13349,2019-06-18,중랑구,12.5,0,0,0,0,0
13350,2019-06-19,강남구,0.0,0,13,4,6,23
13351,2019-06-19,강동구,0.0,0,6,0,0,6
13352,2019-06-19,강북구,0.0,0,3,0,0,3
13353,2019-06-19,강서구,0.0,0,12,0,2,14
13354,2019-06-19,관악구,0.5,0,2,0,2,4
13355,2019-06-19,광진구,0.0,0,1,2,0,3
13356,2019-06-19,구로구,0.5,0,4,0,2,6
13357,2019-06-19,금천구,0.0,0,0,0,0,0
13358,2019-06-19,노원구,0.5,0,9,0,2,11
13359,2019-06-19,도봉구,0.0,0,6,0,0,6
13360,2019-06-19,동대문구,0.0,1,1,1,0,3
13361,2019-06-19,동작구,0.5,0,5,0,2,7
13362,2019-06-19,마포구,0.0,0,0,0,1,1
13363,2019-06-19,서대문구,0.0,0,16,8,5,29
13364,2019-06-19,서초구,0.0,0,4,0,0,4
13365,2019-06-19,성동구,0.0,0,5,0,2,7
13366,2019-06-19,성북구,0.5,0,2,2,1,5
13367,2019-06-19,송파구,0.0,0,8,1,3,12
13368,2019-06-19,양천구,0.0,0,5,1,0,6
13369,2019-06-19,영등포구,0.25,0,5,2,2,9
13370,2019-06-19,용산구,0.0,0,1,0,3,4
13371,2019-06-19,은평구,0.0,0,1,3,0,4
13372,2019-06-19,종로구,0.2,0,2,1,2,5
13373,2019-06-19,중구,0.5,0,4,1,1,6
13374,2019-06-19,중랑구,0.0,0,2,1,2,5
13375,2019-06-20,강남구,0.0,0,10,2,1,13
13376,2019-06-20,강동구,0.0,0,8,0,1,9
13377,2019-06-20,강북구,0.0,0,2,1,0,3
13378,2019-06-20,강서구,0.0,0,8,1,3,12
13379,2019-06-20,관악구,0.0,0,3,2,1,6
13380,2019-06-20,광진구,0.0,0,4,0,0,4
13381,2019-06-20,구로구,0.0,0,6,2,2,10
13382,2019-06-20,금천구,0.0,0,1,0,1,2
13383,2019-06-20,노원구,0.0,0,1,0,1,2
13384,2019-06-20,도봉구,0.0,0,3,0,0,3
13385,2019-06-20,동대문구,0.0,0,2,0,1,3
13386,2019-06-20,동작구,0.0,0,7,1,0,8
13387,2019-06-20,마포구,0.0,0,7,1,2,10
13388,2019-06-20,서대문구,0.0,0,0,0,0,0
13389,2019-06-20,서초구,0.0,0,13,0,0,13
13390,2019-06-20,성동구,0.0,0,6,0,1,7
13391,2019-06-20,성북구,0.0,0,2,0,2,4
13392,2019-06-20,송파구,0.0,0,5,1,3,9
13393,2019-06-20,양천구,0.0,0,6,1,2,9
13394,2019-06-20,영등포구,0.0,0,3,0,0,3
13395,2019-06-20,용산구,0.0,0,1,0,0,1
13396,2019-06-20,은평구,0.0,0,3,0,0,3
13397,2019-06-20,종로구,0.0,0,4,1,0,5
13398,2019-06-20,중구,0.0,0,3,0,1,4
13399,2019-06-20,중랑구,0.0,0,6,1,3,10
13400,2019-06-21,강남구,0.0,0,13,0,3,16
13401,2019-06-21,강동구,0.0,0,8,2,0,10
13402,2019-06-21,강북구,0.0,0,3,0,1,4
13403,2019-06-21,강서구,0.0,0,6,1,0,7
13404,2019-06-21,관악구,0.0,0,2,0,0,2
13405,2019-06-21,광진구,0.0,0,5,1,1,7
13406,2019-06-21,구로구,0.0,0,1,1,3,5
13407,2019-06-21,금천구,0.0,0,2,1,1,4
13408,2019-06-21,노원구,2.0,0,6,0,2,8
13409,2019-06-21,도봉구,0.5,0,4,0,1,5
13410,2019-06-21,동대문구,0.0,0,3,3,2,8
13411,2019-06-21,동작구,0.0,0,1,1,1,3
13412,2019-06-21,마포구,2.5,0,4,0,1,5
13413,2019-06-21,서대문구,0.0,0,5,1,0,6
13414,2019-06-21,서초구,0.0,1,7,1,1,10
13415,2019-06-21,성동구,0.0,0,5,1,1,7
13416,2019-06-21,성북구,1.0,0,4,0,2,6
13417,2019-06-21,송파구,0.0,0,6,1,1,8
13418,2019-06-21,양천구,0.0,0,2,1,0,3
13419,2019-06-21,영등포구,0.25,0,13,1,2,16
13420,2019-06-21,용산구,0.0,0,1,2,1,4
13421,2019-06-21,은평구,0.0,0,0,0,0,0
13422,2019-06-21,종로구,0.2,0,4,0,0,4
13423,2019-06-21,중구,0.0,0,2,0,1,3
13424,2019-06-21,중랑구,0.0,0,8,0,1,9
13425,2019-06-22,강남구,0.0,0,26,1,3,30
13426,2019-06-22,강동구,0.0,0,4,2,2,8
13427,2019-06-22,강북구,0.0,0,2,0,3,5
13428,2019-06-22,강서구,0.0,0,4,0,0,4
13429,2019-06-22,관악구,0.0,0,4,0,0,4
13430,2019-06-22,광진구,0.0,0,2,0,1,3
13431,2019-06-22,구로구,0.0,0,4,0,2,6
13432,2019-06-22,금천구,0.0,0,3,0,1,4
13433,2019-06-22,노원구,0.0,0,6,0,1,7
13434,2019-06-22,도봉구,0.0,0,1,1,0,2
13435,2019-06-22,동대문구,0.0,0,4,0,2,6
13436,2019-06-22,동작구,0.0,0,7,0,0,7
13437,2019-06-22,마포구,0.0,0,2,2,2,6
13438,2019-06-22,서대문구,0.0,0,6,0,1,7
13439,2019-06-22,서초구,0.0,0,15,1,1,17
13440,2019-06-22,성동구,0.0,0,0,0,1,1
13441,2019-06-22,성북구,0.0,0,1,0,2,3
13442,2019-06-22,송파구,0.0,0,7,1,6,14
13443,2019-06-22,양천구,0.0,0,7,2,1,10
13444,2019-06-22,영등포구,0.0,0,11,2,2,15
13445,2019-06-22,용산구,0.0,0,7,0,0,7
13446,2019-06-22,은평구,0.0,0,7,0,1,8
13447,2019-06-22,종로구,0.0,0,1,1,1,3
13448,2019-06-22,중구,0.0,0,2,0,1,3
13449,2019-06-22,중랑구,0.0,0,0,0,1,1
13450,2019-06-23,강남구,0.0,0,9,1,2,12
13451,2019-06-23,강동구,1.5,0,11,2,2,15
13452,2019-06-23,강북구,0.0,0,6,0,1,7
13453,2019-06-23,강서구,0.0,0,8,1,0,9
13454,2019-06-23,관악구,0.0,0,2,0,4,6
13455,2019-06-23,광진구,0.5,0,2,0,1,3
13456,2019-06-23,구로구,0.0,0,3,0,0,3
13457,2019-06-23,금천구,0.0,0,0,0,2,2
13458,2019-06-23,노원구,0.0,0,4,0,2,6
13459,2019-06-23,도봉구,0.0,0,5,0,1,6
13460,2019-06-23,동대문구,0.0,0,3,0,2,5
13461,2019-06-23,동작구,0.0,0,0,0,0,0
13462,2019-06-23,마포구,0.0,0,2,1,1,4
13463,2019-06-23,서대문구,0.0,0,6,2,3,11
13464,2019-06-23,서초구,1.0,0,7,2,0,9
13465,2019-06-23,성동구,0.0,0,1,0,3,4
13466,2019-06-23,성북구,0.0,0,2,0,1,3
13467,2019-06-23,송파구,0.0,0,3,1,0,4
13468,2019-06-23,양천구,0.0,0,5,2,2,9
13469,2019-06-23,영등포구,0.0,0,5,0,0,5
13470,2019-06-23,용산구,0.0,0,0,0,0,0
13471,2019-06-23,은평구,0.0,0,0,0,0,0
13472,2019-06-23,종로구,0.0,0,2,0,0,2
13473,2019-06-23,중구,0.0,0,2,0,1,3
13474,2019-06-23,중랑구,0.0,0,3,0,0,3
13475,2019-06-24,강남구,0.0,0,11,0,1,12
13476,2019-06-24,강동구,0.0,0,5,0,0,5
13477,2019-06-24,강북구,0.0,0,3,0,1,4
13478,2019-06-24,강서구,0.0,0,7,2,3,12
13479,2019-06-24,관악구,0.0,0,3,0,1,4
13480,2019-06-24,광진구,0.0,0,3,0,1,4
13481,2019-06-24,구로구,0.0,0,4,1,2,7
13482,2019-06-24,금천구,0.0,0,4,0,1,5
13483,2019-06-24,노원구,0.0,0,2,0,3,5
13484,2019-06-24,도봉구,0.0,0,3,0,0,3
13485,2019-06-24,동대문구,0.0,0,3,2,2,7
13486,2019-06-24,동작구,0.0,0,15,0,6,21
13487,2019-06-24,마포구,0.0,0,7,0,2,9
13488,2019-06-24,서대문구,0.0,0,2,0,0,2
13489,2019-06-24,서초구,0.0,0,4,4,2,10
13490,2019-06-24,성동구,0.0,0,2,0,2,4
13491,2019-06-24,성북구,0.0,0,1,0,0,1
13492,2019-06-24,송파구,0.0,0,2,0,2,4
13493,2019-06-24,양천구,0.0,0,8,2,0,10
13494,2019-06-24,영등포구,0.0,0,8,1,2,11
13495,2019-06-24,용산구,0.0,0,9,0,0,9
13496,2019-06-24,은평구,0.0,0,2,0,1,3
13497,2019-06-24,종로구,0.0,0,1,0,0,1
13498,2019-06-24,중구,0.0,0,3,0,2,5
13499,2019-06-24,중랑구,0.0,0,3,1,1,5
13500,2019-06-25,강남구,0.0,0,9,2,1,12
13501,2019-06-25,강동구,0.0,0,3,0,0,3
13502,2019-06-25,강북구,0.0,1,2,0,0,3
13503,2019-06-25,강서구,0.0,0,4,1,1,6
13504,2019-06-25,관악구,0.0,0,6,0,3,9
13505,2019-06-25,광진구,0.0,0,5,0,0,5
13506,2019-06-25,구로구,0.0,0,2,0,1,3
13507,2019-06-25,금천구,0.0,0,2,1,1,4
13508,2019-06-25,노원구,0.0,0,9,3,3,15
13509,2019-06-25,도봉구,0.0,0,0,0,1,1
13510,2019-06-25,동대문구,0.0,0,1,3,2,6
13511,2019-06-25,동작구,0.0,0,6,3,4,13
13512,2019-06-25,마포구,0.0,0,5,1,1,7
13513,2019-06-25,서대문구,0.0,0,0,1,1,2
13514,2019-06-25,서초구,0.0,0,4,2,3,9
13515,2019-06-25,성동구,0.0,0,10,0,3,13
13516,2019-06-25,성북구,0.0,0,2,0,3,5
13517,2019-06-25,송파구,0.0,0,13,2,0,15
13518,2019-06-25,양천구,0.0,0,2,0,2,4
13519,2019-06-25,영등포구,0.0,0,11,5,1,17
13520,2019-06-25,용산구,0.0,0,3,0,2,5
13521,2019-06-25,은평구,0.0,0,0,1,2,3
13522,2019-06-25,종로구,0.0,0,3,0,3,6
13523,2019-06-25,중구,0.0,0,3,1,2,6
13524,2019-06-25,중랑구,0.0,0,6,1,0,7
13525,2019-06-26,강남구,0.0,0,10,1,4,15
13526,2019-06-26,강동구,0.0,0,5,0,1,6
13527,2019-06-26,강북구,0.0,0,3,0,1,4
13528,2019-06-26,강서구,0.0,0,7,1,0,8
13529,2019-06-26,관악구,0.0,0,2,0,2,4
13530,2019-06-26,광진구,0.0,0,2,1,0,3
13531,2019-06-26,구로구,0.0,0,3,0,1,4
13532,2019-06-26,금천구,0.0,0,1,0,0,1
13533,2019-06-26,노원구,0.0,0,5,0,0,5
13534,2019-06-26,도봉구,0.0,0,0,1,0,1
13535,2019-06-26,동대문구,0.0,1,6,0,2,9
13536,2019-06-26,동작구,0.0,0,3,1,0,4
13537,2019-06-26,마포구,0.0,0,2,0,3,5
13538,2019-06-26,서대문구,0.0,0,3,0,0,3
13539,2019-06-26,서초구,0.0,0,6,0,4,10
13540,2019-06-26,성동구,0.0,0,3,0,1,4
13541,2019-06-26,성북구,0.0,0,3,0,2,5
13542,2019-06-26,송파구,0.0,0,3,1,3,7
13543,2019-06-26,양천구,0.0,0,6,1,2,9
13544,2019-06-26,영등포구,0.0,0,3,0,0,3
13545,2019-06-26,용산구,0.0,0,3,0,0,3
13546,2019-06-26,은평구,0.0,0,0,0,0,0
13547,2019-06-26,종로구,0.0,0,1,0,0,1
13548,2019-06-26,중구,0.0,0,5,0,0,5
13549,2019-06-26,중랑구,0.0,0,3,5,0,8
13550,2019-06-27,강남구,0.0,0,17,1,1,19
13551,2019-06-27,강동구,1.0,0,6,1,1,8
13552,2019-06-27,강북구,0.5,0,6,0,1,7
13553,2019-06-27,강서구,0.0,0,7,0,1,8
13554,2019-06-27,관악구,0.0,0,5,2,3,10
13555,2019-06-27,광진구,0.5,0,1,0,0,1
13556,2019-06-27,구로구,1.0,0,7,3,0,10
13557,2019-06-27,금천구,0.0,0,0,0,0,0
13558,2019-06-27,노원구,1.0,0,2,1,1,4
13559,2019-06-27,도봉구,1.0,0,0,0,2,2
13560,2019-06-27,동대문구,1.0,0,3,0,3,6
13561,2019-06-27,동작구,0.25,0,6,1,2,9
13562,2019-06-27,마포구,1.0,0,3,0,4,7
13563,2019-06-27,서대문구,0.5,0,1,3,1,5
13564,2019-06-27,서초구,0.0,0,11,0,2,13
13565,2019-06-27,성동구,0.5,0,0,0,0,0
13566,2019-06-27,성북구,1.0,0,1,0,0,1
13567,2019-06-27,송파구,0.0,0,9,0,3,12
13568,2019-06-27,양천구,0.5,0,2,0,0,2
13569,2019-06-27,영등포구,0.5,1,5,0,0,6
13570,2019-06-27,용산구,1.0,0,2,0,1,3
13571,2019-06-27,은평구,0.0,0,2,0,1,3
13572,2019-06-27,종로구,1.4,0,2,1,0,3
13573,2019-06-27,중구,2.5,0,4,0,4,8
13574,2019-06-27,중랑구,1.0,0,2,1,0,3
13575,2019-06-28,강남구,0.0,0,15,2,1,18
13576,2019-06-28,강동구,0.0,0,4,3,0,7
13577,2019-06-28,강북구,0.0,0,3,0,1,4
13578,2019-06-28,강서구,0.0,0,7,0,2,9
13579,2019-06-28,관악구,0.75,0,3,1,1,5
13580,2019-06-28,광진구,0.0,0,1,0,0,1
13581,2019-06-28,구로구,1.0,0,5,3,3,11
13582,2019-06-28,금천구,0.0,0,3,0,0,3
13583,2019-06-28,노원구,0.0,0,6,0,0,6
13584,2019-06-28,도봉구,0.0,0,2,0,1,3
13585,2019-06-28,동대문구,0.0,0,1,0,0,1
13586,2019-06-28,동작구,0.5,0,2,0,4,6
13587,2019-06-28,마포구,0.0,0,5,0,0,5
13588,2019-06-28,서대문구,0.0,0,2,1,1,4
13589,2019-06-28,서초구,0.5,0,3,0,2,5
13590,2019-06-28,성동구,0.0,0,5,0,2,7
13591,2019-06-28,성북구,0.0,0,10,0,4,14
13592,2019-06-28,송파구,0.0,0,12,1,1,14
13593,2019-06-28,양천구,0.0,0,3,0,1,4
13594,2019-06-28,영등포구,0.5,0,7,2,5,14
13595,2019-06-28,용산구,0.0,0,2,0,0,2
13596,2019-06-28,은평구,0.0,0,2,4,3,9
13597,2019-06-28,종로구,0.0,0,4,0,1,5
13598,2019-06-28,중구,0.0,0,4,1,2,7
13599,2019-06-28,중랑구,0.0,0,3,1,0,4
13600,2019-06-29,강남구,2.0,0,14,0,1,15
13601,2019-06-29,강동구,1.0,0,4,1,0,5
13602,2019-06-29,강북구,0.5,0,6,0,0,6
13603,2019-06-29,강서구,3.0,0,7,0,1,8
13604,2019-06-29,관악구,2.5,0,6,1,0,7
13605,2019-06-29,광진구,1.0,0,6,0,1,7
13606,2019-06-29,구로구,2.0,0,10,0,2,12
13607,2019-06-29,금천구,2.5,0,5,0,0,5
13608,2019-06-29,노원구,1.0,0,2,1,1,4
13609,2019-06-29,도봉구,1.0,0,10,1,1,12
13610,2019-06-29,동대문구,1.0,0,6,1,0,7
13611,2019-06-29,동작구,4.0,0,10,4,1,15
13612,2019-06-29,마포구,1.0,0,7,1,3,11
13613,2019-06-29,서대문구,1.0,0,1,1,0,2
13614,2019-06-29,서초구,2.5,0,5,0,0,5
13615,2019-06-29,성동구,1.5,0,5,0,1,6
13616,2019-06-29,성북구,1.5,0,8,0,1,9
13617,2019-06-29,송파구,2.0,0,13,1,2,16
13618,2019-06-29,양천구,1.5,0,2,0,0,2
13619,2019-06-29,영등포구,1.25,0,5,1,2,8
13620,2019-06-29,용산구,1.5,0,1,0,0,1
13621,2019-06-29,은평구,2.0,0,1,1,1,3
13622,2019-06-29,종로구,1.5,0,0,0,1,1
13623,2019-06-29,중구,1.5,0,0,0,0,0
13624,2019-06-29,중랑구,1.0,0,4,1,0,5
13625,2019-06-30,강남구,0.0,0,5,1,0,6
13626,2019-06-30,강동구,0.0,0,4,0,0,4
13627,2019-06-30,강북구,0.0,0,3,0,1,4
13628,2019-06-30,강서구,0.0,0,4,0,0,4
13629,2019-06-30,관악구,0.0,0,1,0,1,2
13630,2019-06-30,광진구,0.0,0,1,1,0,2
13631,2019-06-30,구로구,0.0,0,8,0,0,8
13632,2019-06-30,금천구,0.0,0,1,0,0,1
13633,2019-06-30,노원구,0.0,0,3,0,2,5
13634,2019-06-30,도봉구,0.0,0,0,2,2,4
13635,2019-06-30,동대문구,0.0,0,2,2,0,4
13636,2019-06-30,동작구,0.0,0,1,0,0,1
13637,2019-06-30,마포구,0.0,0,7,1,3,11
13638,2019-06-30,서대문구,0.0,0,1,0,1,2
13639,2019-06-30,서초구,0.0,0,4,0,0,4
13640,2019-06-30,성동구,0.0,0,3,0,0,3
13641,2019-06-30,성북구,0.0,0,2,0,0,2
13642,2019-06-30,송파구,0.0,0,6,0,2,8
13643,2019-06-30,양천구,0.0,0,6,1,0,7
13644,2019-06-30,영등포구,0.0,0,2,0,1,3
13645,2019-06-30,용산구,0.0,0,2,0,1,3
13646,2019-06-30,은평구,0.0,0,0,1,1,2
13647,2019-06-30,종로구,0.0,0,1,0,0,1
13648,2019-06-30,중구,0.0,0,1,2,1,4
13649,2019-06-30,중랑구,0.0,1,1,3,2,7
13650,2019-07-01,강남구,0.0,0,10,0,1,11
13651,2019-07-01,강동구,0.0,0,2,0,2,4
13652,2019-07-01,강북구,0.0,0,4,0,1,5
13653,2019-07-01,강서구,0.0,0,2,0,0,2
13654,2019-07-01,관악구,0.0,0,2,0,2,4
13655,2019-07-01,광진구,0.0,0,3,0,2,5
13656,2019-07-01,구로구,0.0,0,0,0,0,0
13657,2019-07-01,금천구,0.0,0,3,0,1,4
13658,2019-07-01,노원구,0.0,0,5,0,1,6
13659,2019-07-01,도봉구,0.0,0,3,0,3,6
13660,2019-07-01,동대문구,0.0,0,9,1,0,10
13661,2019-07-01,동작구,0.0,0,7,1,1,9
13662,2019-07-01,마포구,0.0,0,6,0,3,9
13663,2019-07-01,서대문구,0.0,0,1,3,2,6
13664,2019-07-01,서초구,0.0,0,3,0,0,3
13665,2019-07-01,성동구,0.0,0,3,0,0,3
13666,2019-07-01,성북구,0.0,0,4,0,2,6
13667,2019-07-01,송파구,0.0,0,4,1,1,6
13668,2019-07-01,양천구,0.0,0,4,0,2,6
13669,2019-07-01,영등포구,0.0,0,9,0,0,9
13670,2019-07-01,용산구,0.0,0,2,0,0,2
13671,2019-07-01,은평구,0.0,0,4,3,1,8
13672,2019-07-01,종로구,0.0,0,4,2,1,7
13673,2019-07-01,중구,0.0,0,5,0,2,7
13674,2019-07-01,중랑구,0.0,0,7,0,1,8
13675,2019-07-02,강남구,0.0,0,15,1,1,17
13676,2019-07-02,강동구,0.0,0,4,0,2,6
13677,2019-07-02,강북구,0.0,0,1,0,0,1
13678,2019-07-02,강서구,0.0,0,1,0,0,1
13679,2019-07-02,관악구,0.0,0,3,0,0,3
13680,2019-07-02,광진구,0.0,0,5,0,1,6
13681,2019-07-02,구로구,0.0,0,5,0,1,6
13682,2019-07-02,금천구,0.0,0,3,1,1,5
13683,2019-07-02,노원구,0.0,0,6,1,2,9
13684,2019-07-02,도봉구,0.0,0,0,0,0,0
13685,2019-07-02,동대문구,0.0,0,7,0,1,8
13686,2019-07-02,동작구,0.0,0,0,0,1,1
13687,2019-07-02,마포구,0.0,0,2,0,4,6
13688,2019-07-02,서대문구,0.0,0,4,0,1,5
13689,2019-07-02,서초구,0.0,0,3,0,4,7
13690,2019-07-02,성동구,0.0,0,4,0,1,5
13691,2019-07-02,성북구,0.0,0,3,0,1,4
13692,2019-07-02,송파구,0.0,0,8,1,5,14
13693,2019-07-02,양천구,0.0,0,2,1,1,4
13694,2019-07-02,영등포구,0.0,0,2,0,1,3
13695,2019-07-02,용산구,0.0,0,1,0,0,1
13696,2019-07-02,은평구,0.0,0,1,1,1,3
13697,2019-07-02,종로구,0.0,0,0,0,1,1
13698,2019-07-02,중구,0.0,0,5,0,0,5
13699,2019-07-02,중랑구,0.0,0,7,1,3,11
13700,2019-07-03,강남구,0.0,0,12,2,2,16
13701,2019-07-03,강동구,0.0,0,6,0,1,7
13702,2019-07-03,강북구,0.0,0,1,0,2,3
13703,2019-07-03,강서구,0.0,0,14,2,3,19
13704,2019-07-03,관악구,0.0,0,2,0,0,2
13705,2019-07-03,광진구,0.0,0,1,0,3,4
13706,2019-07-03,구로구,0.0,0,6,0,0,6
13707,2019-07-03,금천구,0.0,0,2,1,0,3
13708,2019-07-03,노원구,0.0,0,4,0,4,8
13709,2019-07-03,도봉구,0.0,0,1,3,0,4
13710,2019-07-03,동대문구,0.0,0,4,0,1,5
13711,2019-07-03,동작구,0.0,0,0,2,1,3
13712,2019-07-03,마포구,0.0,0,4,2,0,6
13713,2019-07-03,서대문구,0.0,0,4,0,2,6
13714,2019-07-03,서초구,0.0,0,5,0,1,6
13715,2019-07-03,성동구,0.0,0,0,0,1,1
13716,2019-07-03,성북구,0.0,0,2,0,0,2
13717,2019-07-03,송파구,0.0,0,5,2,4,11
13718,2019-07-03,양천구,0.0,0,0,0,0,0
13719,2019-07-03,영등포구,0.0,0,6,0,0,6
13720,2019-07-03,용산구,0.0,0,2,0,0,2
13721,2019-07-03,은평구,0.0,0,2,1,2,5
13722,2019-07-03,종로구,0.0,0,1,0,3,4
13723,2019-07-03,중구,0.0,0,6,1,1,8
13724,2019-07-03,중랑구,0.0,0,6,0,1,7
13725,2019-07-04,강남구,0.0,0,16,3,0,19
13726,2019-07-04,강동구,0.0,0,1,1,0,2
13727,2019-07-04,강북구,0.0,0,4,0,2,6
13728,2019-07-04,강서구,0.0,0,4,2,1,7
13729,2019-07-04,관악구,0.0,0,8,0,1,9
13730,2019-07-04,광진구,0.0,0,2,1,0,3
13731,2019-07-04,구로구,0.0,0,4,1,4,9
13732,2019-07-04,금천구,0.0,0,2,0,0,2
13733,2019-07-04,노원구,0.0,0,3,2,0,5
13734,2019-07-04,도봉구,0.0,0,0,1,0,1
13735,2019-07-04,동대문구,0.0,0,4,0,0,4
13736,2019-07-04,동작구,0.0,0,4,0,0,4
13737,2019-07-04,마포구,0.0,0,11,0,3,14
13738,2019-07-04,서대문구,0.0,0,1,1,0,2
13739,2019-07-04,서초구,0.0,0,4,2,4,10
13740,2019-07-04,성동구,0.0,0,3,0,0,3
13741,2019-07-04,성북구,0.0,0,6,1,2,9
13742,2019-07-04,송파구,0.0,0,9,1,1,11
13743,2019-07-04,양천구,0.0,0,5,1,0,6
13744,2019-07-04,영등포구,0.0,0,4,1,0,5
13745,2019-07-04,용산구,0.0,0,2,1,1,4
13746,2019-07-04,은평구,0.0,0,1,0,0,1
13747,2019-07-04,종로구,0.0,0,5,0,0,5
13748,2019-07-04,중구,0.0,0,1,0,1,2
13749,2019-07-04,중랑구,0.0,0,10,0,3,13
13750,2019-07-05,강남구,0.0,0,19,0,0,19
13751,2019-07-05,강동구,0.5,0,4,0,2,6
13752,2019-07-05,강북구,0.5,0,0,0,2,2
13753,2019-07-05,강서구,0.0,0,12,1,2,15
13754,2019-07-05,관악구,0.0,0,4,0,1,5
13755,2019-07-05,광진구,0.0,1,3,1,1,6
13756,2019-07-05,구로구,0.0,0,5,0,0,5
13757,2019-07-05,금천구,0.0,0,3,0,0,3
13758,2019-07-05,노원구,0.0,0,0,1,1,2
13759,2019-07-05,도봉구,0.0,0,4,0,0,4
13760,2019-07-05,동대문구,0.0,0,7,0,2,9
13761,2019-07-05,동작구,0.0,0,5,1,2,8
13762,2019-07-05,마포구,0.0,0,8,0,3,11
13763,2019-07-05,서대문구,0.0,0,1,1,1,3
13764,2019-07-05,서초구,0.0,0,10,1,0,11
13765,2019-07-05,성동구,0.0,0,5,1,2,8
13766,2019-07-05,성북구,1.0,0,3,0,2,5
13767,2019-07-05,송파구,0.0,0,7,0,1,8
13768,2019-07-05,양천구,0.0,0,2,1,1,4
13769,2019-07-05,영등포구,0.0,0,7,0,3,10
13770,2019-07-05,용산구,0.0,0,4,1,0,5
13771,2019-07-05,은평구,0.0,0,2,0,0,2
13772,2019-07-05,종로구,0.0,0,0,0,0,0
13773,2019-07-05,중구,0.0,0,0,1,0,1
13774,2019-07-05,중랑구,1.5,0,3,0,1,4
13775,2019-07-06,강남구,0.0,0,11,0,1,12
13776,2019-07-06,강동구,0.0,0,3,0,1,4
13777,2019-07-06,강북구,0.0,0,4,1,0,5
13778,2019-07-06,강서구,0.0,0,3,0,0,3
13779,2019-07-06,관악구,0.0,0,2,1,0,3
13780,2019-07-06,광진구,0.0,0,5,0,0,5
13781,2019-07-06,구로구,0.0,0,2,0,1,3
13782,2019-07-06,금천구,0.0,0,4,0,1,5
13783,2019-07-06,노원구,0.0,0,14,0,1,15
13784,2019-07-06,도봉구,0.0,0,3,0,0,3
13785,2019-07-06,동대문구,0.0,0,7,0,1,8
13786,2019-07-06,동작구,0.0,0,2,0,1,3
13787,2019-07-06,마포구,0.0,0,7,1,1,9
13788,2019-07-06,서대문구,0.0,0,4,1,1,6
13789,2019-07-06,서초구,0.0,0,11,1,1,13
13790,2019-07-06,성동구,0.0,0,2,0,2,4
13791,2019-07-06,성북구,0.0,0,2,0,1,3
13792,2019-07-06,송파구,0.0,0,5,0,1,6
13793,2019-07-06,양천구,0.0,0,7,1,1,9
13794,2019-07-06,영등포구,0.0,0,14,4,0,18
13795,2019-07-06,용산구,0.0,0,1,0,2,3
13796,2019-07-06,은평구,0.0,0,0,4,1,5
13797,2019-07-06,종로구,0.0,0,3,3,1,7
13798,2019-07-06,중구,0.0,0,2,1,1,4
13799,2019-07-06,중랑구,0.0,0,3,0,0,3
13800,2019-07-07,강남구,0.0,0,7,1,1,9
13801,2019-07-07,강동구,0.0,0,1,6,2,9
13802,2019-07-07,강북구,0.0,0,1,0,0,1
13803,2019-07-07,강서구,0.0,0,0,0,2,2
13804,2019-07-07,관악구,0.0,0,1,0,2,3
13805,2019-07-07,광진구,0.0,0,1,0,2,3
13806,2019-07-07,구로구,0.0,0,1,1,0,2
13807,2019-07-07,금천구,0.0,0,1,0,0,1
13808,2019-07-07,노원구,0.0,0,7,2,2,11
13809,2019-07-07,도봉구,0.0,0,3,0,2,5
13810,2019-07-07,동대문구,0.0,0,6,0,0,6
13811,2019-07-07,동작구,0.0,0,2,1,0,3
13812,2019-07-07,마포구,0.0,0,8,1,5,14
13813,2019-07-07,서대문구,0.0,0,1,0,2,3
13814,2019-07-07,서초구,0.0,0,5,2,4,11
13815,2019-07-07,성동구,0.0,0,1,0,1,2
13816,2019-07-07,성북구,0.0,0,0,0,0,0
13817,2019-07-07,송파구,0.0,0,7,1,1,9
13818,2019-07-07,양천구,0.0,0,3,1,0,4
13819,2019-07-07,영등포구,0.0,0,7,0,3,10
13820,2019-07-07,용산구,0.0,0,1,0,0,1
13821,2019-07-07,은평구,0.0,0,1,0,0,1
13822,2019-07-07,종로구,0.0,0,2,0,0,2
13823,2019-07-07,중구,0.0,0,4,1,1,6
13824,2019-07-07,중랑구,0.0,0,5,1,3,9
13825,2019-07-08,강남구,0.0,0,19,1,2,22
13826,2019-07-08,강동구,0.0,0,5,1,3,9
13827,2019-07-08,강북구,0.0,0,1,0,1,2
13828,2019-07-08,강서구,0.0,0,3,0,1,4
13829,2019-07-08,관악구,0.0,0,12,0,0,12
13830,2019-07-08,광진구,0.0,0,4,0,1,5
13831,2019-07-08,구로구,0.0,0,2,0,1,3
13832,2019-07-08,금천구,0.0,0,2,0,3,5
13833,2019-07-08,노원구,0.0,0,5,0,3,8
13834,2019-07-08,도봉구,0.0,0,0,1,0,1
13835,2019-07-08,동대문구,0.0,0,6,0,2,8
13836,2019-07-08,동작구,0.0,0,6,1,1,8
13837,2019-07-08,마포구,0.0,0,1,2,0,3
13838,2019-07-08,서대문구,0.0,0,0,0,1,1
13839,2019-07-08,서초구,0.0,0,15,2,1,18
13840,2019-07-08,성동구,0.0,0,1,0,0,1
13841,2019-07-08,성북구,0.0,0,5,0,1,6
13842,2019-07-08,송파구,0.0,0,5,4,2,11
13843,2019-07-08,양천구,0.0,0,1,2,0,3
13844,2019-07-08,영등포구,0.0,0,8,1,1,10
13845,2019-07-08,용산구,0.0,0,6,1,0,7
13846,2019-07-08,은평구,0.0,0,3,0,0,3
13847,2019-07-08,종로구,0.0,0,2,0,3,5
13848,2019-07-08,중구,0.0,0,5,2,1,8
13849,2019-07-08,중랑구,0.0,0,0,0,0,0
13850,2019-07-09,강남구,0.0,0,5,1,1,7
13851,2019-07-09,강동구,0.0,1,10,0,3,14
13852,2019-07-09,강북구,0.0,0,2,0,1,3
13853,2019-07-09,강서구,0.0,0,7,1,1,9
13854,2019-07-09,관악구,0.0,0,3,0,1,4
13855,2019-07-09,광진구,0.0,0,0,0,0,0
13856,2019-07-09,구로구,0.0,0,2,0,0,2
13857,2019-07-09,금천구,0.0,0,2,0,1,3
13858,2019-07-09,노원구,0.0,0,1,3,2,6
13859,2019-07-09,도봉구,0.0,0,1,1,1,3
13860,2019-07-09,동대문구,0.0,0,4,1,2,7
13861,2019-07-09,동작구,0.0,0,5,1,1,7
13862,2019-07-09,마포구,0.0,0,10,0,0,10
13863,2019-07-09,서대문구,0.0,0,2,0,1,3
13864,2019-07-09,서초구,0.0,0,9,1,2,12
13865,2019-07-09,성동구,0.0,0,3,0,0,3
13866,2019-07-09,성북구,0.0,0,4,0,0,4
13867,2019-07-09,송파구,0.0,0,10,1,2,13
13868,2019-07-09,양천구,0.0,0,2,0,1,3
13869,2019-07-09,영등포구,0.0,0,5,0,1,6
13870,2019-07-09,용산구,0.0,0,1,0,0,1
13871,2019-07-09,은평구,0.0,0,3,1,1,5
13872,2019-07-09,종로구,0.0,0,3,0,1,4
13873,2019-07-09,중구,0.0,0,4,0,2,6
13874,2019-07-09,중랑구,0.0,0,2,1,1,4
13875,2019-07-10,강남구,15.0,0,15,0,0,15
13876,2019-07-10,강동구,12.5,0,5,0,1,6
13877,2019-07-10,강북구,8.0,0,1,0,0,1
13878,2019-07-10,강서구,5.5,0,8,1,1,10
13879,2019-07-10,관악구,13.25,0,3,1,2,6
13880,2019-07-10,광진구,13.5,0,1,0,0,1
13881,2019-07-10,구로구,6.5,0,6,0,1,7
13882,2019-07-10,금천구,8.0,0,4,0,2,6
13883,2019-07-10,노원구,11.5,0,2,0,1,3
13884,2019-07-10,도봉구,8.5,0,0,0,0,0
13885,2019-07-10,동대문구,11.0,0,2,0,0,2
13886,2019-07-10,동작구,9.25,0,17,1,5,23
13887,2019-07-10,마포구,7.0,0,2,1,0,3
13888,2019-07-10,서대문구,7.0,0,3,3,1,7
13889,2019-07-10,서초구,12.5,0,8,0,1,9
13890,2019-07-10,성동구,11.0,0,2,0,0,2
13891,2019-07-10,성북구,7.5,0,3,0,0,3
13892,2019-07-10,송파구,13.0,0,15,1,3,19
13893,2019-07-10,양천구,6.5,0,5,0,2,7
13894,2019-07-10,영등포구,6.25,0,4,2,3,9
13895,2019-07-10,용산구,0.0,0,6,0,3,9
13896,2019-07-10,은평구,5.0,0,1,0,1,2
13897,2019-07-10,종로구,8.5,0,4,1,1,6
13898,2019-07-10,중구,5.0,0,4,0,3,7
13899,2019-07-10,중랑구,12.5,0,3,1,0,4
13900,2019-07-11,강남구,5.0,0,16,0,4,20
13901,2019-07-11,강동구,3.0,0,4,0,0,4
13902,2019-07-11,강북구,1.5,0,5,0,3,8
13903,2019-07-11,강서구,1.0,0,5,0,2,7
13904,2019-07-11,관악구,6.25,0,3,0,2,5
13905,2019-07-11,광진구,6.0,0,1,0,0,1
13906,2019-07-11,구로구,0.5,0,10,0,0,10
13907,2019-07-11,금천구,3.0,0,6,0,1,7
13908,2019-07-11,노원구,2.5,0,2,1,2,5
13909,2019-07-11,도봉구,2.0,0,5,0,0,5
13910,2019-07-11,동대문구,2.0,0,6,0,2,8
13911,2019-07-11,동작구,3.5,0,2,0,0,2
13912,2019-07-11,마포구,2.5,0,4,1,6,11
13913,2019-07-11,서대문구,2.5,0,7,0,1,8
13914,2019-07-11,서초구,5.0,0,4,2,5,11
13915,2019-07-11,성동구,2.5,0,8,1,0,9
13916,2019-07-11,성북구,2.5,0,2,0,0,2
13917,2019-07-11,송파구,3.5,0,3,0,2,5
13918,2019-07-11,양천구,1.5,0,11,0,3,14
13919,2019-07-11,영등포구,2.25,0,5,0,1,6
13920,2019-07-11,용산구,2.5,0,0,0,0,0
13921,2019-07-11,은평구,4.0,0,1,1,0,2
13922,2019-07-11,종로구,2.9,0,2,0,3,5
13923,2019-07-11,중구,1.0,0,7,1,1,9
13924,2019-07-11,중랑구,3.5,0,5,1,0,6
13925,2019-07-12,강남구,0.0,0,13,4,1,18
13926,2019-07-12,강동구,0.0,0,6,0,0,6
13927,2019-07-12,강북구,0.0,0,2,0,1,3
13928,2019-07-12,강서구,0.0,0,4,0,2,6
13929,2019-07-12,관악구,0.0,0,5,2,0,7
13930,2019-07-12,광진구,0.0,0,3,0,2,5
13931,2019-07-12,구로구,0.0,0,2,0,1,3
13932,2019-07-12,금천구,0.0,0,3,0,0,3
13933,2019-07-12,노원구,0.0,0,4,1,1,6
13934,2019-07-12,도봉구,0.0,0,3,0,2,5
13935,2019-07-12,동대문구,0.0,0,4,0,0,4
13936,2019-07-12,동작구,0.0,0,1,0,1,2
13937,2019-07-12,마포구,0.0,0,4,0,0,4
13938,2019-07-12,서대문구,0.0,0,2,0,1,3
13939,2019-07-12,서초구,0.0,0,8,1,4,13
13940,2019-07-12,성동구,0.0,0,2,0,0,2
13941,2019-07-12,성북구,0.0,0,3,0,3,6
13942,2019-07-12,송파구,0.0,0,12,1,6,19
13943,2019-07-12,양천구,0.0,0,7,0,1,8
13944,2019-07-12,영등포구,0.0,0,14,2,2,18
13945,2019-07-12,용산구,0.0,0,3,2,1,6
13946,2019-07-12,은평구,0.0,0,2,0,1,3
13947,2019-07-12,종로구,0.0,0,1,0,1,2
13948,2019-07-12,중구,0.0,0,3,0,0,3
13949,2019-07-12,중랑구,0.0,0,3,0,3,6
13950,2019-07-13,강남구,0.0,0,4,0,3,7
13951,2019-07-13,강동구,0.0,0,6,0,0,6
13952,2019-07-13,강북구,0.0,0,2,0,0,2
13953,2019-07-13,강서구,0.0,0,4,1,2,7
13954,2019-07-13,관악구,0.0,0,0,0,1,1
13955,2019-07-13,광진구,0.0,0,6,0,1,7
13956,2019-07-13,구로구,0.0,0,7,1,0,8
13957,2019-07-13,금천구,0.5,0,3,0,2,5
13958,2019-07-13,노원구,0.0,0,4,0,1,5
13959,2019-07-13,도봉구,0.0,0,0,0,0,0
13960,2019-07-13,동대문구,0.0,0,5,0,0,5
13961,2019-07-13,동작구,0.0,0,1,0,0,1
13962,2019-07-13,마포구,0.0,0,0,0,3,3
13963,2019-07-13,서대문구,0.0,0,3,0,0,3
13964,2019-07-13,서초구,0.0,0,17,1,2,20
13965,2019-07-13,성동구,0.0,0,2,0,2,4
13966,2019-07-13,성북구,0.0,0,4,0,0,4
13967,2019-07-13,송파구,0.0,0,8,1,2,11
13968,2019-07-13,양천구,0.0,0,4,1,2,7
13969,2019-07-13,영등포구,0.0,0,5,0,2,7
13970,2019-07-13,용산구,0.0,0,2,0,1,3
13971,2019-07-13,은평구,0.0,0,2,0,1,3
13972,2019-07-13,종로구,0.0,0,4,1,0,5
13973,2019-07-13,중구,0.0,0,0,0,0,0
13974,2019-07-13,중랑구,0.0,1,0,0,1,2
13975,2019-07-14,강남구,0.0,0,12,4,0,16
13976,2019-07-14,강동구,0.0,0,2,0,0,2
13977,2019-07-14,강북구,0.0,0,1,0,2,3
13978,2019-07-14,강서구,0.0,0,4,0,1,5
13979,2019-07-14,관악구,0.0,0,5,0,2,7
13980,2019-07-14,광진구,0.0,0,0,0,0,0
13981,2019-07-14,구로구,0.0,0,1,0,1,2
13982,2019-07-14,금천구,0.0,0,3,0,0,3
13983,2019-07-14,노원구,16.0,0,3,0,2,5
13984,2019-07-14,도봉구,4.5,0,1,2,2,5
13985,2019-07-14,동대문구,0.0,0,0,0,0,0
13986,2019-07-14,동작구,0.0,0,2,0,1,3
13987,2019-07-14,마포구,0.0,0,8,3,0,11
13988,2019-07-14,서대문구,0.0,0,3,1,0,4
13989,2019-07-14,서초구,0.0,0,4,1,0,5
13990,2019-07-14,성동구,0.0,0,2,0,0,2
13991,2019-07-14,성북구,0.0,0,0,0,0,0
13992,2019-07-14,송파구,0.0,0,7,1,0,8
13993,2019-07-14,양천구,0.0,0,3,0,1,4
13994,2019-07-14,영등포구,0.0,0,3,2,2,7
13995,2019-07-14,용산구,0.0,0,5,0,0,5
13996,2019-07-14,은평구,0.0,0,1,0,0,1
13997,2019-07-14,종로구,0.0,0,2,0,0,2
13998,2019-07-14,중구,0.0,0,0,0,0,0
13999,2019-07-14,중랑구,0.0,0,4,2,4,10
14000,2019-07-15,강남구,26.5,0,10,1,5,16
14001,2019-07-15,강동구,19.5,0,4,0,2,6
14002,2019-07-15,강북구,57.5,0,3,0,2,5
14003,2019-07-15,강서구,9.0,0,4,0,1,5
14004,2019-07-15,관악구,4.0,0,3,0,1,4
14005,2019-07-15,광진구,29.5,0,1,1,0,2
14006,2019-07-15,구로구,35.5,0,2,0,0,2
14007,2019-07-15,금천구,12.5,0,3,0,2,5
14008,2019-07-15,노원구,34.0,0,2,0,0,2
14009,2019-07-15,도봉구,57.5,0,6,0,1,7
14010,2019-07-15,동대문구,31.5,0,3,0,0,3
14011,2019-07-15,동작구,9.75,0,3,1,1,5
14012,2019-07-15,마포구,1.5,0,5,2,2,9
14013,2019-07-15,서대문구,11.0,0,4,1,1,6
14014,2019-07-15,서초구,2.5,0,5,0,0,5
14015,2019-07-15,성동구,41.5,0,6,0,1,7
14016,2019-07-15,성북구,38.0,0,6,0,1,7
14017,2019-07-15,송파구,23.5,0,2,0,1,3
14018,2019-07-15,양천구,27.0,0,8,0,0,8
14019,2019-07-15,영등포구,22.5,0,5,0,0,5
14020,2019-07-15,용산구,6.0,0,5,0,0,5
14021,2019-07-15,은평구,10.5,0,2,0,0,2
14022,2019-07-15,종로구,7.7,0,3,0,0,3
14023,2019-07-15,중구,2.0,0,1,0,2,3
14024,2019-07-15,중랑구,51.5,0,3,0,1,4
14025,2019-07-16,강남구,0.5,0,12,0,1,13
14026,2019-07-16,강동구,6.5,0,5,2,1,8
14027,2019-07-16,강북구,7.5,0,3,0,3,6
14028,2019-07-16,강서구,6.0,0,6,0,0,6
14029,2019-07-16,관악구,1.0,0,6,0,2,8
14030,2019-07-16,광진구,1.0,0,0,0,0,0
14031,2019-07-16,구로구,0.0,0,2,0,3,5
14032,2019-07-16,금천구,4.5,0,1,0,1,2
14033,2019-07-16,노원구,54.5,0,2,1,0,3
14034,2019-07-16,도봉구,2.5,0,1,0,1,2
14035,2019-07-16,동대문구,38.0,0,0,0,2,2
14036,2019-07-16,동작구,0.25,0,1,1,1,3
14037,2019-07-16,마포구,0.0,0,3,0,1,4
14038,2019-07-16,서대문구,5.5,0,1,0,0,1
14039,2019-07-16,서초구,1.0,0,5,2,2,9
14040,2019-07-16,성동구,15.5,0,7,0,0,7
14041,2019-07-16,성북구,8.5,0,1,0,2,3
14042,2019-07-16,송파구,0.0,0,7,0,0,7
14043,2019-07-16,양천구,0.0,0,6,1,0,7
14044,2019-07-16,영등포구,0.25,0,0,0,0,0
14045,2019-07-16,용산구,0.0,0,4,0,1,5
14046,2019-07-16,은평구,10.5,0,3,0,1,4
14047,2019-07-16,종로구,6.3,0,1,0,0,1
14048,2019-07-16,중구,8.0,0,5,1,0,6
14049,2019-07-16,중랑구,45.5,0,10,0,1,11
14050,2019-07-17,강남구,0.0,0,11,2,1,14
14051,2019-07-17,강동구,0.0,0,2,1,2,5
14052,2019-07-17,강북구,0.0,0,1,1,0,2
14053,2019-07-17,강서구,0.0,0,4,0,0,4
14054,2019-07-17,관악구,0.0,0,7,0,0,7
14055,2019-07-17,광진구,0.0,0,2,0,1,3
14056,2019-07-17,구로구,0.0,0,3,1,3,7
14057,2019-07-17,금천구,0.0,0,1,0,2,3
14058,2019-07-17,노원구,5.0,0,5,0,1,6
14059,2019-07-17,도봉구,2.0,0,2,0,0,2
14060,2019-07-17,동대문구,0.0,0,5,0,2,7
14061,2019-07-17,동작구,0.0,0,7,0,1,8
14062,2019-07-17,마포구,0.0,0,1,2,0,3
14063,2019-07-17,서대문구,0.0,0,1,0,2,3
14064,2019-07-17,서초구,0.0,0,7,1,0,8
14065,2019-07-17,성동구,0.0,0,3,0,1,4
14066,2019-07-17,성북구,0.5,0,5,0,1,6
14067,2019-07-17,송파구,0.0,0,4,2,2,8
14068,2019-07-17,양천구,0.5,0,7,0,1,8
14069,2019-07-17,영등포구,0.25,0,7,3,2,12
14070,2019-07-17,용산구,0.0,0,4,0,1,5
14071,2019-07-17,은평구,0.0,0,2,0,1,3
14072,2019-07-17,종로구,0.7,0,3,0,0,3
14073,2019-07-17,중구,0.0,0,2,1,0,3
14074,2019-07-17,중랑구,2.0,0,0,1,1,2
14075,2019-07-18,강남구,9.5,0,7,1,2,10
14076,2019-07-18,강동구,0.0,0,2,3,1,6
14077,2019-07-18,강북구,0.0,0,0,1,1,2
14078,2019-07-18,강서구,0.0,0,1,1,2,4
14079,2019-07-18,관악구,10.5,0,4,0,1,5
14080,2019-07-18,광진구,0.5,0,1,0,0,1
14081,2019-07-18,구로구,0.0,0,2,0,1,3
14082,2019-07-18,금천구,0.0,0,0,0,1,1
14083,2019-07-18,노원구,0.0,0,3,0,1,4
14084,2019-07-18,도봉구,0.0,0,0,0,0,0
14085,2019-07-18,동대문구,0.0,0,3,0,0,3
14086,2019-07-18,동작구,0.0,0,1,0,1,2
14087,2019-07-18,마포구,0.0,0,7,1,0,8
14088,2019-07-18,서대문구,0.0,0,2,1,0,3
14089,2019-07-18,서초구,7.5,0,8,2,4,14
14090,2019-07-18,성동구,0.0,0,5,0,0,5
14091,2019-07-18,성북구,0.0,0,4,0,2,6
14092,2019-07-18,송파구,1.5,0,9,1,0,10
14093,2019-07-18,양천구,0.0,0,3,1,0,4
14094,2019-07-18,영등포구,0.0,0,2,0,0,2
14095,2019-07-18,용산구,0.0,0,3,0,0,3
14096,2019-07-18,은평구,0.0,0,0,0,2,2
14097,2019-07-18,종로구,0.0,0,4,0,0,4
14098,2019-07-18,중구,0.0,0,3,0,0,3
14099,2019-07-18,중랑구,1.0,0,3,0,1,4
14100,2019-07-19,강남구,0.5,0,7,1,2,10
14101,2019-07-19,강동구,0.0,0,2,0,0,2
14102,2019-07-19,강북구,0.0,0,2,1,0,3
14103,2019-07-19,강서구,0.0,0,4,0,2,6
14104,2019-07-19,관악구,0.0,0,2,0,1,3
14105,2019-07-19,광진구,0.0,0,0,1,0,1
14106,2019-07-19,구로구,0.0,0,2,0,1,3
14107,2019-07-19,금천구,0.0,0,1,1,0,2
14108,2019-07-19,노원구,0.0,0,10,1,1,12
14109,2019-07-19,도봉구,0.0,0,1,1,1,3
14110,2019-07-19,동대문구,0.0,0,8,0,2,10
14111,2019-07-19,동작구,0.0,0,4,1,1,6
14112,2019-07-19,마포구,0.0,0,6,3,1,10
14113,2019-07-19,서대문구,0.0,0,4,1,2,7
14114,2019-07-19,서초구,0.0,0,4,1,0,5
14115,2019-07-19,성동구,0.0,0,11,0,1,12
14116,2019-07-19,성북구,0.0,0,14,0,1,15
14117,2019-07-19,송파구,0.0,1,17,3,1,22
14118,2019-07-19,양천구,0.0,0,1,1,1,3
14119,2019-07-19,영등포구,0.0,0,6,2,3,11
14120,2019-07-19,용산구,0.0,0,1,1,1,3
14121,2019-07-19,은평구,0.0,0,1,0,0,1
14122,2019-07-19,종로구,0.0,0,2,1,0,3
14123,2019-07-19,중구,0.0,0,1,0,2,3
14124,2019-07-19,중랑구,0.0,0,4,1,1,6
14125,2019-07-20,강남구,1.0,0,2,0,1,3
14126,2019-07-20,강동구,2.0,0,5,1,0,6
14127,2019-07-20,강북구,0.5,0,4,0,4,8
14128,2019-07-20,강서구,0.0,0,6,0,0,6
14129,2019-07-20,관악구,0.75,0,10,0,4,14
14130,2019-07-20,광진구,0.0,0,1,0,0,1
14131,2019-07-20,구로구,1.5,0,1,0,1,2
14132,2019-07-20,금천구,2.0,0,5,0,0,5
14133,2019-07-20,노원구,0.0,0,6,1,1,8
14134,2019-07-20,도봉구,0.0,0,1,0,2,3
14135,2019-07-20,동대문구,3.0,0,3,0,1,4
14136,2019-07-20,동작구,0.0,0,1,0,2,3
14137,2019-07-20,마포구,0.0,0,2,0,1,3
14138,2019-07-20,서대문구,0.5,0,3,0,0,3
14139,2019-07-20,서초구,1.0,0,9,1,2,12
14140,2019-07-20,성동구,0.0,0,0,0,0,0
14141,2019-07-20,성북구,2.5,0,7,0,3,10
14142,2019-07-20,송파구,0.0,0,5,0,2,7
14143,2019-07-20,양천구,0.0,0,5,0,0,5
14144,2019-07-20,영등포구,0.0,1,14,4,6,25
14145,2019-07-20,용산구,0.5,0,2,0,0,2
14146,2019-07-20,은평구,1.0,0,1,0,0,1
14147,2019-07-20,종로구,1.1,0,2,0,1,3
14148,2019-07-20,중구,0.5,0,3,0,0,3
14149,2019-07-20,중랑구,1.5,0,2,0,0,2
14150,2019-07-21,강남구,8.0,0,18,1,1,20
14151,2019-07-21,강동구,7.5,0,5,0,0,5
14152,2019-07-21,강북구,5.0,0,6,0,1,7
14153,2019-07-21,강서구,4.5,0,4,0,1,5
14154,2019-07-21,관악구,15.75,0,1,0,2,3
14155,2019-07-21,광진구,6.0,0,1,0,1,2
14156,2019-07-21,구로구,7.0,0,2,0,0,2
14157,2019-07-21,금천구,8.0,0,5,0,0,5
14158,2019-07-21,노원구,5.0,0,8,0,1,9
14159,2019-07-21,도봉구,5.0,0,0,1,0,1
14160,2019-07-21,동대문구,5.0,0,4,0,1,5
14161,2019-07-21,동작구,8.25,0,2,0,0,2
14162,2019-07-21,마포구,5.5,0,4,0,2,6
14163,2019-07-21,서대문구,6.0,0,1,2,2,5
14164,2019-07-21,서초구,8.5,0,2,0,0,2
14165,2019-07-21,성동구,4.5,0,0,0,0,0
14166,2019-07-21,성북구,5.5,0,3,0,1,4
14167,2019-07-21,송파구,8.0,0,5,0,0,5
14168,2019-07-21,양천구,6.5,0,0,0,1,1
14169,2019-07-21,영등포구,5.5,0,6,0,0,6
14170,2019-07-21,용산구,5.5,0,3,0,0,3
14171,2019-07-21,은평구,4.5,0,1,0,0,1
14172,2019-07-21,종로구,6.2,0,1,0,0,1
14173,2019-07-21,중구,3.5,0,4,0,0,4
14174,2019-07-21,중랑구,7.5,0,3,0,0,3
14175,2019-07-22,강남구,0.0,0,15,4,3,22
14176,2019-07-22,강동구,0.0,0,5,0,4,9
14177,2019-07-22,강북구,0.0,0,3,0,0,3
14178,2019-07-22,강서구,0.0,0,5,2,0,7
14179,2019-07-22,관악구,0.0,0,1,0,1,2
14180,2019-07-22,광진구,0.0,0,3,0,1,4
14181,2019-07-22,구로구,0.0,0,2,0,2,4
14182,2019-07-22,금천구,0.0,0,8,0,1,9
14183,2019-07-22,노원구,0.0,1,7,0,0,8
14184,2019-07-22,도봉구,4.1,0,0,0,0,0
14185,2019-07-22,동대문구,0.0,0,5,1,0,6
14186,2019-07-22,동작구,0.0,0,3,0,3,6
14187,2019-07-22,마포구,0.0,0,6,1,4,11
14188,2019-07-22,서대문구,0.0,0,8,7,1,16
14189,2019-07-22,서초구,0.0,0,9,3,4,16
14190,2019-07-22,성동구,0.0,0,4,0,0,4
14191,2019-07-22,성북구,0.0,0,3,1,0,4
14192,2019-07-22,송파구,0.0,0,8,2,3,13
14193,2019-07-22,양천구,0.0,0,3,0,2,5
14194,2019-07-22,영등포구,0.0,0,13,1,1,15
14195,2019-07-22,용산구,0.0,0,6,0,2,8
14196,2019-07-22,은평구,0.0,0,6,0,2,8
14197,2019-07-22,종로구,0.1,0,1,0,1,2
14198,2019-07-22,중구,0.0,0,1,1,1,3
14199,2019-07-22,중랑구,0.0,0,8,0,2,10
14200,2019-07-23,강남구,0.0,0,9,0,2,11
14201,2019-07-23,강동구,0.0,0,3,1,1,5
14202,2019-07-23,강북구,0.0,0,2,0,2,4
14203,2019-07-23,강서구,0.0,0,3,0,2,5
14204,2019-07-23,관악구,0.0,0,5,1,1,7
14205,2019-07-23,광진구,0.0,0,4,0,0,4
14206,2019-07-23,구로구,0.0,0,8,1,1,10
14207,2019-07-23,금천구,0.0,0,3,0,0,3
14208,2019-07-23,노원구,0.0,0,3,0,0,3
14209,2019-07-23,도봉구,0.0,0,1,0,0,1
14210,2019-07-23,동대문구,0.0,0,1,0,3,4
14211,2019-07-23,동작구,0.0,0,8,0,0,8
14212,2019-07-23,마포구,0.0,0,5,0,2,7
14213,2019-07-23,서대문구,0.0,0,3,2,0,5
14214,2019-07-23,서초구,0.0,0,4,0,0,4
14215,2019-07-23,성동구,0.0,0,2,0,0,2
14216,2019-07-23,성북구,0.0,0,3,0,1,4
14217,2019-07-23,송파구,0.0,0,7,1,2,10
14218,2019-07-23,양천구,0.0,0,11,1,0,12
14219,2019-07-23,영등포구,0.0,0,5,1,0,6
14220,2019-07-23,용산구,0.0,0,7,1,2,10
14221,2019-07-23,은평구,0.0,0,3,1,1,5
14222,2019-07-23,종로구,0.0,0,2,0,1,3
14223,2019-07-23,중구,0.0,0,2,0,0,2
14224,2019-07-23,중랑구,0.0,0,4,0,0,4
14225,2019-07-24,강남구,0.0,0,14,2,0,16
14226,2019-07-24,강동구,0.5,0,6,0,4,10
14227,2019-07-24,강북구,2.0,0,2,0,0,2
14228,2019-07-24,강서구,1.5,0,6,0,1,7
14229,2019-07-24,관악구,2.75,0,3,0,1,4
14230,2019-07-24,광진구,0.0,0,5,0,1,6
14231,2019-07-24,구로구,2.0,0,4,2,1,7
14232,2019-07-24,금천구,2.0,0,3,0,0,3
14233,2019-07-24,노원구,4.0,0,5,1,3,9
14234,2019-07-24,도봉구,3.0,0,0,0,0,0
14235,2019-07-24,동대문구,0.5,1,3,0,0,4
14236,2019-07-24,동작구,1.25,0,1,0,1,2
14237,2019-07-24,마포구,1.0,0,3,0,3,6
14238,2019-07-24,서대문구,0.5,0,7,1,0,8
14239,2019-07-24,서초구,0.5,0,11,0,3,14
14240,2019-07-24,성동구,1.0,0,4,0,0,4
14241,2019-07-24,성북구,2.0,0,1,0,6,7
14242,2019-07-24,송파구,0.0,0,9,1,1,11
14243,2019-07-24,양천구,1.0,0,4,0,1,5
14244,2019-07-24,영등포구,0.5,0,10,0,4,14
14245,2019-07-24,용산구,0.0,0,5,0,1,6
14246,2019-07-24,은평구,2.0,0,3,2,1,6
14247,2019-07-24,종로구,1.0,0,4,0,2,6
14248,2019-07-24,중구,1.5,0,2,1,2,5
14249,2019-07-24,중랑구,1.0,0,2,0,0,2
14250,2019-07-25,강남구,8.5,0,15,2,2,19
14251,2019-07-25,강동구,12.5,0,6,0,1,7
14252,2019-07-25,강북구,12.5,0,5,1,0,6
14253,2019-07-25,강서구,8.0,0,5,0,1,6
14254,2019-07-25,관악구,10.0,0,2,0,0,2
14255,2019-07-25,광진구,11.0,0,4,0,2,6
14256,2019-07-25,구로구,4.0,0,5,1,0,6
14257,2019-07-25,금천구,4.0,0,1,0,1,2
14258,2019-07-25,노원구,5.0,0,1,0,0,1
14259,2019-07-25,도봉구,13.5,0,1,0,1,2
14260,2019-07-25,동대문구,6.0,0,5,0,3,8
14261,2019-07-25,동작구,3.5,0,4,1,2,7
14262,2019-07-25,마포구,11.0,0,6,0,3,9
14263,2019-07-25,서대문구,10.0,0,5,0,0,5
14264,2019-07-25,서초구,10.0,0,8,3,4,15
14265,2019-07-25,성동구,6.5,0,3,0,0,3
14266,2019-07-25,성북구,9.0,0,6,1,0,7
14267,2019-07-25,송파구,11.0,0,4,6,3,13
14268,2019-07-25,양천구,10.5,0,5,2,2,9
14269,2019-07-25,영등포구,2.25,0,5,0,2,7
14270,2019-07-25,용산구,4.0,0,2,0,0,2
14271,2019-07-25,은평구,12.0,0,1,0,0,1
14272,2019-07-25,종로구,9.7,0,4,0,1,5
14273,2019-07-25,중구,4.0,0,2,0,1,3
14274,2019-07-25,중랑구,7.0,0,7,1,2,10
14275,2019-07-26,강남구,115.5,0,11,0,1,12
14276,2019-07-26,강동구,79.0,0,4,2,0,6
14277,2019-07-26,강북구,74.5,0,2,0,2,4
14278,2019-07-26,강서구,82.0,0,5,0,0,5
14279,2019-07-26,관악구,96.5,0,2,0,1,3
14280,2019-07-26,광진구,91.5,0,0,0,1,1
14281,2019-07-26,구로구,60.5,0,2,0,3,5
14282,2019-07-26,금천구,76.5,0,1,0,2,3
14283,2019-07-26,노원구,61.0,1,6,0,3,10
14284,2019-07-26,도봉구,97.5,0,0,0,3,3
14285,2019-07-26,동대문구,60.0,0,1,0,1,2
14286,2019-07-26,동작구,77.25,0,6,1,0,7
14287,2019-07-26,마포구,41.0,0,5,1,1,7
14288,2019-07-26,서대문구,53.5,0,2,0,2,4
14289,2019-07-26,서초구,102.5,1,11,1,3,16
14290,2019-07-26,성동구,80.0,0,3,0,0,3
14291,2019-07-26,성북구,60.0,0,7,0,3,10
14292,2019-07-26,송파구,106.5,0,5,4,4,13
14293,2019-07-26,양천구,57.0,0,0,0,0,0
14294,2019-07-26,영등포구,66.25,0,8,0,2,10
14295,2019-07-26,용산구,80.5,0,3,0,1,4
14296,2019-07-26,은평구,91.0,0,3,0,0,3
14297,2019-07-26,종로구,60.0,0,2,0,0,2
14298,2019-07-26,중구,62.0,0,8,0,0,8
14299,2019-07-26,중랑구,73.0,0,4,0,1,5
14300,2019-07-27,강남구,29.5,0,23,6,1,30
14301,2019-07-27,강동구,38.5,1,3,0,1,5
14302,2019-07-27,강북구,0.5,0,1,0,2,3
14303,2019-07-27,강서구,6.5,0,3,1,2,6
14304,2019-07-27,관악구,7.0,0,10,0,0,10
14305,2019-07-27,광진구,36.0,0,2,0,0,2
14306,2019-07-27,구로구,0.0,0,0,0,0,0
14307,2019-07-27,금천구,7.5,0,5,0,1,6
14308,2019-07-27,노원구,4.0,0,3,0,1,4
14309,2019-07-27,도봉구,0.5,0,0,0,0,0
14310,2019-07-27,동대문구,5.5,0,6,0,2,8
14311,2019-07-27,동작구,8.0,0,0,1,1,2
14312,2019-07-27,마포구,3.0,0,4,0,0,4
14313,2019-07-27,서대문구,3.0,0,2,3,2,7
14314,2019-07-27,서초구,28.0,0,8,1,1,10
14315,2019-07-27,성동구,14.5,0,3,0,0,3
14316,2019-07-27,성북구,1.5,0,3,1,2,6
14317,2019-07-27,송파구,40.5,0,3,1,1,5
14318,2019-07-27,양천구,11.5,0,2,0,1,3
14319,2019-07-27,영등포구,6.5,0,12,1,0,13
14320,2019-07-27,용산구,3.5,0,4,0,0,4
14321,2019-07-27,은평구,0.0,0,6,0,1,7
14322,2019-07-27,종로구,0.6,0,3,0,0,3
14323,2019-07-27,중구,1.0,0,5,1,1,7
14324,2019-07-27,중랑구,11.5,0,2,1,2,5
14325,2019-07-28,강남구,27.0,0,15,0,1,16
14326,2019-07-28,강동구,35.0,0,3,0,1,4
14327,2019-07-28,강북구,32.0,0,0,0,0,0
14328,2019-07-28,강서구,33.0,0,0,0,1,1
14329,2019-07-28,관악구,16.5,0,2,0,0,2
14330,2019-07-28,광진구,31.5,0,5,0,1,6
14331,2019-07-28,구로구,32.0,0,2,0,1,3
14332,2019-07-28,금천구,25.0,0,0,1,2,3
14333,2019-07-28,노원구,33.5,0,1,0,2,3
14334,2019-07-28,도봉구,33.5,0,2,0,2,4
14335,2019-07-28,동대문구,28.0,0,2,0,2,4
14336,2019-07-28,동작구,19.5,0,7,1,3,11
14337,2019-07-28,마포구,27.0,0,6,0,0,6
14338,2019-07-28,서대문구,26.5,0,1,1,0,2
14339,2019-07-28,서초구,25.0,0,0,0,0,0
14340,2019-07-28,성동구,22.0,0,4,0,0,4
14341,2019-07-28,성북구,29.5,0,4,0,2,6
14342,2019-07-28,송파구,30.5,0,0,0,3,3
14343,2019-07-28,양천구,32.5,0,3,0,2,5
14344,2019-07-28,영등포구,25.5,0,4,0,4,8
14345,2019-07-28,용산구,15.0,0,0,0,0,0
14346,2019-07-28,은평구,36.0,0,7,1,0,8
14347,2019-07-28,종로구,25.6,0,1,0,0,1
14348,2019-07-28,중구,21.5,0,4,1,0,5
14349,2019-07-28,중랑구,35.5,0,10,0,1,11
14350,2019-07-29,강남구,0.5,0,7,0,0,7
14351,2019-07-29,강동구,0.5,0,3,0,2,5
14352,2019-07-29,강북구,0.0,0,3,0,0,3
14353,2019-07-29,강서구,0.0,0,1,1,0,2
14354,2019-07-29,관악구,0.0,0,0,0,2,2
14355,2019-07-29,광진구,0.5,0,2,0,0,2
14356,2019-07-29,구로구,2.0,0,7,0,0,7
14357,2019-07-29,금천구,0.0,0,3,1,0,4
14358,2019-07-29,노원구,0.5,0,5,2,1,8
14359,2019-07-29,도봉구,0.0,0,0,1,1,2
14360,2019-07-29,동대문구,2.0,0,2,1,0,3
14361,2019-07-29,동작구,0.5,0,4,1,0,5
14362,2019-07-29,마포구,0.5,1,7,0,1,9
14363,2019-07-29,서대문구,0.5,0,2,1,0,3
14364,2019-07-29,서초구,0.5,1,8,2,0,11
14365,2019-07-29,성동구,1.5,0,2,0,0,2
14366,2019-07-29,성북구,0.5,0,9,0,1,10
14367,2019-07-29,송파구,1.0,0,14,2,2,18
14368,2019-07-29,양천구,0.5,0,0,0,0,0
14369,2019-07-29,영등포구,3.25,0,6,0,0,6
14370,2019-07-29,용산구,1.0,1,3,0,0,4
14371,2019-07-29,은평구,0.0,0,3,0,0,3
14372,2019-07-29,종로구,0.5,0,2,0,1,3
14373,2019-07-29,중구,3.5,0,1,0,1,2
14374,2019-07-29,중랑구,1.0,0,0,0,0,0
14375,2019-07-30,강남구,0.0,0,6,1,4,11
14376,2019-07-30,강동구,0.0,0,11,0,1,12
14377,2019-07-30,강북구,0.5,0,0,0,1,1
14378,2019-07-30,강서구,1.5,0,3,0,0,3
14379,2019-07-30,관악구,0.5,0,5,1,1,7
14380,2019-07-30,광진구,0.0,0,2,0,6,8
14381,2019-07-30,구로구,0.5,0,6,0,2,8
14382,2019-07-30,금천구,0.5,0,5,0,0,5
14383,2019-07-30,노원구,0.0,0,1,1,1,3
14384,2019-07-30,도봉구,1.0,0,1,0,1,2
14385,2019-07-30,동대문구,0.0,0,7,0,0,7
14386,2019-07-30,동작구,1.0,0,0,3,0,3
14387,2019-07-30,마포구,1.5,0,3,1,1,5
14388,2019-07-30,서대문구,1.0,1,3,1,1,6
14389,2019-07-30,서초구,0.0,0,3,1,0,4
14390,2019-07-30,성동구,0.0,0,2,0,2,4
14391,2019-07-30,성북구,0.0,0,9,3,1,13
14392,2019-07-30,송파구,0.0,0,5,0,1,6
14393,2019-07-30,양천구,1.0,0,3,0,0,3
14394,2019-07-30,영등포구,0.0,0,4,2,2,8
14395,2019-07-30,용산구,0.0,1,2,0,0,3
14396,2019-07-30,은평구,3.0,0,2,1,2,5
14397,2019-07-30,종로구,1.2,0,8,0,0,8
14398,2019-07-30,중구,0.0,0,0,0,1,1
14399,2019-07-30,중랑구,0.0,0,4,0,0,4
14400,2019-07-31,강남구,64.0,0,9,1,2,12
14401,2019-07-31,강동구,70.0,0,3,2,0,5
14402,2019-07-31,강북구,61.5,0,4,0,0,4
14403,2019-07-31,강서구,51.0,0,7,1,2,10
14404,2019-07-31,관악구,64.0,0,11,1,0,12
14405,2019-07-31,광진구,67.5,0,1,0,2,3
14406,2019-07-31,구로구,34.5,0,8,0,0,8
14407,2019-07-31,금천구,37.0,0,6,0,1,7
14408,2019-07-31,노원구,82.5,0,4,1,2,7
14409,2019-07-31,도봉구,65.0,0,0,1,1,2
14410,2019-07-31,동대문구,66.5,0,9,2,1,12
14411,2019-07-31,동작구,51.5,0,10,0,1,11
14412,2019-07-31,마포구,48.0,0,3,0,1,4
14413,2019-07-31,서대문구,62.5,0,3,0,0,3
14414,2019-07-31,서초구,51.0,0,3,0,1,4
14415,2019-07-31,성동구,68.5,0,1,0,1,2
14416,2019-07-31,성북구,71.5,0,1,0,0,1
14417,2019-07-31,송파구,65.0,0,5,1,2,8
14418,2019-07-31,양천구,52.0,0,4,5,0,9
14419,2019-07-31,영등포구,46.25,0,11,1,2,14
14420,2019-07-31,용산구,71.0,0,3,0,1,4
14421,2019-07-31,은평구,77.0,0,1,0,0,1
14422,2019-07-31,종로구,62.3,0,3,0,0,3
14423,2019-07-31,중구,69.5,0,11,1,1,13
14424,2019-07-31,중랑구,91.0,0,4,2,0,6
14425,2019-08-01,강남구,50.0,0,14,1,0,15
14426,2019-08-01,강동구,47.0,0,5,0,0,5
14427,2019-08-01,강북구,14.0,0,5,0,2,7
14428,2019-08-01,강서구,21.0,0,7,1,1,9
14429,2019-08-01,관악구,61.0,0,4,0,1,5
14430,2019-08-01,광진구,60.5,0,2,0,1,3
14431,2019-08-01,구로구,37.0,0,4,1,0,5
14432,2019-08-01,금천구,52.5,1,4,0,3,8
14433,2019-08-01,노원구,25.0,0,3,1,0,4
14434,2019-08-01,도봉구,17.5,0,1,1,1,3
14435,2019-08-01,동대문구,38.5,0,1,0,1,2
14436,2019-08-01,동작구,59.75,0,4,0,0,4
14437,2019-08-01,마포구,11.5,0,4,3,1,8
14438,2019-08-01,서대문구,23.5,0,5,0,1,6
14439,2019-08-01,서초구,58.5,0,9,0,4,13
14440,2019-08-01,성동구,44.5,0,1,0,1,2
14441,2019-08-01,성북구,20.0,0,3,1,1,5
14442,2019-08-01,송파구,48.0,0,7,1,1,9
14443,2019-08-01,양천구,29.5,0,3,0,1,4
14444,2019-08-01,영등포구,37.75,0,17,1,1,19
14445,2019-08-01,용산구,49.0,0,3,0,3,6
14446,2019-08-01,은평구,21.0,0,1,0,1,2
14447,2019-08-01,종로구,26.9,0,2,0,1,3
14448,2019-08-01,중구,33.0,0,6,0,1,7
14449,2019-08-01,중랑구,48.5,0,5,1,1,7
14450,2019-08-02,강남구,0.0,0,12,1,3,16
14451,2019-08-02,강동구,0.0,0,2,1,0,3
14452,2019-08-02,강북구,0.0,0,10,1,1,12
14453,2019-08-02,강서구,0.0,0,10,1,4,15
14454,2019-08-02,관악구,0.0,0,6,0,2,8
14455,2019-08-02,광진구,0.0,0,4,0,0,4
14456,2019-08-02,구로구,0.0,0,2,0,2,4
14457,2019-08-02,금천구,0.0,0,6,1,1,8
14458,2019-08-02,노원구,0.0,0,8,0,0,8
14459,2019-08-02,도봉구,0.0,0,3,0,0,3
14460,2019-08-02,동대문구,0.0,0,4,0,0,4
14461,2019-08-02,동작구,0.0,0,6,1,1,8
14462,2019-08-02,마포구,0.0,0,5,1,2,8
14463,2019-08-02,서대문구,0.0,0,3,0,0,3
14464,2019-08-02,서초구,0.0,0,6,1,2,9
14465,2019-08-02,성동구,0.0,0,8,0,2,10
14466,2019-08-02,성북구,0.0,0,0,0,0,0
14467,2019-08-02,송파구,0.0,0,9,1,0,10
14468,2019-08-02,양천구,0.0,0,2,0,2,4
14469,2019-08-02,영등포구,0.0,0,7,2,4,13
14470,2019-08-02,용산구,0.0,0,2,0,1,3
14471,2019-08-02,은평구,0.0,0,2,1,0,3
14472,2019-08-02,종로구,0.0,0,1,0,1,2
14473,2019-08-02,중구,0.0,0,3,0,2,5
14474,2019-08-02,중랑구,0.0,0,0,0,2,2
14475,2019-08-03,강남구,0.0,0,11,1,3,15
14476,2019-08-03,강동구,12.0,0,6,0,1,7
14477,2019-08-03,강북구,7.0,0,0,0,4,4
14478,2019-08-03,강서구,14.5,0,4,1,1,6
14479,2019-08-03,관악구,17.0,0,2,0,0,2
14480,2019-08-03,광진구,0.0,0,6,0,1,7
14481,2019-08-03,구로구,2.5,0,1,2,2,5
14482,2019-08-03,금천구,17.5,0,4,0,1,5
14483,2019-08-03,노원구,5.0,0,1,0,0,1
14484,2019-08-03,도봉구,8.5,0,1,0,0,1
14485,2019-08-03,동대문구,0.0,0,1,0,2,3
14486,2019-08-03,동작구,13.5,0,1,0,2,3
14487,2019-08-03,마포구,5.0,0,2,0,1,3
14488,2019-08-03,서대문구,5.5,0,0,0,1,1
14489,2019-08-03,서초구,1.5,0,6,1,1,8
14490,2019-08-03,성동구,0.0,0,2,0,0,2
14491,2019-08-03,성북구,1.5,0,6,0,2,8
14492,2019-08-03,송파구,0.0,0,4,0,2,6
14493,2019-08-03,양천구,3.0,0,2,0,1,3
14494,2019-08-03,영등포구,9.0,0,13,3,1,17
14495,2019-08-03,용산구,3.0,1,4,0,1,6
14496,2019-08-03,은평구,13.0,0,2,0,0,2
14497,2019-08-03,종로구,3.0,0,2,0,0,2
14498,2019-08-03,중구,1.0,0,0,0,0,0
14499,2019-08-03,중랑구,0.0,0,9,1,0,10
14500,2019-08-04,강남구,0.0,0,12,3,0,15
14501,2019-08-04,강동구,20.0,0,2,0,0,2
14502,2019-08-04,강북구,48.5,0,6,0,0,6
14503,2019-08-04,강서구,0.0,0,8,1,1,10
14504,2019-08-04,관악구,0.0,0,3,0,0,3
14505,2019-08-04,광진구,25.5,0,0,1,0,1
14506,2019-08-04,구로구,0.0,0,5,0,0,5
14507,2019-08-04,금천구,1.0,0,1,0,1,2
14508,2019-08-04,노원구,12.0,0,4,1,1,6
14509,2019-08-04,도봉구,42.5,0,0,0,0,0
14510,2019-08-04,동대문구,39.0,0,11,1,2,14
14511,2019-08-04,동작구,4.25,0,2,1,0,3
14512,2019-08-04,마포구,3.0,0,15,0,2,17
14513,2019-08-04,서대문구,5.5,0,5,0,1,6
14514,2019-08-04,서초구,0.0,0,6,0,1,7
14515,2019-08-04,성동구,15.0,0,0,0,0,0
14516,2019-08-04,성북구,41.5,0,1,0,0,1
14517,2019-08-04,송파구,0.0,0,8,1,3,12
14518,2019-08-04,양천구,0.0,0,2,1,0,3
14519,2019-08-04,영등포구,11.75,0,4,1,5,10
14520,2019-08-04,용산구,0.0,0,0,0,0,0
14521,2019-08-04,은평구,2.5,0,0,0,1,1
14522,2019-08-04,종로구,8.6,0,5,1,0,6
14523,2019-08-04,중구,41.0,0,2,0,0,2
14524,2019-08-04,중랑구,33.5,0,4,1,1,6
14525,2019-08-05,강남구,0.0,0,10,3,1,14
14526,2019-08-05,강동구,0.0,0,2,1,3,6
14527,2019-08-05,강북구,0.0,0,1,0,0,1
14528,2019-08-05,강서구,0.0,0,3,0,0,3
14529,2019-08-05,관악구,0.0,0,3,0,2,5
14530,2019-08-05,광진구,0.0,0,2,0,0,2
14531,2019-08-05,구로구,0.0,0,5,0,2,7
14532,2019-08-05,금천구,0.0,0,4,0,0,4
14533,2019-08-05,노원구,0.0,0,2,1,2,5
14534,2019-08-05,도봉구,0.0,0,0,1,2,3
14535,2019-08-05,동대문구,0.0,0,1,0,0,1
14536,2019-08-05,동작구,0.0,0,4,3,1,8
14537,2019-08-05,마포구,0.0,0,0,3,2,5
14538,2019-08-05,서대문구,0.0,0,2,0,0,2
14539,2019-08-05,서초구,0.0,0,2,0,0,2
14540,2019-08-05,성동구,0.0,0,2,1,0,3
14541,2019-08-05,성북구,0.0,0,1,0,1,2
14542,2019-08-05,송파구,0.0,0,6,2,2,10
14543,2019-08-05,양천구,0.0,0,10,1,1,12
14544,2019-08-05,영등포구,0.0,0,7,0,3,10
14545,2019-08-05,용산구,0.0,0,4,0,0,4
14546,2019-08-05,은평구,0.0,0,1,0,3,4
14547,2019-08-05,종로구,0.0,0,7,2,1,10
14548,2019-08-05,중구,0.0,0,3,0,1,4
14549,2019-08-05,중랑구,0.0,0,3,1,1,5
14550,2019-08-06,강남구,0.0,0,13,2,1,16
14551,2019-08-06,강동구,0.0,0,7,1,1,9
14552,2019-08-06,강북구,0.0,0,5,0,1,6
14553,2019-08-06,강서구,0.0,0,3,0,1,4
14554,2019-08-06,관악구,0.0,0,0,0,0,0
14555,2019-08-06,광진구,0.0,0,4,1,2,7
14556,2019-08-06,구로구,0.0,0,10,0,2,12
14557,2019-08-06,금천구,0.0,0,5,0,2,7
14558,2019-08-06,노원구,0.0,0,0,0,1,1
14559,2019-08-06,도봉구,0.0,0,2,1,1,4
14560,2019-08-06,동대문구,0.0,0,4,0,1,5
14561,2019-08-06,동작구,0.0,0,2,0,1,3
14562,2019-08-06,마포구,0.0,0,5,1,1,7
14563,2019-08-06,서대문구,0.0,0,1,2,2,5
14564,2019-08-06,서초구,0.0,0,7,0,0,7
14565,2019-08-06,성동구,0.0,0,2,1,0,3
14566,2019-08-06,성북구,0.0,0,8,0,0,8
14567,2019-08-06,송파구,0.0,0,9,0,1,10
14568,2019-08-06,양천구,0.0,0,0,0,1,1
14569,2019-08-06,영등포구,0.0,0,10,1,2,13
14570,2019-08-06,용산구,0.0,1,1,0,1,3
14571,2019-08-06,은평구,0.0,0,2,1,2,5
14572,2019-08-06,종로구,0.0,0,9,0,0,9
14573,2019-08-06,중구,0.0,0,3,1,1,5
14574,2019-08-06,중랑구,0.0,0,2,0,2,4
14575,2019-08-07,강남구,13.5,1,12,0,1,14
14576,2019-08-07,강동구,16.0,0,4,1,2,7
14577,2019-08-07,강북구,10.0,1,4,0,0,5
14578,2019-08-07,강서구,3.5,0,9,0,2,11
14579,2019-08-07,관악구,9.25,0,3,1,0,4
14580,2019-08-07,광진구,13.0,0,0,0,0,0
14581,2019-08-07,구로구,3.0,0,2,0,0,2
14582,2019-08-07,금천구,6.0,0,2,0,2,4
14583,2019-08-07,노원구,14.0,0,5,0,2,7
14584,2019-08-07,도봉구,11.5,0,3,0,4,7
14585,2019-08-07,동대문구,12.5,0,1,0,1,2
14586,2019-08-07,동작구,7.5,0,2,0,0,2
14587,2019-08-07,마포구,6.5,0,7,0,0,7
14588,2019-08-07,서대문구,6.0,0,0,1,2,3
14589,2019-08-07,서초구,11.0,0,7,0,1,8
14590,2019-08-07,성동구,11.0,0,4,0,1,5
14591,2019-08-07,성북구,9.5,0,4,1,0,5
14592,2019-08-07,송파구,12.5,0,2,1,1,4
14593,2019-08-07,양천구,4.0,0,16,1,1,18
14594,2019-08-07,영등포구,6.25,0,7,0,1,8
14595,2019-08-07,용산구,9.0,0,3,0,1,4
14596,2019-08-07,은평구,8.0,0,2,0,1,3
14597,2019-08-07,종로구,8.0,0,2,0,0,2
14598,2019-08-07,중구,7.0,0,4,1,1,6
14599,2019-08-07,중랑구,14.5,0,5,0,1,6
14600,2019-08-08,강남구,0.0,0,7,5,1,13
14601,2019-08-08,강동구,0.0,0,3,1,1,5
14602,2019-08-08,강북구,0.0,0,1,0,1,2
14603,2019-08-08,강서구,0.0,0,5,0,5,10
14604,2019-08-08,관악구,0.0,0,4,0,2,6
14605,2019-08-08,광진구,0.0,0,1,0,0,1
14606,2019-08-08,구로구,0.0,0,5,0,2,7
14607,2019-08-08,금천구,0.0,0,2,0,1,3
14608,2019-08-08,노원구,0.0,0,9,1,0,10
14609,2019-08-08,도봉구,0.0,0,0,1,0,1
14610,2019-08-08,동대문구,0.5,0,3,1,0,4
14611,2019-08-08,동작구,0.0,0,7,2,0,9
14612,2019-08-08,마포구,0.0,0,2,0,3,5
14613,2019-08-08,서대문구,0.0,0,2,1,1,4
14614,2019-08-08,서초구,0.0,0,8,0,1,9
14615,2019-08-08,성동구,0.0,0,3,0,1,4
14616,2019-08-08,성북구,0.5,0,4,0,1,5
14617,2019-08-08,송파구,0.0,0,12,2,3,17
14618,2019-08-08,양천구,0.0,1,6,1,0,8
14619,2019-08-08,영등포구,0.0,0,7,1,3,11
14620,2019-08-08,용산구,0.0,0,1,0,0,1
14621,2019-08-08,은평구,0.0,0,2,0,2,4
14622,2019-08-08,종로구,0.0,0,4,1,1,6
14623,2019-08-08,중구,0.0,0,0,0,1,1
14624,2019-08-08,중랑구,0.0,0,4,0,3,7
14625,2019-08-09,강남구,0.0,0,15,0,3,18
14626,2019-08-09,강동구,0.0,0,4,0,0,4
14627,2019-08-09,강북구,0.0,0,3,0,2,5
14628,2019-08-09,강서구,0.0,0,9,0,1,10
14629,2019-08-09,관악구,0.0,0,6,0,0,6
14630,2019-08-09,광진구,0.0,0,0,0,1,1
14631,2019-08-09,구로구,0.0,0,1,0,0,1
14632,2019-08-09,금천구,0.0,0,14,13,6,33
14633,2019-08-09,노원구,0.0,0,5,2,1,8
14634,2019-08-09,도봉구,0.0,0,1,0,0,1
14635,2019-08-09,동대문구,0.0,0,4,0,7,11
14636,2019-08-09,동작구,0.0,0,5,1,2,8
14637,2019-08-09,마포구,0.0,0,5,0,2,7
14638,2019-08-09,서대문구,0.0,1,3,1,0,5
14639,2019-08-09,서초구,0.0,0,6,3,1,10
14640,2019-08-09,성동구,0.0,0,2,0,0,2
14641,2019-08-09,성북구,0.0,0,1,0,0,1
14642,2019-08-09,송파구,7.5,0,11,3,1,15
14643,2019-08-09,양천구,0.0,0,8,1,1,10
14644,2019-08-09,영등포구,0.0,0,9,1,1,11
14645,2019-08-09,용산구,0.0,0,2,0,0,2
14646,2019-08-09,은평구,0.0,0,1,4,0,5
14647,2019-08-09,종로구,0.0,0,4,1,2,7
14648,2019-08-09,중구,0.0,0,9,0,1,10
14649,2019-08-09,중랑구,0.0,0,2,1,2,5
14650,2019-08-10,강남구,0.0,0,11,4,4,19
14651,2019-08-10,강동구,0.0,0,8,0,2,10
14652,2019-08-10,강북구,0.0,0,2,0,0,2
14653,2019-08-10,강서구,0.0,0,6,0,1,7
14654,2019-08-10,관악구,0.0,0,2,0,0,2
14655,2019-08-10,광진구,0.0,0,2,0,1,3
14656,2019-08-10,구로구,0.0,0,7,0,1,8
14657,2019-08-10,금천구,0.0,0,2,0,0,2
14658,2019-08-10,노원구,0.0,0,6,3,1,10
14659,2019-08-10,도봉구,0.0,0,9,0,2,11
14660,2019-08-10,동대문구,0.0,1,1,1,0,3
14661,2019-08-10,동작구,0.0,0,9,1,1,11
14662,2019-08-10,마포구,0.0,0,8,0,0,8
14663,2019-08-10,서대문구,0.0,0,1,0,0,1
14664,2019-08-10,서초구,0.0,0,10,0,3,13
14665,2019-08-10,성동구,0.0,0,1,0,1,2
14666,2019-08-10,성북구,0.0,0,2,0,2,4
14667,2019-08-10,송파구,0.0,0,10,0,1,11
14668,2019-08-10,양천구,0.0,0,12,2,0,14
14669,2019-08-10,영등포구,0.0,0,2,2,1,5
14670,2019-08-10,용산구,0.0,0,5,0,1,6
14671,2019-08-10,은평구,0.0,0,3,2,1,6
14672,2019-08-10,종로구,0.0,0,3,1,1,5
14673,2019-08-10,중구,0.0,0,3,0,1,4
14674,2019-08-10,중랑구,0.0,0,4,0,0,4
14675,2019-08-11,강남구,4.0,0,14,0,2,16
14676,2019-08-11,강동구,2.0,0,2,0,1,3
14677,2019-08-11,강북구,5.5,0,3,0,3,6
14678,2019-08-11,강서구,8.0,0,6,1,3,10
14679,2019-08-11,관악구,7.75,0,2,0,1,3
14680,2019-08-11,광진구,3.5,0,1,1,3,5
14681,2019-08-11,구로구,9.5,0,13,0,2,15
14682,2019-08-11,금천구,8.0,0,0,0,1,1
14683,2019-08-11,노원구,3.5,0,5,0,1,6
14684,2019-08-11,도봉구,6.0,0,0,0,0,0
14685,2019-08-11,동대문구,4.0,0,4,0,2,6
14686,2019-08-11,동작구,7.75,0,0,1,0,1
14687,2019-08-11,마포구,6.5,0,2,1,0,3
14688,2019-08-11,서대문구,5.5,0,0,0,1,1
14689,2019-08-11,서초구,5.5,0,8,2,1,11
14690,2019-08-11,성동구,4.5,0,3,0,2,5
14691,2019-08-11,성북구,6.0,0,1,0,0,1
14692,2019-08-11,송파구,3.5,0,9,1,1,11
14693,2019-08-11,양천구,7.0,0,3,1,0,4
14694,2019-08-11,영등포구,6.5,0,8,1,0,9
14695,2019-08-11,용산구,7.5,0,4,0,1,5
14696,2019-08-11,은평구,7.0,0,3,0,1,4
14697,2019-08-11,종로구,6.7,0,1,0,0,1
14698,2019-08-11,중구,5.5,0,2,0,0,2
14699,2019-08-11,중랑구,3.5,0,5,0,0,5
14700,2019-08-12,강남구,44.0,0,6,2,1,9
14701,2019-08-12,강동구,41.5,0,5,1,0,6
14702,2019-08-12,강북구,61.5,0,6,0,1,7
14703,2019-08-12,강서구,55.5,0,8,0,3,11
14704,2019-08-12,관악구,47.25,0,5,3,1,9
14705,2019-08-12,광진구,40.0,0,1,1,1,3
14706,2019-08-12,구로구,45.5,0,5,0,4,9
14707,2019-08-12,금천구,35.0,0,0,0,1,1
14708,2019-08-12,노원구,47.0,0,5,0,1,6
14709,2019-08-12,도봉구,72.5,0,1,0,1,2
14710,2019-08-12,동대문구,38.5,0,0,0,1,1
14711,2019-08-12,동작구,39.25,0,2,0,0,2
14712,2019-08-12,마포구,52.5,0,2,0,1,3
14713,2019-08-12,서대문구,55.0,0,0,3,0,3
14714,2019-08-12,서초구,38.5,0,7,1,0,8
14715,2019-08-12,성동구,37.0,0,4,1,0,5
14716,2019-08-12,성북구,64.5,0,6,4,1,11
14717,2019-08-12,송파구,42.5,0,3,1,1,5
14718,2019-08-12,양천구,43.0,0,4,1,1,6
14719,2019-08-12,영등포구,38.75,0,10,1,1,12
14720,2019-08-12,용산구,39.5,0,4,0,0,4
14721,2019-08-12,은평구,61.5,0,3,0,1,4
14722,2019-08-12,종로구,56.2,0,7,1,3,11
14723,2019-08-12,중구,47.5,0,10,1,1,12
14724,2019-08-12,중랑구,42.0,0,5,0,1,6
14725,2019-08-13,강남구,0.0,0,8,2,2,12
14726,2019-08-13,강동구,0.0,0,3,0,3,6
14727,2019-08-13,강북구,0.0,0,4,0,0,4
14728,2019-08-13,강서구,14.5,0,1,0,0,1
14729,2019-08-13,관악구,4.25,0,8,0,2,10
14730,2019-08-13,광진구,0.0,0,2,0,1,3
14731,2019-08-13,구로구,4.5,1,1,0,2,4
14732,2019-08-13,금천구,6.5,0,7,0,0,7
14733,2019-08-13,노원구,0.0,0,7,1,0,8
14734,2019-08-13,도봉구,0.0,0,3,0,1,4
14735,2019-08-13,동대문구,0.0,0,1,1,0,2
14736,2019-08-13,동작구,6.75,0,6,1,2,9
14737,2019-08-13,마포구,10.5,0,8,0,1,9
14738,2019-08-13,서대문구,7.5,0,1,2,0,3
14739,2019-08-13,서초구,0.0,0,12,0,0,12
14740,2019-08-13,성동구,0.0,0,1,0,0,1
14741,2019-08-13,성북구,0.0,0,2,0,0,2
14742,2019-08-13,송파구,0.0,0,11,1,0,12
14743,2019-08-13,양천구,5.0,0,7,0,0,7
14744,2019-08-13,영등포구,8.0,0,9,0,1,10
14745,2019-08-13,용산구,7.5,0,4,0,2,6
14746,2019-08-13,은평구,17.5,0,1,0,0,1
14747,2019-08-13,종로구,6.4,0,2,0,0,2
14748,2019-08-13,중구,2.0,0,3,1,0,4
14749,2019-08-13,중랑구,0.0,0,2,0,2,4
14750,2019-08-14,강남구,0.0,0,11,0,2,13
14751,2019-08-14,강동구,0.0,0,1,0,4,5
14752,2019-08-14,강북구,0.0,0,10,0,4,14
14753,2019-08-14,강서구,0.0,0,5,0,1,6
14754,2019-08-14,관악구,0.0,0,7,1,1,9
14755,2019-08-14,광진구,0.0,0,6,0,2,8
14756,2019-08-14,구로구,0.0,0,12,2,1,15
14757,2019-08-14,금천구,0.0,0,2,1,0,3
14758,2019-08-14,노원구,0.0,0,3,2,1,6
14759,2019-08-14,도봉구,0.0,0,0,0,3,3
14760,2019-08-14,동대문구,0.0,0,2,0,3,5
14761,2019-08-14,동작구,0.0,0,5,0,1,6
14762,2019-08-14,마포구,0.0,0,2,0,1,3
14763,2019-08-14,서대문구,0.5,0,3,3,0,6
14764,2019-08-14,서초구,0.0,0,6,2,1,9
14765,2019-08-14,성동구,0.0,0,1,0,1,2
14766,2019-08-14,성북구,0.0,0,2,0,2,4
14767,2019-08-14,송파구,0.0,0,12,4,3,19
14768,2019-08-14,양천구,0.0,0,10,0,0,10
14769,2019-08-14,영등포구,0.5,1,5,2,0,8
14770,2019-08-14,용산구,0.0,0,9,0,2,11
14771,2019-08-14,은평구,0.0,0,3,0,3,6
14772,2019-08-14,종로구,0.0,0,4,0,1,5
14773,2019-08-14,중구,0.0,0,0,1,2,3
14774,2019-08-14,중랑구,0.0,0,7,1,2,10
14775,2019-08-15,강남구,35.5,0,15,1,0,16
14776,2019-08-15,강동구,47.0,0,10,0,1,11
14777,2019-08-15,강북구,15.5,0,5,1,0,6
14778,2019-08-15,강서구,6.5,0,1,0,0,1
14779,2019-08-15,관악구,15.75,0,5,0,1,6
14780,2019-08-15,광진구,37.5,0,2,0,0,2
14781,2019-08-15,구로구,7.0,0,0,0,1,1
14782,2019-08-15,금천구,19.0,0,1,0,1,2
14783,2019-08-15,노원구,54.5,0,3,0,1,4
14784,2019-08-15,도봉구,17.0,0,2,1,0,3
14785,2019-08-15,동대문구,33.0,0,3,1,0,4
14786,2019-08-15,동작구,27.75,0,0,0,0,0
14787,2019-08-15,마포구,18.5,0,2,0,1,3
14788,2019-08-15,서대문구,12.0,0,4,1,1,6
14789,2019-08-15,서초구,32.5,0,1,0,0,1
14790,2019-08-15,성동구,30.5,0,1,0,1,2
14791,2019-08-15,성북구,13.5,0,6,0,2,8
14792,2019-08-15,송파구,35.0,0,6,1,3,10
14793,2019-08-15,양천구,8.5,0,4,0,1,5
14794,2019-08-15,영등포구,17.0,0,5,0,0,5
14795,2019-08-15,용산구,29.0,0,6,0,1,7
14796,2019-08-15,은평구,9.0,0,2,0,1,3
14797,2019-08-15,종로구,16.2,0,8,0,0,8
14798,2019-08-15,중구,11.0,0,3,1,0,4
14799,2019-08-15,중랑구,41.0,0,0,0,1,1
14800,2019-08-16,강남구,0.0,0,8,1,0,9
14801,2019-08-16,강동구,0.5,0,6,2,0,8
14802,2019-08-16,강북구,0.0,0,1,1,0,2
14803,2019-08-16,강서구,0.5,0,7,1,2,10
14804,2019-08-16,관악구,0.0,0,6,1,1,8
14805,2019-08-16,광진구,0.0,0,7,0,2,9
14806,2019-08-16,구로구,0.0,0,4,0,0,4
14807,2019-08-16,금천구,0.0,0,4,0,0,4
14808,2019-08-16,노원구,0.5,0,4,1,5,10
14809,2019-08-16,도봉구,0.5,0,2,0,2,4
14810,2019-08-16,동대문구,3.0,0,2,0,5,7
14811,2019-08-16,동작구,0.0,0,4,2,0,6
14812,2019-08-16,마포구,0.0,0,3,0,2,5
14813,2019-08-16,서대문구,0.0,0,4,0,0,4
14814,2019-08-16,서초구,0.0,0,3,0,1,4
14815,2019-08-16,성동구,0.0,0,2,1,0,3
14816,2019-08-16,성북구,1.5,0,3,1,1,5
14817,2019-08-16,송파구,0.0,0,10,4,2,16
14818,2019-08-16,양천구,0.0,0,3,0,1,4
14819,2019-08-16,영등포구,0.5,0,4,0,1,5
14820,2019-08-16,용산구,0.0,0,1,0,0,1
14821,2019-08-16,은평구,0.0,0,3,0,1,4
14822,2019-08-16,종로구,0.1,0,1,2,0,3
14823,2019-08-16,중구,0.0,0,4,1,1,6
14824,2019-08-16,중랑구,2.5,0,4,1,1,6
14825,2019-08-17,강남구,1.5,0,6,1,3,10
14826,2019-08-17,강동구,0.0,1,4,0,6,11
14827,2019-08-17,강북구,0.0,0,8,0,2,10
14828,2019-08-17,강서구,0.0,0,3,0,0,3
14829,2019-08-17,관악구,0.0,0,5,0,1,6
14830,2019-08-17,광진구,0.0,0,11,0,1,12
14831,2019-08-17,구로구,0.0,0,4,0,1,5
14832,2019-08-17,금천구,0.0,0,3,1,3,7
14833,2019-08-17,노원구,0.0,0,4,1,0,5
14834,2019-08-17,도봉구,0.0,0,1,1,1,3
14835,2019-08-17,동대문구,0.0,0,4,0,0,4
14836,2019-08-17,동작구,0.0,0,4,1,1,6
14837,2019-08-17,마포구,0.0,0,11,0,2,13
14838,2019-08-17,서대문구,0.0,0,3,1,2,6
14839,2019-08-17,서초구,0.5,0,3,0,2,5
14840,2019-08-17,성동구,0.0,0,2,0,0,2
14841,2019-08-17,성북구,0.0,0,1,0,1,2
14842,2019-08-17,송파구,0.5,0,7,0,5,12
14843,2019-08-17,양천구,0.0,0,7,1,0,8
14844,2019-08-17,영등포구,0.0,0,8,1,4,13
14845,2019-08-17,용산구,0.0,0,4,3,0,7
14846,2019-08-17,은평구,0.0,0,1,1,3,5
14847,2019-08-17,종로구,0.0,0,4,0,0,4
14848,2019-08-17,중구,0.0,0,3,0,0,3
14849,2019-08-17,중랑구,0.0,0,4,0,1,5
14850,2019-08-18,강남구,0.0,0,3,0,2,5
14851,2019-08-18,강동구,0.0,0,0,0,0,0
14852,2019-08-18,강북구,0.0,0,2,1,0,3
14853,2019-08-18,강서구,0.0,0,6,2,2,10
14854,2019-08-18,관악구,0.0,0,0,0,1,1
14855,2019-08-18,광진구,0.0,0,4,0,1,5
14856,2019-08-18,구로구,0.0,0,2,0,0,2
14857,2019-08-18,금천구,0.0,0,3,1,0,4
14858,2019-08-18,노원구,0.0,0,6,0,2,8
14859,2019-08-18,도봉구,0.0,0,0,0,2,2
14860,2019-08-18,동대문구,0.0,0,4,0,1,5
14861,2019-08-18,동작구,0.0,0,2,0,0,2
14862,2019-08-18,마포구,0.0,0,1,0,0,1
14863,2019-08-18,서대문구,0.0,0,1,1,1,3
14864,2019-08-18,서초구,0.0,0,3,0,0,3
14865,2019-08-18,성동구,0.0,0,3,0,0,3
14866,2019-08-18,성북구,0.0,0,4,2,0,6
14867,2019-08-18,송파구,0.0,0,8,1,0,9
14868,2019-08-18,양천구,0.0,1,6,1,0,8
14869,2019-08-18,영등포구,0.0,0,4,0,0,4
14870,2019-08-18,용산구,0.0,0,2,0,2,4
14871,2019-08-18,은평구,0.0,0,0,0,0,0
14872,2019-08-18,종로구,0.0,0,0,0,2,2
14873,2019-08-18,중구,0.0,0,0,0,0,0
14874,2019-08-18,중랑구,0.0,0,1,1,0,2
14875,2019-08-19,강남구,0.0,0,8,3,2,13
14876,2019-08-19,강동구,0.0,0,5,1,0,6
14877,2019-08-19,강북구,0.0,0,6,0,1,7
14878,2019-08-19,강서구,0.0,0,5,1,0,6
14879,2019-08-19,관악구,0.0,0,0,5,0,5
14880,2019-08-19,광진구,0.0,0,7,0,1,8
14881,2019-08-19,구로구,0.0,0,4,1,2,7
14882,2019-08-19,금천구,0.0,0,9,0,0,9
14883,2019-08-19,노원구,0.0,0,7,0,2,9
14884,2019-08-19,도봉구,0.0,1,6,0,0,7
14885,2019-08-19,동대문구,0.0,0,2,0,1,3
14886,2019-08-19,동작구,0.0,0,3,0,0,3
14887,2019-08-19,마포구,0.0,0,6,0,0,6
14888,2019-08-19,서대문구,0.0,0,4,0,1,5
14889,2019-08-19,서초구,0.0,0,2,1,1,4
14890,2019-08-19,성동구,0.0,0,5,0,0,5
14891,2019-08-19,성북구,0.0,0,9,0,1,10
14892,2019-08-19,송파구,0.0,0,4,2,3,9
14893,2019-08-19,양천구,0.0,0,6,0,2,8
14894,2019-08-19,영등포구,0.0,0,4,1,1,6
14895,2019-08-19,용산구,0.0,0,2,0,0,2
14896,2019-08-19,은평구,0.0,0,0,0,0,0
14897,2019-08-19,종로구,0.0,0,0,0,0,0
14898,2019-08-19,중구,0.0,0,2,0,0,2
14899,2019-08-19,중랑구,0.0,0,5,2,2,9
14900,2019-08-20,강남구,0.0,0,3,1,1,5
14901,2019-08-20,강동구,0.0,0,6,1,3,10
14902,2019-08-20,강북구,0.0,0,4,0,1,5
14903,2019-08-20,강서구,0.0,0,6,0,2,8
14904,2019-08-20,관악구,0.0,0,5,0,1,6
14905,2019-08-20,광진구,0.0,0,3,0,1,4
14906,2019-08-20,구로구,0.0,0,5,1,1,7
14907,2019-08-20,금천구,0.0,0,1,0,1,2
14908,2019-08-20,노원구,0.0,0,1,0,1,2
14909,2019-08-20,도봉구,0.0,0,2,2,0,4
14910,2019-08-20,동대문구,0.0,0,4,1,0,5
14911,2019-08-20,동작구,0.0,0,4,0,1,5
14912,2019-08-20,마포구,0.0,0,3,0,2,5
14913,2019-08-20,서대문구,0.0,0,1,0,1,2
14914,2019-08-20,서초구,0.0,0,14,1,1,16
14915,2019-08-20,성동구,0.0,0,4,0,0,4
14916,2019-08-20,성북구,0.0,0,9,0,0,9
14917,2019-08-20,송파구,0.0,1,5,0,3,9
14918,2019-08-20,양천구,0.0,0,9,0,3,12
14919,2019-08-20,영등포구,0.0,0,5,0,1,6
14920,2019-08-20,용산구,0.0,0,2,0,0,2
14921,2019-08-20,은평구,0.0,0,0,0,0,0
14922,2019-08-20,종로구,0.0,0,2,0,0,2
14923,2019-08-20,중구,0.0,0,1,1,1,3
14924,2019-08-20,중랑구,0.0,0,2,0,1,3
14925,2019-08-21,강남구,0.5,0,14,1,4,19
14926,2019-08-21,강동구,2.0,0,4,2,0,6
14927,2019-08-21,강북구,0.5,0,3,0,1,4
14928,2019-08-21,강서구,0.5,0,1,0,1,2
14929,2019-08-21,관악구,0.0,0,4,2,0,6
14930,2019-08-21,광진구,1.5,0,7,0,0,7
14931,2019-08-21,구로구,1.0,0,4,0,2,6
14932,2019-08-21,금천구,0.5,0,2,0,2,4
14933,2019-08-21,노원구,0.5,0,4,0,2,6
14934,2019-08-21,도봉구,0.5,0,2,0,1,3
14935,2019-08-21,동대문구,1.0,0,7,1,3,11
14936,2019-08-21,동작구,0.5,0,2,0,1,3
14937,2019-08-21,마포구,1.0,0,6,0,1,7
14938,2019-08-21,서대문구,1.0,0,0,1,0,1
14939,2019-08-21,서초구,0.5,0,10,0,2,12
14940,2019-08-21,성동구,1.5,0,6,0,0,6
14941,2019-08-21,성북구,0.5,0,5,1,0,6
14942,2019-08-21,송파구,1.0,0,11,2,0,13
14943,2019-08-21,양천구,1.0,0,6,0,3,9
14944,2019-08-21,영등포구,1.0,0,7,0,4,11
14945,2019-08-21,용산구,1.0,1,4,1,0,6
14946,2019-08-21,은평구,0.5,0,3,0,3,6
14947,2019-08-21,종로구,1.3,0,4,0,1,5
14948,2019-08-21,중구,1.0,0,2,0,1,3
14949,2019-08-21,중랑구,1.0,0,4,0,1,5
14950,2019-08-22,강남구,0.0,0,11,0,2,13
14951,2019-08-22,강동구,0.0,0,9,1,0,10
14952,2019-08-22,강북구,0.0,0,3,0,0,3
14953,2019-08-22,강서구,0.0,0,10,0,1,11
14954,2019-08-22,관악구,0.0,0,5,1,1,7
14955,2019-08-22,광진구,0.0,0,4,0,0,4
14956,2019-08-22,구로구,0.0,0,5,0,1,6
14957,2019-08-22,금천구,0.0,0,2,1,0,3
14958,2019-08-22,노원구,0.0,0,5,1,1,7
14959,2019-08-22,도봉구,0.0,0,1,1,1,3
14960,2019-08-22,동대문구,0.0,0,9,0,2,11
14961,2019-08-22,동작구,0.0,0,6,1,1,8
14962,2019-08-22,마포구,0.0,0,8,1,0,9
14963,2019-08-22,서대문구,0.0,0,1,0,0,1
14964,2019-08-22,서초구,0.0,0,5,1,5,11
14965,2019-08-22,성동구,0.0,0,3,0,1,4
14966,2019-08-22,성북구,0.0,0,7,0,2,9
14967,2019-08-22,송파구,0.0,0,11,1,2,14
14968,2019-08-22,양천구,0.0,0,7,0,0,7
14969,2019-08-22,영등포구,0.0,0,2,2,1,5
14970,2019-08-22,용산구,0.0,0,0,0,2,2
14971,2019-08-22,은평구,0.0,0,3,1,1,5
14972,2019-08-22,종로구,0.0,0,4,5,0,9
14973,2019-08-22,중구,0.0,0,3,0,0,3
14974,2019-08-22,중랑구,0.0,0,3,0,4,7
14975,2019-08-23,강남구,0.0,0,11,2,3,16
14976,2019-08-23,강동구,0.0,0,1,1,2,4
14977,2019-08-23,강북구,0.0,0,5,0,1,6
14978,2019-08-23,강서구,0.0,0,6,0,1,7
14979,2019-08-23,관악구,0.0,0,1,0,0,1
14980,2019-08-23,광진구,0.0,0,1,0,0,1
14981,2019-08-23,구로구,0.0,0,3,2,1,6
14982,2019-08-23,금천구,0.0,0,7,1,3,11
14983,2019-08-23,노원구,0.0,0,1,0,3,4
14984,2019-08-23,도봉구,0.0,0,4,0,2,6
14985,2019-08-23,동대문구,0.0,0,7,1,2,10
14986,2019-08-23,동작구,0.0,0,1,0,0,1
14987,2019-08-23,마포구,0.0,0,8,1,1,10
14988,2019-08-23,서대문구,0.0,0,4,1,0,5
14989,2019-08-23,서초구,0.0,0,16,0,1,17
14990,2019-08-23,성동구,0.0,0,3,0,2,5
14991,2019-08-23,성북구,0.0,0,5,2,1,8
14992,2019-08-23,송파구,0.0,0,3,0,1,4
14993,2019-08-23,양천구,0.0,0,5,0,2,7
14994,2019-08-23,영등포구,0.0,0,7,1,2,10
14995,2019-08-23,용산구,0.0,0,1,1,4,6
14996,2019-08-23,은평구,0.0,0,2,0,1,3
14997,2019-08-23,종로구,0.0,0,0,2,1,3
14998,2019-08-23,중구,0.0,0,3,0,1,4
14999,2019-08-23,중랑구,0.0,0,9,0,1,10
15000,2019-08-24,강남구,0.0,0,10,0,3,13
15001,2019-08-24,강동구,0.0,0,2,0,0,2
15002,2019-08-24,강북구,0.0,0,4,0,0,4
15003,2019-08-24,강서구,0.0,0,4,0,4,8
15004,2019-08-24,관악구,0.0,0,4,4,1,9
15005,2019-08-24,광진구,0.0,0,2,1,0,3
15006,2019-08-24,구로구,0.0,0,5,0,0,5
15007,2019-08-24,금천구,0.0,0,0,0,0,0
15008,2019-08-24,노원구,0.0,0,9,2,0,11
15009,2019-08-24,도봉구,0.0,0,4,0,0,4
15010,2019-08-24,동대문구,0.0,0,0,0,1,1
15011,2019-08-24,동작구,0.0,0,10,1,0,11
15012,2019-08-24,마포구,0.0,0,2,1,3,6
15013,2019-08-24,서대문구,0.0,0,6,2,0,8
15014,2019-08-24,서초구,0.0,0,3,0,1,4
15015,2019-08-24,성동구,0.0,0,2,1,0,3
15016,2019-08-24,성북구,0.0,0,6,0,3,9
15017,2019-08-24,송파구,0.0,0,13,2,1,16
15018,2019-08-24,양천구,0.0,0,4,0,0,4
15019,2019-08-24,영등포구,0.0,0,9,0,4,13
15020,2019-08-24,용산구,0.0,0,9,0,1,10
15021,2019-08-24,은평구,0.0,0,9,2,4,15
15022,2019-08-24,종로구,0.0,0,10,1,1,12
15023,2019-08-24,중구,0.0,0,5,0,0,5
15024,2019-08-24,중랑구,0.0,0,9,1,2,12
15025,2019-08-25,강남구,0.0,0,13,1,3,17
15026,2019-08-25,강동구,0.0,0,5,0,1,6
15027,2019-08-25,강북구,0.0,0,2,0,1,3
15028,2019-08-25,강서구,0.0,0,9,0,1,10
15029,2019-08-25,관악구,0.0,0,2,0,0,2
15030,2019-08-25,광진구,0.0,0,4,0,0,4
15031,2019-08-25,구로구,0.0,0,0,0,0,0
15032,2019-08-25,금천구,0.0,0,8,5,0,13
15033,2019-08-25,노원구,0.0,0,2,1,1,4
15034,2019-08-25,도봉구,0.0,0,1,0,0,1
15035,2019-08-25,동대문구,0.0,0,5,0,1,6
15036,2019-08-25,동작구,0.0,0,1,0,0,1
15037,2019-08-25,마포구,0.0,0,9,1,1,11
15038,2019-08-25,서대문구,0.0,0,1,1,0,2
15039,2019-08-25,서초구,0.0,0,6,0,0,6
15040,2019-08-25,성동구,0.0,0,4,0,0,4
15041,2019-08-25,성북구,0.0,0,6,1,1,8
15042,2019-08-25,송파구,0.0,0,5,3,3,11
15043,2019-08-25,양천구,0.0,0,0,1,2,3
15044,2019-08-25,영등포구,0.0,0,3,3,2,8
15045,2019-08-25,용산구,0.0,0,2,0,0,2
15046,2019-08-25,은평구,0.0,0,0,0,0,0
15047,2019-08-25,종로구,0.0,0,3,0,0,3
15048,2019-08-25,중구,0.0,0,2,0,2,4
15049,2019-08-25,중랑구,0.0,1,0,1,0,2
15050,2019-08-26,강남구,0.0,0,15,0,2,17
15051,2019-08-26,강동구,0.0,0,2,0,2,4
15052,2019-08-26,강북구,0.0,0,6,0,1,7
15053,2019-08-26,강서구,0.0,0,2,0,1,3
15054,2019-08-26,관악구,0.0,0,1,0,0,1
15055,2019-08-26,광진구,0.0,0,2,0,0,2
15056,2019-08-26,구로구,0.0,0,3,1,2,6
15057,2019-08-26,금천구,0.0,0,3,0,1,4
15058,2019-08-26,노원구,0.0,0,6,2,1,9
15059,2019-08-26,도봉구,0.0,0,4,4,1,9
15060,2019-08-26,동대문구,0.0,0,5,2,0,7
15061,2019-08-26,동작구,0.0,0,2,0,0,2
15062,2019-08-26,마포구,0.0,0,3,0,0,3
15063,2019-08-26,서대문구,0.0,0,6,1,1,8
15064,2019-08-26,서초구,0.0,0,1,1,0,2
15065,2019-08-26,성동구,0.0,0,4,0,1,5
15066,2019-08-26,성북구,0.0,0,5,0,1,6
15067,2019-08-26,송파구,0.0,0,7,2,5,14
15068,2019-08-26,양천구,0.0,0,8,0,1,9
15069,2019-08-26,영등포구,0.0,0,5,2,0,7
15070,2019-08-26,용산구,0.0,0,1,0,0,1
15071,2019-08-26,은평구,0.0,1,1,0,3,5
15072,2019-08-26,종로구,0.0,0,1,0,0,1
15073,2019-08-26,중구,0.0,0,2,0,2,4
15074,2019-08-26,중랑구,0.0,0,11,2,4,17
15075,2019-08-27,강남구,2.5,0,15,1,2,18
15076,2019-08-27,강동구,2.5,0,6,0,0,6
15077,2019-08-27,강북구,2.0,0,6,2,0,8
15078,2019-08-27,강서구,4.0,0,11,1,3,15
15079,2019-08-27,관악구,3.5,0,2,0,2,4
15080,2019-08-27,광진구,4.5,0,5,1,1,7
15081,2019-08-27,구로구,6.0,0,1,0,1,2
15082,2019-08-27,금천구,2.5,0,2,0,2,4
15083,2019-08-27,노원구,5.5,0,6,0,1,7
15084,2019-08-27,도봉구,1.5,0,1,0,0,1
15085,2019-08-27,동대문구,3.5,1,3,0,1,5
15086,2019-08-27,동작구,14.0,0,3,0,1,4
15087,2019-08-27,마포구,6.5,0,7,0,0,7
15088,2019-08-27,서대문구,18.0,0,2,0,0,2
15089,2019-08-27,서초구,3.5,0,14,2,2,18
15090,2019-08-27,성동구,7.5,0,0,0,1,1
15091,2019-08-27,성북구,8.5,0,2,0,0,2
15092,2019-08-27,송파구,2.5,0,3,1,4,8
15093,2019-08-27,양천구,11.5,0,8,1,3,12
15094,2019-08-27,영등포구,22.5,0,3,2,1,6
15095,2019-08-27,용산구,15.5,0,4,0,0,4
15096,2019-08-27,은평구,1.5,0,1,0,1,2
15097,2019-08-27,종로구,20.0,0,2,2,1,5
15098,2019-08-27,중구,8.5,0,1,0,2,3
15099,2019-08-27,중랑구,9.5,0,0,1,0,1
15100,2019-08-28,강남구,0.5,0,8,0,0,8
15101,2019-08-28,강동구,0.0,0,5,0,0,5
15102,2019-08-28,강북구,0.0,0,4,0,1,5
15103,2019-08-28,강서구,0.0,0,9,1,3,13
15104,2019-08-28,관악구,0.0,0,4,0,2,6
15105,2019-08-28,광진구,0.5,0,2,0,1,3
15106,2019-08-28,구로구,0.0,0,2,1,0,3
15107,2019-08-28,금천구,0.0,0,3,0,0,3
15108,2019-08-28,노원구,0.0,0,1,0,2,3
15109,2019-08-28,도봉구,0.0,0,2,0,0,2
15110,2019-08-28,동대문구,0.0,0,6,0,1,7
15111,2019-08-28,동작구,0.0,0,7,2,0,9
15112,2019-08-28,마포구,0.0,0,0,0,1,1
15113,2019-08-28,서대문구,0.0,0,0,0,6,6
15114,2019-08-28,서초구,0.0,0,14,0,0,14
15115,2019-08-28,성동구,0.0,0,0,0,0,0
15116,2019-08-28,성북구,0.0,0,3,2,0,5
15117,2019-08-28,송파구,0.0,0,11,1,1,13
15118,2019-08-28,양천구,0.0,0,3,0,0,3
15119,2019-08-28,영등포구,0.0,0,10,1,0,11
15120,2019-08-28,용산구,0.0,0,1,0,0,1
15121,2019-08-28,은평구,0.0,0,0,0,0,0
15122,2019-08-28,종로구,0.0,0,7,4,3,14
15123,2019-08-28,중구,0.0,0,2,2,0,4
15124,2019-08-28,중랑구,0.0,0,4,0,0,4
15125,2019-08-29,강남구,45.5,0,21,0,4,25
15126,2019-08-29,강동구,27.5,1,1,0,0,2
15127,2019-08-29,강북구,29.0,0,1,0,0,1
15128,2019-08-29,강서구,32.0,1,8,1,0,10
15129,2019-08-29,관악구,51.75,0,6,0,3,9
15130,2019-08-29,광진구,55.0,0,5,1,0,6
15131,2019-08-29,구로구,72.0,0,4,0,1,5
15132,2019-08-29,금천구,38.0,0,4,0,2,6
15133,2019-08-29,노원구,22.5,0,2,0,3,5
15134,2019-08-29,도봉구,13.0,0,4,1,0,5
15135,2019-08-29,동대문구,24.5,0,4,2,0,6
15136,2019-08-29,동작구,58.0,0,5,0,0,5
15137,2019-08-29,마포구,52.5,0,1,1,0,2
15138,2019-08-29,서대문구,36.5,1,5,0,2,8
15139,2019-08-29,서초구,55.0,0,9,1,2,12
15140,2019-08-29,성동구,44.0,0,2,0,1,3
15141,2019-08-29,성북구,22.5,0,7,0,1,8
15142,2019-08-29,송파구,59.5,0,7,2,3,12
15143,2019-08-29,양천구,78.0,0,3,0,0,3
15144,2019-08-29,영등포구,65.75,0,5,0,1,6
15145,2019-08-29,용산구,61.5,0,8,0,0,8
15146,2019-08-29,은평구,11.0,0,1,0,0,1
15147,2019-08-29,종로구,36.9,0,8,0,0,8
15148,2019-08-29,중구,19.5,0,1,0,0,1
15149,2019-08-29,중랑구,22.0,0,2,0,1,3
15150,2019-08-30,강남구,0.0,0,11,4,2,17
15151,2019-08-30,강동구,6.0,0,0,0,0,0
15152,2019-08-30,강북구,5.5,0,10,0,1,11
15153,2019-08-30,강서구,0.0,0,9,2,4,15
15154,2019-08-30,관악구,0.0,0,10,1,3,14
15155,2019-08-30,광진구,0.0,0,7,0,1,8
15156,2019-08-30,구로구,0.0,0,6,0,1,7
15157,2019-08-30,금천구,0.0,0,1,0,0,1
15158,2019-08-30,노원구,6.5,0,2,0,1,3
15159,2019-08-30,도봉구,2.0,0,0,0,1,1
15160,2019-08-30,동대문구,4.5,0,9,1,1,11
15161,2019-08-30,동작구,0.5,0,0,0,0,0
15162,2019-08-30,마포구,0.0,0,4,2,1,7
15163,2019-08-30,서대문구,0.0,0,5,1,0,6
15164,2019-08-30,서초구,1.0,0,3,0,2,5
15165,2019-08-30,성동구,0.5,0,4,0,0,4
15166,2019-08-30,성북구,4.0,0,15,3,0,18
15167,2019-08-30,송파구,0.0,0,1,3,2,6
15168,2019-08-30,양천구,0.0,0,3,1,1,5
15169,2019-08-30,영등포구,0.0,0,2,0,4,6
15170,2019-08-30,용산구,0.0,0,1,0,0,1
15171,2019-08-30,은평구,12.0,1,10,0,1,12
15172,2019-08-30,종로구,0.2,0,4,0,1,5
15173,2019-08-30,중구,0.0,0,5,0,0,5
15174,2019-08-30,중랑구,7.0,0,3,3,5,11
15175,2019-08-31,강남구,0.0,0,7,1,2,10
15176,2019-08-31,강동구,0.0,0,4,1,3,8
15177,2019-08-31,강북구,0.0,0,6,1,1,8
15178,2019-08-31,강서구,0.0,0,15,0,1,16
15179,2019-08-31,관악구,0.0,0,2,0,1,3
15180,2019-08-31,광진구,0.0,0,3,0,2,5
15181,2019-08-31,구로구,0.0,0,5,2,0,7
15182,2019-08-31,금천구,0.0,0,4,0,1,5
15183,2019-08-31,노원구,0.0,0,3,0,2,5
15184,2019-08-31,도봉구,0.0,0,1,0,6,7
15185,2019-08-31,동대문구,0.0,0,4,1,2,7
15186,2019-08-31,동작구,0.0,0,3,1,3,7
15187,2019-08-31,마포구,0.0,0,10,2,5,17
15188,2019-08-31,서대문구,0.0,0,1,0,2,3
15189,2019-08-31,서초구,0.0,0,7,1,3,11
15190,2019-08-31,성동구,0.0,0,3,0,0,3
15191,2019-08-31,성북구,0.0,0,1,0,0,1
15192,2019-08-31,송파구,0.0,0,11,0,3,14
15193,2019-08-31,양천구,0.0,0,8,0,0,8
15194,2019-08-31,영등포구,0.0,0,15,1,2,18
15195,2019-08-31,용산구,0.0,0,8,1,0,9
15196,2019-08-31,은평구,0.0,0,2,0,4,6
15197,2019-08-31,종로구,0.0,0,7,0,2,9
15198,2019-08-31,중구,0.0,0,4,1,3,8
15199,2019-08-31,중랑구,0.0,0,7,0,2,9
15200,2019-09-01,강남구,0.0,0,8,1,1,10
15201,2019-09-01,강동구,0.0,0,3,0,0,3
15202,2019-09-01,강북구,0.0,0,2,0,0,2
15203,2019-09-01,강서구,0.0,0,2,1,0,3
15204,2019-09-01,관악구,0.0,0,7,1,0,8
15205,2019-09-01,광진구,0.0,0,4,0,0,4
15206,2019-09-01,구로구,0.0,0,5,0,1,6
15207,2019-09-01,금천구,0.0,0,1,0,0,1
15208,2019-09-01,노원구,0.0,0,0,0,2,2
15209,2019-09-01,도봉구,0.0,0,9,0,0,9
15210,2019-09-01,동대문구,0.0,0,6,0,2,8
15211,2019-09-01,동작구,0.0,0,3,3,1,7
15212,2019-09-01,마포구,0.0,0,2,0,0,2
15213,2019-09-01,서대문구,0.0,0,5,1,3,9
15214,2019-09-01,서초구,0.0,0,5,0,1,6
15215,2019-09-01,성동구,0.0,0,2,1,0,3
15216,2019-09-01,성북구,0.0,0,2,0,3,5
15217,2019-09-01,송파구,0.0,0,9,1,1,11
15218,2019-09-01,양천구,0.0,0,1,1,1,3
15219,2019-09-01,영등포구,0.0,0,8,0,1,9
15220,2019-09-01,용산구,0.0,0,7,0,0,7
15221,2019-09-01,은평구,0.0,0,0,0,1,1
15222,2019-09-01,종로구,0.0,0,6,1,2,9
15223,2019-09-01,중구,0.0,0,0,1,0,1
15224,2019-09-01,중랑구,0.0,0,3,0,1,4
15225,2019-09-02,강남구,0.0,0,17,1,2,20
15226,2019-09-02,강동구,0.0,1,1,0,2,4
15227,2019-09-02,강북구,0.0,0,7,0,2,9
15228,2019-09-02,강서구,0.0,0,2,0,0,2
15229,2019-09-02,관악구,0.0,0,9,0,0,9
15230,2019-09-02,광진구,0.0,0,6,0,2,8
15231,2019-09-02,구로구,0.0,0,5,0,1,6
15232,2019-09-02,금천구,0.0,0,2,0,3,5
15233,2019-09-02,노원구,0.0,0,19,1,3,23
15234,2019-09-02,도봉구,0.0,0,1,0,0,1
15235,2019-09-02,동대문구,0.0,1,2,0,3,6
15236,2019-09-02,동작구,0.0,0,4,0,0,4
15237,2019-09-02,마포구,0.0,0,8,0,2,10
15238,2019-09-02,서대문구,0.0,0,2,0,1,3
15239,2019-09-02,서초구,0.0,0,3,0,2,5
15240,2019-09-02,성동구,0.0,0,2,0,1,3
15241,2019-09-02,성북구,0.0,0,6,2,0,8
15242,2019-09-02,송파구,0.0,0,3,0,4,7
15243,2019-09-02,양천구,0.0,0,1,3,1,5
15244,2019-09-02,영등포구,0.0,0,11,1,1,13
15245,2019-09-02,용산구,0.0,0,0,0,1,1
15246,2019-09-02,은평구,0.0,0,2,1,0,3
15247,2019-09-02,종로구,0.0,0,3,1,0,4
15248,2019-09-02,중구,0.0,0,8,1,1,10
15249,2019-09-02,중랑구,0.0,0,11,1,4,16
15250,2019-09-03,강남구,0.0,0,4,0,5,9
15251,2019-09-03,강동구,1.0,0,0,0,0,0
15252,2019-09-03,강북구,1.0,0,1,0,1,2
15253,2019-09-03,강서구,0.5,0,7,0,1,8
15254,2019-09-03,관악구,1.5,0,2,1,5,8
15255,2019-09-03,광진구,0.0,0,4,0,2,6
15256,2019-09-03,구로구,0.0,0,4,0,3,7
15257,2019-09-03,금천구,0.5,0,3,0,1,4
15258,2019-09-03,노원구,4.5,1,8,0,0,9
15259,2019-09-03,도봉구,1.5,0,2,0,0,2
15260,2019-09-03,동대문구,0.0,0,8,0,4,12
15261,2019-09-03,동작구,3.25,0,5,0,2,7
15262,2019-09-03,마포구,1.0,0,5,0,3,8
15263,2019-09-03,서대문구,0.0,0,3,0,2,5
15264,2019-09-03,서초구,1.0,0,7,1,5,13
15265,2019-09-03,성동구,0.0,0,3,0,2,5
15266,2019-09-03,성북구,0.0,0,6,3,1,10
15267,2019-09-03,송파구,0.0,0,7,1,2,10
15268,2019-09-03,양천구,3.0,0,4,0,0,4
15269,2019-09-03,영등포구,1.75,0,5,0,0,5
15270,2019-09-03,용산구,1.0,0,0,0,0,0
15271,2019-09-03,은평구,0.0,0,5,1,2,8
15272,2019-09-03,종로구,0.0,0,2,0,2,4
15273,2019-09-03,중구,0.0,0,6,0,0,6
15274,2019-09-03,중랑구,0.5,0,2,0,2,4
15275,2019-09-04,강남구,0.0,0,10,0,1,11
15276,2019-09-04,강동구,13.0,0,11,0,3,14
15277,2019-09-04,강북구,19.0,0,7,1,0,8
15278,2019-09-04,강서구,55.5,0,3,1,2,6
15279,2019-09-04,관악구,14.5,0,1,0,0,1
15280,2019-09-04,광진구,10.5,0,5,0,3,8
15281,2019-09-04,구로구,47.0,0,8,0,1,9
15282,2019-09-04,금천구,21.5,0,2,0,0,2
15283,2019-09-04,노원구,13.0,0,7,0,0,7
15284,2019-09-04,도봉구,22.5,0,4,2,0,6
15285,2019-09-04,동대문구,13.5,0,7,0,1,8
15286,2019-09-04,동작구,20.5,0,2,1,0,3
15287,2019-09-04,마포구,31.5,0,1,0,0,1
15288,2019-09-04,서대문구,30.5,0,1,0,3,4
15289,2019-09-04,서초구,9.5,0,6,0,0,6
15290,2019-09-04,성동구,12.5,0,1,0,0,1
15291,2019-09-04,성북구,20.5,0,4,0,0,4
15292,2019-09-04,송파구,14.0,0,4,0,3,7
15293,2019-09-04,양천구,40.0,0,2,1,1,4
15294,2019-09-04,영등포구,27.5,0,10,0,0,10
15295,2019-09-04,용산구,18.0,0,0,0,0,0
15296,2019-09-04,은평구,39.0,0,4,0,2,6
15297,2019-09-04,종로구,22.7,0,1,1,1,3
15298,2019-09-04,중구,11.0,0,3,0,0,3
15299,2019-09-04,중랑구,13.0,0,1,5,1,7
15300,2019-09-05,강남구,0.0,0,8,1,2,11
15301,2019-09-05,강동구,66.0,0,4,0,0,4
15302,2019-09-05,강북구,27.0,0,9,0,2,11
15303,2019-09-05,강서구,18.5,0,7,0,0,7
15304,2019-09-05,관악구,51.0,0,7,0,0,7
15305,2019-09-05,광진구,46.5,0,2,0,1,3
15306,2019-09-05,구로구,20.0,0,3,1,2,6
15307,2019-09-05,금천구,46.0,1,3,0,0,4
15308,2019-09-05,노원구,37.5,0,4,0,3,7
15309,2019-09-05,도봉구,38.0,0,5,0,1,6
15310,2019-09-05,동대문구,30.0,0,2,0,2,4
15311,2019-09-05,동작구,60.0,0,4,0,0,4
15312,2019-09-05,마포구,64.5,0,13,0,1,14
15313,2019-09-05,서대문구,56.5,0,4,0,0,4
15314,2019-09-05,서초구,47.5,0,7,0,1,8
15315,2019-09-05,성동구,37.5,0,1,2,1,4
15316,2019-09-05,성북구,30.5,0,0,0,2,2
15317,2019-09-05,송파구,48.5,0,7,3,1,11
15318,2019-09-05,양천구,28.5,0,4,1,2,7
15319,2019-09-05,영등포구,53.5,0,3,0,0,3
15320,2019-09-05,용산구,44.0,0,2,0,2,4
15321,2019-09-05,은평구,52.5,0,1,0,0,1
15322,2019-09-05,종로구,36.4,0,6,0,1,7
15323,2019-09-05,중구,26.5,0,4,1,1,6
15324,2019-09-05,중랑구,39.5,0,8,0,0,8
15325,2019-09-06,강남구,0.0,0,17,2,3,22
15326,2019-09-06,강동구,1.0,0,4,2,0,6
15327,2019-09-06,강북구,3.5,0,8,1,0,9
15328,2019-09-06,강서구,4.5,0,3,0,3,6
15329,2019-09-06,관악구,4.0,0,1,1,1,3
15330,2019-09-06,광진구,0.5,0,4,0,0,4
15331,2019-09-06,구로구,6.5,0,5,2,0,7
15332,2019-09-06,금천구,2.0,0,1,1,2,4
15333,2019-09-06,노원구,1.5,0,8,1,0,9
15334,2019-09-06,도봉구,3.0,0,4,0,0,4
15335,2019-09-06,동대문구,2.0,0,1,0,1,2
15336,2019-09-06,동작구,3.0,0,4,0,2,6
15337,2019-09-06,마포구,5.0,0,12,0,3,15
15338,2019-09-06,서대문구,4.0,0,0,1,1,2
15339,2019-09-06,서초구,0.5,0,1,0,1,2
15340,2019-09-06,성동구,0.5,0,3,0,1,4
15341,2019-09-06,성북구,1.5,0,9,0,1,10
15342,2019-09-06,송파구,1.0,0,9,1,3,13
15343,2019-09-06,양천구,5.5,0,2,2,0,4
15344,2019-09-06,영등포구,4.25,0,9,0,2,11
15345,2019-09-06,용산구,2.0,0,1,0,1,2
15346,2019-09-06,은평구,6.0,0,13,0,2,15
15347,2019-09-06,종로구,2.4,0,7,0,0,7
15348,2019-09-06,중구,1.0,0,3,0,2,5
15349,2019-09-06,중랑구,3.0,1,3,1,5,10
15350,2019-09-07,강남구,0.0,0,11,2,1,14
15351,2019-09-07,강동구,3.5,0,3,2,0,5
15352,2019-09-07,강북구,3.5,0,0,0,0,0
15353,2019-09-07,강서구,3.5,1,6,0,2,9
15354,2019-09-07,관악구,3.5,0,1,0,0,1
15355,2019-09-07,광진구,2.0,0,5,0,1,6
15356,2019-09-07,구로구,2.5,0,0,0,0,0
15357,2019-09-07,금천구,1.5,0,1,2,0,3
15358,2019-09-07,노원구,4.0,0,3,0,0,3
15359,2019-09-07,도봉구,7.0,0,2,1,0,3
15360,2019-09-07,동대문구,2.5,0,5,2,3,10
15361,2019-09-07,동작구,2.75,0,2,0,1,3
15362,2019-09-07,마포구,2.5,0,4,0,0,4
15363,2019-09-07,서대문구,2.5,0,5,1,2,8
15364,2019-09-07,서초구,2.0,0,8,0,1,9
15365,2019-09-07,성동구,2.5,0,0,0,1,1
15366,2019-09-07,성북구,2.0,0,0,0,0,0
15367,2019-09-07,송파구,2.5,0,14,0,0,14
15368,2019-09-07,양천구,3.0,0,3,0,0,3
15369,2019-09-07,영등포구,1.0,0,2,1,0,3
15370,2019-09-07,용산구,1.5,0,4,0,0,4
15371,2019-09-07,은평구,4.5,0,2,2,3,7
15372,2019-09-07,종로구,2.8,0,0,0,0,0
15373,2019-09-07,중구,2.0,0,7,1,2,10
15374,2019-09-07,중랑구,2.5,0,4,1,1,6
15375,2019-09-08,강남구,0.0,0,2,2,0,4
15376,2019-09-08,강동구,0.0,0,0,0,0,0
15377,2019-09-08,강북구,0.0,0,0,0,0,0
15378,2019-09-08,강서구,0.0,0,5,1,3,9
15379,2019-09-08,관악구,0.0,0,2,1,1,4
15380,2019-09-08,광진구,0.5,0,0,0,1,1
15381,2019-09-08,구로구,0.0,0,6,0,1,7
15382,2019-09-08,금천구,0.5,0,3,0,0,3
15383,2019-09-08,노원구,0.5,0,7,1,0,8
15384,2019-09-08,도봉구,0.0,0,1,0,1,2
15385,2019-09-08,동대문구,0.0,0,3,0,3,6
15386,2019-09-08,동작구,0.25,0,6,1,0,7
15387,2019-09-08,마포구,0.0,0,5,0,2,7
15388,2019-09-08,서대문구,0.0,0,6,0,1,7
15389,2019-09-08,서초구,0.0,0,8,1,1,10
15390,2019-09-08,성동구,0.0,0,5,0,0,5
15391,2019-09-08,성북구,0.0,0,2,0,2,4
15392,2019-09-08,송파구,0.0,0,1,0,0,1
15393,2019-09-08,양천구,0.0,0,2,1,1,4
15394,2019-09-08,영등포구,0.0,0,1,0,0,1
15395,2019-09-08,용산구,0.5,0,4,0,0,4
15396,2019-09-08,은평구,0.0,0,3,1,1,5
15397,2019-09-08,종로구,0.0,0,2,0,0,2
15398,2019-09-08,중구,0.0,0,2,1,0,3
15399,2019-09-08,중랑구,0.5,0,7,0,1,8
15400,2019-09-09,강남구,0.0,0,8,0,0,8
15401,2019-09-09,강동구,1.5,0,1,0,4,5
15402,2019-09-09,강북구,0.0,0,4,0,1,5
15403,2019-09-09,강서구,0.0,0,12,0,3,15
15404,2019-09-09,관악구,0.25,0,5,0,0,5
15405,2019-09-09,광진구,0.0,0,0,0,2,2
15406,2019-09-09,구로구,0.0,0,4,3,0,7
15407,2019-09-09,금천구,0.0,0,2,0,0,2
15408,2019-09-09,노원구,1.0,0,8,0,3,11
15409,2019-09-09,도봉구,0.0,0,2,0,0,2
15410,2019-09-09,동대문구,0.5,0,2,0,2,4
15411,2019-09-09,동작구,0.0,0,2,2,3,7
15412,2019-09-09,마포구,0.0,0,7,0,0,7
15413,2019-09-09,서대문구,0.0,0,7,1,1,9
15414,2019-09-09,서초구,1.0,0,8,1,0,9
15415,2019-09-09,성동구,0.5,0,8,0,2,10
15416,2019-09-09,성북구,0.0,0,5,1,2,8
15417,2019-09-09,송파구,0.5,0,14,0,2,16
15418,2019-09-09,양천구,0.0,0,2,3,1,6
15419,2019-09-09,영등포구,0.0,0,6,1,5,12
15420,2019-09-09,용산구,0.0,0,6,0,1,7
15421,2019-09-09,은평구,0.0,0,2,0,0,2
15422,2019-09-09,종로구,0.0,0,6,0,5,11
15423,2019-09-09,중구,0.0,0,3,0,1,4
15424,2019-09-09,중랑구,0.5,0,8,0,0,8
15425,2019-09-10,강남구,56.5,0,23,3,3,29
15426,2019-09-10,강동구,50.5,0,3,0,0,3
15427,2019-09-10,강북구,71.5,1,8,1,3,13
15428,2019-09-10,강서구,104.0,0,7,0,2,9
15429,2019-09-10,관악구,68.5,0,7,0,5,12
15430,2019-09-10,광진구,56.0,0,0,0,2,2
15431,2019-09-10,구로구,90.0,0,11,1,2,14
15432,2019-09-10,금천구,61.0,0,5,0,3,8
15433,2019-09-10,노원구,56.0,0,5,3,1,9
15434,2019-09-10,도봉구,81.0,0,4,1,0,5
15435,2019-09-10,동대문구,54.0,0,3,0,3,6
15436,2019-09-10,동작구,66.0,0,3,0,2,5
15437,2019-09-10,마포구,54.5,0,7,2,2,11
15438,2019-09-10,서대문구,64.0,0,3,0,2,5
15439,2019-09-10,서초구,56.5,0,13,1,3,17
15440,2019-09-10,성동구,61.5,0,3,0,0,3
15441,2019-09-10,성북구,64.5,0,2,0,3,5
15442,2019-09-10,송파구,54.0,0,7,1,3,11
15443,2019-09-10,양천구,69.5,0,8,0,2,10
15444,2019-09-10,영등포구,68.75,0,3,0,1,4
15445,2019-09-10,용산구,62.0,0,4,0,0,4
15446,2019-09-10,은평구,73.0,0,3,0,2,5
15447,2019-09-10,종로구,63.2,0,8,1,2,11
15448,2019-09-10,중구,41.0,0,8,0,2,10
15449,2019-09-10,중랑구,63.0,0,2,2,2,6
15450,2019-09-11,강남구,9.0,0,8,0,3,11
15451,2019-09-11,강동구,13.5,0,4,0,0,4
15452,2019-09-11,강북구,11.0,0,4,0,0,4
15453,2019-09-11,강서구,4.0,0,8,0,3,11
15454,2019-09-11,관악구,9.0,0,2,0,3,5
15455,2019-09-11,광진구,10.0,0,4,2,2,8
15456,2019-09-11,구로구,6.5,0,1,1,2,4
15457,2019-09-11,금천구,8.0,0,6,0,0,6
15458,2019-09-11,노원구,9.5,0,9,2,1,12
15459,2019-09-11,도봉구,9.5,0,2,0,3,5
15460,2019-09-11,동대문구,9.5,0,6,0,4,10
15461,2019-09-11,동작구,9.25,0,12,0,1,13
15462,2019-09-11,마포구,0.0,0,5,0,2,7
15463,2019-09-11,서대문구,6.0,0,2,2,0,4
15464,2019-09-11,서초구,6.5,0,6,1,0,7
15465,2019-09-11,성동구,10.0,0,5,0,2,7
15466,2019-09-11,성북구,12.5,0,4,0,2,6
15467,2019-09-11,송파구,9.5,0,8,3,2,13
15468,2019-09-11,양천구,8.0,0,2,1,1,4
15469,2019-09-11,영등포구,5.5,0,9,0,0,9
15470,2019-09-11,용산구,7.0,0,2,0,1,3
15471,2019-09-11,은평구,3.0,0,3,0,2,5
15472,2019-09-11,종로구,7.6,0,2,1,1,4
15473,2019-09-11,중구,4.5,0,8,1,4,13
15474,2019-09-11,중랑구,12.5,1,5,3,1,10
15475,2019-09-12,강남구,2.0,0,4,1,0,5
15476,2019-09-12,강동구,0.5,0,3,0,1,4
15477,2019-09-12,강북구,1.5,0,1,0,0,1
15478,2019-09-12,강서구,6.0,0,4,2,2,8
15479,2019-09-12,관악구,14.5,0,4,0,1,5
15480,2019-09-12,광진구,1.0,0,0,0,1,1
15481,2019-09-12,구로구,20.0,0,3,0,0,3
15482,2019-09-12,금천구,20.5,1,1,0,1,3
15483,2019-09-12,노원구,2.5,0,6,0,2,8
15484,2019-09-12,도봉구,2.0,0,5,1,0,6
15485,2019-09-12,동대문구,1.0,0,3,0,0,3
15486,2019-09-12,동작구,11.5,0,0,2,1,3
15487,2019-09-12,마포구,6.5,0,2,2,0,4
15488,2019-09-12,서대문구,6.5,2,9,0,4,15
15489,2019-09-12,서초구,5.0,0,11,1,0,12
15490,2019-09-12,성동구,1.5,0,3,0,0,3
15491,2019-09-12,성북구,3.0,0,1,0,0,1
15492,2019-09-12,송파구,1.5,0,4,1,0,5
15493,2019-09-12,양천구,11.5,0,5,0,0,5
15494,2019-09-12,영등포구,8.75,0,4,0,0,4
15495,2019-09-12,용산구,6.0,0,2,0,1,3
15496,2019-09-12,은평구,6.5,0,0,0,1,1
15497,2019-09-12,종로구,3.9,0,2,0,0,2
15498,2019-09-12,중구,3.0,0,1,0,0,1
15499,2019-09-12,중랑구,0.5,0,5,0,0,5
15500,2019-09-13,강남구,0.0,0,2,0,3,5
15501,2019-09-13,강동구,0.0,0,2,0,0,2
15502,2019-09-13,강북구,0.0,0,0,0,1,1
15503,2019-09-13,강서구,0.0,0,1,0,1,2
15504,2019-09-13,관악구,0.0,0,5,0,0,5
15505,2019-09-13,광진구,0.0,0,4,0,1,5
15506,2019-09-13,구로구,0.5,0,8,0,0,8
15507,2019-09-13,금천구,0.5,0,7,0,0,7
15508,2019-09-13,노원구,0.0,0,5,0,0,5
15509,2019-09-13,도봉구,0.0,0,2,0,1,3
15510,2019-09-13,동대문구,0.0,0,4,0,0,4
15511,2019-09-13,동작구,0.0,0,9,0,1,10
15512,2019-09-13,마포구,0.0,0,1,0,2,3
15513,2019-09-13,서대문구,0.0,0,5,0,0,5
15514,2019-09-13,서초구,0.0,0,21,5,0,26
15515,2019-09-13,성동구,0.0,0,0,0,0,0
15516,2019-09-13,성북구,0.0,0,1,0,1,2
15517,2019-09-13,송파구,0.0,0,4,0,1,5
15518,2019-09-13,양천구,0.0,0,2,0,2,4
15519,2019-09-13,영등포구,0.0,0,8,0,1,9
15520,2019-09-13,용산구,0.0,1,3,0,2,6
15521,2019-09-13,은평구,0.0,0,0,0,0,0
15522,2019-09-13,종로구,0.1,0,2,1,0,3
15523,2019-09-13,중구,0.0,0,3,0,0,3
15524,2019-09-13,중랑구,0.0,0,2,1,1,4
15525,2019-09-14,강남구,1.0,0,3,1,1,5
15526,2019-09-14,강동구,1.0,0,6,2,1,9
15527,2019-09-14,강북구,0.5,0,4,1,0,5
15528,2019-09-14,강서구,0.0,0,4,3,3,10
15529,2019-09-14,관악구,0.25,0,1,0,1,2
15530,2019-09-14,광진구,1.0,0,5,0,0,5
15531,2019-09-14,구로구,1.0,0,0,0,0,0
15532,2019-09-14,금천구,0.5,0,0,0,0,0
15533,2019-09-14,노원구,0.0,0,5,1,2,8
15534,2019-09-14,도봉구,1.0,0,1,0,0,1
15535,2019-09-14,동대문구,0.0,0,4,1,0,5
15536,2019-09-14,동작구,0.75,0,0,1,0,1
15537,2019-09-14,마포구,0.0,0,5,0,1,6
15538,2019-09-14,서대문구,0.0,0,5,0,1,6
15539,2019-09-14,서초구,1.0,0,6,0,2,8
15540,2019-09-14,성동구,0.5,0,1,1,0,2
15541,2019-09-14,성북구,1.0,0,6,0,2,8
15542,2019-09-14,송파구,0.5,0,3,1,1,5
15543,2019-09-14,양천구,0.5,0,1,2,0,3
15544,2019-09-14,영등포구,0.25,0,3,0,0,3
15545,2019-09-14,용산구,1.0,0,2,1,0,3
15546,2019-09-14,은평구,0.5,0,1,1,0,2
15547,2019-09-14,종로구,0.3,0,0,0,1,1
15548,2019-09-14,중구,0.5,0,0,0,0,0
15549,2019-09-14,중랑구,0.0,0,5,0,0,5
15550,2019-09-15,강남구,0.0,0,3,2,1,6
15551,2019-09-15,강동구,0.0,0,0,0,0,0
15552,2019-09-15,강북구,0.0,0,9,0,0,9
15553,2019-09-15,강서구,0.0,0,4,1,1,6
15554,2019-09-15,관악구,0.0,0,0,0,0,0
15555,2019-09-15,광진구,0.0,0,4,0,0,4
15556,2019-09-15,구로구,0.0,0,3,0,2,5
15557,2019-09-15,금천구,0.0,0,1,0,1,2
15558,2019-09-15,노원구,0.0,0,1,0,0,1
15559,2019-09-15,도봉구,0.0,0,5,1,4,10
15560,2019-09-15,동대문구,0.0,0,3,0,3,6
15561,2019-09-15,동작구,0.0,0,1,0,0,1
15562,2019-09-15,마포구,0.0,0,3,0,0,3
15563,2019-09-15,서대문구,0.0,0,1,1,2,4
15564,2019-09-15,서초구,0.0,0,5,0,7,12
15565,2019-09-15,성동구,0.0,0,3,0,0,3
15566,2019-09-15,성북구,0.0,0,0,0,2,2
15567,2019-09-15,송파구,0.0,0,3,0,1,4
15568,2019-09-15,양천구,0.0,0,4,0,1,5
15569,2019-09-15,영등포구,0.0,0,9,5,0,14
15570,2019-09-15,용산구,0.0,0,2,0,1,3
15571,2019-09-15,은평구,0.0,0,4,0,0,4
15572,2019-09-15,종로구,0.0,0,4,1,0,5
15573,2019-09-15,중구,0.0,0,0,0,0,0
15574,2019-09-15,중랑구,0.0,0,0,0,1,1
15575,2019-09-16,강남구,0.0,0,3,0,1,4
15576,2019-09-16,강동구,0.0,0,5,1,0,6
15577,2019-09-16,강북구,0.0,0,3,1,0,4
15578,2019-09-16,강서구,0.0,0,7,0,1,8
15579,2019-09-16,관악구,0.0,0,2,0,0,2
15580,2019-09-16,광진구,0.0,0,0,0,1,1
15581,2019-09-16,구로구,0.0,0,4,0,2,6
15582,2019-09-16,금천구,0.0,0,4,0,0,4
15583,2019-09-16,노원구,0.0,0,5,0,1,6
15584,2019-09-16,도봉구,0.0,0,1,0,0,1
15585,2019-09-16,동대문구,0.0,0,9,0,3,12
15586,2019-09-16,동작구,0.0,0,1,0,0,1
15587,2019-09-16,마포구,0.0,0,2,0,2,4
15588,2019-09-16,서대문구,0.0,0,2,2,1,5
15589,2019-09-16,서초구,0.0,0,6,2,1,9
15590,2019-09-16,성동구,0.0,0,2,0,0,2
15591,2019-09-16,성북구,0.0,0,4,0,0,4
15592,2019-09-16,송파구,0.0,0,11,2,1,14
15593,2019-09-16,양천구,0.0,0,2,3,1,6
15594,2019-09-16,영등포구,0.0,0,1,0,2,3
15595,2019-09-16,용산구,0.0,0,3,0,1,4
15596,2019-09-16,은평구,0.0,0,2,0,1,3
15597,2019-09-16,종로구,0.0,0,5,1,0,6
15598,2019-09-16,중구,0.0,0,1,0,1,2
15599,2019-09-16,중랑구,0.0,0,1,0,2,3
15600,2019-09-17,강남구,0.0,0,8,0,4,12
15601,2019-09-17,강동구,0.0,0,1,2,0,3
15602,2019-09-17,강북구,0.0,0,5,0,1,6
15603,2019-09-17,강서구,0.0,0,12,1,3,16
15604,2019-09-17,관악구,0.0,0,5,0,2,7
15605,2019-09-17,광진구,0.0,0,0,0,2,2
15606,2019-09-17,구로구,0.0,0,6,1,1,8
15607,2019-09-17,금천구,0.0,0,1,1,1,3
15608,2019-09-17,노원구,0.0,0,10,0,0,10
15609,2019-09-17,도봉구,0.0,0,2,0,0,2
15610,2019-09-17,동대문구,0.0,0,2,1,1,4
15611,2019-09-17,동작구,0.0,1,5,0,2,8
15612,2019-09-17,마포구,0.0,0,1,0,1,2
15613,2019-09-17,서대문구,0.0,0,1,2,0,3
15614,2019-09-17,서초구,0.0,0,15,1,4,20
15615,2019-09-17,성동구,0.0,0,1,0,0,1
15616,2019-09-17,성북구,0.0,0,5,0,2,7
15617,2019-09-17,송파구,0.0,0,2,2,4,8
15618,2019-09-17,양천구,0.0,0,2,0,0,2
15619,2019-09-17,영등포구,0.0,0,9,0,2,11
15620,2019-09-17,용산구,0.0,0,2,0,0,2
15621,2019-09-17,은평구,0.0,0,3,0,0,3
15622,2019-09-17,종로구,0.0,0,2,0,0,2
15623,2019-09-17,중구,0.0,0,0,0,0,0
15624,2019-09-17,중랑구,0.0,0,8,2,1,11
15625,2019-09-18,강남구,0.0,0,16,3,4,23
15626,2019-09-18,강동구,0.0,0,3,2,1,6
15627,2019-09-18,강북구,0.0,0,8,1,2,11
15628,2019-09-18,강서구,0.0,0,1,0,0,1
15629,2019-09-18,관악구,0.0,0,2,0,1,3
15630,2019-09-18,광진구,0.0,0,2,0,0,2
15631,2019-09-18,구로구,0.0,0,8,0,1,9
15632,2019-09-18,금천구,0.0,0,0,0,0,0
15633,2019-09-18,노원구,0.0,0,2,1,2,5
15634,2019-09-18,도봉구,0.0,0,1,0,0,1
15635,2019-09-18,동대문구,0.0,0,4,0,4,8
15636,2019-09-18,동작구,0.0,0,1,0,2,3
15637,2019-09-18,마포구,0.0,0,5,1,2,8
15638,2019-09-18,서대문구,0.0,0,5,1,1,7
15639,2019-09-18,서초구,0.0,0,17,2,2,21
15640,2019-09-18,성동구,0.0,0,5,1,1,7
15641,2019-09-18,성북구,0.0,0,1,0,0,1
15642,2019-09-18,송파구,0.0,0,5,2,1,8
15643,2019-09-18,양천구,0.0,0,2,0,0,2
15644,2019-09-18,영등포구,0.0,0,12,2,2,16
15645,2019-09-18,용산구,0.0,0,1,0,3,4
15646,2019-09-18,은평구,0.0,0,3,0,0,3
15647,2019-09-18,종로구,0.0,0,3,1,0,4
15648,2019-09-18,중구,0.0,0,5,1,1,7
15649,2019-09-18,중랑구,0.0,0,3,0,2,5
15650,2019-09-19,강남구,0.0,0,10,0,1,11
15651,2019-09-19,강동구,0.0,0,6,2,2,10
15652,2019-09-19,강북구,0.0,0,5,0,2,7
15653,2019-09-19,강서구,0.0,0,6,3,3,12
15654,2019-09-19,관악구,0.0,0,3,1,0,4
15655,2019-09-19,광진구,0.0,0,2,0,2,4
15656,2019-09-19,구로구,0.0,0,3,0,0,3
15657,2019-09-19,금천구,0.0,0,0,0,0,0
15658,2019-09-19,노원구,0.0,0,2,0,0,2
15659,2019-09-19,도봉구,0.0,0,0,1,0,1
15660,2019-09-19,동대문구,0.0,0,2,1,0,3
15661,2019-09-19,동작구,0.0,0,8,0,0,8
15662,2019-09-19,마포구,0.0,0,3,0,0,3
15663,2019-09-19,서대문구,0.0,0,4,0,3,7
15664,2019-09-19,서초구,0.0,0,5,1,0,6
15665,2019-09-19,성동구,0.0,0,3,0,0,3
15666,2019-09-19,성북구,0.0,0,1,0,1,2
15667,2019-09-19,송파구,0.0,0,9,2,4,15
15668,2019-09-19,양천구,0.0,0,1,0,0,1
15669,2019-09-19,영등포구,0.0,0,8,3,1,12
15670,2019-09-19,용산구,0.0,0,3,0,0,3
15671,2019-09-19,은평구,0.0,0,7,0,0,7
15672,2019-09-19,종로구,0.0,0,2,1,1,4
15673,2019-09-19,중구,0.0,0,3,0,0,3
15674,2019-09-19,중랑구,0.0,0,4,0,2,6
15675,2019-09-20,강남구,0.0,0,15,2,1,18
15676,2019-09-20,강동구,0.0,0,2,0,0,2
15677,2019-09-20,강북구,0.0,0,7,0,0,7
15678,2019-09-20,강서구,0.0,0,4,4,0,8
15679,2019-09-20,관악구,0.0,1,1,1,2,5
15680,2019-09-20,광진구,0.0,0,1,1,0,2
15681,2019-09-20,구로구,0.0,0,4,0,0,4
15682,2019-09-20,금천구,0.0,0,2,0,2,4
15683,2019-09-20,노원구,0.0,0,7,0,0,7
15684,2019-09-20,도봉구,0.0,0,2,1,1,4
15685,2019-09-20,동대문구,0.0,0,4,0,0,4
15686,2019-09-20,동작구,0.0,0,3,0,1,4
15687,2019-09-20,마포구,0.0,0,3,2,1,6
15688,2019-09-20,서대문구,0.0,0,1,1,1,3
15689,2019-09-20,서초구,0.0,0,6,2,3,11
15690,2019-09-20,성동구,0.0,0,4,0,0,4
15691,2019-09-20,성북구,0.0,0,6,0,1,7
15692,2019-09-20,송파구,0.0,0,13,5,0,18
15693,2019-09-20,양천구,0.0,0,0,1,0,1
15694,2019-09-20,영등포구,0.0,0,7,1,1,9
15695,2019-09-20,용산구,0.0,0,4,0,3,7
15696,2019-09-20,은평구,0.0,0,3,0,3,6
15697,2019-09-20,종로구,0.0,0,4,1,2,7
15698,2019-09-20,중구,0.0,0,3,2,4,9
15699,2019-09-20,중랑구,0.0,0,1,0,0,1
15700,2019-09-21,강남구,0.0,0,9,0,3,12
15701,2019-09-21,강동구,0.0,1,1,0,6,8
15702,2019-09-21,강북구,0.0,0,4,0,0,4
15703,2019-09-21,강서구,0.0,0,14,1,5,20
15704,2019-09-21,관악구,0.0,0,2,0,4,6
15705,2019-09-21,광진구,0.0,0,7,0,1,8
15706,2019-09-21,구로구,0.0,0,4,0,1,5
15707,2019-09-21,금천구,0.0,0,0,0,1,1
15708,2019-09-21,노원구,0.0,0,3,0,3,6
15709,2019-09-21,도봉구,0.0,0,0,1,0,1
15710,2019-09-21,동대문구,0.0,0,2,0,0,2
15711,2019-09-21,동작구,0.0,1,2,2,2,7
15712,2019-09-21,마포구,0.0,0,3,4,3,10
15713,2019-09-21,서대문구,0.0,0,5,1,2,8
15714,2019-09-21,서초구,0.0,0,4,1,2,7
15715,2019-09-21,성동구,0.0,0,2,0,0,2
15716,2019-09-21,성북구,0.0,0,7,2,0,9
15717,2019-09-21,송파구,0.0,0,11,0,3,14
15718,2019-09-21,양천구,0.0,0,4,0,0,4
15719,2019-09-21,영등포구,0.0,0,15,0,1,16
15720,2019-09-21,용산구,0.0,0,2,0,1,3
15721,2019-09-21,은평구,0.0,0,1,0,0,1
15722,2019-09-21,종로구,0.0,0,4,0,3,7
15723,2019-09-21,중구,0.0,0,2,0,1,3
15724,2019-09-21,중랑구,0.0,0,3,0,1,4
15725,2019-09-22,강남구,3.5,0,7,1,4,12
15726,2019-09-22,강동구,3.5,0,1,0,3,4
15727,2019-09-22,강북구,0.0,0,6,1,0,7
15728,2019-09-22,강서구,0.0,0,4,1,3,8
15729,2019-09-22,관악구,2.25,0,8,0,0,8
15730,2019-09-22,광진구,2.5,0,1,0,3,4
15731,2019-09-22,구로구,0.0,0,3,1,3,7
15732,2019-09-22,금천구,0.5,0,0,0,1,1
15733,2019-09-22,노원구,0.5,0,7,1,0,8
15734,2019-09-22,도봉구,0.0,0,0,0,2,2
15735,2019-09-22,동대문구,0.5,1,3,1,0,5
15736,2019-09-22,동작구,1.0,0,4,0,2,6
15737,2019-09-22,마포구,0.0,0,7,1,1,9
15738,2019-09-22,서대문구,0.0,0,4,2,0,6
15739,2019-09-22,서초구,3.0,0,10,0,0,10
15740,2019-09-22,성동구,1.0,0,5,0,1,6
15741,2019-09-22,성북구,0.0,0,2,0,0,2
15742,2019-09-22,송파구,3.0,0,8,3,1,12
15743,2019-09-22,양천구,0.0,0,2,0,0,2
15744,2019-09-22,영등포구,0.0,0,8,2,1,11
15745,2019-09-22,용산구,0.0,0,6,0,2,8
15746,2019-09-22,은평구,0.0,0,1,0,0,1
15747,2019-09-22,종로구,0.4,0,0,1,0,1
15748,2019-09-22,중구,0.0,0,0,3,0,3
15749,2019-09-22,중랑구,0.5,0,3,0,1,4
15750,2019-09-23,강남구,0.0,0,6,2,4,12
15751,2019-09-23,강동구,0.0,0,2,0,4,6
15752,2019-09-23,강북구,0.0,0,5,0,1,6
15753,2019-09-23,강서구,0.0,0,3,0,2,5
15754,2019-09-23,관악구,0.0,0,4,0,4,8
15755,2019-09-23,광진구,0.0,0,5,0,4,9
15756,2019-09-23,구로구,0.0,0,7,0,1,8
15757,2019-09-23,금천구,0.0,0,1,0,0,1
15758,2019-09-23,노원구,0.0,0,4,0,1,5
15759,2019-09-23,도봉구,0.0,0,0,0,1,1
15760,2019-09-23,동대문구,0.0,0,2,0,2,4
15761,2019-09-23,동작구,0.0,0,3,2,0,5
15762,2019-09-23,마포구,0.0,0,4,0,1,5
15763,2019-09-23,서대문구,0.0,0,2,0,1,3
15764,2019-09-23,서초구,0.0,2,5,1,0,8
15765,2019-09-23,성동구,0.0,0,3,0,0,3
15766,2019-09-23,성북구,0.0,0,5,0,0,5
15767,2019-09-23,송파구,0.0,0,2,1,3,6
15768,2019-09-23,양천구,0.0,0,6,0,2,8
15769,2019-09-23,영등포구,0.0,0,18,2,2,22
15770,2019-09-23,용산구,0.0,0,1,0,0,1
15771,2019-09-23,은평구,0.0,0,6,0,0,6
15772,2019-09-23,종로구,0.0,0,2,0,1,3
15773,2019-09-23,중구,0.0,0,4,1,3,8
15774,2019-09-23,중랑구,0.0,0,4,0,0,4
15775,2019-09-24,강남구,0.0,0,10,2,4,16
15776,2019-09-24,강동구,0.0,0,5,0,1,6
15777,2019-09-24,강북구,0.0,0,3,0,0,3
15778,2019-09-24,강서구,0.0,0,3,2,2,7
15779,2019-09-24,관악구,0.0,0,2,0,3,5
15780,2019-09-24,광진구,0.0,0,3,0,0,3
15781,2019-09-24,구로구,0.0,0,5,0,1,6
15782,2019-09-24,금천구,0.0,0,3,0,3,6
15783,2019-09-24,노원구,0.0,0,2,1,3,6
15784,2019-09-24,도봉구,0.0,0,1,1,0,2
15785,2019-09-24,동대문구,0.0,0,7,0,5,12
15786,2019-09-24,동작구,0.0,0,1,0,0,1
15787,2019-09-24,마포구,0.0,0,4,0,0,4
15788,2019-09-24,서대문구,0.0,0,0,1,1,2
15789,2019-09-24,서초구,0.0,0,3,2,0,5
15790,2019-09-24,성동구,0.0,0,1,0,0,1
15791,2019-09-24,성북구,0.0,0,4,0,2,6
15792,2019-09-24,송파구,0.0,0,4,2,5,11
15793,2019-09-24,양천구,0.0,0,5,1,1,7
15794,2019-09-24,영등포구,0.0,0,4,0,1,5
15795,2019-09-24,용산구,0.0,0,6,0,0,6
15796,2019-09-24,은평구,0.0,0,5,1,0,6
15797,2019-09-24,종로구,0.0,0,2,0,0,2
15798,2019-09-24,중구,0.0,0,1,1,0,2
15799,2019-09-24,중랑구,0.0,0,5,2,2,9
15800,2019-09-25,강남구,0.0,0,14,0,4,18
15801,2019-09-25,강동구,0.0,0,2,1,0,3
15802,2019-09-25,강북구,0.0,0,4,0,0,4
15803,2019-09-25,강서구,0.0,0,7,0,4,11
15804,2019-09-25,관악구,0.0,0,6,0,1,7
15805,2019-09-25,광진구,0.0,0,0,0,2,2
15806,2019-09-25,구로구,0.0,0,2,0,2,4
15807,2019-09-25,금천구,0.0,0,0,1,0,1
15808,2019-09-25,노원구,0.0,0,5,0,1,6
15809,2019-09-25,도봉구,0.0,0,3,0,1,4
15810,2019-09-25,동대문구,0.0,0,10,3,1,14
15811,2019-09-25,동작구,0.0,0,6,3,2,11
15812,2019-09-25,마포구,0.0,0,2,0,0,2
15813,2019-09-25,서대문구,0.0,0,3,1,0,4
15814,2019-09-25,서초구,0.0,0,5,0,0,5
15815,2019-09-25,성동구,0.0,0,4,1,1,6
15816,2019-09-25,성북구,0.0,0,5,0,1,6
15817,2019-09-25,송파구,0.0,0,11,1,3,15
15818,2019-09-25,양천구,0.0,1,3,0,0,4
15819,2019-09-25,영등포구,0.0,0,2,0,1,3
15820,2019-09-25,용산구,0.0,0,1,0,0,1
15821,2019-09-25,은평구,0.0,0,7,0,1,8
15822,2019-09-25,종로구,0.0,0,10,3,5,18
15823,2019-09-25,중구,0.0,0,0,0,0,0
15824,2019-09-25,중랑구,0.0,0,2,0,1,3
15825,2019-09-26,강남구,0.0,0,14,1,4,19
15826,2019-09-26,강동구,0.0,0,3,0,1,4
15827,2019-09-26,강북구,0.0,0,3,0,0,3
15828,2019-09-26,강서구,0.0,0,2,0,1,3
15829,2019-09-26,관악구,0.0,0,0,0,0,0
15830,2019-09-26,광진구,0.0,0,1,0,0,1
15831,2019-09-26,구로구,0.0,0,5,0,1,6
15832,2019-09-26,금천구,0.0,0,0,0,1,1
15833,2019-09-26,노원구,0.0,0,2,0,0,2
15834,2019-09-26,도봉구,0.0,0,1,1,0,2
15835,2019-09-26,동대문구,0.0,0,2,2,3,7
15836,2019-09-26,동작구,0.0,0,5,1,1,7
15837,2019-09-26,마포구,0.0,0,2,0,0,2
15838,2019-09-26,서대문구,0.0,0,7,3,1,11
15839,2019-09-26,서초구,0.0,0,10,0,0,10
15840,2019-09-26,성동구,0.0,0,4,0,0,4
15841,2019-09-26,성북구,0.0,0,4,0,2,6
15842,2019-09-26,송파구,0.0,0,13,1,2,16
15843,2019-09-26,양천구,0.0,0,5,1,0,6
15844,2019-09-26,영등포구,0.0,0,6,0,2,8
15845,2019-09-26,용산구,0.0,0,1,0,2,3
15846,2019-09-26,은평구,0.0,0,7,0,1,8
15847,2019-09-26,종로구,0.0,0,3,1,0,4
15848,2019-09-26,중구,0.0,0,3,0,0,3
15849,2019-09-26,중랑구,0.0,0,5,0,3,8
15850,2019-09-27,강남구,0.0,0,10,1,5,16
15851,2019-09-27,강동구,0.0,0,2,0,0,2
15852,2019-09-27,강북구,0.0,0,2,0,0,2
15853,2019-09-27,강서구,0.0,0,5,2,1,8
15854,2019-09-27,관악구,0.0,0,7,1,1,9
15855,2019-09-27,광진구,0.0,0,2,0,0,2
15856,2019-09-27,구로구,0.0,0,8,1,3,12
15857,2019-09-27,금천구,0.0,0,0,1,1,2
15858,2019-09-27,노원구,0.0,0,20,0,0,20
15859,2019-09-27,도봉구,0.0,0,0,0,0,0
15860,2019-09-27,동대문구,0.0,0,9,0,1,10
15861,2019-09-27,동작구,0.0,0,1,2,4,7
15862,2019-09-27,마포구,0.0,0,3,1,0,4
15863,2019-09-27,서대문구,0.0,0,7,3,0,10
15864,2019-09-27,서초구,0.0,1,8,0,1,10
15865,2019-09-27,성동구,0.0,0,0,1,2,3
15866,2019-09-27,성북구,0.0,0,6,0,1,7
15867,2019-09-27,송파구,0.0,0,13,2,1,16
15868,2019-09-27,양천구,0.0,0,2,1,1,4
15869,2019-09-27,영등포구,0.0,0,10,0,3,13
15870,2019-09-27,용산구,0.0,0,5,0,0,5
15871,2019-09-27,은평구,0.0,0,4,1,5,10
15872,2019-09-27,종로구,0.0,0,4,0,1,5
15873,2019-09-27,중구,0.0,0,2,0,1,3
15874,2019-09-27,중랑구,0.0,1,6,0,1,8
15875,2019-09-28,강남구,0.0,0,10,3,2,15
15876,2019-09-28,강동구,0.0,0,2,0,2,4
15877,2019-09-28,강북구,0.0,0,3,0,1,4
15878,2019-09-28,강서구,0.0,0,8,1,2,11
15879,2019-09-28,관악구,0.0,0,6,0,1,7
15880,2019-09-28,광진구,0.0,0,2,0,1,3
15881,2019-09-28,구로구,0.0,0,3,1,1,5
15882,2019-09-28,금천구,0.0,0,7,0,2,9
15883,2019-09-28,노원구,0.0,0,6,0,2,8
15884,2019-09-28,도봉구,0.0,0,0,0,1,1
15885,2019-09-28,동대문구,0.0,0,5,0,0,5
15886,2019-09-28,동작구,0.0,0,4,0,1,5
15887,2019-09-28,마포구,0.0,0,4,0,1,5
15888,2019-09-28,서대문구,0.0,0,4,1,1,6
15889,2019-09-28,서초구,0.0,0,5,0,2,7
15890,2019-09-28,성동구,0.0,0,7,0,3,10
15891,2019-09-28,성북구,0.0,0,3,0,4,7
15892,2019-09-28,송파구,0.0,0,14,2,6,22
15893,2019-09-28,양천구,0.0,0,5,0,3,8
15894,2019-09-28,영등포구,0.0,0,18,1,3,22
15895,2019-09-28,용산구,0.0,0,8,0,2,10
15896,2019-09-28,은평구,0.0,0,2,0,2,4
15897,2019-09-28,종로구,0.0,0,3,0,0,3
15898,2019-09-28,중구,0.0,0,3,0,0,3
15899,2019-09-28,중랑구,0.0,0,0,2,3,5
15900,2019-09-29,강남구,0.0,0,8,3,5,16
15901,2019-09-29,강동구,0.0,0,6,2,0,8
15902,2019-09-29,강북구,0.0,0,8,0,0,8
15903,2019-09-29,강서구,0.0,0,3,2,0,5
15904,2019-09-29,관악구,0.0,0,1,0,0,1
15905,2019-09-29,광진구,0.0,0,5,2,2,9
15906,2019-09-29,구로구,0.0,0,2,0,0,2
15907,2019-09-29,금천구,0.0,0,1,0,2,3
15908,2019-09-29,노원구,0.0,0,2,1,2,5
15909,2019-09-29,도봉구,0.0,0,0,1,1,2
15910,2019-09-29,동대문구,0.0,0,2,1,4,7
15911,2019-09-29,동작구,0.0,0,2,1,0,3
15912,2019-09-29,마포구,0.0,1,3,0,0,4
15913,2019-09-29,서대문구,0.0,1,7,1,1,10
15914,2019-09-29,서초구,0.0,0,7,0,1,8
15915,2019-09-29,성동구,0.0,0,4,0,5,9
15916,2019-09-29,성북구,0.0,0,9,0,2,11
15917,2019-09-29,송파구,0.0,0,11,2,3,16
15918,2019-09-29,양천구,0.0,0,8,0,0,8
15919,2019-09-29,영등포구,0.0,0,5,1,1,7
15920,2019-09-29,용산구,0.0,0,8,1,1,10
15921,2019-09-29,은평구,0.0,0,4,0,0,4
15922,2019-09-29,종로구,0.0,0,0,0,0,0
15923,2019-09-29,중구,0.0,0,3,1,0,4
15924,2019-09-29,중랑구,0.0,0,2,1,1,4
15925,2019-09-30,강남구,0.0,0,7,1,7,15
15926,2019-09-30,강동구,0.0,0,4,0,0,4
15927,2019-09-30,강북구,0.0,0,6,1,2,9
15928,2019-09-30,강서구,0.0,0,4,0,0,4
15929,2019-09-30,관악구,0.0,0,2,0,1,3
15930,2019-09-30,광진구,0.0,0,5,0,1,6
15931,2019-09-30,구로구,0.0,0,6,0,0,6
15932,2019-09-30,금천구,0.0,1,2,0,1,4
15933,2019-09-30,노원구,0.0,0,3,1,1,5
15934,2019-09-30,도봉구,0.0,0,3,0,1,4
15935,2019-09-30,동대문구,0.0,0,2,1,2,5
15936,2019-09-30,동작구,0.0,0,1,0,0,1
15937,2019-09-30,마포구,0.0,0,5,0,1,6
15938,2019-09-30,서대문구,0.0,0,5,0,1,6
15939,2019-09-30,서초구,0.0,0,12,0,5,17
15940,2019-09-30,성동구,0.0,0,4,0,4,8
15941,2019-09-30,성북구,0.0,0,6,0,0,6
15942,2019-09-30,송파구,0.0,0,11,2,4,17
15943,2019-09-30,양천구,0.0,0,2,0,0,2
15944,2019-09-30,영등포구,0.0,0,12,1,5,18
15945,2019-09-30,용산구,0.0,0,7,0,1,8
15946,2019-09-30,은평구,0.0,0,4,0,2,6
15947,2019-09-30,종로구,0.0,0,4,0,0,4
15948,2019-09-30,중구,0.0,0,0,0,0,0
15949,2019-09-30,중랑구,0.0,0,4,1,1,6
15950,2019-10-01,강남구,0.0,0,12,2,2,16
15951,2019-10-01,강동구,0.0,0,1,1,1,3
15952,2019-10-01,강북구,0.0,0,3,0,1,4
15953,2019-10-01,강서구,0.0,1,4,0,1,6
15954,2019-10-01,관악구,0.0,0,3,0,1,4
15955,2019-10-01,광진구,0.0,0,3,0,2,5
15956,2019-10-01,구로구,0.0,0,2,0,0,2
15957,2019-10-01,금천구,0.0,1,0,0,2,3
15958,2019-10-01,노원구,0.0,0,3,0,0,3
15959,2019-10-01,도봉구,0.0,0,0,0,1,1
15960,2019-10-01,동대문구,0.0,0,3,0,1,4
15961,2019-10-01,동작구,0.0,0,4,0,3,7
15962,2019-10-01,마포구,0.0,0,1,0,0,1
15963,2019-10-01,서대문구,0.0,0,4,0,1,5
15964,2019-10-01,서초구,0.0,0,3,2,0,5
15965,2019-10-01,성동구,0.0,0,1,0,1,2
15966,2019-10-01,성북구,0.0,0,9,1,0,10
15967,2019-10-01,송파구,0.0,0,12,1,0,13
15968,2019-10-01,양천구,0.0,0,5,0,0,5
15969,2019-10-01,영등포구,0.0,1,17,2,3,23
15970,2019-10-01,용산구,0.0,0,0,0,0,0
15971,2019-10-01,은평구,0.0,1,1,0,4,6
15972,2019-10-01,종로구,0.0,0,1,1,0,2
15973,2019-10-01,중구,0.0,0,7,5,1,13
15974,2019-10-01,중랑구,0.0,0,4,0,2,6
15975,2019-10-02,강남구,24.0,0,8,1,3,12
15976,2019-10-02,강동구,25.0,0,3,1,0,4
15977,2019-10-02,강북구,16.5,0,7,1,1,9
15978,2019-10-02,강서구,15.0,0,3,0,1,4
15979,2019-10-02,관악구,23.5,0,1,2,0,3
15980,2019-10-02,광진구,21.0,0,0,0,0,0
15981,2019-10-02,구로구,19.5,0,5,1,5,11
15982,2019-10-02,금천구,25.5,0,0,0,1,1
15983,2019-10-02,노원구,19.0,0,4,0,3,7
15984,2019-10-02,도봉구,19.5,0,1,0,2,3
15985,2019-10-02,동대문구,19.5,0,4,1,1,6
15986,2019-10-02,동작구,21.0,0,5,1,2,8
15987,2019-10-02,마포구,18.5,0,1,0,0,1
15988,2019-10-02,서대문구,19.0,0,3,0,2,5
15989,2019-10-02,서초구,20.5,1,8,1,1,11
15990,2019-10-02,성동구,18.0,0,2,0,1,3
15991,2019-10-02,성북구,23.0,0,13,1,2,16
15992,2019-10-02,송파구,23.0,0,15,4,2,21
15993,2019-10-02,양천구,17.0,0,5,1,2,8
15994,2019-10-02,영등포구,17.0,0,18,2,2,22
15995,2019-10-02,용산구,18.0,0,3,0,0,3
15996,2019-10-02,은평구,14.0,0,4,0,1,5
15997,2019-10-02,종로구,23.1,0,3,0,1,4
15998,2019-10-02,중구,7.5,0,4,1,4,9
15999,2019-10-02,중랑구,22.5,0,15,0,2,17
16000,2019-10-03,강남구,18.0,1,13,1,2,17
16001,2019-10-03,강동구,15.0,0,5,1,2,8
16002,2019-10-03,강북구,4.0,0,3,0,3,6
16003,2019-10-03,강서구,2.5,0,8,1,3,12
16004,2019-10-03,관악구,10.0,0,6,0,2,8
16005,2019-10-03,광진구,14.5,0,7,0,0,7
16006,2019-10-03,구로구,4.0,0,2,0,2,4
16007,2019-10-03,금천구,5.5,0,0,1,1,2
16008,2019-10-03,노원구,8.5,0,3,0,0,3
16009,2019-10-03,도봉구,4.5,0,4,0,1,5
16010,2019-10-03,동대문구,7.0,0,3,0,0,3
16011,2019-10-03,동작구,6.0,0,5,0,3,8
16012,2019-10-03,마포구,5.0,0,0,1,1,2
16013,2019-10-03,서대문구,4.5,0,2,1,1,4
16014,2019-10-03,서초구,9.5,0,7,0,0,7
16015,2019-10-03,성동구,7.0,0,1,0,1,2
16016,2019-10-03,성북구,4.5,0,3,0,4,7
16017,2019-10-03,송파구,19.5,0,7,1,3,11
16018,2019-10-03,양천구,4.5,0,3,1,1,5
16019,2019-10-03,영등포구,5.0,0,6,0,4,10
16020,2019-10-03,용산구,5.5,0,1,0,0,1
16021,2019-10-03,은평구,4.0,0,4,0,0,4
16022,2019-10-03,종로구,4.6,0,3,0,0,3
16023,2019-10-03,중구,0.0,0,4,0,0,4
16024,2019-10-03,중랑구,10.0,0,8,0,1,9
16025,2019-10-04,강남구,0.0,0,11,1,3,15
16026,2019-10-04,강동구,0.0,0,0,0,0,0
16027,2019-10-04,강북구,0.0,0,5,0,1,6
16028,2019-10-04,강서구,0.0,0,3,0,0,3
16029,2019-10-04,관악구,0.0,0,3,1,0,4
16030,2019-10-04,광진구,0.0,0,3,0,2,5
16031,2019-10-04,구로구,0.0,0,2,1,0,3
16032,2019-10-04,금천구,0.0,0,5,0,0,5
16033,2019-10-04,노원구,0.0,0,8,0,2,10
16034,2019-10-04,도봉구,0.0,0,1,1,0,2
16035,2019-10-04,동대문구,0.0,1,1,1,2,5
16036,2019-10-04,동작구,0.0,0,10,1,0,11
16037,2019-10-04,마포구,0.0,0,4,0,0,4
16038,2019-10-04,서대문구,0.0,0,6,1,1,8
16039,2019-10-04,서초구,0.0,0,11,2,1,14
16040,2019-10-04,성동구,0.0,0,2,0,1,3
16041,2019-10-04,성북구,0.0,0,9,0,2,11
16042,2019-10-04,송파구,0.0,0,14,2,1,17
16043,2019-10-04,양천구,0.0,0,4,0,2,6
16044,2019-10-04,영등포구,0.0,0,8,1,0,9
16045,2019-10-04,용산구,0.0,0,6,0,0,6
16046,2019-10-04,은평구,0.0,0,2,0,3,5
16047,2019-10-04,종로구,0.0,0,4,0,1,5
16048,2019-10-04,중구,0.0,0,2,0,0,2
16049,2019-10-04,중랑구,0.0,0,4,1,3,8
16050,2019-10-05,강남구,0.0,0,8,6,3,17
16051,2019-10-05,강동구,0.5,0,2,0,0,2
16052,2019-10-05,강북구,0.0,0,1,0,0,1
16053,2019-10-05,강서구,0.0,0,4,0,1,5
16054,2019-10-05,관악구,0.0,0,2,1,0,3
16055,2019-10-05,광진구,0.0,0,0,0,0,0
16056,2019-10-05,구로구,0.0,0,9,0,0,9
16057,2019-10-05,금천구,0.0,0,1,0,0,1
16058,2019-10-05,노원구,0.0,0,3,1,3,7
16059,2019-10-05,도봉구,0.0,0,0,1,0,1
16060,2019-10-05,동대문구,0.0,0,6,0,0,6
16061,2019-10-05,동작구,0.0,0,2,2,1,5
16062,2019-10-05,마포구,0.0,0,8,0,1,9
16063,2019-10-05,서대문구,0.0,0,7,0,1,8
16064,2019-10-05,서초구,0.0,0,22,1,1,24
16065,2019-10-05,성동구,0.0,1,4,0,0,5
16066,2019-10-05,성북구,0.0,0,11,0,2,13
16067,2019-10-05,송파구,0.0,0,18,0,3,21
16068,2019-10-05,양천구,0.0,0,13,2,4,19
16069,2019-10-05,영등포구,0.0,0,8,1,4,13
16070,2019-10-05,용산구,0.0,0,2,0,0,2
16071,2019-10-05,은평구,0.0,0,1,1,0,2
16072,2019-10-05,종로구,0.6,0,6,0,0,6
16073,2019-10-05,중구,0.0,0,0,0,0,0
16074,2019-10-05,중랑구,0.0,0,2,2,2,6
16075,2019-10-06,강남구,0.0,0,4,0,1,5
16076,2019-10-06,강동구,0.0,0,6,1,0,7
16077,2019-10-06,강북구,0.0,0,3,2,1,6
16078,2019-10-06,강서구,0.0,0,13,0,2,15
16079,2019-10-06,관악구,0.0,0,1,0,2,3
16080,2019-10-06,광진구,0.0,0,1,0,0,1
16081,2019-10-06,구로구,0.0,0,1,0,0,1
16082,2019-10-06,금천구,0.0,0,3,1,1,5
16083,2019-10-06,노원구,0.0,0,3,0,1,4
16084,2019-10-06,도봉구,0.0,0,0,0,0,0
16085,2019-10-06,동대문구,0.0,0,1,0,0,1
16086,2019-10-06,동작구,0.0,0,1,0,1,2
16087,2019-10-06,마포구,0.0,0,4,1,2,7
16088,2019-10-06,서대문구,0.0,0,2,0,0,2
16089,2019-10-06,서초구,0.0,0,2,0,1,3
16090,2019-10-06,성동구,0.0,0,1,1,1,3
16091,2019-10-06,성북구,0.0,0,0,0,1,1
16092,2019-10-06,송파구,0.0,0,6,3,2,11
16093,2019-10-06,양천구,0.0,0,5,1,0,6
16094,2019-10-06,영등포구,0.0,0,6,2,1,9
16095,2019-10-06,용산구,0.0,0,8,0,2,10
16096,2019-10-06,은평구,0.0,0,4,1,0,5
16097,2019-10-06,종로구,0.0,0,3,0,0,3
16098,2019-10-06,중구,0.0,1,1,0,0,2
16099,2019-10-06,중랑구,0.0,0,8,3,3,14
16100,2019-10-07,강남구,28.0,0,21,1,1,23
16101,2019-10-07,강동구,24.5,0,5,0,1,6
16102,2019-10-07,강북구,22.5,0,2,0,2,4
16103,2019-10-07,강서구,15.0,0,0,0,0,0
16104,2019-10-07,관악구,24.5,0,4,1,1,6
16105,2019-10-07,광진구,25.5,0,4,0,1,5
16106,2019-10-07,구로구,15.5,0,7,0,2,9
16107,2019-10-07,금천구,20.5,0,1,2,1,4
16108,2019-10-07,노원구,21.0,0,6,0,2,8
16109,2019-10-07,도봉구,25.0,0,4,0,1,5
16110,2019-10-07,동대문구,23.0,0,3,1,2,6
16111,2019-10-07,동작구,22.0,0,2,0,2,4
16112,2019-10-07,마포구,21.5,0,5,0,0,5
16113,2019-10-07,서대문구,21.5,0,3,0,1,4
16114,2019-10-07,서초구,27.0,0,5,0,1,6
16115,2019-10-07,성동구,25.5,0,2,0,0,2
16116,2019-10-07,성북구,24.0,0,1,0,0,1
16117,2019-10-07,송파구,25.0,1,8,0,1,10
16118,2019-10-07,양천구,18.0,0,7,2,0,9
16119,2019-10-07,영등포구,19.75,0,5,0,1,6
16120,2019-10-07,용산구,24.5,0,2,0,0,2
16121,2019-10-07,은평구,19.0,0,2,1,1,4
16122,2019-10-07,종로구,25.4,0,6,2,1,9
16123,2019-10-07,중구,9.0,0,4,0,1,5
16124,2019-10-07,중랑구,21.0,0,4,1,4,9
16125,2019-10-08,강남구,0.0,0,24,3,2,29
16126,2019-10-08,강동구,0.0,1,3,0,1,5
16127,2019-10-08,강북구,0.0,0,7,2,0,9
16128,2019-10-08,강서구,0.0,0,8,1,1,10
16129,2019-10-08,관악구,0.0,0,5,0,4,9
16130,2019-10-08,광진구,0.0,0,1,0,0,1
16131,2019-10-08,구로구,0.0,0,9,0,2,11
16132,2019-10-08,금천구,0.0,0,4,0,2,6
16133,2019-10-08,노원구,0.0,0,6,1,6,13
16134,2019-10-08,도봉구,0.0,0,2,0,1,3
16135,2019-10-08,동대문구,0.0,0,4,0,0,4
16136,2019-10-08,동작구,0.0,0,2,0,0,2
16137,2019-10-08,마포구,0.0,0,1,1,0,2
16138,2019-10-08,서대문구,0.0,0,1,0,0,1
16139,2019-10-08,서초구,0.0,0,5,2,5,12
16140,2019-10-08,성동구,0.0,0,4,0,2,6
16141,2019-10-08,성북구,0.0,0,6,1,4,11
16142,2019-10-08,송파구,0.0,0,11,0,3,14
16143,2019-10-08,양천구,0.0,0,5,2,0,7
16144,2019-10-08,영등포구,0.0,0,13,4,3,20
16145,2019-10-08,용산구,0.0,0,4,0,0,4
16146,2019-10-08,은평구,0.0,0,3,0,5,8
16147,2019-10-08,종로구,0.0,0,0,0,1,1
16148,2019-10-08,중구,0.0,0,2,1,0,3
16149,2019-10-08,중랑구,0.0,0,6,1,2,9
16150,2019-10-09,강남구,0.0,0,11,1,2,14
16151,2019-10-09,강동구,0.0,0,3,0,0,3
16152,2019-10-09,강북구,0.0,0,0,0,0,0
16153,2019-10-09,강서구,0.0,0,9,0,1,10
16154,2019-10-09,관악구,0.0,0,2,0,2,4
16155,2019-10-09,광진구,0.0,0,0,0,1,1
16156,2019-10-09,구로구,0.0,1,7,1,1,10
16157,2019-10-09,금천구,0.0,0,2,0,0,2
16158,2019-10-09,노원구,0.0,0,6,0,2,8
16159,2019-10-09,도봉구,0.0,0,1,0,0,1
16160,2019-10-09,동대문구,0.0,0,2,0,2,4
16161,2019-10-09,동작구,0.0,0,2,0,3,5
16162,2019-10-09,마포구,0.0,0,9,0,4,13
16163,2019-10-09,서대문구,0.0,0,2,2,0,4
16164,2019-10-09,서초구,0.0,0,6,0,2,8
16165,2019-10-09,성동구,0.0,0,2,0,0,2
16166,2019-10-09,성북구,0.0,0,6,0,1,7
16167,2019-10-09,송파구,0.0,0,4,1,6,11
16168,2019-10-09,양천구,0.0,0,2,0,0,2
16169,2019-10-09,영등포구,0.0,0,6,0,5,11
16170,2019-10-09,용산구,0.0,0,3,0,1,4
16171,2019-10-09,은평구,0.0,0,1,0,0,1
16172,2019-10-09,종로구,0.0,0,3,0,1,4
16173,2019-10-09,중구,0.0,0,1,0,2,3
16174,2019-10-09,중랑구,0.0,0,2,1,2,5
16175,2019-10-10,강남구,0.0,0,10,0,2,12
16176,2019-10-10,강동구,0.0,0,5,1,3,9
16177,2019-10-10,강북구,0.0,0,5,0,0,5
16178,2019-10-10,강서구,0.0,0,5,1,1,7
16179,2019-10-10,관악구,0.0,0,0,0,2,2
16180,2019-10-10,광진구,0.0,0,1,0,1,2
16181,2019-10-10,구로구,0.0,0,4,0,0,4
16182,2019-10-10,금천구,0.0,0,1,0,1,2
16183,2019-10-10,노원구,0.0,0,3,0,0,3
16184,2019-10-10,도봉구,0.0,0,1,0,2,3
16185,2019-10-10,동대문구,0.0,0,3,2,2,7
16186,2019-10-10,동작구,0.0,0,2,0,0,2
16187,2019-10-10,마포구,0.0,0,4,0,3,7
16188,2019-10-10,서대문구,0.0,0,0,0,0,0
16189,2019-10-10,서초구,0.0,0,6,0,0,6
16190,2019-10-10,성동구,0.0,0,2,0,1,3
16191,2019-10-10,성북구,0.0,0,5,0,0,5
16192,2019-10-10,송파구,0.0,0,4,1,4,9
16193,2019-10-10,양천구,0.0,0,3,0,0,3
16194,2019-10-10,영등포구,0.0,0,9,3,1,13
16195,2019-10-10,용산구,0.0,0,7,0,2,9
16196,2019-10-10,은평구,0.0,0,5,0,3,8
16197,2019-10-10,종로구,0.0,0,1,0,1,2
16198,2019-10-10,중구,0.0,0,2,0,2,4
16199,2019-10-10,중랑구,0.0,0,1,0,2,3
16200,2019-10-11,강남구,0.0,0,7,0,0,7
16201,2019-10-11,강동구,0.0,0,1,2,3,6
16202,2019-10-11,강북구,0.0,0,2,1,2,5
16203,2019-10-11,강서구,0.0,0,4,2,4,10
16204,2019-10-11,관악구,0.0,0,8,0,0,8
16205,2019-10-11,광진구,0.0,0,3,0,2,5
16206,2019-10-11,구로구,0.0,0,1,2,0,3
16207,2019-10-11,금천구,0.0,1,8,0,4,13
16208,2019-10-11,노원구,0.0,0,9,1,0,10
16209,2019-10-11,도봉구,0.0,0,2,1,3,6
16210,2019-10-11,동대문구,0.0,1,7,0,1,9
16211,2019-10-11,동작구,0.0,0,6,2,0,8
16212,2019-10-11,마포구,0.0,0,3,0,2,5
16213,2019-10-11,서대문구,0.0,0,5,0,1,6
16214,2019-10-11,서초구,0.0,0,12,1,2,15
16215,2019-10-11,성동구,0.0,0,5,1,1,7
16216,2019-10-11,성북구,0.0,0,1,0,0,1
16217,2019-10-11,송파구,0.0,0,4,1,0,5
16218,2019-10-11,양천구,0.0,0,8,3,1,12
16219,2019-10-11,영등포구,0.0,0,6,0,4,10
16220,2019-10-11,용산구,0.0,0,1,0,1,2
16221,2019-10-11,은평구,0.0,0,8,0,4,12
16222,2019-10-11,종로구,0.0,0,2,0,3,5
16223,2019-10-11,중구,0.0,0,6,1,0,7
16224,2019-10-11,중랑구,0.0,0,1,1,1,3
16225,2019-10-12,강남구,0.0,0,10,0,2,12
16226,2019-10-12,강동구,0.0,0,4,0,0,4
16227,2019-10-12,강북구,0.0,0,2,0,0,2
16228,2019-10-12,강서구,0.0,0,4,1,2,7
16229,2019-10-12,관악구,0.0,0,0,0,1,1
16230,2019-10-12,광진구,0.0,0,5,0,1,6
16231,2019-10-12,구로구,0.0,0,7,1,1,9
16232,2019-10-12,금천구,0.0,0,0,1,1,2
16233,2019-10-12,노원구,0.0,0,5,1,1,7
16234,2019-10-12,도봉구,0.0,0,9,0,3,12
16235,2019-10-12,동대문구,0.0,0,17,0,0,17
16236,2019-10-12,동작구,0.0,0,6,0,4,10
16237,2019-10-12,마포구,0.0,0,13,0,1,14
16238,2019-10-12,서대문구,0.0,0,21,3,2,26
16239,2019-10-12,서초구,0.0,0,18,2,0,20
16240,2019-10-12,성동구,0.0,1,2,0,1,4
16241,2019-10-12,성북구,0.0,0,7,0,2,9
16242,2019-10-12,송파구,0.0,0,6,5,2,13
16243,2019-10-12,양천구,0.0,0,2,0,0,2
16244,2019-10-12,영등포구,0.0,0,3,2,1,6
16245,2019-10-12,용산구,0.0,0,7,0,1,8
16246,2019-10-12,은평구,0.0,0,1,0,1,2
16247,2019-10-12,종로구,0.0,0,9,1,2,12
16248,2019-10-12,중구,0.0,0,6,0,2,8
16249,2019-10-12,중랑구,0.0,0,2,0,2,4
16250,2019-10-13,강남구,0.0,0,6,0,7,13
16251,2019-10-13,강동구,0.0,0,4,0,1,5
16252,2019-10-13,강북구,0.0,0,3,0,0,3
16253,2019-10-13,강서구,0.0,0,4,0,1,5
16254,2019-10-13,관악구,0.0,0,6,0,0,6
16255,2019-10-13,광진구,0.0,0,2,0,1,3
16256,2019-10-13,구로구,0.0,0,1,0,1,2
16257,2019-10-13,금천구,0.0,0,4,1,0,5
16258,2019-10-13,노원구,0.0,0,3,1,4,8
16259,2019-10-13,도봉구,0.0,0,2,0,0,2
16260,2019-10-13,동대문구,0.0,0,2,0,2,4
16261,2019-10-13,동작구,0.0,0,6,1,1,8
16262,2019-10-13,마포구,0.0,0,0,0,0,0
16263,2019-10-13,서대문구,0.0,0,2,0,0,2
16264,2019-10-13,서초구,0.0,0,3,1,2,6
16265,2019-10-13,성동구,0.0,0,2,1,0,3
16266,2019-10-13,성북구,0.0,0,4,0,2,6
16267,2019-10-13,송파구,0.0,0,8,3,0,11
16268,2019-10-13,양천구,0.0,0,1,1,1,3
16269,2019-10-13,영등포구,0.0,0,7,0,1,8
16270,2019-10-13,용산구,0.0,0,4,0,0,4
16271,2019-10-13,은평구,0.0,0,2,1,0,3
16272,2019-10-13,종로구,0.0,0,6,1,0,7
16273,2019-10-13,중구,0.0,0,2,0,0,2
16274,2019-10-13,중랑구,0.0,0,1,0,1,2
16275,2019-10-14,강남구,0.0,0,12,2,2,16
16276,2019-10-14,강동구,0.0,0,7,0,0,7
16277,2019-10-14,강북구,0.0,0,8,0,1,9
16278,2019-10-14,강서구,0.0,0,8,0,1,9
16279,2019-10-14,관악구,0.0,0,2,0,1,3
16280,2019-10-14,광진구,0.0,0,1,0,3,4
16281,2019-10-14,구로구,0.0,0,2,0,0,2
16282,2019-10-14,금천구,0.0,0,1,0,1,2
16283,2019-10-14,노원구,0.0,0,5,0,1,6
16284,2019-10-14,도봉구,0.0,0,2,0,1,3
16285,2019-10-14,동대문구,0.0,0,4,1,2,7
16286,2019-10-14,동작구,0.0,0,3,0,1,4
16287,2019-10-14,마포구,0.0,0,5,5,2,12
16288,2019-10-14,서대문구,0.0,1,1,0,0,2
16289,2019-10-14,서초구,0.0,0,5,3,2,10
16290,2019-10-14,성동구,0.0,0,0,0,1,1
16291,2019-10-14,성북구,0.0,0,2,0,2,4
16292,2019-10-14,송파구,0.0,0,4,2,4,10
16293,2019-10-14,양천구,0.0,0,7,1,1,9
16294,2019-10-14,영등포구,0.0,0,4,5,2,11
16295,2019-10-14,용산구,0.0,0,2,0,1,3
16296,2019-10-14,은평구,0.0,0,10,2,3,15
16297,2019-10-14,종로구,0.0,0,1,1,2,4
16298,2019-10-14,중구,0.0,0,1,1,2,4
16299,2019-10-14,중랑구,0.0,0,2,0,4,6
16300,2019-10-15,강남구,0.0,0,9,5,1,15
16301,2019-10-15,강동구,0.0,0,1,0,1,2
16302,2019-10-15,강북구,0.0,0,12,0,0,12
16303,2019-10-15,강서구,0.0,0,3,5,3,11
16304,2019-10-15,관악구,0.0,0,2,0,2,4
16305,2019-10-15,광진구,0.0,0,4,1,2,7
16306,2019-10-15,구로구,0.0,0,10,1,1,12
16307,2019-10-15,금천구,0.0,0,13,2,1,16
16308,2019-10-15,노원구,0.0,0,6,2,2,10
16309,2019-10-15,도봉구,0.0,0,1,0,0,1
16310,2019-10-15,동대문구,0.0,0,2,0,1,3
16311,2019-10-15,동작구,0.0,0,4,2,1,7
16312,2019-10-15,마포구,0.0,0,5,2,1,8
16313,2019-10-15,서대문구,0.0,0,0,0,0,0
16314,2019-10-15,서초구,0.0,0,4,1,1,6
16315,2019-10-15,성동구,0.0,0,9,0,1,10
16316,2019-10-15,성북구,0.0,0,8,1,2,11
16317,2019-10-15,송파구,0.0,0,7,1,5,13
16318,2019-10-15,양천구,0.0,0,1,0,1,2
16319,2019-10-15,영등포구,0.0,0,11,0,3,14
16320,2019-10-15,용산구,0.0,0,2,0,0,2
16321,2019-10-15,은평구,0.0,0,1,0,1,2
16322,2019-10-15,종로구,0.0,0,10,0,3,13
16323,2019-10-15,중구,0.0,0,1,0,2,3
16324,2019-10-15,중랑구,0.0,0,9,0,2,11
16325,2019-10-16,강남구,0.0,0,8,2,1,11
16326,2019-10-16,강동구,0.0,0,5,0,0,5
16327,2019-10-16,강북구,0.0,0,1,0,0,1
16328,2019-10-16,강서구,0.0,0,4,0,0,4
16329,2019-10-16,관악구,0.0,0,3,0,0,3
16330,2019-10-16,광진구,0.0,0,4,0,1,5
16331,2019-10-16,구로구,0.0,0,5,0,0,5
16332,2019-10-16,금천구,0.0,0,0,0,0,0
16333,2019-10-16,노원구,0.0,0,3,0,1,4
16334,2019-10-16,도봉구,4.0,0,2,2,2,6
16335,2019-10-16,동대문구,0.0,0,5,1,0,6
16336,2019-10-16,동작구,0.0,0,7,0,4,11
16337,2019-10-16,마포구,0.0,0,3,1,3,7
16338,2019-10-16,서대문구,0.0,0,0,0,0,0
16339,2019-10-16,서초구,0.0,0,8,0,1,9
16340,2019-10-16,성동구,0.0,0,1,1,0,2
16341,2019-10-16,성북구,0.0,0,1,0,0,1
16342,2019-10-16,송파구,0.0,0,12,1,6,19
16343,2019-10-16,양천구,0.0,0,3,1,0,4
16344,2019-10-16,영등포구,0.0,0,9,0,2,11
16345,2019-10-16,용산구,0.0,0,3,0,0,3
16346,2019-10-16,은평구,0.0,0,3,0,0,3
16347,2019-10-16,종로구,0.0,0,5,1,4,10
16348,2019-10-16,중구,0.0,0,3,0,2,5
16349,2019-10-16,중랑구,0.0,0,2,0,1,3
16350,2019-10-17,강남구,0.0,0,11,0,4,15
16351,2019-10-17,강동구,0.0,0,1,1,0,2
16352,2019-10-17,강북구,0.0,0,4,0,2,6
16353,2019-10-17,강서구,0.0,0,4,0,1,5
16354,2019-10-17,관악구,0.0,0,2,0,0,2
16355,2019-10-17,광진구,0.0,0,2,2,2,6
16356,2019-10-17,구로구,0.0,0,8,0,1,9
16357,2019-10-17,금천구,0.0,0,0,1,0,1
16358,2019-10-17,노원구,0.0,0,7,1,3,11
16359,2019-10-17,도봉구,0.0,0,1,2,3,6
16360,2019-10-17,동대문구,0.0,0,1,0,1,2
16361,2019-10-17,동작구,0.0,0,6,2,1,9
16362,2019-10-17,마포구,0.0,0,3,0,1,4
16363,2019-10-17,서대문구,0.0,0,7,2,2,11
16364,2019-10-17,서초구,0.0,0,5,1,1,7
16365,2019-10-17,성동구,0.0,0,5,0,0,5
16366,2019-10-17,성북구,0.0,0,3,0,3,6
16367,2019-10-17,송파구,0.0,0,11,1,0,12
16368,2019-10-17,양천구,0.0,1,12,0,2,15
16369,2019-10-17,영등포구,0.0,0,3,1,3,7
16370,2019-10-17,용산구,0.0,0,5,0,0,5
16371,2019-10-17,은평구,0.0,0,0,2,2,4
16372,2019-10-17,종로구,0.0,0,1,0,2,3
16373,2019-10-17,중구,0.0,0,1,2,0,3
16374,2019-10-17,중랑구,0.0,0,2,0,2,4
16375,2019-10-18,강남구,0.0,0,14,0,4,18
16376,2019-10-18,강동구,0.0,0,3,0,1,4
16377,2019-10-18,강북구,0.0,0,1,0,0,1
16378,2019-10-18,강서구,0.0,0,6,2,6,14
16379,2019-10-18,관악구,0.0,0,4,2,2,8
16380,2019-10-18,광진구,0.0,0,4,0,0,4
16381,2019-10-18,구로구,0.0,0,6,1,0,7
16382,2019-10-18,금천구,0.0,0,14,0,4,18
16383,2019-10-18,노원구,0.0,0,7,1,3,11
16384,2019-10-18,도봉구,0.0,0,2,1,2,5
16385,2019-10-18,동대문구,0.0,1,3,0,3,7
16386,2019-10-18,동작구,0.0,0,3,0,0,3
16387,2019-10-18,마포구,0.0,0,8,0,3,11
16388,2019-10-18,서대문구,0.0,0,3,1,0,4
16389,2019-10-18,서초구,0.0,0,8,3,0,11
16390,2019-10-18,성동구,0.0,0,4,0,1,5
16391,2019-10-18,성북구,0.0,0,3,1,1,5
16392,2019-10-18,송파구,0.0,0,8,1,4,13
16393,2019-10-18,양천구,0.0,0,7,0,0,7
16394,2019-10-18,영등포구,0.0,0,7,1,1,9
16395,2019-10-18,용산구,0.0,0,8,0,0,8
16396,2019-10-18,은평구,0.0,0,5,0,0,5
16397,2019-10-18,종로구,0.0,0,0,1,0,1
16398,2019-10-18,중구,0.0,0,1,0,0,1
16399,2019-10-18,중랑구,0.0,0,12,2,5,19
16400,2019-10-19,강남구,0.0,0,13,3,2,18
16401,2019-10-19,강동구,0.0,0,3,0,0,3
16402,2019-10-19,강북구,0.0,0,5,0,3,8
16403,2019-10-19,강서구,0.0,0,1,1,1,3
16404,2019-10-19,관악구,0.0,0,5,3,1,9
16405,2019-10-19,광진구,0.0,0,2,0,1,3
16406,2019-10-19,구로구,0.0,0,5,0,0,5
16407,2019-10-19,금천구,0.0,0,7,1,0,8
16408,2019-10-19,노원구,0.0,0,5,0,4,9
16409,2019-10-19,도봉구,0.0,0,4,0,0,4
16410,2019-10-19,동대문구,0.0,0,6,0,0,6
16411,2019-10-19,동작구,0.0,0,2,0,1,3
16412,2019-10-19,마포구,0.0,0,6,2,2,10
16413,2019-10-19,서대문구,0.0,0,1,0,0,1
16414,2019-10-19,서초구,0.0,0,11,1,2,14
16415,2019-10-19,성동구,0.0,0,6,0,2,8
16416,2019-10-19,성북구,0.0,0,0,1,3,4
16417,2019-10-19,송파구,0.0,0,8,3,2,13
16418,2019-10-19,양천구,0.0,0,14,3,3,20
16419,2019-10-19,영등포구,0.0,0,16,0,0,16
16420,2019-10-19,용산구,0.0,0,3,0,2,5
16421,2019-10-19,은평구,0.0,0,1,0,2,3
16422,2019-10-19,종로구,0.0,0,2,0,0,2
16423,2019-10-19,중구,0.0,0,2,0,0,2
16424,2019-10-19,중랑구,0.0,0,7,0,0,7
16425,2019-10-20,강남구,0.0,0,5,0,0,5
16426,2019-10-20,강동구,0.0,0,5,0,2,7
16427,2019-10-20,강북구,0.0,0,2,0,2,4
16428,2019-10-20,강서구,0.0,0,2,0,2,4
16429,2019-10-20,관악구,0.0,0,6,1,0,7
16430,2019-10-20,광진구,0.0,0,0,0,0,0
16431,2019-10-20,구로구,0.0,0,1,0,1,2
16432,2019-10-20,금천구,0.0,0,19,0,1,20
16433,2019-10-20,노원구,0.0,0,6,0,1,7
16434,2019-10-20,도봉구,0.0,0,1,0,0,1
16435,2019-10-20,동대문구,0.0,0,4,0,2,6
16436,2019-10-20,동작구,0.0,0,2,1,0,3
16437,2019-10-20,마포구,0.0,0,2,1,0,3
16438,2019-10-20,서대문구,0.0,0,5,1,1,7
16439,2019-10-20,서초구,0.0,0,4,2,0,6
16440,2019-10-20,성동구,0.0,0,0,0,1,1
16441,2019-10-20,성북구,0.0,0,1,0,0,1
16442,2019-10-20,송파구,0.0,0,11,1,2,14
16443,2019-10-20,양천구,0.0,0,3,0,0,3
16444,2019-10-20,영등포구,0.0,0,7,1,4,12
16445,2019-10-20,용산구,0.0,0,2,1,1,4
16446,2019-10-20,은평구,0.0,0,4,0,0,4
16447,2019-10-20,종로구,0.0,0,1,0,2,3
16448,2019-10-20,중구,0.0,0,3,0,0,3
16449,2019-10-20,중랑구,0.0,0,8,2,2,12
16450,2019-10-21,강남구,0.0,1,9,1,3,14
16451,2019-10-21,강동구,0.0,0,6,1,2,9
16452,2019-10-21,강북구,0.0,0,6,0,1,7
16453,2019-10-21,강서구,0.0,0,4,0,0,4
16454,2019-10-21,관악구,0.0,0,3,1,2,6
16455,2019-10-21,광진구,0.0,0,1,0,0,1
16456,2019-10-21,구로구,0.0,0,0,0,1,1
16457,2019-10-21,금천구,0.0,0,6,0,0,6
16458,2019-10-21,노원구,0.0,0,5,0,0,5
16459,2019-10-21,도봉구,0.0,0,1,1,0,2
16460,2019-10-21,동대문구,0.0,0,3,0,1,4
16461,2019-10-21,동작구,0.0,0,8,1,4,13
16462,2019-10-21,마포구,0.0,0,2,0,0,2
16463,2019-10-21,서대문구,0.0,0,0,0,0,0
16464,2019-10-21,서초구,0.0,0,9,1,2,12
16465,2019-10-21,성동구,0.0,0,4,0,3,7
16466,2019-10-21,성북구,0.0,0,3,1,3,7
16467,2019-10-21,송파구,0.0,0,5,2,0,7
16468,2019-10-21,양천구,0.0,0,5,2,1,8
16469,2019-10-21,영등포구,0.0,0,9,0,3,12
16470,2019-10-21,용산구,0.0,0,3,0,0,3
16471,2019-10-21,은평구,0.0,0,2,1,1,4
16472,2019-10-21,종로구,0.0,0,1,0,0,1
16473,2019-10-21,중구,0.0,0,2,0,2,4
16474,2019-10-21,중랑구,0.0,0,2,1,0,3
16475,2019-10-22,강남구,0.0,0,12,2,6,20
16476,2019-10-22,강동구,0.0,0,3,0,1,4
16477,2019-10-22,강북구,0.0,0,9,0,0,9
16478,2019-10-22,강서구,0.0,0,4,0,2,6
16479,2019-10-22,관악구,0.0,0,0,0,0,0
16480,2019-10-22,광진구,0.0,0,3,0,1,4
16481,2019-10-22,구로구,0.0,0,3,5,3,11
16482,2019-10-22,금천구,0.0,0,2,0,0,2
16483,2019-10-22,노원구,0.0,0,6,1,1,8
16484,2019-10-22,도봉구,0.0,0,2,0,0,2
16485,2019-10-22,동대문구,0.0,0,6,1,1,8
16486,2019-10-22,동작구,0.0,0,5,0,5,10
16487,2019-10-22,마포구,0.0,0,8,0,2,10
16488,2019-10-22,서대문구,0.0,0,1,0,1,2
16489,2019-10-22,서초구,0.0,0,8,0,2,10
16490,2019-10-22,성동구,0.0,0,5,1,0,6
16491,2019-10-22,성북구,0.0,0,4,1,1,6
16492,2019-10-22,송파구,0.0,0,13,1,1,15
16493,2019-10-22,양천구,0.0,0,5,2,0,7
16494,2019-10-22,영등포구,0.0,0,11,1,3,15
16495,2019-10-22,용산구,0.0,0,1,0,0,1
16496,2019-10-22,은평구,0.0,0,2,0,0,2
16497,2019-10-22,종로구,0.0,0,1,0,1,2
16498,2019-10-22,중구,0.0,0,4,0,1,5
16499,2019-10-22,중랑구,0.0,0,6,0,2,8
16500,2019-10-23,강남구,0.0,0,5,3,1,9
16501,2019-10-23,강동구,0.0,0,2,6,7,15
16502,2019-10-23,강북구,0.0,1,1,0,1,3
16503,2019-10-23,강서구,0.0,1,4,0,2,7
16504,2019-10-23,관악구,0.0,0,2,0,1,3
16505,2019-10-23,광진구,0.0,0,4,0,1,5
16506,2019-10-23,구로구,0.0,0,4,0,2,6
16507,2019-10-23,금천구,0.0,0,0,0,1,1
16508,2019-10-23,노원구,0.0,1,4,0,0,5
16509,2019-10-23,도봉구,0.0,0,1,1,0,2
16510,2019-10-23,동대문구,0.0,0,1,1,0,2
16511,2019-10-23,동작구,0.0,0,2,0,0,2
16512,2019-10-23,마포구,0.0,0,2,0,0,2
16513,2019-10-23,서대문구,0.0,0,44,2,9,55
16514,2019-10-23,서초구,0.0,0,3,0,2,5
16515,2019-10-23,성동구,0.0,1,8,0,1,10
16516,2019-10-23,성북구,0.0,0,7,1,2,10
16517,2019-10-23,송파구,0.0,1,13,2,2,18
16518,2019-10-23,양천구,0.0,0,2,0,0,2
16519,2019-10-23,영등포구,0.0,0,5,0,2,7
16520,2019-10-23,용산구,0.0,0,0,0,0,0
16521,2019-10-23,은평구,0.0,0,3,0,2,5
16522,2019-10-23,종로구,0.0,0,1,2,0,3
16523,2019-10-23,중구,0.0,0,1,0,0,1
16524,2019-10-23,중랑구,0.0,0,4,1,2,7
16525,2019-10-24,강남구,0.0,0,10,1,3,14
16526,2019-10-24,강동구,0.0,0,5,1,0,6
16527,2019-10-24,강북구,0.0,0,1,0,2,3
16528,2019-10-24,강서구,0.0,0,7,2,0,9
16529,2019-10-24,관악구,0.0,0,0,2,3,5
16530,2019-10-24,광진구,0.0,0,9,0,1,10
16531,2019-10-24,구로구,0.0,0,4,0,2,6
16532,2019-10-24,금천구,0.0,0,3,0,0,3
16533,2019-10-24,노원구,0.0,0,2,2,1,5
16534,2019-10-24,도봉구,0.0,0,0,0,1,1
16535,2019-10-24,동대문구,0.0,0,7,0,0,7
16536,2019-10-24,동작구,0.0,0,4,1,1,6
16537,2019-10-24,마포구,0.0,0,5,0,5,10
16538,2019-10-24,서대문구,0.0,0,3,0,0,3
16539,2019-10-24,서초구,0.0,0,13,1,4,18
16540,2019-10-24,성동구,0.0,0,2,2,0,4
16541,2019-10-24,성북구,0.0,0,3,1,4,8
16542,2019-10-24,송파구,0.0,0,7,0,3,10
16543,2019-10-24,양천구,0.0,0,5,3,3,11
16544,2019-10-24,영등포구,0.0,1,3,1,4,9
16545,2019-10-24,용산구,0.0,0,2,0,1,3
16546,2019-10-24,은평구,0.0,0,5,0,0,5
16547,2019-10-24,종로구,0.0,0,1,1,1,3
16548,2019-10-24,중구,0.0,0,1,1,3,5
16549,2019-10-24,중랑구,0.0,0,6,1,0,7
16550,2019-10-25,강남구,0.0,0,17,3,3,23
16551,2019-10-25,강동구,0.5,0,4,0,1,5
16552,2019-10-25,강북구,0.0,0,5,0,1,6
16553,2019-10-25,강서구,0.0,0,3,0,0,3
16554,2019-10-25,관악구,0.0,0,1,0,2,3
16555,2019-10-25,광진구,4.0,0,1,0,2,3
16556,2019-10-25,구로구,1.0,0,5,0,1,6
16557,2019-10-25,금천구,0.0,0,3,0,1,4
16558,2019-10-25,노원구,0.0,0,6,0,0,6
16559,2019-10-25,도봉구,0.0,0,3,0,2,5
16560,2019-10-25,동대문구,0.0,0,4,0,1,5
16561,2019-10-25,동작구,1.0,0,2,0,3,5
16562,2019-10-25,마포구,0.0,0,1,0,2,3
16563,2019-10-25,서대문구,0.0,0,5,1,4,10
16564,2019-10-25,서초구,0.0,0,4,1,0,5
16565,2019-10-25,성동구,0.0,0,0,0,2,2
16566,2019-10-25,성북구,0.0,0,3,0,3,6
16567,2019-10-25,송파구,0.0,1,25,4,8,38
16568,2019-10-25,양천구,0.5,0,8,0,2,10
16569,2019-10-25,영등포구,0.5,0,8,0,1,9
16570,2019-10-25,용산구,1.0,0,17,1,2,20
16571,2019-10-25,은평구,0.0,0,4,0,1,5
16572,2019-10-25,종로구,0.0,0,8,0,5,13
16573,2019-10-25,중구,0.0,0,2,0,1,3
16574,2019-10-25,중랑구,0.0,0,7,1,2,10
16575,2019-10-26,강남구,0.0,0,6,2,1,9
16576,2019-10-26,강동구,0.0,0,1,0,2,3
16577,2019-10-26,강북구,0.0,0,3,0,1,4
16578,2019-10-26,강서구,0.0,0,6,2,0,8
16579,2019-10-26,관악구,0.0,0,2,0,2,4
16580,2019-10-26,광진구,0.0,0,2,0,2,4
16581,2019-10-26,구로구,0.0,0,7,1,2,10
16582,2019-10-26,금천구,0.0,0,2,0,0,2
16583,2019-10-26,노원구,0.0,0,1,0,1,2
16584,2019-10-26,도봉구,0.0,0,1,0,0,1
16585,2019-10-26,동대문구,0.0,0,4,2,1,7
16586,2019-10-26,동작구,0.0,0,8,0,2,10
16587,2019-10-26,마포구,0.0,0,5,0,2,7
16588,2019-10-26,서대문구,0.0,1,0,0,1,2
16589,2019-10-26,서초구,0.0,0,8,0,1,9
16590,2019-10-26,성동구,0.0,0,8,0,1,9
16591,2019-10-26,성북구,0.0,0,2,0,0,2
16592,2019-10-26,송파구,0.0,0,4,3,3,10
16593,2019-10-26,양천구,0.0,0,6,1,1,8
16594,2019-10-26,영등포구,0.0,0,11,0,0,11
16595,2019-10-26,용산구,0.0,0,2,0,1,3
16596,2019-10-26,은평구,0.0,0,1,0,2,3
16597,2019-10-26,종로구,0.0,0,1,0,0,1
16598,2019-10-26,중구,0.0,0,2,1,2,5
16599,2019-10-26,중랑구,0.0,0,5,2,0,7
16600,2019-10-27,강남구,0.0,0,6,0,2,8
16601,2019-10-27,강동구,0.0,0,1,0,0,1
16602,2019-10-27,강북구,0.0,0,3,0,1,4
16603,2019-10-27,강서구,0.0,0,4,0,1,5
16604,2019-10-27,관악구,0.0,0,4,1,2,7
16605,2019-10-27,광진구,0.0,0,3,0,0,3
16606,2019-10-27,구로구,0.0,0,4,0,2,6
16607,2019-10-27,금천구,0.0,0,6,0,1,7
16608,2019-10-27,노원구,0.0,0,3,1,0,4
16609,2019-10-27,도봉구,0.0,0,7,0,1,8
16610,2019-10-27,동대문구,0.0,0,10,0,1,11
16611,2019-10-27,동작구,0.0,0,2,0,0,2
16612,2019-10-27,마포구,0.0,0,11,0,1,12
16613,2019-10-27,서대문구,0.0,0,1,1,0,2
16614,2019-10-27,서초구,0.0,0,12,0,0,12
16615,2019-10-27,성동구,0.0,0,3,0,0,3
16616,2019-10-27,성북구,0.0,0,2,0,0,2
16617,2019-10-27,송파구,0.0,0,22,0,0,22
16618,2019-10-27,양천구,0.0,0,3,1,2,6
16619,2019-10-27,영등포구,0.0,0,10,1,3,14
16620,2019-10-27,용산구,0.0,0,13,0,1,14
16621,2019-10-27,은평구,0.0,0,3,1,0,4
16622,2019-10-27,종로구,0.0,0,0,0,0,0
16623,2019-10-27,중구,0.0,0,2,0,0,2
16624,2019-10-27,중랑구,0.0,0,0,0,3,3
16625,2019-10-28,강남구,2.5,0,9,2,3,14
16626,2019-10-28,강동구,5.0,0,1,0,0,1
16627,2019-10-28,강북구,2.5,0,5,0,1,6
16628,2019-10-28,강서구,0.0,2,10,0,2,14
16629,2019-10-28,관악구,2.0,0,4,0,1,5
16630,2019-10-28,광진구,2.5,0,1,0,0,1
16631,2019-10-28,구로구,2.5,0,2,0,4,6
16632,2019-10-28,금천구,2.5,0,3,0,0,3
16633,2019-10-28,노원구,3.0,0,2,0,0,2
16634,2019-10-28,도봉구,2.0,0,5,0,0,5
16635,2019-10-28,동대문구,2.0,0,2,0,0,2
16636,2019-10-28,동작구,2.5,0,2,0,0,2
16637,2019-10-28,마포구,2.0,0,3,0,0,3
16638,2019-10-28,서대문구,2.0,0,5,1,2,8
16639,2019-10-28,서초구,2.5,0,2,2,0,4
16640,2019-10-28,성동구,4.5,0,1,0,0,1
16641,2019-10-28,성북구,2.5,0,6,0,2,8
16642,2019-10-28,송파구,2.5,0,11,25,0,36
16643,2019-10-28,양천구,2.5,0,4,0,1,5
16644,2019-10-28,영등포구,2.25,0,7,1,1,9
16645,2019-10-28,용산구,4.0,0,0,0,1,1
16646,2019-10-28,은평구,2.0,0,2,0,1,3
16647,2019-10-28,종로구,1.7,0,0,0,0,0
16648,2019-10-28,중구,2.0,0,4,0,1,5
16649,2019-10-28,중랑구,2.5,0,1,0,1,2
16650,2019-10-29,강남구,0.5,0,12,1,0,13
16651,2019-10-29,강동구,0.5,0,3,0,0,3
16652,2019-10-29,강북구,0.0,0,1,0,1,2
16653,2019-10-29,강서구,0.0,0,3,0,1,4
16654,2019-10-29,관악구,0.5,0,3,0,0,3
16655,2019-10-29,광진구,0.5,0,5,0,1,6
16656,2019-10-29,구로구,0.5,0,3,0,0,3
16657,2019-10-29,금천구,0.5,0,11,0,2,13
16658,2019-10-29,노원구,0.0,0,5,0,0,5
16659,2019-10-29,도봉구,0.0,0,3,1,0,4
16660,2019-10-29,동대문구,0.0,0,5,1,1,7
16661,2019-10-29,동작구,0.25,0,3,0,1,4
16662,2019-10-29,마포구,0.5,0,4,1,1,6
16663,2019-10-29,서대문구,0.0,0,2,1,0,3
16664,2019-10-29,서초구,0.5,0,12,0,3,15
16665,2019-10-29,성동구,0.5,0,4,0,1,5
16666,2019-10-29,성북구,0.0,0,3,0,1,4
16667,2019-10-29,송파구,0.0,0,6,1,3,10
16668,2019-10-29,양천구,0.0,0,10,0,1,11
16669,2019-10-29,영등포구,0.25,0,4,0,2,6
16670,2019-10-29,용산구,0.5,0,3,0,0,3
16671,2019-10-29,은평구,0.0,0,2,1,0,3
16672,2019-10-29,종로구,0.1,0,1,0,2,3
16673,2019-10-29,중구,0.5,0,8,2,3,13
16674,2019-10-29,중랑구,1.0,0,4,0,1,5
16675,2019-10-30,강남구,0.0,0,14,2,4,20
16676,2019-10-30,강동구,0.0,0,0,0,1,1
16677,2019-10-30,강북구,0.0,0,4,0,0,4
16678,2019-10-30,강서구,0.0,0,5,0,3,8
16679,2019-10-30,관악구,0.0,1,5,0,2,8
16680,2019-10-30,광진구,0.0,0,9,0,2,11
16681,2019-10-30,구로구,0.0,0,2,0,2,4
16682,2019-10-30,금천구,0.0,0,6,1,1,8
16683,2019-10-30,노원구,0.0,0,5,0,1,6
16684,2019-10-30,도봉구,0.0,0,5,0,2,7
16685,2019-10-30,동대문구,0.0,0,2,0,2,4
16686,2019-10-30,동작구,0.0,0,3,1,0,4
16687,2019-10-30,마포구,0.0,0,4,0,1,5
16688,2019-10-30,서대문구,0.0,0,1,1,1,3
16689,2019-10-30,서초구,0.0,0,16,3,2,21
16690,2019-10-30,성동구,0.0,0,4,1,2,7
16691,2019-10-30,성북구,0.0,0,8,0,1,9
16692,2019-10-30,송파구,0.0,0,10,1,1,12
16693,2019-10-30,양천구,0.0,0,8,0,1,9
16694,2019-10-30,영등포구,0.0,0,2,0,2,4
16695,2019-10-30,용산구,0.0,0,2,0,0,2
16696,2019-10-30,은평구,0.0,0,2,1,0,3
16697,2019-10-30,종로구,0.0,0,1,2,1,4
16698,2019-10-30,중구,0.0,0,3,1,0,4
16699,2019-10-30,중랑구,0.0,1,9,1,4,15
16700,2019-10-31,강남구,0.0,0,7,1,0,8
16701,2019-10-31,강동구,0.0,0,4,0,1,5
16702,2019-10-31,강북구,0.0,0,0,0,0,0
16703,2019-10-31,강서구,0.0,0,3,0,3,6
16704,2019-10-31,관악구,0.0,0,2,0,2,4
16705,2019-10-31,광진구,0.0,0,2,0,1,3
16706,2019-10-31,구로구,0.0,0,0,0,0,0
16707,2019-10-31,금천구,0.0,0,1,0,0,1
16708,2019-10-31,노원구,0.0,0,4,1,2,7
16709,2019-10-31,도봉구,0.0,0,2,1,0,3
16710,2019-10-31,동대문구,0.0,0,5,0,0,5
16711,2019-10-31,동작구,0.0,0,3,2,1,6
16712,2019-10-31,마포구,0.0,0,4,0,0,4
16713,2019-10-31,서대문구,0.0,0,2,0,1,3
16714,2019-10-31,서초구,0.0,0,7,1,2,10
16715,2019-10-31,성동구,0.0,0,4,0,2,6
16716,2019-10-31,성북구,0.0,0,2,0,3,5
16717,2019-10-31,송파구,0.0,0,7,3,1,11
16718,2019-10-31,양천구,0.0,0,5,1,3,9
16719,2019-10-31,영등포구,0.0,0,7,0,3,10
16720,2019-10-31,용산구,0.0,0,3,0,1,4
16721,2019-10-31,은평구,0.0,0,2,0,0,2
16722,2019-10-31,종로구,0.0,0,7,0,3,10
16723,2019-10-31,중구,0.0,0,4,0,0,4
16724,2019-10-31,중랑구,0.0,0,4,0,2,6
16725,2019-11-01,강남구,0.0,1,6,0,7,14
16726,2019-11-01,강동구,0.0,0,2,0,0,2
16727,2019-11-01,강북구,0.0,0,2,0,1,3
16728,2019-11-01,강서구,0.0,0,2,0,2,4
16729,2019-11-01,관악구,0.0,0,6,0,0,6
16730,2019-11-01,광진구,0.0,0,1,0,0,1
16731,2019-11-01,구로구,0.0,0,13,0,1,14
16732,2019-11-01,금천구,0.0,0,8,0,1,9
16733,2019-11-01,노원구,0.0,0,5,0,2,7
16734,2019-11-01,도봉구,0.0,0,0,0,1,1
16735,2019-11-01,동대문구,0.0,0,2,0,2,4
16736,2019-11-01,동작구,0.0,0,3,1,3,7
16737,2019-11-01,마포구,0.0,0,9,1,5,15
16738,2019-11-01,서대문구,0.0,0,4,0,2,6
16739,2019-11-01,서초구,0.0,0,4,1,2,7
16740,2019-11-01,성동구,0.0,0,1,0,0,1
16741,2019-11-01,성북구,0.0,1,3,1,0,5
16742,2019-11-01,송파구,0.0,0,12,2,5,19
16743,2019-11-01,양천구,0.0,0,3,0,0,3
16744,2019-11-01,영등포구,0.0,0,8,1,2,11
16745,2019-11-01,용산구,0.0,0,2,1,1,4
16746,2019-11-01,은평구,0.0,0,0,0,0,0
16747,2019-11-01,종로구,0.0,0,6,1,2,9
16748,2019-11-01,중구,0.0,0,10,0,4,14
16749,2019-11-01,중랑구,0.0,0,7,2,0,9
16750,2019-11-02,강남구,0.0,0,10,1,3,14
16751,2019-11-02,강동구,0.0,0,12,0,2,14
16752,2019-11-02,강북구,0.0,0,2,0,0,2
16753,2019-11-02,강서구,0.0,0,14,0,2,16
16754,2019-11-02,관악구,0.0,0,3,1,1,5
16755,2019-11-02,광진구,0.0,0,0,2,1,3
16756,2019-11-02,구로구,0.0,0,8,0,2,10
16757,2019-11-02,금천구,0.0,0,6,0,0,6
16758,2019-11-02,노원구,0.0,0,7,0,1,8
16759,2019-11-02,도봉구,0.0,0,2,1,0,3
16760,2019-11-02,동대문구,0.0,0,5,0,0,5
16761,2019-11-02,동작구,0.0,0,7,0,2,9
16762,2019-11-02,마포구,0.0,0,3,0,0,3
16763,2019-11-02,서대문구,0.0,1,4,2,2,9
16764,2019-11-02,서초구,0.0,0,26,1,2,29
16765,2019-11-02,성동구,0.0,0,8,2,2,12
16766,2019-11-02,성북구,0.0,0,9,1,5,15
16767,2019-11-02,송파구,0.0,0,8,0,2,10
16768,2019-11-02,양천구,0.0,0,1,0,3,4
16769,2019-11-02,영등포구,0.0,0,10,1,6,17
16770,2019-11-02,용산구,0.0,0,3,0,3,6
16771,2019-11-02,은평구,0.0,0,3,0,0,3
16772,2019-11-02,종로구,0.0,0,4,0,2,6
16773,2019-11-02,중구,0.0,0,1,0,1,2
16774,2019-11-02,중랑구,0.0,0,2,1,2,5
16775,2019-11-03,강남구,0.0,0,8,0,2,10
16776,2019-11-03,강동구,0.0,0,1,1,2,4
16777,2019-11-03,강북구,0.0,0,1,0,0,1
16778,2019-11-03,강서구,0.0,0,5,1,6,12
16779,2019-11-03,관악구,0.0,0,3,0,1,4
16780,2019-11-03,광진구,0.0,0,1,0,0,1
16781,2019-11-03,구로구,0.0,0,3,0,0,3
16782,2019-11-03,금천구,0.0,0,6,1,5,12
16783,2019-11-03,노원구,0.0,0,2,0,1,3
16784,2019-11-03,도봉구,0.0,0,5,0,2,7
16785,2019-11-03,동대문구,0.0,0,4,2,0,6
16786,2019-11-03,동작구,0.0,0,2,0,0,2
16787,2019-11-03,마포구,0.0,0,1,0,0,1
16788,2019-11-03,서대문구,0.0,0,2,1,1,4
16789,2019-11-03,서초구,0.0,0,8,1,1,10
16790,2019-11-03,성동구,0.0,0,2,1,1,4
16791,2019-11-03,성북구,0.0,0,3,0,1,4
16792,2019-11-03,송파구,0.0,0,5,1,1,7
16793,2019-11-03,양천구,0.0,0,2,0,0,2
16794,2019-11-03,영등포구,0.0,0,4,1,4,9
16795,2019-11-03,용산구,0.0,0,2,0,1,3
16796,2019-11-03,은평구,1.5,0,4,0,0,4
16797,2019-11-03,종로구,0.0,0,2,1,0,3
16798,2019-11-03,중구,0.0,0,6,0,2,8
16799,2019-11-03,중랑구,0.0,0,2,0,1,3
16800,2019-11-04,강남구,0.0,0,12,2,2,16
16801,2019-11-04,강동구,0.0,0,3,0,1,4
16802,2019-11-04,강북구,0.0,0,2,0,1,3
16803,2019-11-04,강서구,0.0,0,8,1,1,10
16804,2019-11-04,관악구,0.0,0,3,1,2,6
16805,2019-11-04,광진구,0.0,0,2,0,1,3
16806,2019-11-04,구로구,0.0,0,6,2,2,10
16807,2019-11-04,금천구,0.0,0,3,0,1,4
16808,2019-11-04,노원구,0.0,0,8,0,4,12
16809,2019-11-04,도봉구,0.0,0,1,0,0,1
16810,2019-11-04,동대문구,0.0,0,15,1,1,17
16811,2019-11-04,동작구,0.0,0,0,1,1,2
16812,2019-11-04,마포구,0.0,0,8,0,4,12
16813,2019-11-04,서대문구,0.0,0,1,0,0,1
16814,2019-11-04,서초구,0.0,0,10,1,4,15
16815,2019-11-04,성동구,0.0,0,2,0,2,4
16816,2019-11-04,성북구,0.0,0,0,0,1,1
16817,2019-11-04,송파구,0.0,0,5,1,1,7
16818,2019-11-04,양천구,0.0,0,2,0,0,2
16819,2019-11-04,영등포구,0.0,0,8,0,2,10
16820,2019-11-04,용산구,0.0,0,2,0,0,2
16821,2019-11-04,은평구,0.0,0,1,0,1,2
16822,2019-11-04,종로구,0.0,0,4,1,0,5
16823,2019-11-04,중구,0.0,0,4,1,2,7
16824,2019-11-04,중랑구,0.0,0,6,1,0,7
16825,2019-11-05,강남구,0.0,0,6,1,4,11
16826,2019-11-05,강동구,0.0,0,2,1,1,4
16827,2019-11-05,강북구,0.0,0,2,0,1,3
16828,2019-11-05,강서구,0.0,1,4,0,0,5
16829,2019-11-05,관악구,0.0,0,0,0,2,2
16830,2019-11-05,광진구,0.0,0,3,0,1,4
16831,2019-11-05,구로구,0.0,0,1,0,2,3
16832,2019-11-05,금천구,0.0,0,3,0,3,6
16833,2019-11-05,노원구,0.0,0,5,0,5,10
16834,2019-11-05,도봉구,0.0,0,4,0,1,5
16835,2019-11-05,동대문구,0.0,0,2,1,3,6
16836,2019-11-05,동작구,0.0,0,3,0,2,5
16837,2019-11-05,마포구,0.0,0,6,0,0,6
16838,2019-11-05,서대문구,0.0,0,2,0,1,3
16839,2019-11-05,서초구,0.0,0,7,1,2,10
16840,2019-11-05,성동구,0.0,0,0,0,0,0
16841,2019-11-05,성북구,0.0,0,1,1,4,6
16842,2019-11-05,송파구,0.0,0,9,0,2,11
16843,2019-11-05,양천구,0.0,0,1,2,1,4
16844,2019-11-05,영등포구,0.0,0,9,0,2,11
16845,2019-11-05,용산구,0.0,0,6,0,1,7
16846,2019-11-05,은평구,0.0,0,2,1,0,3
16847,2019-11-05,종로구,0.0,0,2,0,0,2
16848,2019-11-05,중구,0.0,0,6,0,1,7
16849,2019-11-05,중랑구,0.0,0,10,2,1,13
16850,2019-11-06,강남구,0.0,0,7,2,2,11
16851,2019-11-06,강동구,0.0,0,4,1,2,7
16852,2019-11-06,강북구,0.0,0,5,0,0,5
16853,2019-11-06,강서구,0.0,0,2,0,2,4
16854,2019-11-06,관악구,0.0,0,2,0,0,2
16855,2019-11-06,광진구,0.0,0,1,0,0,1
16856,2019-11-06,구로구,0.0,0,5,0,2,7
16857,2019-11-06,금천구,0.0,0,4,0,0,4
16858,2019-11-06,노원구,0.0,0,3,1,1,5
16859,2019-11-06,도봉구,0.0,0,8,0,0,8
16860,2019-11-06,동대문구,0.0,0,8,0,0,8
16861,2019-11-06,동작구,0.0,0,2,0,0,2
16862,2019-11-06,마포구,0.0,0,2,0,0,2
16863,2019-11-06,서대문구,0.0,0,3,0,1,4
16864,2019-11-06,서초구,0.0,0,5,2,0,7
16865,2019-11-06,성동구,0.0,0,2,0,0,2
16866,2019-11-06,성북구,0.0,0,0,0,0,0
16867,2019-11-06,송파구,0.0,0,9,0,1,10
16868,2019-11-06,양천구,0.0,0,8,0,1,9
16869,2019-11-06,영등포구,0.0,0,4,0,1,5
16870,2019-11-06,용산구,0.0,0,3,0,0,3
16871,2019-11-06,은평구,0.0,0,3,0,0,3
16872,2019-11-06,종로구,0.0,0,4,1,0,5
16873,2019-11-06,중구,0.0,0,3,0,4,7
16874,2019-11-06,중랑구,0.0,0,9,0,1,10
16875,2019-11-07,강남구,0.0,0,14,1,4,19
16876,2019-11-07,강동구,0.0,0,4,0,2,6
16877,2019-11-07,강북구,0.0,0,3,1,1,5
16878,2019-11-07,강서구,0.0,0,2,0,1,3
16879,2019-11-07,관악구,0.0,0,7,1,0,8
16880,2019-11-07,광진구,0.0,0,2,0,1,3
16881,2019-11-07,구로구,0.0,0,2,1,1,4
16882,2019-11-07,금천구,0.0,0,3,0,1,4
16883,2019-11-07,노원구,0.0,0,9,0,4,13
16884,2019-11-07,도봉구,0.0,0,2,0,0,2
16885,2019-11-07,동대문구,0.0,0,7,2,3,12
16886,2019-11-07,동작구,0.0,0,2,0,0,2
16887,2019-11-07,마포구,0.0,0,7,0,5,12
16888,2019-11-07,서대문구,0.0,0,0,0,1,1
16889,2019-11-07,서초구,0.0,0,10,0,1,11
16890,2019-11-07,성동구,0.0,0,5,0,2,7
16891,2019-11-07,성북구,0.0,0,3,0,2,5
16892,2019-11-07,송파구,0.0,0,5,0,0,5
16893,2019-11-07,양천구,0.0,0,4,0,0,4
16894,2019-11-07,영등포구,0.0,0,3,1,3,7
16895,2019-11-07,용산구,0.0,0,1,1,2,4
16896,2019-11-07,은평구,0.0,0,2,0,2,4
16897,2019-11-07,종로구,0.0,0,6,1,2,9
16898,2019-11-07,중구,0.0,0,2,0,1,3
16899,2019-11-07,중랑구,0.0,0,2,0,0,2
16900,2019-11-08,강남구,0.0,0,14,1,2,17
16901,2019-11-08,강동구,0.0,0,2,3,2,7
16902,2019-11-08,강북구,0.0,0,1,0,0,1
16903,2019-11-08,강서구,0.0,0,4,0,0,4
16904,2019-11-08,관악구,0.0,0,4,0,0,4
16905,2019-11-08,광진구,0.0,0,6,0,1,7
16906,2019-11-08,구로구,0.0,1,4,0,1,6
16907,2019-11-08,금천구,0.0,0,6,1,0,7
16908,2019-11-08,노원구,0.0,0,10,1,2,13
16909,2019-11-08,도봉구,0.0,0,2,0,0,2
16910,2019-11-08,동대문구,0.0,0,8,0,4,12
16911,2019-11-08,동작구,0.0,0,4,1,1,6
16912,2019-11-08,마포구,0.0,0,5,2,0,7
16913,2019-11-08,서대문구,0.0,0,2,1,0,3
16914,2019-11-08,서초구,0.0,0,8,0,0,8
16915,2019-11-08,성동구,0.0,0,1,0,4,5
16916,2019-11-08,성북구,0.0,0,1,0,3,4
16917,2019-11-08,송파구,0.0,0,2,5,0,7
16918,2019-11-08,양천구,0.0,0,3,1,1,5
16919,2019-11-08,영등포구,0.0,0,3,1,0,4
16920,2019-11-08,용산구,0.0,0,6,1,0,7
16921,2019-11-08,은평구,0.0,0,5,0,0,5
16922,2019-11-08,종로구,0.0,0,2,0,2,4
16923,2019-11-08,중구,0.0,0,1,1,0,2
16924,2019-11-08,중랑구,0.0,0,9,0,3,12
16925,2019-11-09,강남구,0.0,0,11,1,0,12
16926,2019-11-09,강동구,0.0,0,5,0,2,7
16927,2019-11-09,강북구,0.0,0,7,0,0,7
16928,2019-11-09,강서구,0.0,0,2,1,4,7
16929,2019-11-09,관악구,0.0,1,9,1,0,11
16930,2019-11-09,광진구,0.0,0,6,0,1,7
16931,2019-11-09,구로구,0.0,0,2,0,0,2
16932,2019-11-09,금천구,0.0,0,4,1,0,5
16933,2019-11-09,노원구,0.0,0,11,1,5,17
16934,2019-11-09,도봉구,0.0,0,0,0,1,1
16935,2019-11-09,동대문구,0.0,0,2,3,5,10
16936,2019-11-09,동작구,0.0,0,3,1,0,4
16937,2019-11-09,마포구,0.0,0,1,1,2,4
16938,2019-11-09,서대문구,0.0,0,1,0,2,3
16939,2019-11-09,서초구,0.0,0,11,0,1,12
16940,2019-11-09,성동구,0.0,0,2,1,0,3
16941,2019-11-09,성북구,0.0,0,0,0,3,3
16942,2019-11-09,송파구,0.0,0,5,2,0,7
16943,2019-11-09,양천구,0.0,0,2,0,3,5
16944,2019-11-09,영등포구,0.0,0,9,1,4,14
16945,2019-11-09,용산구,0.0,0,0,0,0,0
16946,2019-11-09,은평구,0.0,0,0,0,0,0
16947,2019-11-09,종로구,0.0,0,4,0,1,5
16948,2019-11-09,중구,0.0,0,2,0,0,2
16949,2019-11-09,중랑구,0.0,0,2,1,2,5
16950,2019-11-10,강남구,12.5,0,11,0,0,11
16951,2019-11-10,강동구,10.5,0,2,0,0,2
16952,2019-11-10,강북구,12.0,0,3,0,0,3
16953,2019-11-10,강서구,14.5,0,7,0,2,9
16954,2019-11-10,관악구,14.5,0,1,0,0,1
16955,2019-11-10,광진구,11.0,0,4,0,1,5
16956,2019-11-10,구로구,15.0,0,9,0,0,9
16957,2019-11-10,금천구,10.5,0,3,0,0,3
16958,2019-11-10,노원구,11.0,0,6,0,0,6
16959,2019-11-10,도봉구,11.0,0,0,0,0,0
16960,2019-11-10,동대문구,10.5,0,1,0,2,3
16961,2019-11-10,동작구,13.25,0,7,3,4,14
16962,2019-11-10,마포구,13.0,0,5,2,1,8
16963,2019-11-10,서대문구,11.0,0,5,0,0,5
16964,2019-11-10,서초구,12.5,0,8,0,4,12
16965,2019-11-10,성동구,10.5,0,0,0,1,1
16966,2019-11-10,성북구,12.5,0,6,0,0,6
16967,2019-11-10,송파구,12.5,0,3,1,5,9
16968,2019-11-10,양천구,14.0,0,5,2,1,8
16969,2019-11-10,영등포구,12.0,0,15,1,0,16
16970,2019-11-10,용산구,13.5,0,2,0,2,4
16971,2019-11-10,은평구,12.0,0,11,2,1,14
16972,2019-11-10,종로구,11.8,0,2,0,0,2
16973,2019-11-10,중구,11.5,0,1,0,0,1
16974,2019-11-10,중랑구,11.0,0,17,1,1,19
16975,2019-11-11,강남구,0.5,0,17,0,3,20
16976,2019-11-11,강동구,0.5,0,5,0,0,5
16977,2019-11-11,강북구,0.5,0,2,0,0,2
16978,2019-11-11,강서구,0.5,0,5,0,0,5
16979,2019-11-11,관악구,1.0,0,1,0,0,1
16980,2019-11-11,광진구,0.5,0,4,2,0,6
16981,2019-11-11,구로구,1.5,0,3,0,2,5
16982,2019-11-11,금천구,1.0,0,1,0,3,4
16983,2019-11-11,노원구,0.5,0,5,0,1,6
16984,2019-11-11,도봉구,0.5,0,4,0,0,4
16985,2019-11-11,동대문구,0.5,0,2,0,2,4
16986,2019-11-11,동작구,0.5,0,6,1,3,10
16987,2019-11-11,마포구,1.5,0,6,0,0,6
16988,2019-11-11,서대문구,1.0,0,4,0,0,4
16989,2019-11-11,서초구,0.5,0,5,1,1,7
16990,2019-11-11,성동구,1.0,0,1,0,1,2
16991,2019-11-11,성북구,0.0,0,3,0,2,5
16992,2019-11-11,송파구,0.5,0,8,1,3,12
16993,2019-11-11,양천구,0.5,0,7,2,1,10
16994,2019-11-11,영등포구,0.75,0,5,2,0,7
16995,2019-11-11,용산구,0.5,0,3,0,1,4
16996,2019-11-11,은평구,0.5,0,2,0,1,3
16997,2019-11-11,종로구,1.1,0,0,4,1,5
16998,2019-11-11,중구,1.5,0,6,1,2,9
16999,2019-11-11,중랑구,0.0,0,3,3,2,8
17000,2019-11-12,강남구,0.0,0,17,1,2,20
17001,2019-11-12,강동구,0.0,0,2,1,3,6
17002,2019-11-12,강북구,0.0,0,7,0,0,7
17003,2019-11-12,강서구,0.0,0,3,1,1,5
17004,2019-11-12,관악구,0.0,0,1,1,0,2
17005,2019-11-12,광진구,0.0,0,1,0,1,2
17006,2019-11-12,구로구,0.0,0,2,0,2,4
17007,2019-11-12,금천구,0.0,0,2,0,0,2
17008,2019-11-12,노원구,0.0,0,12,0,3,15
17009,2019-11-12,도봉구,0.0,0,2,0,4,6
17010,2019-11-12,동대문구,0.0,0,4,0,3,7
17011,2019-11-12,동작구,0.0,0,7,1,2,10
17012,2019-11-12,마포구,0.0,0,5,0,1,6
17013,2019-11-12,서대문구,0.0,0,3,0,0,3
17014,2019-11-12,서초구,0.0,0,7,0,0,7
17015,2019-11-12,성동구,0.0,0,4,1,1,6
17016,2019-11-12,성북구,0.0,0,3,1,3,7
17017,2019-11-12,송파구,0.0,0,9,1,5,15
17018,2019-11-12,양천구,0.0,0,6,0,2,8
17019,2019-11-12,영등포구,0.0,0,6,0,1,7
17020,2019-11-12,용산구,0.0,0,3,1,3,7
17021,2019-11-12,은평구,0.0,0,2,0,0,2
17022,2019-11-12,종로구,0.0,0,1,0,1,2
17023,2019-11-12,중구,0.0,0,2,0,0,2
17024,2019-11-12,중랑구,0.0,0,1,0,3,4
17025,2019-11-13,강남구,8.0,0,16,4,5,25
17026,2019-11-13,강동구,8.0,0,1,1,3,5
17027,2019-11-13,강북구,6.5,0,3,1,1,5
17028,2019-11-13,강서구,10.0,0,6,2,3,11
17029,2019-11-13,관악구,12.25,0,4,2,1,7
17030,2019-11-13,광진구,8.5,0,2,0,1,3
17031,2019-11-13,구로구,13.5,0,1,0,2,3
17032,2019-11-13,금천구,12.0,0,4,0,1,5
17033,2019-11-13,노원구,7.5,0,2,0,1,3
17034,2019-11-13,도봉구,8.5,0,0,0,1,1
17035,2019-11-13,동대문구,7.0,0,3,0,0,3
17036,2019-11-13,동작구,11.0,0,7,1,1,9
17037,2019-11-13,마포구,8.0,0,2,0,2,4
17038,2019-11-13,서대문구,5.5,0,2,0,0,2
17039,2019-11-13,서초구,9.0,0,8,2,3,13
17040,2019-11-13,성동구,8.0,0,3,1,2,6
17041,2019-11-13,성북구,7.0,0,4,0,1,5
17042,2019-11-13,송파구,7.5,0,14,2,0,16
17043,2019-11-13,양천구,10.5,0,6,1,1,8
17044,2019-11-13,영등포구,9.75,0,4,0,1,5
17045,2019-11-13,용산구,9.0,0,4,0,1,5
17046,2019-11-13,은평구,6.5,0,2,0,0,2
17047,2019-11-13,종로구,7.5,0,0,0,0,0
17048,2019-11-13,중구,7.0,0,1,0,1,2
17049,2019-11-13,중랑구,6.5,0,3,1,1,5
17050,2019-11-14,강남구,0.0,0,13,0,1,14
17051,2019-11-14,강동구,0.0,0,4,0,5,9
17052,2019-11-14,강북구,0.0,0,7,0,0,7
17053,2019-11-14,강서구,0.0,0,11,3,0,14
17054,2019-11-14,관악구,0.0,0,3,0,1,4
17055,2019-11-14,광진구,0.0,0,2,0,0,2
17056,2019-11-14,구로구,0.0,0,4,0,2,6
17057,2019-11-14,금천구,0.0,0,6,0,0,6
17058,2019-11-14,노원구,0.0,0,3,0,2,5
17059,2019-11-14,도봉구,0.0,0,0,0,0,0
17060,2019-11-14,동대문구,0.0,0,2,0,2,4
17061,2019-11-14,동작구,0.0,0,8,5,1,14
17062,2019-11-14,마포구,0.0,0,5,3,0,8
17063,2019-11-14,서대문구,0.0,0,6,0,1,7
17064,2019-11-14,서초구,0.0,0,7,1,2,10
17065,2019-11-14,성동구,0.0,0,3,1,3,7
17066,2019-11-14,성북구,0.0,0,3,1,0,4
17067,2019-11-14,송파구,0.0,0,6,0,4,10
17068,2019-11-14,양천구,0.0,0,11,0,0,11
17069,2019-11-14,영등포구,0.0,0,8,0,0,8
17070,2019-11-14,용산구,0.0,0,3,0,1,4
17071,2019-11-14,은평구,0.0,0,3,0,1,4
17072,2019-11-14,종로구,0.0,0,2,1,1,4
17073,2019-11-14,중구,0.0,0,3,0,1,4
17074,2019-11-14,중랑구,0.0,0,3,1,1,5
17075,2019-11-15,강남구,24.0,0,24,3,5,32
17076,2019-11-15,강동구,18.5,0,8,1,2,11
17077,2019-11-15,강북구,20.0,0,5,0,0,5
17078,2019-11-15,강서구,19.5,0,7,2,2,11
17079,2019-11-15,관악구,23.5,0,4,1,1,6
17080,2019-11-15,광진구,23.0,0,4,0,0,4
17081,2019-11-15,구로구,26.0,0,9,0,2,11
17082,2019-11-15,금천구,25.0,0,2,0,0,2
17083,2019-11-15,노원구,17.5,0,9,1,1,11
17084,2019-11-15,도봉구,22.0,0,0,0,1,1
17085,2019-11-15,동대문구,20.0,0,8,0,2,10
17086,2019-11-15,동작구,24.75,0,2,0,2,4
17087,2019-11-15,마포구,19.0,0,7,4,3,14
17088,2019-11-15,서대문구,17.0,0,7,1,1,9
17089,2019-11-15,서초구,20.0,1,12,1,6,20
17090,2019-11-15,성동구,19.5,0,5,0,1,6
17091,2019-11-15,성북구,20.5,0,4,1,0,5
17092,2019-11-15,송파구,19.5,1,11,2,1,15
17093,2019-11-15,양천구,21.5,0,15,0,1,16
17094,2019-11-15,영등포구,20.75,0,7,0,2,9
17095,2019-11-15,용산구,24.0,0,10,0,1,11
17096,2019-11-15,은평구,22.0,0,3,2,0,5
17097,2019-11-15,종로구,18.8,0,3,0,0,3
17098,2019-11-15,중구,15.0,0,9,1,6,16
17099,2019-11-15,중랑구,19.0,0,5,1,1,7
17100,2019-11-16,강남구,0.0,0,30,0,3,33
17101,2019-11-16,강동구,0.0,0,1,0,2,3
17102,2019-11-16,강북구,0.0,1,3,0,0,4
17103,2019-11-16,강서구,0.0,0,10,4,0,14
17104,2019-11-16,관악구,0.0,0,4,0,3,7
17105,2019-11-16,광진구,0.0,0,3,0,2,5
17106,2019-11-16,구로구,0.0,0,3,1,0,4
17107,2019-11-16,금천구,0.0,0,1,0,1,2
17108,2019-11-16,노원구,0.0,0,5,3,1,9
17109,2019-11-16,도봉구,0.0,0,2,0,1,3
17110,2019-11-16,동대문구,0.0,0,6,1,3,10
17111,2019-11-16,동작구,0.0,0,0,1,0,1
17112,2019-11-16,마포구,0.0,0,1,2,0,3
17113,2019-11-16,서대문구,0.0,0,6,0,1,7
17114,2019-11-16,서초구,0.0,0,10,1,3,14
17115,2019-11-16,성동구,0.0,0,1,0,0,1
17116,2019-11-16,성북구,0.0,0,3,0,4,7
17117,2019-11-16,송파구,0.0,1,13,1,2,17
17118,2019-11-16,양천구,0.0,0,1,0,0,1
17119,2019-11-16,영등포구,0.0,0,12,0,1,13
17120,2019-11-16,용산구,0.0,0,1,0,2,3
17121,2019-11-16,은평구,0.0,0,2,0,1,3
17122,2019-11-16,종로구,0.0,0,0,0,0,0
17123,2019-11-16,중구,0.0,0,2,0,1,3
17124,2019-11-16,중랑구,0.0,0,5,0,3,8
17125,2019-11-17,강남구,37.0,0,12,5,5,22
17126,2019-11-17,강동구,31.5,0,4,0,0,4
17127,2019-11-17,강북구,23.0,0,3,1,0,4
17128,2019-11-17,강서구,19.0,0,4,0,1,5
17129,2019-11-17,관악구,39.75,0,0,0,1,1
17130,2019-11-17,광진구,34.5,0,2,1,0,3
17131,2019-11-17,구로구,25.0,0,0,0,1,1
17132,2019-11-17,금천구,32.0,0,1,0,2,3
17133,2019-11-17,노원구,24.0,0,4,1,1,6
17134,2019-11-17,도봉구,18.0,0,1,0,0,1
17135,2019-11-17,동대문구,27.5,0,4,1,1,6
17136,2019-11-17,동작구,32.0,0,6,1,2,9
17137,2019-11-17,마포구,22.0,0,5,0,1,6
17138,2019-11-17,서대문구,20.0,0,2,0,3,5
17139,2019-11-17,서초구,32.0,0,7,1,0,8
17140,2019-11-17,성동구,31.5,0,9,1,0,10
17141,2019-11-17,성북구,20.5,0,5,0,0,5
17142,2019-11-17,송파구,35.0,0,5,0,1,6
17143,2019-11-17,양천구,23.5,0,2,0,1,3
17144,2019-11-17,영등포구,24.75,0,8,0,2,10
17145,2019-11-17,용산구,33.0,0,1,0,2,3
17146,2019-11-17,은평구,17.5,0,1,1,2,4
17147,2019-11-17,종로구,21.1,0,3,1,1,5
17148,2019-11-17,중구,0.5,0,4,0,0,4
17149,2019-11-17,중랑구,31.0,0,4,0,2,6
17150,2019-11-18,강남구,17.0,0,14,3,1,18
17151,2019-11-18,강동구,16.0,0,7,0,2,9
17152,2019-11-18,강북구,16.5,0,8,1,2,11
17153,2019-11-18,강서구,14.0,0,8,1,3,12
17154,2019-11-18,관악구,15.5,0,3,0,1,4
17155,2019-11-18,광진구,16.5,0,0,0,1,1
17156,2019-11-18,구로구,14.5,0,5,0,3,8
17157,2019-11-18,금천구,13.0,0,1,0,1,2
17158,2019-11-18,노원구,18.0,0,5,0,0,5
17159,2019-11-18,도봉구,16.0,0,11,1,3,15
17160,2019-11-18,동대문구,17.0,0,2,1,0,3
17161,2019-11-18,동작구,14.0,0,12,1,7,20
17162,2019-11-18,마포구,13.0,0,7,1,0,8
17163,2019-11-18,서대문구,13.0,0,3,0,3,6
17164,2019-11-18,서초구,14.0,0,8,0,0,8
17165,2019-11-18,성동구,16.0,0,3,0,1,4
17166,2019-11-18,성북구,15.0,0,7,0,1,8
17167,2019-11-18,송파구,17.0,0,12,2,0,14
17168,2019-11-18,양천구,11.5,0,3,0,1,4
17169,2019-11-18,영등포구,12.5,0,5,1,4,10
17170,2019-11-18,용산구,13.5,0,4,0,3,7
17171,2019-11-18,은평구,12.5,0,5,0,1,6
17172,2019-11-18,종로구,14.7,0,7,2,1,10
17173,2019-11-18,중구,14.0,0,7,0,3,10
17174,2019-11-18,중랑구,16.5,0,8,1,0,9
17175,2019-11-19,강남구,0.0,0,13,0,5,18
17176,2019-11-19,강동구,0.0,0,4,0,5,9
17177,2019-11-19,강북구,0.0,0,4,1,2,7
17178,2019-11-19,강서구,0.0,0,7,0,3,10
17179,2019-11-19,관악구,0.0,0,5,0,1,6
17180,2019-11-19,광진구,0.0,0,2,0,1,3
17181,2019-11-19,구로구,0.0,0,2,0,2,4
17182,2019-11-19,금천구,0.0,0,5,1,3,9
17183,2019-11-19,노원구,0.0,0,5,0,2,7
17184,2019-11-19,도봉구,0.0,0,1,0,0,1
17185,2019-11-19,동대문구,0.0,0,5,0,1,6
17186,2019-11-19,동작구,0.0,0,2,0,2,4
17187,2019-11-19,마포구,0.0,0,0,0,1,1
17188,2019-11-19,서대문구,0.0,0,2,1,1,4
17189,2019-11-19,서초구,0.0,0,13,1,3,17
17190,2019-11-19,성동구,0.0,0,5,1,0,6
17191,2019-11-19,성북구,0.0,0,5,0,8,13
17192,2019-11-19,송파구,0.0,0,13,3,2,18
17193,2019-11-19,양천구,0.0,0,4,0,1,5
17194,2019-11-19,영등포구,0.0,0,8,2,4,14
17195,2019-11-19,용산구,0.0,0,7,0,2,9
17196,2019-11-19,은평구,0.0,0,1,0,3,4
17197,2019-11-19,종로구,0.0,0,7,0,0,7
17198,2019-11-19,중구,0.0,0,3,0,0,3
17199,2019-11-19,중랑구,0.0,0,6,1,1,8
17200,2019-11-20,강남구,0.0,0,24,6,0,30
17201,2019-11-20,강동구,0.0,0,2,0,3,5
17202,2019-11-20,강북구,0.0,0,4,0,1,5
17203,2019-11-20,강서구,0.0,0,4,0,2,6
17204,2019-11-20,관악구,0.0,0,4,0,2,6
17205,2019-11-20,광진구,0.0,0,1,0,1,2
17206,2019-11-20,구로구,0.0,0,2,0,0,2
17207,2019-11-20,금천구,0.0,0,0,0,0,0
17208,2019-11-20,노원구,0.0,0,7,0,1,8
17209,2019-11-20,도봉구,0.0,0,1,0,5,6
17210,2019-11-20,동대문구,0.0,0,3,0,1,4
17211,2019-11-20,동작구,0.0,0,2,0,2,4
17212,2019-11-20,마포구,0.0,0,2,1,0,3
17213,2019-11-20,서대문구,0.0,0,5,0,0,5
17214,2019-11-20,서초구,0.0,0,9,1,3,13
17215,2019-11-20,성동구,0.0,0,4,1,1,6
17216,2019-11-20,성북구,0.0,0,4,0,1,5
17217,2019-11-20,송파구,0.0,0,8,2,4,14
17218,2019-11-20,양천구,0.0,0,5,2,1,8
17219,2019-11-20,영등포구,0.0,0,10,0,0,10
17220,2019-11-20,용산구,0.0,0,3,0,1,4
17221,2019-11-20,은평구,0.0,0,6,0,2,8
17222,2019-11-20,종로구,0.0,0,4,0,0,4
17223,2019-11-20,중구,0.0,0,2,0,0,2
17224,2019-11-20,중랑구,0.0,0,4,0,1,5
17225,2019-11-21,강남구,0.0,1,19,1,3,24
17226,2019-11-21,강동구,0.0,0,9,1,1,11
17227,2019-11-21,강북구,0.0,0,2,0,2,4
17228,2019-11-21,강서구,0.0,0,3,0,1,4
17229,2019-11-21,관악구,0.0,0,8,0,0,8
17230,2019-11-21,광진구,0.0,0,0,0,0,0
17231,2019-11-21,구로구,0.0,0,3,1,4,8
17232,2019-11-21,금천구,0.0,0,4,0,2,6
17233,2019-11-21,노원구,0.0,0,4,0,1,5
17234,2019-11-21,도봉구,0.0,0,1,1,4,6
17235,2019-11-21,동대문구,0.0,0,2,1,1,4
17236,2019-11-21,동작구,0.0,0,4,0,0,4
17237,2019-11-21,마포구,0.0,0,2,0,1,3
17238,2019-11-21,서대문구,0.0,0,3,1,0,4
17239,2019-11-21,서초구,0.0,0,7,4,4,15
17240,2019-11-21,성동구,0.0,0,2,0,0,2
17241,2019-11-21,성북구,0.0,0,2,0,4,6
17242,2019-11-21,송파구,0.0,0,10,1,1,12
17243,2019-11-21,양천구,0.0,0,2,1,1,4
17244,2019-11-21,영등포구,0.0,1,5,0,1,7
17245,2019-11-21,용산구,0.0,0,3,0,1,4
17246,2019-11-21,은평구,0.0,0,6,0,2,8
17247,2019-11-21,종로구,0.0,0,1,0,1,2
17248,2019-11-21,중구,0.0,0,6,0,0,6
17249,2019-11-21,중랑구,0.0,0,4,1,1,6
17250,2019-11-22,강남구,0.0,0,15,3,0,18
17251,2019-11-22,강동구,0.0,0,7,0,0,7
17252,2019-11-22,강북구,0.0,0,1,0,0,1
17253,2019-11-22,강서구,0.0,0,3,2,2,7
17254,2019-11-22,관악구,0.0,0,0,1,0,1
17255,2019-11-22,광진구,0.0,0,3,1,0,4
17256,2019-11-22,구로구,0.0,0,6,0,1,7
17257,2019-11-22,금천구,0.0,0,1,0,0,1
17258,2019-11-22,노원구,0.0,0,7,1,0,8
17259,2019-11-22,도봉구,0.0,0,2,1,0,3
17260,2019-11-22,동대문구,0.0,0,4,0,1,5
17261,2019-11-22,동작구,0.0,0,3,0,1,4
17262,2019-11-22,마포구,0.0,0,4,1,0,5
17263,2019-11-22,서대문구,0.0,0,2,1,1,4
17264,2019-11-22,서초구,0.0,0,7,1,3,11
17265,2019-11-22,성동구,0.0,0,3,0,0,3
17266,2019-11-22,성북구,0.0,0,8,0,1,9
17267,2019-11-22,송파구,0.0,0,9,0,3,12
17268,2019-11-22,양천구,0.0,0,7,2,1,10
17269,2019-11-22,영등포구,0.0,0,3,1,2,6
17270,2019-11-22,용산구,0.0,0,4,0,0,4
17271,2019-11-22,은평구,0.0,0,4,0,3,7
17272,2019-11-22,종로구,0.0,0,2,0,1,3
17273,2019-11-22,중구,0.0,0,5,0,2,7
17274,2019-11-22,중랑구,0.0,0,6,0,0,6
17275,2019-11-23,강남구,0.0,0,8,1,2,11
17276,2019-11-23,강동구,0.0,0,5,2,3,10
17277,2019-11-23,강북구,0.0,0,5,1,3,9
17278,2019-11-23,강서구,0.0,0,6,0,0,6
17279,2019-11-23,관악구,0.0,0,5,1,0,6
17280,2019-11-23,광진구,0.0,0,1,0,2,3
17281,2019-11-23,구로구,0.0,0,5,0,0,5
17282,2019-11-23,금천구,0.0,0,1,0,2,3
17283,2019-11-23,노원구,0.0,0,6,1,1,8
17284,2019-11-23,도봉구,0.0,0,0,0,1,1
17285,2019-11-23,동대문구,0.0,0,7,0,3,10
17286,2019-11-23,동작구,0.0,0,9,0,0,9
17287,2019-11-23,마포구,0.0,0,6,2,0,8
17288,2019-11-23,서대문구,0.0,0,7,2,1,10
17289,2019-11-23,서초구,0.0,0,15,0,1,16
17290,2019-11-23,성동구,0.0,0,1,0,0,1
17291,2019-11-23,성북구,0.0,0,4,2,5,11
17292,2019-11-23,송파구,0.0,0,6,0,2,8
17293,2019-11-23,양천구,0.0,0,3,0,2,5
17294,2019-11-23,영등포구,0.0,0,9,2,1,12
17295,2019-11-23,용산구,0.0,0,6,0,1,7
17296,2019-11-23,은평구,0.0,0,7,0,0,7
17297,2019-11-23,종로구,0.0,0,2,0,1,3
17298,2019-11-23,중구,0.0,0,3,0,1,4
17299,2019-11-23,중랑구,0.0,0,5,0,2,7
17300,2019-11-24,강남구,2.5,0,8,1,0,9
17301,2019-11-24,강동구,1.5,0,1,0,1,2
17302,2019-11-24,강북구,0.5,0,6,0,1,7
17303,2019-11-24,강서구,2.5,0,3,0,0,3
17304,2019-11-24,관악구,5.75,0,0,0,0,0
17305,2019-11-24,광진구,2.5,0,0,0,0,0
17306,2019-11-24,구로구,4.0,0,1,0,0,1
17307,2019-11-24,금천구,4.5,0,2,0,1,3
17308,2019-11-24,노원구,1.5,0,3,0,1,4
17309,2019-11-24,도봉구,1.0,0,4,0,3,7
17310,2019-11-24,동대문구,1.5,0,5,1,2,8
17311,2019-11-24,동작구,3.75,0,2,0,0,2
17312,2019-11-24,마포구,3.0,0,0,0,0,0
17313,2019-11-24,서대문구,3.5,0,3,0,1,4
17314,2019-11-24,서초구,4.0,0,1,0,3,4
17315,2019-11-24,성동구,1.5,0,2,0,1,3
17316,2019-11-24,성북구,1.0,0,4,0,0,4
17317,2019-11-24,송파구,2.5,0,8,0,3,11
17318,2019-11-24,양천구,3.0,0,1,0,2,3
17319,2019-11-24,영등포구,2.75,0,10,0,2,12
17320,2019-11-24,용산구,3.0,0,9,0,0,9
17321,2019-11-24,은평구,3.5,0,3,0,0,3
17322,2019-11-24,종로구,3.8,0,3,1,0,4
17323,2019-11-24,중구,2.5,0,4,0,1,5
17324,2019-11-24,중랑구,1.5,0,8,0,1,9
17325,2019-11-25,강남구,0.0,0,10,1,3,14
17326,2019-11-25,강동구,0.0,0,2,1,1,4
17327,2019-11-25,강북구,0.0,0,1,0,2,3
17328,2019-11-25,강서구,0.0,0,6,1,4,11
17329,2019-11-25,관악구,0.0,0,3,0,0,3
17330,2019-11-25,광진구,0.0,0,1,0,1,2
17331,2019-11-25,구로구,0.0,0,1,0,2,3
17332,2019-11-25,금천구,0.0,0,2,0,0,2
17333,2019-11-25,노원구,0.0,0,4,1,2,7
17334,2019-11-25,도봉구,0.0,0,0,0,1,1
17335,2019-11-25,동대문구,0.0,0,6,0,1,7
17336,2019-11-25,동작구,0.0,0,12,1,3,16
17337,2019-11-25,마포구,0.0,0,2,0,3,5
17338,2019-11-25,서대문구,0.0,0,3,1,0,4
17339,2019-11-25,서초구,0.0,0,7,1,0,8
17340,2019-11-25,성동구,0.0,0,4,0,1,5
17341,2019-11-25,성북구,0.0,0,5,1,0,6
17342,2019-11-25,송파구,0.0,1,10,0,0,11
17343,2019-11-25,양천구,0.0,0,1,0,1,2
17344,2019-11-25,영등포구,0.0,0,7,0,1,8
17345,2019-11-25,용산구,0.0,0,3,1,0,4
17346,2019-11-25,은평구,0.0,0,3,0,0,3
17347,2019-11-25,종로구,0.0,0,1,0,0,1
17348,2019-11-25,중구,0.0,0,2,0,1,3
17349,2019-11-25,중랑구,0.0,0,4,0,0,4
17350,2019-11-26,강남구,0.0,0,13,3,5,21
17351,2019-11-26,강동구,0.0,0,6,1,3,10
17352,2019-11-26,강북구,0.0,0,10,0,0,10
17353,2019-11-26,강서구,0.0,0,5,0,2,7
17354,2019-11-26,관악구,0.0,0,2,0,2,4
17355,2019-11-26,광진구,0.0,0,5,0,0,5
17356,2019-11-26,구로구,0.0,0,4,0,0,4
17357,2019-11-26,금천구,0.0,0,2,0,0,2
17358,2019-11-26,노원구,0.0,0,2,0,1,3
17359,2019-11-26,도봉구,0.0,0,0,0,0,0
17360,2019-11-26,동대문구,0.0,0,4,0,4,8
17361,2019-11-26,동작구,0.0,0,3,1,1,5
17362,2019-11-26,마포구,0.0,0,5,1,0,6
17363,2019-11-26,서대문구,0.0,0,0,1,1,2
17364,2019-11-26,서초구,0.0,0,11,2,3,16
17365,2019-11-26,성동구,0.0,0,4,0,1,5
17366,2019-11-26,성북구,0.0,0,1,1,2,4
17367,2019-11-26,송파구,0.0,0,8,0,1,9
17368,2019-11-26,양천구,0.0,0,4,1,2,7
17369,2019-11-26,영등포구,0.0,0,2,0,0,2
17370,2019-11-26,용산구,0.0,0,7,0,0,7
17371,2019-11-26,은평구,0.0,0,2,0,0,2
17372,2019-11-26,종로구,0.0,0,2,1,2,5
17373,2019-11-26,중구,0.0,0,3,1,1,5
17374,2019-11-26,중랑구,0.0,0,9,0,2,11
17375,2019-11-27,강남구,0.0,0,13,2,1,16
17376,2019-11-27,강동구,0.0,0,5,1,1,7
17377,2019-11-27,강북구,0.0,0,2,0,2,4
17378,2019-11-27,강서구,0.0,0,5,1,3,9
17379,2019-11-27,관악구,0.0,0,7,0,1,8
17380,2019-11-27,광진구,0.0,0,2,0,1,3
17381,2019-11-27,구로구,0.0,0,3,0,1,4
17382,2019-11-27,금천구,0.0,0,3,0,1,4
17383,2019-11-27,노원구,0.0,0,3,0,1,4
17384,2019-11-27,도봉구,0.0,0,5,4,1,10
17385,2019-11-27,동대문구,0.0,0,1,0,1,2
17386,2019-11-27,동작구,0.0,0,1,1,0,2
17387,2019-11-27,마포구,0.0,0,5,1,0,6
17388,2019-11-27,서대문구,0.0,0,3,1,0,4
17389,2019-11-27,서초구,0.0,1,5,2,0,8
17390,2019-11-27,성동구,0.0,0,1,0,0,1
17391,2019-11-27,성북구,0.0,0,3,0,0,3
17392,2019-11-27,송파구,0.0,0,9,0,0,9
17393,2019-11-27,양천구,0.0,0,3,0,0,3
17394,2019-11-27,영등포구,0.0,0,8,1,2,11
17395,2019-11-27,용산구,0.0,0,2,0,0,2
17396,2019-11-27,은평구,0.0,0,4,2,1,7
17397,2019-11-27,종로구,0.0,0,2,0,1,3
17398,2019-11-27,중구,0.0,0,7,1,1,9
17399,2019-11-27,중랑구,0.0,0,3,2,1,6
17400,2019-11-28,강남구,0.0,0,17,1,5,23
17401,2019-11-28,강동구,0.0,0,6,1,1,8
17402,2019-11-28,강북구,0.0,0,3,0,2,5
17403,2019-11-28,강서구,0.0,0,2,0,0,2
17404,2019-11-28,관악구,0.0,0,2,0,1,3
17405,2019-11-28,광진구,0.0,0,5,0,0,5
17406,2019-11-28,구로구,0.0,0,3,0,1,4
17407,2019-11-28,금천구,0.0,0,1,0,1,2
17408,2019-11-28,노원구,0.0,0,4,0,1,5
17409,2019-11-28,도봉구,0.0,0,1,0,0,1
17410,2019-11-28,동대문구,0.0,0,3,0,2,5
17411,2019-11-28,동작구,0.0,0,0,0,2,2
17412,2019-11-28,마포구,0.0,0,4,0,2,6
17413,2019-11-28,서대문구,0.0,0,2,0,2,4
17414,2019-11-28,서초구,0.0,0,8,2,7,17
17415,2019-11-28,성동구,0.0,0,3,0,1,4
17416,2019-11-28,성북구,0.0,0,4,2,0,6
17417,2019-11-28,송파구,0.0,0,3,0,2,5
17418,2019-11-28,양천구,0.0,0,2,1,2,5
17419,2019-11-28,영등포구,0.0,0,6,0,0,6
17420,2019-11-28,용산구,0.0,0,3,0,0,3
17421,2019-11-28,은평구,0.0,0,6,1,0,7
17422,2019-11-28,종로구,0.0,0,1,1,1,3
17423,2019-11-28,중구,0.0,0,2,1,1,4
17424,2019-11-28,중랑구,0.0,0,1,0,1,2
17425,2019-11-29,강남구,0.0,0,11,1,4,16
17426,2019-11-29,강동구,0.0,0,1,3,4,8
17427,2019-11-29,강북구,0.0,0,6,0,0,6
17428,2019-11-29,강서구,0.0,0,2,0,2,4
17429,2019-11-29,관악구,0.0,0,8,0,1,9
17430,2019-11-29,광진구,0.0,0,4,0,3,7
17431,2019-11-29,구로구,0.0,0,6,0,2,8
17432,2019-11-29,금천구,0.0,0,1,0,0,1
17433,2019-11-29,노원구,0.0,0,9,0,2,11
17434,2019-11-29,도봉구,0.0,0,2,0,0,2
17435,2019-11-29,동대문구,0.0,0,2,0,0,2
17436,2019-11-29,동작구,0.0,0,5,0,1,6
17437,2019-11-29,마포구,0.0,0,1,0,0,1
17438,2019-11-29,서대문구,0.0,0,1,2,1,4
17439,2019-11-29,서초구,0.0,0,14,2,3,19
17440,2019-11-29,성동구,0.0,0,0,1,1,2
17441,2019-11-29,성북구,0.0,0,5,0,3,8
17442,2019-11-29,송파구,0.0,0,10,0,3,13
17443,2019-11-29,양천구,0.0,0,5,0,2,7
17444,2019-11-29,영등포구,0.0,0,4,0,4,8
17445,2019-11-29,용산구,0.0,0,2,0,0,2
17446,2019-11-29,은평구,0.0,0,7,0,3,10
17447,2019-11-29,종로구,0.0,0,4,0,2,6
17448,2019-11-29,중구,0.0,0,1,0,3,4
17449,2019-11-29,중랑구,0.0,0,10,0,1,11
17450,2019-11-30,강남구,0.0,0,18,3,4,25
17451,2019-11-30,강동구,0.0,0,4,0,5,9
17452,2019-11-30,강북구,0.0,0,7,0,4,11
17453,2019-11-30,강서구,0.0,0,6,0,1,7
17454,2019-11-30,관악구,0.0,0,5,2,0,7
17455,2019-11-30,광진구,0.0,0,2,0,1,3
17456,2019-11-30,구로구,0.0,0,4,2,2,8
17457,2019-11-30,금천구,0.0,0,0,0,0,0
17458,2019-11-30,노원구,0.0,0,5,0,2,7
17459,2019-11-30,도봉구,0.0,0,1,0,0,1
17460,2019-11-30,동대문구,0.0,0,9,0,0,9
17461,2019-11-30,동작구,0.0,0,5,0,0,5
17462,2019-11-30,마포구,0.0,0,5,0,1,6
17463,2019-11-30,서대문구,0.0,0,6,2,1,9
17464,2019-11-30,서초구,0.0,0,15,6,0,21
17465,2019-11-30,성동구,0.0,0,5,0,2,7
17466,2019-11-30,성북구,0.0,0,7,0,2,9
17467,2019-11-30,송파구,0.0,0,9,0,5,14
17468,2019-11-30,양천구,0.0,0,6,0,0,6
17469,2019-11-30,영등포구,0.0,0,9,1,1,11
17470,2019-11-30,용산구,0.0,0,12,0,0,12
17471,2019-11-30,은평구,0.0,0,4,1,1,6
17472,2019-11-30,종로구,0.0,0,5,1,0,6
17473,2019-11-30,중구,0.0,0,4,1,3,8
17474,2019-11-30,중랑구,0.0,0,4,0,3,7
17475,2019-12-01,강남구,4.0,0,6,3,2,11
17476,2019-12-01,강동구,2.0,1,8,2,1,12
17477,2019-12-01,강북구,1.0,0,6,0,1,7
17478,2019-12-01,강서구,3.0,0,3,0,1,4
17479,2019-12-01,관악구,4.5,0,5,1,0,6
17480,2019-12-01,광진구,3.0,0,3,0,0,3
17481,2019-12-01,구로구,3.5,0,1,0,0,1
17482,2019-12-01,금천구,3.5,0,3,0,0,3
17483,2019-12-01,노원구,1.0,0,3,0,1,4
17484,2019-12-01,도봉구,1.0,0,3,0,1,4
17485,2019-12-01,동대문구,2.0,0,4,2,2,8
17486,2019-12-01,동작구,3.5,0,3,2,0,5
17487,2019-12-01,마포구,2.0,1,5,1,2,9
17488,2019-12-01,서대문구,2.5,0,0,0,0,0
17489,2019-12-01,서초구,3.5,0,7,0,1,8
17490,2019-12-01,성동구,3.0,0,2,0,0,2
17491,2019-12-01,성북구,1.5,0,8,1,0,9
17492,2019-12-01,송파구,2.0,0,5,1,2,8
17493,2019-12-01,양천구,2.5,0,5,0,2,7
17494,2019-12-01,영등포구,2.75,0,10,0,0,10
17495,2019-12-01,용산구,3.5,0,8,0,1,9
17496,2019-12-01,은평구,2.5,0,2,1,2,5
17497,2019-12-01,종로구,3.3,0,6,0,0,6
17498,2019-12-01,중구,2.5,0,5,0,0,5
17499,2019-12-01,중랑구,2.0,0,7,0,1,8
17500,2019-12-02,강남구,0.0,0,17,2,1,20
17501,2019-12-02,강동구,0.0,0,0,0,1,1
17502,2019-12-02,강북구,0.0,0,6,0,0,6
17503,2019-12-02,강서구,0.0,0,12,2,2,16
17504,2019-12-02,관악구,0.0,0,10,0,0,10
17505,2019-12-02,광진구,0.0,0,0,1,1,2
17506,2019-12-02,구로구,0.0,0,8,0,2,10
17507,2019-12-02,금천구,0.0,0,4,0,2,6
17508,2019-12-02,노원구,0.0,0,4,0,1,5
17509,2019-12-02,도봉구,0.0,0,4,0,0,4
17510,2019-12-02,동대문구,0.0,0,6,0,1,7
17511,2019-12-02,동작구,0.0,0,4,0,1,5
17512,2019-12-02,마포구,0.0,0,2,0,1,3
17513,2019-12-02,서대문구,0.0,0,3,0,1,4
17514,2019-12-02,서초구,0.0,0,4,1,1,6
17515,2019-12-02,성동구,0.0,0,3,1,0,4
17516,2019-12-02,성북구,0.0,0,2,1,0,3
17517,2019-12-02,송파구,0.0,0,21,0,2,23
17518,2019-12-02,양천구,0.0,0,3,0,0,3
17519,2019-12-02,영등포구,0.0,0,11,0,5,16
17520,2019-12-02,용산구,0.0,0,1,0,1,2
17521,2019-12-02,은평구,0.0,0,3,1,1,5
17522,2019-12-02,종로구,0.0,0,2,0,3,5
17523,2019-12-02,중구,0.0,0,4,0,2,6
17524,2019-12-02,중랑구,0.0,0,4,0,0,4
17525,2019-12-03,강남구,0.5,0,15,4,5,24
17526,2019-12-03,강동구,0.0,0,2,2,0,4
17527,2019-12-03,강북구,0.0,0,5,0,0,5
17528,2019-12-03,강서구,0.5,0,5,0,1,6
17529,2019-12-03,관악구,2.0,1,3,0,0,4
17530,2019-12-03,광진구,0.5,0,3,0,0,3
17531,2019-12-03,구로구,1.5,0,4,1,1,6
17532,2019-12-03,금천구,1.5,0,2,0,0,2
17533,2019-12-03,노원구,0.0,0,1,0,1,2
17534,2019-12-03,도봉구,0.0,0,7,0,2,9
17535,2019-12-03,동대문구,0.0,1,4,2,3,10
17536,2019-12-03,동작구,0.75,0,5,1,0,6
17537,2019-12-03,마포구,0.0,0,1,0,0,1
17538,2019-12-03,서대문구,0.0,0,3,0,0,3
17539,2019-12-03,서초구,0.5,0,3,0,0,3
17540,2019-12-03,성동구,0.0,1,3,0,2,6
17541,2019-12-03,성북구,0.0,0,3,0,4,7
17542,2019-12-03,송파구,0.0,0,12,3,1,16
17543,2019-12-03,양천구,0.5,0,3,1,1,5
17544,2019-12-03,영등포구,0.25,0,5,0,2,7
17545,2019-12-03,용산구,0.0,0,8,0,0,8
17546,2019-12-03,은평구,0.0,0,5,1,1,7
17547,2019-12-03,종로구,0.6,0,3,0,0,3
17548,2019-12-03,중구,0.0,0,1,1,0,2
17549,2019-12-03,중랑구,0.0,0,7,0,3,10
17550,2019-12-04,강남구,0.5,0,13,0,5,18
17551,2019-12-04,강동구,0.0,0,4,0,0,4
17552,2019-12-04,강북구,0.0,0,7,0,1,8
17553,2019-12-04,강서구,0.0,1,5,0,0,6
17554,2019-12-04,관악구,0.0,0,4,0,1,5
17555,2019-12-04,광진구,0.0,0,3,0,0,3
17556,2019-12-04,구로구,0.0,0,3,1,0,4
17557,2019-12-04,금천구,0.0,0,3,0,0,3
17558,2019-12-04,노원구,0.0,0,7,0,2,9
17559,2019-12-04,도봉구,0.0,0,1,0,0,1
17560,2019-12-04,동대문구,0.0,0,3,0,3,6
17561,2019-12-04,동작구,0.0,0,10,1,2,13
17562,2019-12-04,마포구,0.0,0,3,2,1,6
17563,2019-12-04,서대문구,0.0,0,2,1,0,3
17564,2019-12-04,서초구,0.0,0,9,0,2,11
17565,2019-12-04,성동구,0.0,0,0,0,0,0
17566,2019-12-04,성북구,0.0,0,2,1,2,5
17567,2019-12-04,송파구,0.0,0,17,6,2,25
17568,2019-12-04,양천구,0.0,0,6,0,4,10
17569,2019-12-04,영등포구,0.0,0,7,1,1,9
17570,2019-12-04,용산구,0.5,0,3,0,0,3
17571,2019-12-04,은평구,0.0,0,1,1,1,3
17572,2019-12-04,종로구,0.0,0,2,1,0,3
17573,2019-12-04,중구,0.0,0,5,0,1,6
17574,2019-12-04,중랑구,0.0,0,8,0,0,8
17575,2019-12-05,강남구,0.0,0,17,1,1,19
17576,2019-12-05,강동구,0.0,0,2,0,2,4
17577,2019-12-05,강북구,0.0,0,3,0,0,3
17578,2019-12-05,강서구,0.0,0,8,0,1,9
17579,2019-12-05,관악구,0.0,0,3,0,0,3
17580,2019-12-05,광진구,0.0,0,1,0,0,1
17581,2019-12-05,구로구,0.0,0,5,0,3,8
17582,2019-12-05,금천구,0.0,0,1,0,4,5
17583,2019-12-05,노원구,0.0,0,0,1,1,2
17584,2019-12-05,도봉구,0.0,0,1,0,1,2
17585,2019-12-05,동대문구,0.0,0,6,0,2,8
17586,2019-12-05,동작구,0.0,0,5,0,1,6
17587,2019-12-05,마포구,0.0,0,3,0,2,5
17588,2019-12-05,서대문구,0.0,0,2,0,2,4
17589,2019-12-05,서초구,0.0,0,3,1,0,4
17590,2019-12-05,성동구,0.0,0,1,0,0,1
17591,2019-12-05,성북구,0.0,0,5,1,3,9
17592,2019-12-05,송파구,0.0,0,4,1,2,7
17593,2019-12-05,양천구,0.0,0,5,1,2,8
17594,2019-12-05,영등포구,0.0,0,8,2,2,12
17595,2019-12-05,용산구,0.0,0,1,0,1,2
17596,2019-12-05,은평구,0.0,0,1,0,1,2
17597,2019-12-05,종로구,0.0,0,2,2,4,8
17598,2019-12-05,중구,0.0,0,5,0,4,9
17599,2019-12-05,중랑구,0.0,0,2,2,6,10
17600,2019-12-06,강남구,0.0,0,10,1,3,14
17601,2019-12-06,강동구,0.0,0,1,0,0,1
17602,2019-12-06,강북구,0.0,0,2,0,0,2
17603,2019-12-06,강서구,0.0,0,6,0,2,8
17604,2019-12-06,관악구,0.0,0,1,0,0,1
17605,2019-12-06,광진구,0.0,0,1,0,0,1
17606,2019-12-06,구로구,0.0,0,2,1,2,5
17607,2019-12-06,금천구,0.0,0,1,0,0,1
17608,2019-12-06,노원구,0.0,0,4,0,3,7
17609,2019-12-06,도봉구,0.0,0,5,0,0,5
17610,2019-12-06,동대문구,0.0,0,5,1,2,8
17611,2019-12-06,동작구,0.0,0,3,1,2,6
17612,2019-12-06,마포구,0.0,0,8,0,1,9
17613,2019-12-06,서대문구,0.0,0,5,2,3,10
17614,2019-12-06,서초구,0.0,0,7,1,1,9
17615,2019-12-06,성동구,0.0,0,4,0,1,5
17616,2019-12-06,성북구,0.0,0,2,0,1,3
17617,2019-12-06,송파구,0.0,0,6,0,0,6
17618,2019-12-06,양천구,0.0,0,7,0,2,9
17619,2019-12-06,영등포구,0.0,0,4,0,0,4
17620,2019-12-06,용산구,0.0,0,1,0,1,2
17621,2019-12-06,은평구,0.0,0,6,1,2,9
17622,2019-12-06,종로구,0.0,0,1,0,1,2
17623,2019-12-06,중구,0.0,0,4,1,2,7
17624,2019-12-06,중랑구,0.0,0,4,0,4,8
17625,2019-12-07,강남구,0.0,0,19,1,0,20
17626,2019-12-07,강동구,0.0,0,3,0,0,3
17627,2019-12-07,강북구,0.0,0,3,0,0,3
17628,2019-12-07,강서구,0.0,0,0,0,1,1
17629,2019-12-07,관악구,0.0,0,1,0,1,2
17630,2019-12-07,광진구,0.0,0,6,0,1,7
17631,2019-12-07,구로구,0.0,0,2,0,1,3
17632,2019-12-07,금천구,0.0,0,2,1,0,3
17633,2019-12-07,노원구,0.0,1,2,3,0,6
17634,2019-12-07,도봉구,0.0,0,4,0,0,4
17635,2019-12-07,동대문구,0.0,0,7,1,0,8
17636,2019-12-07,동작구,0.0,0,5,1,1,7
17637,2019-12-07,마포구,0.0,0,7,0,3,10
17638,2019-12-07,서대문구,0.0,0,2,1,0,3
17639,2019-12-07,서초구,0.0,0,12,1,2,15
17640,2019-12-07,성동구,0.0,0,1,0,0,1
17641,2019-12-07,성북구,0.0,0,8,0,0,8
17642,2019-12-07,송파구,0.0,0,6,0,3,9
17643,2019-12-07,양천구,0.0,0,10,1,4,15
17644,2019-12-07,영등포구,0.0,0,4,0,0,4
17645,2019-12-07,용산구,0.0,0,3,0,1,4
17646,2019-12-07,은평구,0.0,0,2,0,2,4
17647,2019-12-07,종로구,0.1,0,8,1,1,10
17648,2019-12-07,중구,0.0,0,20,16,1,37
17649,2019-12-07,중랑구,0.0,0,5,1,3,9
17650,2019-12-08,강남구,0.0,0,22,1,2,25
17651,2019-12-08,강동구,0.0,0,3,0,1,4
17652,2019-12-08,강북구,0.0,0,1,0,0,1
17653,2019-12-08,강서구,0.0,0,4,1,0,5
17654,2019-12-08,관악구,0.0,0,2,0,0,2
17655,2019-12-08,광진구,0.0,0,2,0,1,3
17656,2019-12-08,구로구,0.0,0,6,0,1,7
17657,2019-12-08,금천구,0.0,0,5,0,0,5
17658,2019-12-08,노원구,0.0,0,4,0,2,6
17659,2019-12-08,도봉구,0.0,0,1,1,0,2
17660,2019-12-08,동대문구,0.0,0,2,0,1,3
17661,2019-12-08,동작구,0.0,0,4,0,2,6
17662,2019-12-08,마포구,0.0,0,3,0,0,3
17663,2019-12-08,서대문구,0.0,1,1,1,0,3
17664,2019-12-08,서초구,0.0,0,3,0,3,6
17665,2019-12-08,성동구,0.0,0,3,0,1,4
17666,2019-12-08,성북구,0.0,0,2,0,0,2
17667,2019-12-08,송파구,0.0,0,3,0,0,3
17668,2019-12-08,양천구,0.0,0,3,0,0,3
17669,2019-12-08,영등포구,0.0,0,7,0,1,8
17670,2019-12-08,용산구,0.0,0,0,0,1,1
17671,2019-12-08,은평구,0.0,0,0,0,1,1
17672,2019-12-08,종로구,0.0,0,1,0,1,2
17673,2019-12-08,중구,0.0,0,0,0,0,0
17674,2019-12-08,중랑구,0.0,0,1,1,1,3
17675,2019-12-09,강남구,0.0,0,6,1,4,11
17676,2019-12-09,강동구,0.0,0,3,0,0,3
17677,2019-12-09,강북구,0.0,0,2,1,0,3
17678,2019-12-09,강서구,0.0,0,4,0,2,6
17679,2019-12-09,관악구,0.0,0,0,0,0,0
17680,2019-12-09,광진구,0.0,0,0,0,1,1
17681,2019-12-09,구로구,0.0,0,5,0,1,6
17682,2019-12-09,금천구,0.0,0,0,0,3,3
17683,2019-12-09,노원구,0.0,0,6,0,2,8
17684,2019-12-09,도봉구,0.0,0,1,4,1,6
17685,2019-12-09,동대문구,0.0,0,2,0,5,7
17686,2019-12-09,동작구,0.0,0,3,0,1,4
17687,2019-12-09,마포구,0.0,1,3,0,1,5
17688,2019-12-09,서대문구,0.0,0,2,1,1,4
17689,2019-12-09,서초구,0.0,0,10,0,0,10
17690,2019-12-09,성동구,0.0,0,7,0,0,7
17691,2019-12-09,성북구,0.0,0,6,0,1,7
17692,2019-12-09,송파구,0.0,0,4,0,0,4
17693,2019-12-09,양천구,0.0,0,3,1,1,5
17694,2019-12-09,영등포구,0.0,0,2,1,0,3
17695,2019-12-09,용산구,0.0,0,1,0,0,1
17696,2019-12-09,은평구,0.0,0,2,3,1,6
17697,2019-12-09,종로구,0.0,0,1,0,1,2
17698,2019-12-09,중구,0.0,0,2,0,1,3
17699,2019-12-09,중랑구,0.0,0,1,0,0,1
17700,2019-12-10,강남구,1.5,0,7,2,3,12
17701,2019-12-10,강동구,2.0,0,2,1,1,4
17702,2019-12-10,강북구,1.0,0,2,0,2,4
17703,2019-12-10,강서구,2.0,0,3,0,1,4
17704,2019-12-10,관악구,2.0,0,4,0,1,5
17705,2019-12-10,광진구,2.5,0,3,0,1,4
17706,2019-12-10,구로구,1.0,0,3,1,0,4
17707,2019-12-10,금천구,1.5,0,1,0,0,1
17708,2019-12-10,노원구,1.0,0,1,1,3,5
17709,2019-12-10,도봉구,2.0,0,1,1,0,2
17710,2019-12-10,동대문구,2.5,0,2,1,2,5
17711,2019-12-10,동작구,2.0,0,4,0,1,5
17712,2019-12-10,마포구,1.5,0,2,0,0,2
17713,2019-12-10,서대문구,1.0,0,6,0,1,7
17714,2019-12-10,서초구,2.0,0,4,1,2,7
17715,2019-12-10,성동구,3.0,0,3,1,1,5
17716,2019-12-10,성북구,0.5,1,5,1,2,9
17717,2019-12-10,송파구,1.5,0,7,0,1,8
17718,2019-12-10,양천구,2.0,0,3,0,0,3
17719,2019-12-10,영등포구,1.5,0,5,2,2,9
17720,2019-12-10,용산구,2.0,0,2,0,0,2
17721,2019-12-10,은평구,2.0,0,2,0,0,2
17722,2019-12-10,종로구,1.7,0,5,2,1,8
17723,2019-12-10,중구,2.0,0,9,0,3,12
17724,2019-12-10,중랑구,2.0,0,2,0,1,3
17725,2019-12-11,강남구,0.5,0,12,0,1,13
17726,2019-12-11,강동구,0.0,0,2,0,1,3
17727,2019-12-11,강북구,0.0,0,4,1,1,6
17728,2019-12-11,강서구,0.5,0,3,1,2,6
17729,2019-12-11,관악구,0.0,0,3,0,0,3
17730,2019-12-11,광진구,0.0,0,3,0,0,3
17731,2019-12-11,구로구,0.0,0,4,0,1,5
17732,2019-12-11,금천구,0.0,0,1,0,0,1
17733,2019-12-11,노원구,0.0,0,0,0,1,1
17734,2019-12-11,도봉구,0.0,0,1,0,2,3
17735,2019-12-11,동대문구,0.0,0,3,1,1,5
17736,2019-12-11,동작구,0.0,0,3,1,0,4
17737,2019-12-11,마포구,0.0,0,4,0,2,6
17738,2019-12-11,서대문구,0.0,0,2,1,0,3
17739,2019-12-11,서초구,0.0,0,5,1,2,8
17740,2019-12-11,성동구,0.0,0,1,0,1,2
17741,2019-12-11,성북구,0.0,0,6,2,0,8
17742,2019-12-11,송파구,0.0,0,4,0,1,5
17743,2019-12-11,양천구,0.0,0,2,0,1,3
17744,2019-12-11,영등포구,0.0,0,4,1,2,7
17745,2019-12-11,용산구,0.5,0,2,0,2,4
17746,2019-12-11,은평구,0.0,0,3,1,1,5
17747,2019-12-11,종로구,0.2,0,6,0,0,6
17748,2019-12-11,중구,0.0,0,6,2,2,10
17749,2019-12-11,중랑구,0.0,0,2,1,1,4
17750,2019-12-12,강남구,0.0,0,14,2,4,20
17751,2019-12-12,강동구,0.0,0,6,0,0,6
17752,2019-12-12,강북구,0.0,0,3,1,0,4
17753,2019-12-12,강서구,0.0,0,3,1,1,5
17754,2019-12-12,관악구,0.0,0,7,2,0,9
17755,2019-12-12,광진구,0.0,0,0,0,0,0
17756,2019-12-12,구로구,0.0,0,1,1,1,3
17757,2019-12-12,금천구,0.0,0,1,0,3,4
17758,2019-12-12,노원구,0.0,0,10,1,3,14
17759,2019-12-12,도봉구,0.0,0,0,0,0,0
17760,2019-12-12,동대문구,0.0,0,4,0,0,4
17761,2019-12-12,동작구,0.0,0,4,1,1,6
17762,2019-12-12,마포구,0.0,0,3,1,0,4
17763,2019-12-12,서대문구,0.0,0,0,0,0,0
17764,2019-12-12,서초구,0.0,1,7,0,3,11
17765,2019-12-12,성동구,0.0,0,8,0,1,9
17766,2019-12-12,성북구,0.0,0,7,1,1,9
17767,2019-12-12,송파구,0.0,0,6,0,1,7
17768,2019-12-12,양천구,0.0,1,7,1,0,9
17769,2019-12-12,영등포구,0.0,0,1,0,1,2
17770,2019-12-12,용산구,0.0,1,5,1,0,7
17771,2019-12-12,은평구,0.0,0,2,0,2,4
17772,2019-12-12,종로구,0.0,0,2,0,0,2
17773,2019-12-12,중구,0.0,0,10,0,1,11
17774,2019-12-12,중랑구,0.0,0,5,0,1,6
17775,2019-12-13,강남구,0.5,0,12,1,5,18
17776,2019-12-13,강동구,0.0,0,2,1,1,4
17777,2019-12-13,강북구,0.0,0,4,0,0,4
17778,2019-12-13,강서구,0.0,0,3,0,0,3
17779,2019-12-13,관악구,0.5,0,0,0,0,0
17780,2019-12-13,광진구,0.0,0,2,0,0,2
17781,2019-12-13,구로구,0.5,0,5,0,2,7
17782,2019-12-13,금천구,0.5,0,11,0,0,11
17783,2019-12-13,노원구,0.0,0,5,0,2,7
17784,2019-12-13,도봉구,1.0,0,4,2,0,6
17785,2019-12-13,동대문구,0.5,0,4,0,4,8
17786,2019-12-13,동작구,0.25,0,8,0,2,10
17787,2019-12-13,마포구,0.5,0,4,0,0,4
17788,2019-12-13,서대문구,1.0,0,3,1,2,6
17789,2019-12-13,서초구,0.0,0,10,1,1,12
17790,2019-12-13,성동구,0.5,0,2,0,0,2
17791,2019-12-13,성북구,0.0,0,1,1,1,3
17792,2019-12-13,송파구,0.0,0,10,2,1,13
17793,2019-12-13,양천구,0.5,0,4,1,0,5
17794,2019-12-13,영등포구,0.5,0,13,2,4,19
17795,2019-12-13,용산구,0.0,0,2,0,0,2
17796,2019-12-13,은평구,0.5,0,2,0,1,3
17797,2019-12-13,종로구,1.0,0,4,1,1,6
17798,2019-12-13,중구,0.5,0,7,1,2,10
17799,2019-12-13,중랑구,0.5,0,1,0,1,2
17800,2019-12-14,강남구,0.5,0,16,5,4,25
17801,2019-12-14,강동구,0.5,0,3,2,2,7
17802,2019-12-14,강북구,0.5,0,6,0,1,7
17803,2019-12-14,강서구,0.0,0,2,0,5,7
17804,2019-12-14,관악구,0.25,0,5,1,1,7
17805,2019-12-14,광진구,0.5,0,1,0,0,1
17806,2019-12-14,구로구,0.5,0,3,0,1,4
17807,2019-12-14,금천구,0.0,0,4,0,1,5
17808,2019-12-14,노원구,0.5,0,4,1,0,5
17809,2019-12-14,도봉구,0.0,0,1,1,0,2
17810,2019-12-14,동대문구,0.0,0,14,0,1,15
17811,2019-12-14,동작구,0.25,0,5,1,1,7
17812,2019-12-14,마포구,0.0,0,10,1,3,14
17813,2019-12-14,서대문구,0.0,0,2,2,0,4
17814,2019-12-14,서초구,0.5,0,10,0,2,12
17815,2019-12-14,성동구,0.0,1,1,0,1,3
17816,2019-12-14,성북구,0.5,1,14,0,3,18
17817,2019-12-14,송파구,0.5,0,5,1,5,11
17818,2019-12-14,양천구,0.5,0,9,0,1,10
17819,2019-12-14,영등포구,0.5,0,3,1,0,4
17820,2019-12-14,용산구,0.5,0,11,0,2,13
17821,2019-12-14,은평구,0.0,0,2,0,1,3
17822,2019-12-14,종로구,0.0,0,12,0,4,16
17823,2019-12-14,중구,0.0,0,3,1,0,4
17824,2019-12-14,중랑구,0.0,0,5,0,2,7
17825,2019-12-15,강남구,0.0,0,2,0,0,2
17826,2019-12-15,강동구,0.0,0,4,1,1,6
17827,2019-12-15,강북구,0.0,0,5,0,0,5
17828,2019-12-15,강서구,0.0,0,1,0,1,2
17829,2019-12-15,관악구,0.0,0,4,0,0,4
17830,2019-12-15,광진구,0.0,0,0,1,0,1
17831,2019-12-15,구로구,0.0,0,3,1,0,4
17832,2019-12-15,금천구,0.0,0,1,0,0,1
17833,2019-12-15,노원구,0.0,0,2,0,1,3
17834,2019-12-15,도봉구,0.0,0,0,0,0,0
17835,2019-12-15,동대문구,0.0,0,3,0,1,4
17836,2019-12-15,동작구,0.0,0,1,0,0,1
17837,2019-12-15,마포구,0.0,0,5,0,1,6
17838,2019-12-15,서대문구,0.0,0,3,1,0,4
17839,2019-12-15,서초구,0.0,0,2,0,1,3
17840,2019-12-15,성동구,0.0,0,9,0,0,9
17841,2019-12-15,성북구,0.0,0,7,0,2,9
17842,2019-12-15,송파구,0.0,0,3,1,1,5
17843,2019-12-15,양천구,0.0,0,3,0,2,5
17844,2019-12-15,영등포구,0.0,0,6,0,2,8
17845,2019-12-15,용산구,0.0,0,3,0,0,3
17846,2019-12-15,은평구,0.0,0,6,1,1,8
17847,2019-12-15,종로구,0.0,0,3,0,1,4
17848,2019-12-15,중구,0.0,0,2,0,0,2
17849,2019-12-15,중랑구,0.0,0,5,1,1,7
17850,2019-12-16,강남구,0.0,0,7,2,3,12
17851,2019-12-16,강동구,0.0,0,0,0,0,0
17852,2019-12-16,강북구,0.0,0,1,1,0,2
17853,2019-12-16,강서구,0.0,1,6,1,2,10
17854,2019-12-16,관악구,0.0,1,6,0,0,7
17855,2019-12-16,광진구,0.0,0,0,1,0,1
17856,2019-12-16,구로구,0.0,0,2,0,1,3
17857,2019-12-16,금천구,0.0,0,2,1,0,3
17858,2019-12-16,노원구,0.0,0,0,0,0,0
17859,2019-12-16,도봉구,0.0,0,0,2,0,2
17860,2019-12-16,동대문구,0.0,0,4,0,4,8
17861,2019-12-16,동작구,0.0,0,7,0,1,8
17862,2019-12-16,마포구,0.0,0,0,0,1,1
17863,2019-12-16,서대문구,0.0,0,3,2,0,5
17864,2019-12-16,서초구,0.0,0,9,0,0,9
17865,2019-12-16,성동구,0.0,0,1,0,1,2
17866,2019-12-16,성북구,0.0,0,1,0,1,2
17867,2019-12-16,송파구,0.0,0,3,2,0,5
17868,2019-12-16,양천구,0.0,0,4,0,1,5
17869,2019-12-16,영등포구,0.0,0,7,1,5,13
17870,2019-12-16,용산구,0.0,0,0,0,4,4
17871,2019-12-16,은평구,0.0,0,2,1,0,3
17872,2019-12-16,종로구,0.0,0,4,0,1,5
17873,2019-12-16,중구,0.0,0,1,0,1,2
17874,2019-12-16,중랑구,0.0,0,4,0,2,6
17875,2019-12-17,강남구,9.0,0,8,0,2,10
17876,2019-12-17,강동구,8.0,0,7,2,1,10
17877,2019-12-17,강북구,8.5,0,1,0,0,1
17878,2019-12-17,강서구,7.5,0,5,3,0,8
17879,2019-12-17,관악구,9.5,1,1,1,0,3
17880,2019-12-17,광진구,10.0,0,1,0,0,1
17881,2019-12-17,구로구,7.0,0,3,2,1,6
17882,2019-12-17,금천구,7.0,0,1,0,0,1
17883,2019-12-17,노원구,8.5,0,3,0,2,5
17884,2019-12-17,도봉구,10.0,0,4,1,0,5
17885,2019-12-17,동대문구,11.5,0,8,0,0,8
17886,2019-12-17,동작구,7.5,0,1,0,0,1
17887,2019-12-17,마포구,9.0,0,9,0,0,9
17888,2019-12-17,서대문구,8.5,0,7,1,1,9
17889,2019-12-17,서초구,7.5,0,6,3,1,10
17890,2019-12-17,성동구,11.0,0,2,0,3,5
17891,2019-12-17,성북구,9.0,0,4,0,2,6
17892,2019-12-17,송파구,9.5,0,4,4,1,9
17893,2019-12-17,양천구,7.5,0,4,0,0,4
17894,2019-12-17,영등포구,7.5,0,8,2,0,10
17895,2019-12-17,용산구,8.5,0,2,0,0,2
17896,2019-12-17,은평구,8.5,0,2,1,0,3
17897,2019-12-17,종로구,9.8,0,0,0,1,1
17898,2019-12-17,중구,9.5,0,6,1,1,8
17899,2019-12-17,중랑구,11.0,0,9,0,1,10
17900,2019-12-18,강남구,0.0,0,11,3,3,17
17901,2019-12-18,강동구,0.0,0,1,1,1,3
17902,2019-12-18,강북구,0.0,0,3,1,1,5
17903,2019-12-18,강서구,0.0,0,14,0,0,14
17904,2019-12-18,관악구,0.0,0,4,0,0,4
17905,2019-12-18,광진구,0.0,0,2,0,3,5
17906,2019-12-18,구로구,0.0,0,4,0,1,5
17907,2019-12-18,금천구,0.0,0,1,1,0,2
17908,2019-12-18,노원구,0.0,0,4,0,1,5
17909,2019-12-18,도봉구,0.0,0,1,0,1,2
17910,2019-12-18,동대문구,0.0,0,3,0,1,4
17911,2019-12-18,동작구,0.0,0,2,1,0,3
17912,2019-12-18,마포구,0.0,0,2,1,1,4
17913,2019-12-18,서대문구,0.0,0,1,1,1,3
17914,2019-12-18,서초구,0.0,0,8,0,0,8
17915,2019-12-18,성동구,0.0,0,1,0,1,2
17916,2019-12-18,성북구,0.0,0,3,0,1,4
17917,2019-12-18,송파구,0.0,0,6,3,0,9
17918,2019-12-18,양천구,0.0,0,5,1,1,7
17919,2019-12-18,영등포구,0.0,0,7,1,2,10
17920,2019-12-18,용산구,0.0,0,2,1,0,3
17921,2019-12-18,은평구,0.0,0,12,2,0,14
17922,2019-12-18,종로구,0.0,0,1,0,0,1
17923,2019-12-18,중구,0.0,0,4,0,0,4
17924,2019-12-18,중랑구,0.0,0,4,0,0,4
17925,2019-12-19,강남구,0.0,0,11,2,2,15
17926,2019-12-19,강동구,0.0,0,4,0,2,6
17927,2019-12-19,강북구,0.0,0,2,0,1,3
17928,2019-12-19,강서구,0.0,0,5,0,2,7
17929,2019-12-19,관악구,0.0,0,0,0,3,3
17930,2019-12-19,광진구,0.0,0,8,0,0,8
17931,2019-12-19,구로구,0.0,0,0,0,4,4
17932,2019-12-19,금천구,0.0,0,3,0,1,4
17933,2019-12-19,노원구,0.0,0,2,0,0,2
17934,2019-12-19,도봉구,0.0,0,3,0,1,4
17935,2019-12-19,동대문구,0.0,0,5,0,4,9
17936,2019-12-19,동작구,0.0,0,7,0,0,7
17937,2019-12-19,마포구,0.0,0,0,0,0,0
17938,2019-12-19,서대문구,0.0,0,2,0,0,2
17939,2019-12-19,서초구,0.0,0,13,0,2,15
17940,2019-12-19,성동구,0.0,0,2,0,1,3
17941,2019-12-19,성북구,0.0,0,1,1,1,3
17942,2019-12-19,송파구,0.0,0,7,1,1,9
17943,2019-12-19,양천구,0.0,0,6,1,2,9
17944,2019-12-19,영등포구,0.0,0,3,0,3,6
17945,2019-12-19,용산구,0.0,0,4,0,0,4
17946,2019-12-19,은평구,0.0,0,9,1,2,12
17947,2019-12-19,종로구,0.0,0,1,1,3,5
17948,2019-12-19,중구,0.0,0,3,0,1,4
17949,2019-12-19,중랑구,0.0,0,3,0,0,3
17950,2019-12-20,강남구,0.0,0,11,3,3,17
17951,2019-12-20,강동구,0.0,0,1,0,1,2
17952,2019-12-20,강북구,0.0,0,3,3,0,6
17953,2019-12-20,강서구,0.0,0,12,0,2,14
17954,2019-12-20,관악구,0.0,0,5,0,0,5
17955,2019-12-20,광진구,0.0,0,0,0,1,1
17956,2019-12-20,구로구,0.0,1,3,1,2,7
17957,2019-12-20,금천구,0.0,0,4,0,1,5
17958,2019-12-20,노원구,0.0,0,8,0,1,9
17959,2019-12-20,도봉구,0.0,0,2,0,3,5
17960,2019-12-20,동대문구,0.0,0,5,0,1,6
17961,2019-12-20,동작구,0.0,0,4,2,0,6
17962,2019-12-20,마포구,0.0,0,6,1,1,8
17963,2019-12-20,서대문구,0.0,0,5,4,2,11
17964,2019-12-20,서초구,0.0,0,4,2,3,9
17965,2019-12-20,성동구,0.0,0,3,0,0,3
17966,2019-12-20,성북구,0.0,0,1,0,1,2
17967,2019-12-20,송파구,0.0,0,7,0,3,10
17968,2019-12-20,양천구,0.0,0,1,0,1,2
17969,2019-12-20,영등포구,0.0,0,13,0,3,16
17970,2019-12-20,용산구,0.0,0,4,0,1,5
17971,2019-12-20,은평구,0.0,0,2,0,2,4
17972,2019-12-20,종로구,0.0,0,2,0,0,2
17973,2019-12-20,중구,0.0,0,1,0,0,1
17974,2019-12-20,중랑구,0.0,0,6,1,2,9
17975,2019-12-21,강남구,0.0,0,10,0,1,11
17976,2019-12-21,강동구,0.0,0,1,0,1,2
17977,2019-12-21,강북구,0.0,0,2,0,1,3
17978,2019-12-21,강서구,0.5,0,7,0,3,10
17979,2019-12-21,관악구,0.0,0,7,0,4,11
17980,2019-12-21,광진구,0.5,0,3,0,2,5
17981,2019-12-21,구로구,0.5,0,2,0,0,2
17982,2019-12-21,금천구,0.0,0,6,0,1,7
17983,2019-12-21,노원구,0.0,0,1,0,0,1
17984,2019-12-21,도봉구,0.0,0,1,0,0,1
17985,2019-12-21,동대문구,0.0,0,2,1,0,3
17986,2019-12-21,동작구,0.0,0,9,1,0,10
17987,2019-12-21,마포구,0.0,0,2,0,2,4
17988,2019-12-21,서대문구,0.0,0,1,1,1,3
17989,2019-12-21,서초구,0.0,0,8,0,2,10
17990,2019-12-21,성동구,0.0,0,1,0,1,2
17991,2019-12-21,성북구,0.0,0,5,1,0,6
17992,2019-12-21,송파구,0.0,0,5,2,2,9
17993,2019-12-21,양천구,0.0,0,3,0,2,5
17994,2019-12-21,영등포구,0.0,0,9,3,1,13
17995,2019-12-21,용산구,0.0,0,3,1,0,4
17996,2019-12-21,은평구,0.0,0,4,1,0,5
17997,2019-12-21,종로구,0.6,0,7,0,2,9
17998,2019-12-21,중구,0.0,0,6,2,1,9
17999,2019-12-21,중랑구,0.0,0,8,0,1,9
18000,2019-12-22,강남구,0.5,0,0,0,1,1
18001,2019-12-22,강동구,0.0,0,2,0,1,3
18002,2019-12-22,강북구,0.0,0,4,1,0,5
18003,2019-12-22,강서구,0.5,0,6,0,3,9
18004,2019-12-22,관악구,0.0,0,7,0,0,7
18005,2019-12-22,광진구,0.5,0,0,1,4,5
18006,2019-12-22,구로구,0.5,0,2,0,0,2
18007,2019-12-22,금천구,0.0,0,5,1,2,8
18008,2019-12-22,노원구,0.0,0,4,0,0,4
18009,2019-12-22,도봉구,0.0,0,0,0,0,0
18010,2019-12-22,동대문구,0.5,0,1,0,0,1
18011,2019-12-22,동작구,0.0,0,1,0,0,1
18012,2019-12-22,마포구,0.0,0,5,1,0,6
18013,2019-12-22,서대문구,0.0,0,2,2,0,4
18014,2019-12-22,서초구,0.0,1,10,2,3,16
18015,2019-12-22,성동구,0.0,0,4,0,0,4
18016,2019-12-22,성북구,0.0,0,4,0,2,6
18017,2019-12-22,송파구,0.0,0,11,0,2,13
18018,2019-12-22,양천구,0.5,0,2,1,1,4
18019,2019-12-22,영등포구,0.25,0,3,1,1,5
18020,2019-12-22,용산구,0.5,0,4,0,1,5
18021,2019-12-22,은평구,0.0,0,0,0,0,0
18022,2019-12-22,종로구,0.3,0,2,1,0,3
18023,2019-12-22,중구,0.0,0,5,4,0,9
18024,2019-12-22,중랑구,0.0,0,1,1,2,4
18025,2019-12-23,강남구,2.0,0,5,0,2,7
18026,2019-12-23,강동구,3.0,0,3,1,2,6
18027,2019-12-23,강북구,2.5,0,1,0,0,1
18028,2019-12-23,강서구,4.0,0,4,0,1,5
18029,2019-12-23,관악구,3.5,0,3,1,2,6
18030,2019-12-23,광진구,2.5,0,2,0,2,4
18031,2019-12-23,구로구,3.5,0,8,0,4,12
18032,2019-12-23,금천구,3.5,0,2,0,1,3
18033,2019-12-23,노원구,2.5,0,11,2,3,16
18034,2019-12-23,도봉구,3.5,0,0,0,0,0
18035,2019-12-23,동대문구,3.0,0,10,2,3,15
18036,2019-12-23,동작구,3.0,0,5,0,1,6
18037,2019-12-23,마포구,2.5,0,1,0,1,2
18038,2019-12-23,서대문구,3.0,0,3,2,0,5
18039,2019-12-23,서초구,2.5,0,10,0,1,11
18040,2019-12-23,성동구,3.0,0,2,0,1,3
18041,2019-12-23,성북구,3.0,0,1,0,1,2
18042,2019-12-23,송파구,1.5,0,6,0,2,8
18043,2019-12-23,양천구,2.5,0,5,0,1,6
18044,2019-12-23,영등포구,2.75,0,7,2,2,11
18045,2019-12-23,용산구,2.5,0,2,0,0,2
18046,2019-12-23,은평구,3.0,0,4,0,1,5
18047,2019-12-23,종로구,2.9,0,3,0,1,4
18048,2019-12-23,중구,3.0,0,0,4,0,4
18049,2019-12-23,중랑구,3.0,0,2,0,1,3
18050,2019-12-24,강남구,0.0,0,19,1,2,22
18051,2019-12-24,강동구,0.0,0,6,1,0,7
18052,2019-12-24,강북구,0.0,0,3,1,1,5
18053,2019-12-24,강서구,0.0,0,4,0,0,4
18054,2019-12-24,관악구,0.0,0,5,1,0,6
18055,2019-12-24,광진구,0.0,0,1,0,1,2
18056,2019-12-24,구로구,0.0,0,11,0,1,12
18057,2019-12-24,금천구,0.0,0,0,0,0,0
18058,2019-12-24,노원구,0.0,0,8,1,0,9
18059,2019-12-24,도봉구,0.0,0,2,0,0,2
18060,2019-12-24,동대문구,0.0,0,3,0,2,5
18061,2019-12-24,동작구,0.0,0,5,2,1,8
18062,2019-12-24,마포구,0.0,0,14,0,2,16
18063,2019-12-24,서대문구,0.0,0,0,0,0,0
18064,2019-12-24,서초구,0.0,0,9,0,3,12
18065,2019-12-24,성동구,0.0,0,3,0,1,4
18066,2019-12-24,성북구,0.0,0,5,0,3,8
18067,2019-12-24,송파구,0.0,0,14,2,0,16
18068,2019-12-24,양천구,0.0,0,3,1,0,4
18069,2019-12-24,영등포구,0.0,0,7,0,2,9
18070,2019-12-24,용산구,0.0,0,4,0,0,4
18071,2019-12-24,은평구,0.0,0,2,0,0,2
18072,2019-12-24,종로구,0.0,0,3,0,1,4
18073,2019-12-24,중구,0.0,0,1,0,2,3
18074,2019-12-24,중랑구,0.0,0,3,1,0,4
18075,2019-12-25,강남구,0.0,0,5,1,1,7
18076,2019-12-25,강동구,0.0,0,1,2,0,3
18077,2019-12-25,강북구,0.0,0,4,1,0,5
18078,2019-12-25,강서구,0.0,0,2,0,0,2
18079,2019-12-25,관악구,0.0,0,5,0,0,5
18080,2019-12-25,광진구,0.0,0,0,0,0,0
18081,2019-12-25,구로구,0.0,0,3,0,1,4
18082,2019-12-25,금천구,0.0,0,1,1,0,2
18083,2019-12-25,노원구,0.0,0,3,0,0,3
18084,2019-12-25,도봉구,0.0,0,2,0,0,2
18085,2019-12-25,동대문구,0.0,0,0,0,0,0
18086,2019-12-25,동작구,0.0,0,0,0,0,0
18087,2019-12-25,마포구,0.0,0,6,0,0,6
18088,2019-12-25,서대문구,0.0,0,1,0,1,2
18089,2019-12-25,서초구,0.0,0,8,1,1,10
18090,2019-12-25,성동구,0.0,0,0,0,0,0
18091,2019-12-25,성북구,0.0,0,1,0,0,1
18092,2019-12-25,송파구,0.0,0,16,4,2,22
18093,2019-12-25,양천구,0.0,0,16,2,1,19
18094,2019-12-25,영등포구,0.0,0,16,0,0,16
18095,2019-12-25,용산구,0.0,0,10,0,0,10
18096,2019-12-25,은평구,0.0,0,0,0,3,3
18097,2019-12-25,종로구,0.0,0,4,0,1,5
18098,2019-12-25,중구,0.0,0,2,0,0,2
18099,2019-12-25,중랑구,0.0,0,1,0,0,1
18100,2019-12-26,강남구,1.0,0,8,0,2,10
18101,2019-12-26,강동구,0.5,0,0,0,0,0
18102,2019-12-26,강북구,0.0,0,2,0,3,5
18103,2019-12-26,강서구,0.0,0,5,0,2,7
18104,2019-12-26,관악구,1.0,0,3,0,1,4
18105,2019-12-26,광진구,1.0,0,3,0,0,3
18106,2019-12-26,구로구,0.5,0,8,1,1,10
18107,2019-12-26,금천구,1.0,0,1,0,0,1
18108,2019-12-26,노원구,0.0,0,8,0,1,9
18109,2019-12-26,도봉구,0.0,0,8,0,5,13
18110,2019-12-26,동대문구,0.5,0,5,0,0,5
18111,2019-12-26,동작구,1.0,0,3,0,2,5
18112,2019-12-26,마포구,0.0,0,4,2,1,7
18113,2019-12-26,서대문구,0.0,0,1,2,0,3
18114,2019-12-26,서초구,1.0,0,4,1,2,7
18115,2019-12-26,성동구,0.5,0,1,0,0,1
18116,2019-12-26,성북구,0.0,0,0,0,0,0
18117,2019-12-26,송파구,0.5,0,5,0,0,5
18118,2019-12-26,양천구,0.0,0,5,1,2,8
18119,2019-12-26,영등포구,0.25,0,4,0,2,6
18120,2019-12-26,용산구,0.5,0,0,1,0,1
18121,2019-12-26,은평구,0.0,1,2,0,1,4
18122,2019-12-26,종로구,0.3,0,6,0,0,6
18123,2019-12-26,중구,0.5,0,0,0,0,0
18124,2019-12-26,중랑구,0.5,0,2,0,2,4
18125,2019-12-27,강남구,0.0,0,10,1,1,12
18126,2019-12-27,강동구,0.0,0,6,0,2,8
18127,2019-12-27,강북구,0.0,0,2,0,0,2
18128,2019-12-27,강서구,0.0,0,4,1,1,6
18129,2019-12-27,관악구,0.0,0,1,0,1,2
18130,2019-12-27,광진구,0.0,0,2,0,2,4
18131,2019-12-27,구로구,0.0,0,6,0,1,7
18132,2019-12-27,금천구,0.0,0,5,0,3,8
18133,2019-12-27,노원구,0.0,0,7,4,0,11
18134,2019-12-27,도봉구,0.0,0,0,0,2,2
18135,2019-12-27,동대문구,0.0,0,1,1,0,2
18136,2019-12-27,동작구,0.0,0,4,1,1,6
18137,2019-12-27,마포구,0.0,0,2,0,0,2
18138,2019-12-27,서대문구,0.0,0,0,0,0,0
18139,2019-12-27,서초구,0.0,0,3,1,0,4
18140,2019-12-27,성동구,0.0,0,2,1,1,4
18141,2019-12-27,성북구,0.0,0,11,0,3,14
18142,2019-12-27,송파구,0.0,0,4,2,4,10
18143,2019-12-27,양천구,0.0,0,1,0,2,3
18144,2019-12-27,영등포구,0.0,0,4,2,1,7
18145,2019-12-27,용산구,0.0,0,3,0,1,4
18146,2019-12-27,은평구,0.0,0,5,0,1,6
18147,2019-12-27,종로구,0.0,0,2,0,0,2
18148,2019-12-27,중구,0.0,0,0,0,0,0
18149,2019-12-27,중랑구,0.0,0,3,0,0,3
18150,2019-12-28,강남구,0.0,0,20,1,3,24
18151,2019-12-28,강동구,0.0,0,8,1,0,9
18152,2019-12-28,강북구,0.0,0,12,0,3,15
18153,2019-12-28,강서구,0.0,0,1,2,2,5
18154,2019-12-28,관악구,0.0,0,2,0,1,3
18155,2019-12-28,광진구,0.0,0,1,0,0,1
18156,2019-12-28,구로구,0.0,0,7,0,2,9
18157,2019-12-28,금천구,0.0,0,1,0,3,4
18158,2019-12-28,노원구,0.0,0,2,0,2,4
18159,2019-12-28,도봉구,0.0,0,0,0,2,2
18160,2019-12-28,동대문구,0.0,0,3,0,0,3
18161,2019-12-28,동작구,0.0,0,7,0,3,10
18162,2019-12-28,마포구,0.0,0,3,1,2,6
18163,2019-12-28,서대문구,0.0,0,1,1,0,2
18164,2019-12-28,서초구,0.0,0,7,1,0,8
18165,2019-12-28,성동구,0.0,0,3,1,2,6
18166,2019-12-28,성북구,0.0,0,7,0,1,8
18167,2019-12-28,송파구,0.0,0,3,0,0,3
18168,2019-12-28,양천구,0.0,0,0,0,0,0
18169,2019-12-28,영등포구,0.0,0,6,0,1,7
18170,2019-12-28,용산구,0.0,0,4,0,0,4
18171,2019-12-28,은평구,0.0,0,2,1,0,3
18172,2019-12-28,종로구,0.0,0,2,0,0,2
18173,2019-12-28,중구,0.0,0,1,0,0,1
18174,2019-12-28,중랑구,0.0,0,2,1,0,3
18175,2019-12-29,강남구,0.5,0,18,1,0,19
18176,2019-12-29,강동구,1.0,0,0,0,0,0
18177,2019-12-29,강북구,0.0,0,0,0,0,0
18178,2019-12-29,강서구,1.0,0,3,0,3,6
18179,2019-12-29,관악구,0.5,0,5,0,1,6
18180,2019-12-29,광진구,1.5,0,8,0,2,10
18181,2019-12-29,구로구,1.5,0,0,0,0,0
18182,2019-12-29,금천구,0.5,0,1,0,1,2
18183,2019-12-29,노원구,0.5,0,5,0,1,6
18184,2019-12-29,도봉구,0.0,0,0,0,0,0
18185,2019-12-29,동대문구,1.5,1,4,0,1,6
18186,2019-12-29,동작구,1.5,0,3,0,0,3
18187,2019-12-29,마포구,0.5,0,3,1,1,5
18188,2019-12-29,서대문구,1.0,0,0,1,0,1
18189,2019-12-29,서초구,0.5,0,7,1,2,10
18190,2019-12-29,성동구,1.5,0,1,0,0,1
18191,2019-12-29,성북구,0.5,0,0,0,1,1
18192,2019-12-29,송파구,0.5,0,1,2,3,6
18193,2019-12-29,양천구,1.0,0,3,0,0,3
18194,2019-12-29,영등포구,1.75,0,16,0,1,17
18195,2019-12-29,용산구,1.5,0,2,0,3,5
18196,2019-12-29,은평구,0.0,0,0,0,3,3
18197,2019-12-29,종로구,1.4,0,1,0,1,2
18198,2019-12-29,중구,1.0,0,3,1,2,6
18199,2019-12-29,중랑구,1.5,0,3,0,0,3
18200,2019-12-30,강남구,0.5,0,19,1,1,21
18201,2019-12-30,강동구,0.0,0,1,0,0,1
18202,2019-12-30,강북구,0.5,0,2,0,0,2
18203,2019-12-30,강서구,0.5,0,4,0,0,4
18204,2019-12-30,관악구,0.25,1,2,0,0,3
18205,2019-12-30,광진구,0.0,0,1,0,0,1
18206,2019-12-30,구로구,0.0,0,3,1,0,4
18207,2019-12-30,금천구,0.5,0,2,0,1,3
18208,2019-12-30,노원구,0.0,0,5,1,1,7
18209,2019-12-30,도봉구,0.0,0,2,0,2,4
18210,2019-12-30,동대문구,0.5,0,5,0,2,7
18211,2019-12-30,동작구,0.0,0,3,0,0,3
18212,2019-12-30,마포구,0.5,0,1,0,1,2
18213,2019-12-30,서대문구,0.5,0,0,0,1,1
18214,2019-12-30,서초구,0.0,0,6,47,4,57
18215,2019-12-30,성동구,0.5,0,5,0,2,7
18216,2019-12-30,성북구,0.0,0,8,0,0,8
18217,2019-12-30,송파구,0.0,0,7,0,0,7
18218,2019-12-30,양천구,0.0,0,3,0,1,4
18219,2019-12-30,영등포구,0.0,0,5,0,0,5
18220,2019-12-30,용산구,0.0,0,2,0,0,2
18221,2019-12-30,은평구,0.5,0,0,1,0,1
18222,2019-12-30,종로구,0.4,0,3,2,1,6
18223,2019-12-30,중구,0.5,0,2,0,0,2
18224,2019-12-30,중랑구,0.0,0,2,0,2,4
18225,2019-12-31,강남구,0.0,1,21,3,2,27
18226,2019-12-31,강동구,0.0,0,3,0,3,6
18227,2019-12-31,강북구,0.0,0,3,0,0,3
18228,2019-12-31,강서구,0.0,0,7,1,1,9
18229,2019-12-31,관악구,0.0,0,1,0,0,1
18230,2019-12-31,광진구,0.0,0,4,0,0,4
18231,2019-12-31,구로구,0.0,0,8,1,1,10
18232,2019-12-31,금천구,0.0,0,3,0,1,4
18233,2019-12-31,노원구,0.0,0,3,1,1,5
18234,2019-12-31,도봉구,0.0,0,1,1,0,2
18235,2019-12-31,동대문구,0.0,0,2,0,1,3
18236,2019-12-31,동작구,0.0,0,3,0,1,4
18237,2019-12-31,마포구,0.0,0,4,0,0,4
18238,2019-12-31,서대문구,0.0,0,2,0,4,6
18239,2019-12-31,서초구,0.0,1,2,0,1,4
18240,2019-12-31,성동구,0.0,0,0,0,2,2
18241,2019-12-31,성북구,0.0,0,6,0,0,6
18242,2019-12-31,송파구,0.0,0,7,1,0,8
18243,2019-12-31,양천구,0.0,0,5,0,0,5
18244,2019-12-31,영등포구,0.0,0,3,1,1,5
18245,2019-12-31,용산구,0.0,0,3,0,0,3
18246,2019-12-31,은평구,0.0,0,4,1,0,5
18247,2019-12-31,종로구,0.0,0,2,0,0,2
18248,2019-12-31,중구,0.0,0,3,0,0,3
18249,2019-12-31,중랑구,0.0,0,2,2,1,5
