,시도,시군구,경상자수,부상신고자수,중상자수,부상자수,사고건수,사망자수,날짜
0,서울,강남구,2,2,1,5,4,0,2018-01-01
1,서울,강남구,16,1,3,20,14,0,2018-02-01
2,서울,강남구,10,1,4,15,9,0,2018-03-01
3,서울,강남구,1,0,2,3,3,0,2018-04-01
4,서울,강남구,11,1,4,16,11,0,2018-05-01
5,서울,강남구,15,3,5,23,18,0,2018-06-01
6,서울,강남구,8,3,2,13,9,0,2018-07-01
7,서울,강남구,14,0,4,18,12,0,2018-08-01
8,서울,강남구,7,1,3,11,9,0,2018-09-01
9,서울,강남구,14,0,2,16,9,0,2018-10-01
10,서울,강남구,9,1,4,14,11,0,2018-11-01
11,서울,강남구,10,2,1,13,11,0,2018-12-01
12,서울,강동구,2,0,1,3,2,0,2018-01-01
13,서울,강동구,4,2,2,8,6,0,2018-02-01
14,서울,강동구,2,0,1,3,2,0,2018-03-01
15,서울,강동구,4,0,1,5,3,0,2018-04-01
16,서울,강동구,18,1,7,26,5,0,2018-05-01
17,서울,강동구,2,1,1,4,3,0,2018-06-01
18,서울,강동구,12,0,2,14,6,0,2018-07-01
19,서울,강동구,8,0,3,11,8,0,2018-08-01
20,서울,강동구,2,1,1,4,2,0,2018-09-01
21,서울,강동구,4,0,0,4,2,0,2018-10-01
22,서울,강동구,2,0,0,2,2,0,2018-11-01
23,서울,강동구,3,0,2,5,4,0,2018-12-01
24,서울,강북구,4,0,1,5,4,0,2018-01-01
25,서울,강북구,5,0,4,9,7,0,2018-02-01
26,서울,강북구,3,0,3,6,4,0,2018-03-01
27,서울,강북구,3,0,1,4,4,0,2018-04-01
28,서울,강북구,2,0,2,4,4,0,2018-05-01
29,서울,강북구,2,0,1,3,2,0,2018-06-01
30,서울,강북구,0,0,1,1,1,0,2018-07-01
31,서울,강북구,4,0,1,5,4,0,2018-08-01
32,서울,강북구,5,1,2,8,5,0,2018-09-01
33,서울,강북구,3,0,0,3,3,0,2018-10-01
34,서울,강북구,3,1,0,4,5,1,2018-11-01
35,서울,강북구,3,0,0,3,3,0,2018-12-01
36,서울,강서구,1,0,0,1,1,0,2018-01-01
37,서울,강서구,9,0,1,10,7,0,2018-02-01
38,서울,강서구,3,1,2,6,5,0,2018-03-01
39,서울,강서구,2,0,0,2,2,0,2018-04-01
40,서울,강서구,3,0,0,3,2,0,2018-05-01
41,서울,강서구,4,0,0,4,3,0,2018-06-01
42,서울,강서구,2,0,1,3,3,0,2018-07-01
43,서울,강서구,5,0,1,6,5,0,2018-08-01
44,서울,강서구,3,0,0,3,2,0,2018-09-01
45,서울,강서구,2,0,0,2,2,0,2018-10-01
46,서울,강서구,9,0,4,13,9,0,2018-11-01
47,서울,강서구,6,0,1,7,4,0,2018-12-01
48,서울,관악구,7,1,1,9,5,0,2018-01-01
49,서울,관악구,2,0,2,4,3,0,2018-02-01
50,서울,관악구,9,1,1,11,6,0,2018-03-01
51,서울,관악구,1,1,1,3,2,0,2018-04-01
52,서울,관악구,4,0,1,5,4,0,2018-05-01
53,서울,관악구,2,0,3,5,4,0,2018-06-01
54,서울,관악구,2,0,0,2,1,0,2018-07-01
55,서울,관악구,8,2,0,10,7,0,2018-08-01
56,서울,관악구,5,0,0,5,3,0,2018-09-01
57,서울,관악구,4,1,0,5,5,0,2018-10-01
58,서울,관악구,3,0,0,3,3,0,2018-11-01
59,서울,관악구,5,2,3,10,8,1,2018-12-01
60,서울,광진구,0,0,2,2,2,0,2018-01-01
61,서울,광진구,1,0,0,1,1,0,2018-02-01
62,서울,광진구,1,1,0,2,2,0,2018-03-01
63,서울,광진구,2,0,0,2,2,0,2018-04-01
64,서울,광진구,3,0,0,3,2,0,2018-05-01
65,서울,광진구,2,0,1,3,2,0,2018-06-01
66,서울,광진구,3,0,1,4,2,0,2018-07-01
67,서울,광진구,6,0,0,6,5,0,2018-08-01
68,서울,광진구,3,0,1,4,3,0,2018-09-01
69,서울,광진구,0,0,1,1,1,0,2018-10-01
70,서울,광진구,5,0,2,7,6,0,2018-11-01
71,서울,광진구,0,0,2,2,3,1,2018-12-01
72,서울,구로구,1,0,2,3,3,0,2018-01-01
73,서울,구로구,13,2,1,16,10,0,2018-02-01
74,서울,구로구,1,0,5,6,5,0,2018-03-01
75,서울,구로구,0,0,0,0,0,0,2018-04-01
76,서울,구로구,3,2,1,6,4,0,2018-05-01
77,서울,구로구,3,0,4,7,5,0,2018-06-01
78,서울,구로구,7,0,1,8,7,0,2018-07-01
79,서울,구로구,4,2,0,6,4,0,2018-08-01
80,서울,구로구,2,0,1,3,3,0,2018-09-01
81,서울,구로구,4,0,4,8,7,0,2018-10-01
82,서울,구로구,5,0,1,6,3,0,2018-11-01
83,서울,구로구,3,0,0,3,2,0,2018-12-01
84,서울,금천구,1,0,0,1,1,0,2018-01-01
85,서울,금천구,2,0,0,2,2,0,2018-02-01
86,서울,금천구,1,0,1,2,2,0,2018-03-01
87,서울,금천구,3,0,0,3,3,0,2018-04-01
88,서울,금천구,2,0,0,2,2,0,2018-05-01
89,서울,금천구,2,1,0,3,2,0,2018-06-01
90,서울,금천구,5,0,1,6,3,0,2018-07-01
91,서울,금천구,0,0,1,1,1,0,2018-08-01
92,서울,금천구,3,1,0,4,4,0,2018-09-01
93,서울,금천구,2,0,3,5,4,0,2018-10-01
94,서울,금천구,5,3,2,10,6,1,2018-11-01
95,서울,금천구,2,0,0,2,1,0,2018-12-01
96,서울,노원구,2,0,0,2,2,0,2018-01-01
97,서울,노원구,5,2,3,10,9,0,2018-02-01
98,서울,노원구,5,0,2,7,5,0,2018-03-01
99,서울,노원구,3,0,0,3,2,0,2018-04-01
100,서울,노원구,2,1,1,4,3,0,2018-05-01
101,서울,노원구,1,0,1,2,2,1,2018-06-01
102,서울,노원구,5,0,2,7,4,0,2018-07-01
103,서울,노원구,7,0,1,8,6,0,2018-08-01
104,서울,노원구,12,0,1,13,4,0,2018-09-01
105,서울,노원구,1,0,0,1,1,0,2018-10-01
106,서울,노원구,6,1,0,7,5,0,2018-11-01
107,서울,노원구,10,0,1,11,6,0,2018-12-01
108,서울,도봉구,0,0,0,0,0,0,2018-01-01
109,서울,도봉구,4,0,0,4,3,0,2018-02-01
110,서울,도봉구,4,0,1,5,4,0,2018-03-01
111,서울,도봉구,3,1,1,5,3,0,2018-04-01
112,서울,도봉구,1,1,0,2,2,0,2018-05-01
113,서울,도봉구,4,0,2,6,6,0,2018-06-01
114,서울,도봉구,1,0,1,2,2,0,2018-07-01
115,서울,도봉구,0,1,1,2,2,0,2018-08-01
116,서울,도봉구,2,0,0,2,1,0,2018-09-01
117,서울,도봉구,4,0,1,5,3,0,2018-10-01
118,서울,도봉구,0,0,1,1,1,0,2018-11-01
119,서울,도봉구,0,0,0,0,0,0,2018-12-01
120,서울,동대문구,1,1,0,2,2,0,2018-01-01
121,서울,동대문구,4,1,5,10,7,0,2018-02-01
122,서울,동대문구,4,0,2,6,5,0,2018-03-01
123,서울,동대문구,1,0,0,1,2,1,2018-04-01
124,서울,동대문구,6,1,0,7,6,0,2018-05-01
125,서울,동대문구,3,0,4,7,6,0,2018-06-01
126,서울,동대문구,7,1,0,8,6,0,2018-07-01
127,서울,동대문구,6,0,1,7,5,0,2018-08-01
128,서울,동대문구,4,2,3,9,8,0,2018-09-01
129,서울,동대문구,3,2,1,6,5,0,2018-10-01
130,서울,동대문구,4,0,5,9,8,0,2018-11-01
131,서울,동대문구,4,1,1,6,3,0,2018-12-01
132,서울,동작구,1,1,1,3,3,0,2018-01-01
133,서울,동작구,2,0,3,5,5,0,2018-02-01
134,서울,동작구,1,0,0,1,1,0,2018-03-01
135,서울,동작구,4,0,1,5,3,0,2018-04-01
136,서울,동작구,3,1,0,4,2,0,2018-05-01
137,서울,동작구,2,0,2,4,3,0,2018-06-01
138,서울,동작구,0,4,3,7,4,0,2018-07-01
139,서울,동작구,6,0,1,7,5,0,2018-08-01
140,서울,동작구,1,0,0,1,1,0,2018-09-01
141,서울,동작구,4,0,0,4,3,0,2018-10-01
142,서울,동작구,0,0,1,1,1,0,2018-11-01
143,서울,동작구,10,0,3,13,4,0,2018-12-01
144,서울,마포구,4,0,2,6,4,0,2018-01-01
145,서울,마포구,4,0,4,8,7,0,2018-02-01
146,서울,마포구,1,0,1,2,2,0,2018-03-01
147,서울,마포구,7,0,2,9,5,0,2018-04-01
148,서울,마포구,4,0,2,6,4,0,2018-05-01
149,서울,마포구,7,0,2,9,7,0,2018-06-01
150,서울,마포구,1,0,0,1,1,0,2018-07-01
151,서울,마포구,8,0,0,8,5,0,2018-08-01
152,서울,마포구,3,1,1,5,2,0,2018-09-01
153,서울,마포구,6,0,0,6,5,0,2018-10-01
154,서울,마포구,5,0,3,8,6,0,2018-11-01
155,서울,마포구,4,0,4,8,7,0,2018-12-01
156,서울,서대문구,0,2,0,2,1,0,2018-01-01
157,서울,서대문구,0,0,1,1,1,0,2018-02-01
158,서울,서대문구,11,1,5,17,14,0,2018-03-01
159,서울,서대문구,7,0,1,8,4,0,2018-04-01
160,서울,서대문구,3,1,0,4,2,0,2018-05-01
161,서울,서대문구,1,0,1,2,2,0,2018-06-01
162,서울,서대문구,0,0,1,1,1,0,2018-07-01
163,서울,서대문구,0,0,1,1,1,0,2018-08-01
164,서울,서대문구,3,0,1,4,3,0,2018-09-01
165,서울,서대문구,2,1,0,3,2,0,2018-10-01
166,서울,서대문구,2,0,0,2,2,0,2018-11-01
167,서울,서대문구,3,0,1,4,3,0,2018-12-01
168,서울,서초구,3,0,1,4,3,0,2018-01-01
169,서울,서초구,11,1,5,17,8,0,2018-02-01
170,서울,서초구,10,1,1,12,6,0,2018-03-01
171,서울,서초구,4,1,0,5,4,0,2018-04-01
172,서울,서초구,3,0,0,3,2,0,2018-05-01
173,서울,서초구,3,0,4,7,5,0,2018-06-01
174,서울,서초구,5,1,1,7,4,0,2018-07-01
175,서울,서초구,6,1,0,7,5,0,2018-08-01
176,서울,서초구,13,1,1,15,12,1,2018-09-01
177,서울,서초구,9,0,1,10,6,0,2018-10-01
178,서울,서초구,12,1,2,15,12,0,2018-11-01
179,서울,서초구,13,0,1,14,8,0,2018-12-01
180,서울,성동구,0,0,0,0,0,0,2018-01-01
181,서울,성동구,0,1,2,3,3,0,2018-02-01
182,서울,성동구,2,0,2,4,3,0,2018-03-01
183,서울,성동구,2,0,0,2,2,0,2018-04-01
184,서울,성동구,7,3,1,11,5,0,2018-05-01
185,서울,성동구,7,0,3,10,5,0,2018-06-01
186,서울,성동구,3,0,0,3,2,0,2018-07-01
187,서울,성동구,4,1,0,5,3,0,2018-08-01
188,서울,성동구,4,0,0,4,4,0,2018-09-01
189,서울,성동구,3,0,0,3,3,0,2018-10-01
190,서울,성동구,3,1,3,7,5,0,2018-11-01
191,서울,성동구,2,0,0,2,2,0,2018-12-01
192,서울,성북구,2,0,4,6,4,0,2018-01-01
193,서울,성북구,9,0,5,14,8,0,2018-02-01
194,서울,성북구,7,0,0,7,3,0,2018-03-01
195,서울,성북구,2,0,0,2,1,0,2018-04-01
196,서울,성북구,6,0,2,8,5,0,2018-05-01
197,서울,성북구,4,1,1,6,6,0,2018-06-01
198,서울,성북구,6,0,1,7,3,0,2018-07-01
199,서울,성북구,5,0,2,7,6,1,2018-08-01
200,서울,성북구,3,1,2,6,4,0,2018-09-01
201,서울,성북구,5,0,1,6,5,0,2018-10-01
202,서울,성북구,1,0,1,2,2,0,2018-11-01
203,서울,성북구,5,1,0,6,4,0,2018-12-01
204,서울,송파구,7,0,6,13,6,0,2018-01-01
205,서울,송파구,3,0,5,8,7,0,2018-02-01
206,서울,송파구,10,0,3,13,8,0,2018-03-01
207,서울,송파구,5,0,4,9,6,0,2018-04-01
208,서울,송파구,11,0,2,13,8,0,2018-05-01
209,서울,송파구,9,3,2,14,13,1,2018-06-01
210,서울,송파구,12,1,3,16,8,0,2018-07-01
211,서울,송파구,13,2,1,16,9,0,2018-08-01
212,서울,송파구,6,5,2,13,9,0,2018-09-01
213,서울,송파구,7,4,0,11,7,0,2018-10-01
214,서울,송파구,5,0,1,6,5,0,2018-11-01
215,서울,송파구,7,0,3,10,6,0,2018-12-01
216,서울,양천구,3,0,0,3,2,0,2018-01-01
217,서울,양천구,2,0,2,4,4,0,2018-02-01
218,서울,양천구,5,1,0,6,4,0,2018-03-01
219,서울,양천구,1,1,2,4,4,0,2018-04-01
220,서울,양천구,4,0,0,4,4,0,2018-05-01
221,서울,양천구,3,1,2,6,6,0,2018-06-01
222,서울,양천구,2,0,1,3,2,0,2018-07-01
223,서울,양천구,5,0,4,9,7,0,2018-08-01
224,서울,양천구,1,0,0,1,1,0,2018-09-01
225,서울,양천구,1,0,1,2,2,0,2018-10-01
226,서울,양천구,2,0,1,3,3,0,2018-11-01
227,서울,양천구,7,0,2,9,7,0,2018-12-01
228,서울,영등포구,5,0,4,9,5,0,2018-01-01
229,서울,영등포구,10,0,2,12,7,0,2018-02-01
230,서울,영등포구,2,0,1,3,3,0,2018-03-01
231,서울,영등포구,7,0,2,9,6,0,2018-04-01
232,서울,영등포구,5,0,1,6,6,0,2018-05-01
233,서울,영등포구,8,0,1,9,6,0,2018-06-01
234,서울,영등포구,7,1,0,8,8,0,2018-07-01
235,서울,영등포구,4,1,2,7,7,0,2018-08-01
236,서울,영등포구,9,0,2,11,7,0,2018-09-01
237,서울,영등포구,3,0,1,4,4,0,2018-10-01
238,서울,영등포구,6,0,1,7,8,1,2018-11-01
239,서울,영등포구,8,0,1,9,5,0,2018-12-01
240,서울,용산구,4,0,0,4,3,0,2018-01-01
241,서울,용산구,5,1,1,7,3,0,2018-02-01
242,서울,용산구,2,0,1,3,3,0,2018-03-01
243,서울,용산구,7,2,1,10,6,0,2018-04-01
244,서울,용산구,3,1,3,7,5,0,2018-05-01
245,서울,용산구,4,0,1,5,3,0,2018-06-01
246,서울,용산구,3,0,1,4,4,0,2018-07-01
247,서울,용산구,7,1,0,8,3,0,2018-08-01
248,서울,용산구,7,1,3,11,8,0,2018-09-01
249,서울,용산구,1,0,0,1,1,0,2018-10-01
250,서울,용산구,4,0,0,4,4,0,2018-11-01
251,서울,용산구,11,0,2,13,8,0,2018-12-01
252,서울,은평구,2,0,1,3,4,1,2018-01-01
253,서울,은평구,4,1,2,7,6,0,2018-02-01
254,서울,은평구,4,0,2,6,5,0,2018-03-01
255,서울,은평구,2,0,0,2,1,0,2018-04-01
256,서울,은평구,3,0,0,3,2,0,2018-05-01
257,서울,은평구,3,0,3,6,6,0,2018-06-01
258,서울,은평구,3,0,1,4,3,0,2018-07-01
259,서울,은평구,2,0,2,4,4,0,2018-08-01
260,서울,은평구,1,0,1,2,2,0,2018-09-01
261,서울,은평구,4,0,1,5,4,0,2018-10-01
262,서울,은평구,4,0,3,7,4,0,2018-11-01
263,서울,은평구,13,0,5,18,6,0,2018-12-01
264,서울,종로구,2,0,1,3,2,0,2018-01-01
265,서울,종로구,1,1,1,3,2,0,2018-02-01
266,서울,종로구,3,1,0,4,3,0,2018-03-01
267,서울,종로구,3,0,0,3,3,0,2018-04-01
268,서울,종로구,0,0,1,1,1,0,2018-05-01
269,서울,종로구,4,0,0,4,4,0,2018-06-01
270,서울,종로구,0,0,0,0,0,0,2018-07-01
271,서울,종로구,0,0,0,0,0,0,2018-08-01
272,서울,종로구,4,1,3,8,5,0,2018-09-01
273,서울,종로구,2,0,0,2,2,0,2018-10-01
274,서울,종로구,0,2,0,2,2,0,2018-11-01
275,서울,종로구,2,1,2,5,3,0,2018-12-01
276,서울,중구,1,0,1,2,1,0,2018-01-01
277,서울,중구,2,1,1,4,4,0,2018-02-01
278,서울,중구,2,1,0,3,3,0,2018-03-01
279,서울,중구,2,0,0,2,1,0,2018-04-01
280,서울,중구,1,1,0,2,2,0,2018-05-01
281,서울,중구,3,0,2,5,2,0,2018-06-01
282,서울,중구,5,0,1,6,4,0,2018-07-01
283,서울,중구,1,1,0,2,2,0,2018-08-01
284,서울,중구,1,1,1,3,3,0,2018-09-01
285,서울,중구,3,0,1,4,2,0,2018-10-01
286,서울,중구,0,0,0,0,0,0,2018-11-01
287,서울,중구,2,0,0,2,1,0,2018-12-01
288,서울,중랑구,6,0,3,9,3,0,2018-01-01
289,서울,중랑구,1,0,0,1,1,0,2018-02-01
290,서울,중랑구,2,0,0,2,1,0,2018-03-01
291,서울,중랑구,2,0,1,3,3,0,2018-04-01
292,서울,중랑구,2,0,1,3,3,0,2018-05-01
293,서울,중랑구,1,2,1,4,4,0,2018-06-01
294,서울,중랑구,5,0,2,7,6,0,2018-07-01
295,서울,중랑구,1,0,0,1,1,0,2018-08-01
296,서울,중랑구,2,1,2,5,3,0,2018-09-01
297,서울,중랑구,5,1,2,8,7,0,2018-10-01
298,서울,중랑구,1,1,3,5,5,0,2018-11-01
299,서울,중랑구,4,0,1,5,4,0,2018-12-01
300,서울,강남구,3,0,2,5,5,0,2018-01-02
301,서울,강남구,14,2,3,19,15,0,2018-02-02
302,서울,강남구,10,0,2,12,11,0,2018-03-02
303,서울,강남구,17,0,2,19,12,0,2018-04-02
304,서울,강남구,6,1,3,10,7,0,2018-05-02
305,서울,강남구,17,5,0,22,8,0,2018-06-02
306,서울,강남구,10,0,4,14,12,1,2018-07-02
307,서울,강남구,18,1,1,20,11,0,2018-08-02
308,서울,강남구,6,0,0,6,4,0,2018-09-02
309,서울,강남구,7,2,4,13,12,0,2018-10-02
310,서울,강남구,12,0,1,13,10,0,2018-11-02
311,서울,강남구,3,1,1,5,5,0,2018-12-02
312,서울,강동구,3,1,0,4,4,0,2018-01-02
313,서울,강동구,3,0,1,4,3,0,2018-02-02
314,서울,강동구,2,0,2,4,4,0,2018-03-02
315,서울,강동구,2,0,1,3,3,0,2018-04-02
316,서울,강동구,2,0,1,3,3,0,2018-05-02
317,서울,강동구,7,2,0,9,5,0,2018-06-02
318,서울,강동구,4,1,1,6,6,0,2018-07-02
319,서울,강동구,1,2,3,6,5,0,2018-08-02
320,서울,강동구,2,0,3,5,3,0,2018-09-02
321,서울,강동구,5,1,2,8,7,0,2018-10-02
322,서울,강동구,9,0,3,12,9,0,2018-11-02
323,서울,강동구,4,2,0,6,1,0,2018-12-02
324,서울,강북구,4,0,0,4,3,0,2018-01-02
325,서울,강북구,6,1,0,7,5,0,2018-02-02
326,서울,강북구,2,1,1,4,3,0,2018-03-02
327,서울,강북구,2,0,1,3,3,0,2018-04-02
328,서울,강북구,1,1,2,4,3,0,2018-05-02
329,서울,강북구,3,0,0,3,3,0,2018-06-02
330,서울,강북구,5,0,1,6,3,0,2018-07-02
331,서울,강북구,3,1,0,4,4,0,2018-08-02
332,서울,강북구,5,0,0,5,5,0,2018-09-02
333,서울,강북구,2,0,1,3,2,0,2018-10-02
334,서울,강북구,2,0,2,4,4,0,2018-11-02
335,서울,강북구,1,0,0,1,1,0,2018-12-02
336,서울,강서구,2,0,0,2,2,0,2018-01-02
337,서울,강서구,3,0,2,5,5,0,2018-02-02
338,서울,강서구,2,2,0,4,3,0,2018-03-02
339,서울,강서구,3,0,0,3,2,0,2018-04-02
340,서울,강서구,3,1,0,4,4,0,2018-05-02
341,서울,강서구,3,0,1,4,4,0,2018-06-02
342,서울,강서구,2,0,1,3,3,0,2018-07-02
343,서울,강서구,8,1,3,12,7,0,2018-08-02
344,서울,강서구,11,1,3,15,7,0,2018-09-02
345,서울,강서구,1,0,0,1,1,0,2018-10-02
346,서울,강서구,8,0,1,9,7,0,2018-11-02
347,서울,강서구,1,1,1,3,3,0,2018-12-02
348,서울,관악구,2,0,1,3,3,0,2018-01-02
349,서울,관악구,2,0,0,2,2,0,2018-02-02
350,서울,관악구,9,3,2,14,7,0,2018-03-02
351,서울,관악구,6,3,2,11,5,0,2018-04-02
352,서울,관악구,1,0,0,1,1,0,2018-05-02
353,서울,관악구,2,0,0,2,2,0,2018-06-02
354,서울,관악구,2,1,0,3,3,0,2018-07-02
355,서울,관악구,8,0,0,8,6,0,2018-08-02
356,서울,관악구,3,0,0,3,2,0,2018-09-02
357,서울,관악구,2,3,1,6,4,0,2018-10-02
358,서울,관악구,3,0,0,3,3,0,2018-11-02
359,서울,관악구,1,0,1,2,2,0,2018-12-02
360,서울,광진구,0,0,2,2,2,0,2018-01-02
361,서울,광진구,1,0,0,1,1,0,2018-02-02
362,서울,광진구,2,0,0,2,1,0,2018-03-02
363,서울,광진구,3,0,0,3,3,0,2018-04-02
364,서울,광진구,2,0,1,3,3,0,2018-05-02
365,서울,광진구,5,0,2,7,6,0,2018-06-02
366,서울,광진구,1,0,1,2,2,0,2018-07-02
367,서울,광진구,3,0,1,4,4,0,2018-08-02
368,서울,광진구,3,1,0,4,3,0,2018-09-02
369,서울,광진구,0,1,1,2,2,0,2018-10-02
370,서울,광진구,7,1,1,9,7,0,2018-11-02
371,서울,광진구,1,0,0,1,1,0,2018-12-02
372,서울,구로구,2,0,2,4,3,0,2018-01-02
373,서울,구로구,2,1,1,4,4,0,2018-02-02
374,서울,구로구,1,1,0,2,2,0,2018-03-02
375,서울,구로구,6,0,1,7,6,0,2018-04-02
376,서울,구로구,2,0,1,3,2,0,2018-05-02
377,서울,구로구,8,0,1,9,6,0,2018-06-02
378,서울,구로구,3,0,0,3,3,0,2018-07-02
379,서울,구로구,6,0,1,7,5,0,2018-08-02
380,서울,구로구,4,0,0,4,3,0,2018-09-02
381,서울,구로구,4,1,5,10,6,0,2018-10-02
382,서울,구로구,1,0,1,2,2,0,2018-11-02
383,서울,구로구,1,0,0,1,1,0,2018-12-02
384,서울,금천구,3,0,0,3,3,0,2018-01-02
385,서울,금천구,2,0,0,2,2,0,2018-02-02
386,서울,금천구,1,0,2,3,3,0,2018-03-02
387,서울,금천구,2,0,2,4,2,0,2018-04-02
388,서울,금천구,9,0,3,12,7,0,2018-05-02
389,서울,금천구,1,1,1,3,3,0,2018-06-02
390,서울,금천구,5,0,0,5,4,0,2018-07-02
391,서울,금천구,2,0,0,2,1,0,2018-08-02
392,서울,금천구,3,0,1,4,2,0,2018-09-02
393,서울,금천구,1,0,0,1,1,0,2018-10-02
394,서울,금천구,0,1,1,2,1,0,2018-11-02
395,서울,금천구,3,1,0,4,2,0,2018-12-02
396,서울,노원구,0,0,1,1,1,0,2018-01-02
397,서울,노원구,8,2,2,12,8,0,2018-02-02
398,서울,노원구,3,1,2,6,3,0,2018-03-02
399,서울,노원구,0,3,1,4,3,0,2018-04-02
400,서울,노원구,5,1,0,6,5,0,2018-05-02
401,서울,노원구,4,0,2,6,6,0,2018-06-02
402,서울,노원구,8,2,2,12,8,0,2018-07-02
403,서울,노원구,5,0,0,5,4,0,2018-08-02
404,서울,노원구,10,0,0,10,4,0,2018-09-02
405,서울,노원구,5,1,2,8,6,0,2018-10-02
406,서울,노원구,2,0,2,4,3,0,2018-11-02
407,서울,노원구,3,0,1,4,3,0,2018-12-02
408,서울,도봉구,1,0,1,2,2,0,2018-01-02
409,서울,도봉구,10,1,3,14,8,0,2018-02-02
410,서울,도봉구,2,1,1,4,4,0,2018-03-02
411,서울,도봉구,3,0,1,4,2,0,2018-04-02
412,서울,도봉구,2,1,0,3,3,0,2018-05-02
413,서울,도봉구,2,0,1,3,3,0,2018-06-02
414,서울,도봉구,6,0,1,7,4,0,2018-07-02
415,서울,도봉구,2,0,1,3,3,0,2018-08-02
416,서울,도봉구,0,0,0,0,0,0,2018-09-02
417,서울,도봉구,2,2,1,5,5,0,2018-10-02
418,서울,도봉구,1,0,0,1,1,0,2018-11-02
419,서울,도봉구,1,0,0,1,1,0,2018-12-02
420,서울,동대문구,1,0,2,3,3,0,2018-01-02
421,서울,동대문구,8,1,2,11,10,0,2018-02-02
422,서울,동대문구,4,0,1,5,4,0,2018-03-02
423,서울,동대문구,2,1,3,6,6,0,2018-04-02
424,서울,동대문구,9,0,2,11,6,0,2018-05-02
425,서울,동대문구,4,1,1,6,6,0,2018-06-02
426,서울,동대문구,3,0,2,5,5,0,2018-07-02
427,서울,동대문구,6,0,1,7,7,0,2018-08-02
428,서울,동대문구,6,0,1,7,5,0,2018-09-02
429,서울,동대문구,10,0,1,11,4,0,2018-10-02
430,서울,동대문구,4,1,1,6,4,0,2018-11-02
431,서울,동대문구,6,0,1,7,5,0,2018-12-02
432,서울,동작구,0,0,0,0,0,0,2018-01-02
433,서울,동작구,3,0,0,3,3,0,2018-02-02
434,서울,동작구,2,0,0,2,2,0,2018-03-02
435,서울,동작구,11,0,1,12,7,0,2018-04-02
436,서울,동작구,7,0,3,10,6,0,2018-05-02
437,서울,동작구,11,0,3,14,9,0,2018-06-02
438,서울,동작구,2,0,0,2,2,0,2018-07-02
439,서울,동작구,0,1,2,3,3,0,2018-08-02
440,서울,동작구,1,0,0,1,1,0,2018-09-02
441,서울,동작구,4,3,0,7,6,0,2018-10-02
442,서울,동작구,1,0,1,2,1,0,2018-11-02
443,서울,동작구,3,2,3,8,6,0,2018-12-02
444,서울,마포구,3,0,2,5,4,0,2018-01-02
445,서울,마포구,3,0,2,5,4,0,2018-02-02
446,서울,마포구,1,0,3,4,4,0,2018-03-02
447,서울,마포구,3,0,0,3,2,0,2018-04-02
448,서울,마포구,1,0,1,2,2,0,2018-05-02
449,서울,마포구,1,0,2,3,3,0,2018-06-02
450,서울,마포구,5,1,0,6,4,0,2018-07-02
451,서울,마포구,4,0,3,7,3,0,2018-08-02
452,서울,마포구,5,2,1,8,5,0,2018-09-02
453,서울,마포구,2,1,2,5,4,0,2018-10-02
454,서울,마포구,3,0,1,4,3,0,2018-11-02
455,서울,마포구,2,0,0,2,2,0,2018-12-02
456,서울,서대문구,1,0,1,2,2,0,2018-01-02
457,서울,서대문구,1,2,1,4,3,0,2018-02-02
458,서울,서대문구,2,1,2,5,5,0,2018-03-02
459,서울,서대문구,3,1,0,4,5,1,2018-04-02
460,서울,서대문구,5,1,0,6,3,0,2018-05-02
461,서울,서대문구,6,0,0,6,4,0,2018-06-02
462,서울,서대문구,3,0,2,5,4,0,2018-07-02
463,서울,서대문구,1,1,0,2,2,0,2018-08-02
464,서울,서대문구,1,0,0,1,1,0,2018-09-02
465,서울,서대문구,2,0,1,3,3,0,2018-10-02
466,서울,서대문구,1,0,1,2,2,0,2018-11-02
467,서울,서대문구,1,0,1,2,2,0,2018-12-02
468,서울,서초구,2,0,2,4,4,0,2018-01-02
469,서울,서초구,7,3,2,12,9,0,2018-02-02
470,서울,서초구,7,4,4,15,10,0,2018-03-02
471,서울,서초구,3,0,1,4,3,0,2018-04-02
472,서울,서초구,9,1,3,13,10,0,2018-05-02
473,서울,서초구,10,0,0,10,5,0,2018-06-02
474,서울,서초구,6,1,3,10,7,0,2018-07-02
475,서울,서초구,5,1,2,8,6,0,2018-08-02
476,서울,서초구,2,0,1,3,3,0,2018-09-02
477,서울,서초구,9,0,2,11,8,0,2018-10-02
478,서울,서초구,14,2,1,17,12,0,2018-11-02
479,서울,서초구,5,0,2,7,5,0,2018-12-02
480,서울,성동구,1,0,0,1,1,0,2018-01-02
481,서울,성동구,5,0,2,7,6,0,2018-02-02
482,서울,성동구,4,2,0,6,6,0,2018-03-02
483,서울,성동구,5,0,1,6,3,0,2018-04-02
484,서울,성동구,1,0,0,1,1,0,2018-05-02
485,서울,성동구,6,0,0,6,3,0,2018-06-02
486,서울,성동구,1,0,1,2,2,0,2018-07-02
487,서울,성동구,4,0,0,4,3,0,2018-08-02
488,서울,성동구,1,0,0,1,1,0,2018-09-02
489,서울,성동구,2,0,0,2,2,0,2018-10-02
490,서울,성동구,1,0,1,2,2,0,2018-11-02
491,서울,성동구,4,1,0,5,3,0,2018-12-02
492,서울,성북구,3,0,0,3,2,0,2018-01-02
493,서울,성북구,7,7,4,18,10,0,2018-02-02
494,서울,성북구,7,1,1,9,6,0,2018-03-02
495,서울,성북구,10,1,2,13,5,0,2018-04-02
496,서울,성북구,3,0,1,4,4,0,2018-05-02
497,서울,성북구,5,2,1,8,5,0,2018-06-02
498,서울,성북구,1,1,0,2,2,0,2018-07-02
499,서울,성북구,2,1,1,4,4,0,2018-08-02
500,서울,성북구,3,0,0,3,3,0,2018-09-02
501,서울,성북구,4,3,0,7,6,0,2018-10-02
502,서울,성북구,0,2,0,2,2,0,2018-11-02
503,서울,성북구,7,2,1,10,3,0,2018-12-02
504,서울,송파구,6,2,2,10,8,0,2018-01-02
505,서울,송파구,8,3,2,13,9,0,2018-02-02
506,서울,송파구,4,0,2,6,5,0,2018-03-02
507,서울,송파구,12,1,0,13,9,0,2018-04-02
508,서울,송파구,9,4,2,15,11,0,2018-05-02
509,서울,송파구,8,1,3,12,8,0,2018-06-02
510,서울,송파구,6,0,7,13,11,0,2018-07-02
511,서울,송파구,7,3,5,15,12,0,2018-08-02
512,서울,송파구,8,1,3,12,6,0,2018-09-02
513,서울,송파구,11,1,4,16,15,0,2018-10-02
514,서울,송파구,10,0,3,13,8,0,2018-11-02
515,서울,송파구,3,0,0,3,2,0,2018-12-02
516,서울,양천구,3,0,2,5,4,0,2018-01-02
517,서울,양천구,13,1,4,18,13,0,2018-02-02
518,서울,양천구,4,0,0,4,3,0,2018-03-02
519,서울,양천구,2,0,1,3,3,0,2018-04-02
520,서울,양천구,7,0,0,7,5,0,2018-05-02
521,서울,양천구,12,0,0,12,8,0,2018-06-02
522,서울,양천구,5,1,1,7,5,0,2018-07-02
523,서울,양천구,3,0,0,3,3,0,2018-08-02
524,서울,양천구,5,1,2,8,5,0,2018-09-02
525,서울,양천구,8,0,0,8,7,0,2018-10-02
526,서울,양천구,2,0,3,5,5,0,2018-11-02
527,서울,양천구,2,0,2,4,3,0,2018-12-02
528,서울,영등포구,3,0,1,4,4,0,2018-01-02
529,서울,영등포구,4,0,0,4,4,0,2018-02-02
530,서울,영등포구,14,1,1,16,10,0,2018-03-02
531,서울,영등포구,3,0,2,5,5,0,2018-04-02
532,서울,영등포구,6,0,1,7,5,0,2018-05-02
533,서울,영등포구,12,3,2,17,9,0,2018-06-02
534,서울,영등포구,8,0,1,9,5,0,2018-07-02
535,서울,영등포구,10,3,2,15,9,0,2018-08-02
536,서울,영등포구,7,0,2,9,7,0,2018-09-02
537,서울,영등포구,6,2,2,10,7,0,2018-10-02
538,서울,영등포구,9,4,0,13,12,0,2018-11-02
539,서울,영등포구,4,0,0,4,4,0,2018-12-02
540,서울,용산구,3,0,1,4,3,0,2018-01-02
541,서울,용산구,4,0,2,6,6,0,2018-02-02
542,서울,용산구,0,0,0,0,0,0,2018-03-02
543,서울,용산구,3,0,0,3,2,0,2018-04-02
544,서울,용산구,2,0,1,3,2,0,2018-05-02
545,서울,용산구,2,0,0,2,1,0,2018-06-02
546,서울,용산구,6,0,0,6,5,0,2018-07-02
547,서울,용산구,1,0,2,3,3,0,2018-08-02
548,서울,용산구,6,0,0,6,5,1,2018-09-02
549,서울,용산구,6,0,1,7,6,0,2018-10-02
550,서울,용산구,1,0,1,2,2,0,2018-11-02
551,서울,용산구,3,0,0,3,3,0,2018-12-02
552,서울,은평구,3,0,3,6,4,0,2018-01-02
553,서울,은평구,2,0,0,2,2,0,2018-02-02
554,서울,은평구,3,0,2,5,4,0,2018-03-02
555,서울,은평구,5,2,0,7,6,0,2018-04-02
556,서울,은평구,3,0,1,4,2,0,2018-05-02
557,서울,은평구,1,1,1,3,3,0,2018-06-02
558,서울,은평구,4,1,0,5,5,0,2018-07-02
559,서울,은평구,3,0,1,4,3,0,2018-08-02
560,서울,은평구,4,1,1,6,6,0,2018-09-02
561,서울,은평구,1,0,1,2,2,0,2018-10-02
562,서울,은평구,1,0,2,3,3,0,2018-11-02
563,서울,은평구,3,0,1,4,3,0,2018-12-02
564,서울,종로구,0,0,0,0,0,0,2018-01-02
565,서울,종로구,5,1,0,6,5,0,2018-02-02
566,서울,종로구,7,0,2,9,4,0,2018-03-02
567,서울,종로구,4,0,2,6,5,0,2018-04-02
568,서울,종로구,4,1,1,6,4,0,2018-05-02
569,서울,종로구,4,0,4,8,4,0,2018-06-02
570,서울,종로구,2,0,2,4,3,0,2018-07-02
571,서울,종로구,2,0,2,4,3,0,2018-08-02
572,서울,종로구,0,0,0,0,0,0,2018-09-02
573,서울,종로구,1,1,0,2,2,0,2018-10-02
574,서울,종로구,4,0,2,6,4,0,2018-11-02
575,서울,종로구,1,0,1,2,2,0,2018-12-02
576,서울,중구,4,0,4,8,7,0,2018-01-02
577,서울,중구,4,0,1,5,4,0,2018-02-02
578,서울,중구,4,0,1,5,3,0,2018-03-02
579,서울,중구,2,3,1,6,3,0,2018-04-02
580,서울,중구,0,0,5,5,3,0,2018-05-02
581,서울,중구,5,0,1,6,4,0,2018-06-02
582,서울,중구,2,2,2,6,3,0,2018-07-02
583,서울,중구,5,0,0,5,4,0,2018-08-02
584,서울,중구,0,0,2,2,2,0,2018-09-02
585,서울,중구,1,0,0,1,1,0,2018-10-02
586,서울,중구,7,0,0,7,7,0,2018-11-02
587,서울,중구,2,1,0,3,1,0,2018-12-02
588,서울,중랑구,5,1,0,6,4,0,2018-01-02
589,서울,중랑구,5,0,2,7,7,0,2018-02-02
590,서울,중랑구,4,1,3,8,7,0,2018-03-02
591,서울,중랑구,6,0,1,7,5,0,2018-04-02
592,서울,중랑구,3,0,2,5,5,0,2018-05-02
593,서울,중랑구,6,2,0,8,7,0,2018-06-02
594,서울,중랑구,1,0,0,1,1,0,2018-07-02
595,서울,중랑구,1,0,1,2,2,0,2018-08-02
596,서울,중랑구,1,0,1,2,2,0,2018-09-02
597,서울,중랑구,5,1,4,10,8,0,2018-10-02
598,서울,중랑구,7,1,6,14,10,0,2018-11-02
599,서울,중랑구,0,0,2,2,2,0,2018-12-02
600,서울,강남구,8,1,4,13,9,0,2018-01-03
601,서울,강남구,22,1,4,27,16,0,2018-02-03
602,서울,강남구,6,0,3,9,4,0,2018-03-03
603,서울,강남구,14,1,3,18,11,0,2018-04-03
604,서울,강남구,14,0,1,15,11,0,2018-05-03
605,서울,강남구,12,0,3,15,7,0,2018-06-03
606,서울,강남구,8,0,6,14,13,0,2018-07-03
607,서울,강남구,7,0,0,7,6,0,2018-08-03
608,서울,강남구,7,1,1,9,5,0,2018-09-03
609,서울,강남구,12,0,3,15,11,0,2018-10-03
610,서울,강남구,14,0,8,22,11,0,2018-11-03
611,서울,강남구,5,4,0,9,5,0,2018-12-03
612,서울,강동구,1,1,2,4,3,0,2018-01-03
613,서울,강동구,6,0,4,10,8,0,2018-02-03
614,서울,강동구,7,0,0,7,5,0,2018-03-03
615,서울,강동구,0,0,0,0,0,0,2018-04-03
616,서울,강동구,4,2,1,7,7,0,2018-05-03
617,서울,강동구,7,0,0,7,3,0,2018-06-03
618,서울,강동구,4,0,2,6,4,0,2018-07-03
619,서울,강동구,8,0,4,12,7,0,2018-08-03
620,서울,강동구,3,0,0,3,3,0,2018-09-03
621,서울,강동구,1,1,0,2,2,0,2018-10-03
622,서울,강동구,1,1,1,3,2,0,2018-11-03
623,서울,강동구,2,1,2,5,5,0,2018-12-03
624,서울,강북구,1,0,1,2,2,0,2018-01-03
625,서울,강북구,5,0,0,5,5,0,2018-02-03
626,서울,강북구,0,0,0,0,0,0,2018-03-03
627,서울,강북구,3,1,0,4,3,0,2018-04-03
628,서울,강북구,4,0,3,7,7,0,2018-05-03
629,서울,강북구,3,0,1,4,3,0,2018-06-03
630,서울,강북구,3,1,0,4,3,0,2018-07-03
631,서울,강북구,1,0,0,1,1,0,2018-08-03
632,서울,강북구,2,2,0,4,3,0,2018-09-03
633,서울,강북구,2,0,2,4,4,0,2018-10-03
634,서울,강북구,4,1,1,6,5,0,2018-11-03
635,서울,강북구,3,0,5,8,8,0,2018-12-03
636,서울,강서구,5,3,1,9,2,0,2018-01-03
637,서울,강서구,8,2,3,13,9,0,2018-02-03
638,서울,강서구,7,1,1,9,5,0,2018-03-03
639,서울,강서구,2,0,1,3,2,0,2018-04-03
640,서울,강서구,3,0,2,5,4,0,2018-05-03
641,서울,강서구,1,0,0,1,1,0,2018-06-03
642,서울,강서구,2,0,2,4,4,0,2018-07-03
643,서울,강서구,3,0,0,3,3,0,2018-08-03
644,서울,강서구,2,0,1,3,3,0,2018-09-03
645,서울,강서구,1,3,0,4,2,0,2018-10-03
646,서울,강서구,7,1,1,9,5,0,2018-11-03
647,서울,강서구,3,1,6,10,8,0,2018-12-03
648,서울,관악구,1,0,1,2,2,0,2018-01-03
649,서울,관악구,2,1,2,5,5,0,2018-02-03
650,서울,관악구,2,1,1,4,2,0,2018-03-03
651,서울,관악구,10,0,0,10,7,0,2018-04-03
652,서울,관악구,8,1,2,11,7,0,2018-05-03
653,서울,관악구,1,0,1,2,2,0,2018-06-03
654,서울,관악구,0,0,2,2,2,0,2018-07-03
655,서울,관악구,2,0,0,2,2,0,2018-08-03
656,서울,관악구,2,0,0,2,2,0,2018-09-03
657,서울,관악구,2,1,0,3,3,0,2018-10-03
658,서울,관악구,6,1,0,7,7,0,2018-11-03
659,서울,관악구,2,1,0,3,3,0,2018-12-03
660,서울,광진구,1,1,1,3,3,0,2018-01-03
661,서울,광진구,4,1,0,5,4,0,2018-02-03
662,서울,광진구,0,0,0,0,1,1,2018-03-03
663,서울,광진구,0,0,1,1,1,0,2018-04-03
664,서울,광진구,2,0,0,2,2,0,2018-05-03
665,서울,광진구,7,0,1,8,5,0,2018-06-03
666,서울,광진구,4,0,2,6,6,0,2018-07-03
667,서울,광진구,3,1,1,5,4,0,2018-08-03
668,서울,광진구,5,1,0,6,6,0,2018-09-03
669,서울,광진구,5,0,1,6,4,0,2018-10-03
670,서울,광진구,2,0,0,2,1,0,2018-11-03
671,서울,광진구,6,0,1,7,4,0,2018-12-03
672,서울,구로구,4,1,1,6,2,0,2018-01-03
673,서울,구로구,13,0,4,17,9,0,2018-02-03
674,서울,구로구,1,0,1,2,2,0,2018-03-03
675,서울,구로구,6,0,1,7,4,0,2018-04-03
676,서울,구로구,4,0,1,5,3,0,2018-05-03
677,서울,구로구,1,1,0,2,2,0,2018-06-03
678,서울,구로구,3,0,0,3,3,0,2018-07-03
679,서울,구로구,0,0,4,4,4,0,2018-08-03
680,서울,구로구,5,0,0,5,4,0,2018-09-03
681,서울,구로구,1,0,0,1,1,0,2018-10-03
682,서울,구로구,9,1,1,11,4,0,2018-11-03
683,서울,구로구,7,0,0,7,5,0,2018-12-03
684,서울,금천구,0,0,0,0,0,0,2018-01-03
685,서울,금천구,0,0,0,0,0,0,2018-02-03
686,서울,금천구,0,0,1,1,1,0,2018-03-03
687,서울,금천구,1,1,0,2,2,0,2018-04-03
688,서울,금천구,4,0,1,5,4,0,2018-05-03
689,서울,금천구,1,0,0,1,1,0,2018-06-03
690,서울,금천구,5,0,1,6,6,1,2018-07-03
691,서울,금천구,2,0,1,3,2,0,2018-08-03
692,서울,금천구,4,1,1,6,4,0,2018-09-03
693,서울,금천구,3,1,1,5,4,0,2018-10-03
694,서울,금천구,3,0,2,5,4,0,2018-11-03
695,서울,금천구,1,0,2,3,3,0,2018-12-03
696,서울,노원구,3,0,1,4,3,0,2018-01-03
697,서울,노원구,5,3,1,9,6,0,2018-02-03
698,서울,노원구,8,1,0,9,5,0,2018-03-03
699,서울,노원구,3,1,5,9,7,0,2018-04-03
700,서울,노원구,1,0,0,1,1,0,2018-05-03
701,서울,노원구,1,0,1,2,2,0,2018-06-03
702,서울,노원구,5,1,1,7,5,0,2018-07-03
703,서울,노원구,9,1,0,10,4,0,2018-08-03
704,서울,노원구,3,2,1,6,3,0,2018-09-03
705,서울,노원구,3,0,0,3,3,0,2018-10-03
706,서울,노원구,5,2,0,7,6,0,2018-11-03
707,서울,노원구,12,0,1,13,9,0,2018-12-03
708,서울,도봉구,3,0,0,3,2,0,2018-01-03
709,서울,도봉구,2,0,0,2,2,0,2018-02-03
710,서울,도봉구,0,0,0,0,0,0,2018-03-03
711,서울,도봉구,1,0,1,2,2,0,2018-04-03
712,서울,도봉구,1,1,1,3,3,0,2018-05-03
713,서울,도봉구,0,1,0,1,1,0,2018-06-03
714,서울,도봉구,1,1,1,3,3,0,2018-07-03
715,서울,도봉구,3,0,1,4,4,0,2018-08-03
716,서울,도봉구,1,0,2,3,3,0,2018-09-03
717,서울,도봉구,0,0,0,0,0,0,2018-10-03
718,서울,도봉구,13,0,1,14,2,0,2018-11-03
719,서울,도봉구,0,0,1,1,1,0,2018-12-03
720,서울,동대문구,2,1,3,6,5,0,2018-01-03
721,서울,동대문구,2,0,2,4,4,0,2018-02-03
722,서울,동대문구,6,0,2,8,5,0,2018-03-03
723,서울,동대문구,5,1,0,6,6,0,2018-04-03
724,서울,동대문구,0,0,1,1,1,0,2018-05-03
725,서울,동대문구,4,0,1,5,5,0,2018-06-03
726,서울,동대문구,4,0,5,9,7,0,2018-07-03
727,서울,동대문구,3,0,2,5,5,0,2018-08-03
728,서울,동대문구,4,0,3,7,6,1,2018-09-03
729,서울,동대문구,5,2,0,7,6,0,2018-10-03
730,서울,동대문구,3,1,1,5,4,0,2018-11-03
731,서울,동대문구,2,1,1,4,4,0,2018-12-03
732,서울,동작구,1,0,0,1,1,0,2018-01-03
733,서울,동작구,10,6,5,21,6,0,2018-02-03
734,서울,동작구,2,1,1,4,3,0,2018-03-03
735,서울,동작구,5,0,0,5,5,0,2018-04-03
736,서울,동작구,6,0,0,6,5,1,2018-05-03
737,서울,동작구,3,0,1,4,4,0,2018-06-03
738,서울,동작구,4,0,1,5,4,0,2018-07-03
739,서울,동작구,7,1,0,8,4,0,2018-08-03
740,서울,동작구,5,3,3,11,9,0,2018-09-03
741,서울,동작구,5,0,0,5,4,0,2018-10-03
742,서울,동작구,2,0,2,4,4,0,2018-11-03
743,서울,동작구,5,1,0,6,3,0,2018-12-03
744,서울,마포구,3,0,2,5,4,0,2018-01-03
745,서울,마포구,6,1,0,7,4,0,2018-02-03
746,서울,마포구,10,0,0,10,7,0,2018-03-03
747,서울,마포구,6,0,2,8,5,0,2018-04-03
748,서울,마포구,5,0,3,8,6,0,2018-05-03
749,서울,마포구,6,1,0,7,3,0,2018-06-03
750,서울,마포구,2,0,1,3,3,0,2018-07-03
751,서울,마포구,3,0,3,6,4,0,2018-08-03
752,서울,마포구,5,1,0,6,5,0,2018-09-03
753,서울,마포구,2,1,3,6,6,0,2018-10-03
754,서울,마포구,4,0,2,6,6,0,2018-11-03
755,서울,마포구,4,0,1,5,5,0,2018-12-03
756,서울,서대문구,3,0,0,3,3,0,2018-01-03
757,서울,서대문구,6,2,0,8,4,0,2018-02-03
758,서울,서대문구,0,0,0,0,0,0,2018-03-03
759,서울,서대문구,3,1,0,4,3,0,2018-04-03
760,서울,서대문구,3,0,0,3,3,0,2018-05-03
761,서울,서대문구,2,1,3,6,4,0,2018-06-03
762,서울,서대문구,2,0,0,2,2,0,2018-07-03
763,서울,서대문구,0,2,3,5,5,0,2018-08-03
764,서울,서대문구,1,2,0,3,2,0,2018-09-03
765,서울,서대문구,1,1,0,2,2,0,2018-10-03
766,서울,서대문구,0,1,2,3,3,0,2018-11-03
767,서울,서대문구,2,1,5,8,6,0,2018-12-03
768,서울,서초구,2,0,0,2,2,0,2018-01-03
769,서울,서초구,10,3,3,16,7,0,2018-02-03
770,서울,서초구,7,3,4,14,10,0,2018-03-03
771,서울,서초구,4,0,4,8,8,0,2018-04-03
772,서울,서초구,8,1,0,9,5,1,2018-05-03
773,서울,서초구,11,0,0,11,7,0,2018-06-03
774,서울,서초구,5,1,0,6,6,0,2018-07-03
775,서울,서초구,7,0,3,10,7,0,2018-08-03
776,서울,서초구,6,1,2,9,8,0,2018-09-03
777,서울,서초구,5,0,1,6,3,0,2018-10-03
778,서울,서초구,7,0,2,9,5,0,2018-11-03
779,서울,서초구,8,1,2,11,9,0,2018-12-03
780,서울,성동구,1,0,1,2,2,0,2018-01-03
781,서울,성동구,8,0,1,9,6,0,2018-02-03
782,서울,성동구,3,0,1,4,3,0,2018-03-03
783,서울,성동구,4,0,3,7,5,0,2018-04-03
784,서울,성동구,3,1,2,6,6,0,2018-05-03
785,서울,성동구,1,0,0,1,1,0,2018-06-03
786,서울,성동구,1,0,0,1,1,0,2018-07-03
787,서울,성동구,3,0,1,4,3,0,2018-08-03
788,서울,성동구,2,0,0,2,2,0,2018-09-03
789,서울,성동구,2,0,0,2,2,0,2018-10-03
790,서울,성동구,6,1,1,8,8,0,2018-11-03
791,서울,성동구,3,0,0,3,2,0,2018-12-03
792,서울,성북구,1,0,3,4,4,0,2018-01-03
793,서울,성북구,9,1,4,14,7,0,2018-02-03
794,서울,성북구,4,0,0,4,3,0,2018-03-03
795,서울,성북구,12,0,6,18,5,0,2018-04-03
796,서울,성북구,19,0,7,26,10,0,2018-05-03
797,서울,성북구,2,0,2,4,2,0,2018-06-03
798,서울,성북구,3,1,2,6,6,0,2018-07-03
799,서울,성북구,1,0,1,2,2,0,2018-08-03
800,서울,성북구,2,0,0,2,2,0,2018-09-03
801,서울,성북구,10,0,1,11,6,0,2018-10-03
802,서울,성북구,3,0,1,4,3,0,2018-11-03
803,서울,성북구,4,0,8,12,5,0,2018-12-03
804,서울,송파구,3,2,0,5,3,0,2018-01-03
805,서울,송파구,4,2,5,11,9,0,2018-02-03
806,서울,송파구,15,1,1,17,6,0,2018-03-03
807,서울,송파구,8,0,2,10,8,0,2018-04-03
808,서울,송파구,8,1,3,12,8,0,2018-05-03
809,서울,송파구,5,2,3,10,9,0,2018-06-03
810,서울,송파구,8,0,4,12,9,0,2018-07-03
811,서울,송파구,9,4,1,14,8,0,2018-08-03
812,서울,송파구,8,1,1,10,10,0,2018-09-03
813,서울,송파구,4,2,0,6,6,0,2018-10-03
814,서울,송파구,3,0,0,3,3,0,2018-11-03
815,서울,송파구,8,0,2,10,7,0,2018-12-03
816,서울,양천구,2,0,2,4,3,0,2018-01-03
817,서울,양천구,2,0,0,2,2,0,2018-02-03
818,서울,양천구,6,0,0,6,3,0,2018-03-03
819,서울,양천구,2,0,2,4,3,0,2018-04-03
820,서울,양천구,11,0,0,11,5,0,2018-05-03
821,서울,양천구,5,2,1,8,3,0,2018-06-03
822,서울,양천구,0,0,1,1,1,0,2018-07-03
823,서울,양천구,3,0,1,4,3,0,2018-08-03
824,서울,양천구,0,0,0,0,0,0,2018-09-03
825,서울,양천구,7,2,1,10,8,0,2018-10-03
826,서울,양천구,1,0,2,3,2,0,2018-11-03
827,서울,양천구,0,0,0,0,0,0,2018-12-03
828,서울,영등포구,1,1,2,4,3,0,2018-01-03
829,서울,영등포구,7,1,6,14,10,0,2018-02-03
830,서울,영등포구,8,1,1,10,6,0,2018-03-03
831,서울,영등포구,4,0,1,5,5,0,2018-04-03
832,서울,영등포구,6,1,2,9,7,0,2018-05-03
833,서울,영등포구,7,0,1,8,6,0,2018-06-03
834,서울,영등포구,5,0,0,5,3,0,2018-07-03
835,서울,영등포구,8,0,2,10,8,0,2018-08-03
836,서울,영등포구,4,1,2,7,5,1,2018-09-03
837,서울,영등포구,7,0,0,7,7,1,2018-10-03
838,서울,영등포구,2,0,1,3,3,0,2018-11-03
839,서울,영등포구,5,0,3,8,6,0,2018-12-03
840,서울,용산구,3,0,1,4,4,2,2018-01-03
841,서울,용산구,7,6,1,14,6,0,2018-02-03
842,서울,용산구,3,0,1,4,3,0,2018-03-03
843,서울,용산구,7,1,0,8,5,0,2018-04-03
844,서울,용산구,7,0,0,7,4,0,2018-05-03
845,서울,용산구,5,0,1,6,4,0,2018-06-03
846,서울,용산구,1,1,1,3,3,0,2018-07-03
847,서울,용산구,4,0,1,5,2,0,2018-08-03
848,서울,용산구,5,2,4,11,7,0,2018-09-03
849,서울,용산구,5,0,0,5,4,0,2018-10-03
850,서울,용산구,6,0,2,8,5,0,2018-11-03
851,서울,용산구,3,0,0,3,3,0,2018-12-03
852,서울,은평구,2,0,0,2,2,0,2018-01-03
853,서울,은평구,5,2,1,8,4,0,2018-02-03
854,서울,은평구,2,0,0,2,2,0,2018-03-03
855,서울,은평구,4,0,3,7,7,0,2018-04-03
856,서울,은평구,2,1,1,4,3,0,2018-05-03
857,서울,은평구,1,1,4,6,2,0,2018-06-03
858,서울,은평구,1,0,1,2,2,0,2018-07-03
859,서울,은평구,3,0,2,5,4,0,2018-08-03
860,서울,은평구,1,0,0,1,1,0,2018-09-03
861,서울,은평구,1,0,0,1,1,0,2018-10-03
862,서울,은평구,1,2,2,5,4,0,2018-11-03
863,서울,은평구,1,1,0,2,2,0,2018-12-03
864,서울,종로구,3,0,1,4,4,0,2018-01-03
865,서울,종로구,15,1,0,16,10,0,2018-02-03
866,서울,종로구,0,0,1,1,1,0,2018-03-03
867,서울,종로구,6,0,2,8,8,0,2018-04-03
868,서울,종로구,4,0,1,5,3,1,2018-05-03
869,서울,종로구,2,0,2,4,3,1,2018-06-03
870,서울,종로구,1,0,0,1,1,0,2018-07-03
871,서울,종로구,2,0,2,4,4,0,2018-08-03
872,서울,종로구,2,0,0,2,2,0,2018-09-03
873,서울,종로구,3,0,0,3,2,0,2018-10-03
874,서울,종로구,5,0,0,5,2,0,2018-11-03
875,서울,종로구,4,2,1,7,5,0,2018-12-03
876,서울,중구,3,0,1,4,3,0,2018-01-03
877,서울,중구,3,0,2,5,4,0,2018-02-03
878,서울,중구,5,0,2,7,5,0,2018-03-03
879,서울,중구,5,0,1,6,4,0,2018-04-03
880,서울,중구,5,1,3,9,7,1,2018-05-03
881,서울,중구,4,0,0,4,3,0,2018-06-03
882,서울,중구,3,1,1,5,4,0,2018-07-03
883,서울,중구,5,0,0,5,3,0,2018-08-03
884,서울,중구,3,0,1,4,4,0,2018-09-03
885,서울,중구,4,0,0,4,4,0,2018-10-03
886,서울,중구,7,0,0,7,5,0,2018-11-03
887,서울,중구,1,1,0,2,2,0,2018-12-03
888,서울,중랑구,2,0,0,2,1,0,2018-01-03
889,서울,중랑구,3,1,1,5,4,0,2018-02-03
890,서울,중랑구,3,0,0,3,3,1,2018-03-03
891,서울,중랑구,9,0,2,11,4,0,2018-04-03
892,서울,중랑구,3,1,1,5,3,0,2018-05-03
893,서울,중랑구,2,0,3,5,4,0,2018-06-03
894,서울,중랑구,7,0,1,8,6,0,2018-07-03
895,서울,중랑구,3,0,0,3,2,0,2018-08-03
896,서울,중랑구,2,0,0,2,2,0,2018-09-03
897,서울,중랑구,7,1,1,9,3,0,2018-10-03
898,서울,중랑구,8,1,3,12,9,0,2018-11-03
899,서울,중랑구,6,0,1,7,5,0,2018-12-03
900,서울,강남구,6,1,3,10,8,0,2018-01-04
901,서울,강남구,12,4,2,18,8,0,2018-02-04
902,서울,강남구,7,0,2,9,7,0,2018-03-04
903,서울,강남구,15,0,3,18,16,0,2018-04-04
904,서울,강남구,10,0,2,12,8,0,2018-05-04
905,서울,강남구,9,1,2,12,8,0,2018-06-04
906,서울,강남구,9,1,1,11,10,0,2018-07-04
907,서울,강남구,8,1,1,10,10,0,2018-08-04
908,서울,강남구,12,1,1,14,9,0,2018-09-04
909,서울,강남구,9,1,1,11,8,0,2018-10-04
910,서울,강남구,10,0,3,13,9,0,2018-11-04
911,서울,강남구,12,0,3,15,11,0,2018-12-04
912,서울,강동구,1,0,2,3,3,0,2018-01-04
913,서울,강동구,2,1,0,3,2,0,2018-02-04
914,서울,강동구,3,1,2,6,5,0,2018-03-04
915,서울,강동구,3,0,3,6,5,0,2018-04-04
916,서울,강동구,2,0,2,4,4,0,2018-05-04
917,서울,강동구,7,0,4,11,6,0,2018-06-04
918,서울,강동구,1,1,0,2,2,0,2018-07-04
919,서울,강동구,3,1,0,4,4,0,2018-08-04
920,서울,강동구,1,0,2,3,2,0,2018-09-04
921,서울,강동구,5,0,2,7,6,0,2018-10-04
922,서울,강동구,0,2,0,2,2,0,2018-11-04
923,서울,강동구,3,0,0,3,3,0,2018-12-04
924,서울,강북구,3,0,1,4,4,0,2018-01-04
925,서울,강북구,3,0,2,5,4,0,2018-02-04
926,서울,강북구,6,0,1,7,4,0,2018-03-04
927,서울,강북구,2,0,1,3,3,0,2018-04-04
928,서울,강북구,1,0,1,2,1,0,2018-05-04
929,서울,강북구,5,0,1,6,4,0,2018-06-04
930,서울,강북구,4,0,1,5,5,0,2018-07-04
931,서울,강북구,2,1,0,3,2,0,2018-08-04
932,서울,강북구,4,0,2,6,5,0,2018-09-04
933,서울,강북구,5,0,0,5,5,0,2018-10-04
934,서울,강북구,2,1,3,6,4,0,2018-11-04
935,서울,강북구,0,0,0,0,0,0,2018-12-04
936,서울,강서구,3,0,0,3,3,0,2018-01-04
937,서울,강서구,7,2,2,11,8,0,2018-02-04
938,서울,강서구,12,1,2,15,6,0,2018-03-04
939,서울,강서구,2,0,1,3,3,0,2018-04-04
940,서울,강서구,5,0,1,6,5,0,2018-05-04
941,서울,강서구,2,0,2,4,4,0,2018-06-04
942,서울,강서구,6,0,0,6,5,0,2018-07-04
943,서울,강서구,5,1,2,8,5,0,2018-08-04
944,서울,강서구,1,0,1,2,2,0,2018-09-04
945,서울,강서구,9,2,3,14,9,0,2018-10-04
946,서울,강서구,2,0,4,6,5,0,2018-11-04
947,서울,강서구,1,0,1,2,3,1,2018-12-04
948,서울,관악구,0,0,0,0,0,0,2018-01-04
949,서울,관악구,5,3,2,10,6,0,2018-02-04
950,서울,관악구,4,0,0,4,3,0,2018-03-04
951,서울,관악구,2,1,1,4,4,0,2018-04-04
952,서울,관악구,8,0,2,10,6,0,2018-05-04
953,서울,관악구,3,0,2,5,4,0,2018-06-04
954,서울,관악구,8,1,2,11,5,0,2018-07-04
955,서울,관악구,6,1,1,8,5,0,2018-08-04
956,서울,관악구,1,1,6,8,6,0,2018-09-04
957,서울,관악구,1,0,0,1,1,0,2018-10-04
958,서울,관악구,4,0,1,5,4,0,2018-11-04
959,서울,관악구,1,0,1,2,2,0,2018-12-04
960,서울,광진구,1,0,0,1,1,0,2018-01-04
961,서울,광진구,0,0,1,1,1,0,2018-02-04
962,서울,광진구,4,1,1,6,4,0,2018-03-04
963,서울,광진구,1,0,2,3,3,0,2018-04-04
964,서울,광진구,1,0,2,3,2,0,2018-05-04
965,서울,광진구,0,2,1,3,3,0,2018-06-04
966,서울,광진구,1,0,2,3,3,0,2018-07-04
967,서울,광진구,3,0,0,3,3,0,2018-08-04
968,서울,광진구,3,0,0,3,2,0,2018-09-04
969,서울,광진구,1,0,1,2,2,0,2018-10-04
970,서울,광진구,3,0,0,3,3,0,2018-11-04
971,서울,광진구,3,0,0,3,2,0,2018-12-04
972,서울,구로구,2,0,1,3,3,0,2018-01-04
973,서울,구로구,5,0,2,7,5,0,2018-02-04
974,서울,구로구,2,0,1,3,3,0,2018-03-04
975,서울,구로구,1,0,0,1,1,0,2018-04-04
976,서울,구로구,7,0,2,9,5,0,2018-05-04
977,서울,구로구,7,0,1,8,3,0,2018-06-04
978,서울,구로구,5,2,0,7,6,0,2018-07-04
979,서울,구로구,0,0,0,0,0,0,2018-08-04
980,서울,구로구,2,0,3,5,3,0,2018-09-04
981,서울,구로구,3,2,4,9,4,0,2018-10-04
982,서울,구로구,1,0,4,5,4,0,2018-11-04
983,서울,구로구,7,1,2,10,6,0,2018-12-04
984,서울,금천구,3,0,1,4,4,0,2018-01-04
985,서울,금천구,2,0,1,3,3,0,2018-02-04
986,서울,금천구,7,0,2,9,5,0,2018-03-04
987,서울,금천구,1,0,1,2,2,0,2018-04-04
988,서울,금천구,2,0,0,2,2,0,2018-05-04
989,서울,금천구,1,0,1,2,2,0,2018-06-04
990,서울,금천구,0,0,0,0,0,0,2018-07-04
991,서울,금천구,4,0,5,9,4,0,2018-08-04
992,서울,금천구,4,1,1,6,5,0,2018-09-04
993,서울,금천구,5,0,1,6,2,0,2018-10-04
994,서울,금천구,4,0,0,4,3,0,2018-11-04
995,서울,금천구,1,0,0,1,1,0,2018-12-04
996,서울,노원구,5,0,0,5,3,0,2018-01-04
997,서울,노원구,2,2,0,4,4,0,2018-02-04
998,서울,노원구,9,0,2,11,4,0,2018-03-04
999,서울,노원구,3,0,1,4,4,0,2018-04-04
1000,서울,노원구,4,1,1,6,6,0,2018-05-04
1001,서울,노원구,0,0,0,0,0,0,2018-06-04
1002,서울,노원구,2,1,0,3,2,0,2018-07-04
1003,서울,노원구,2,0,0,2,1,0,2018-08-04
1004,서울,노원구,3,0,0,3,3,0,2018-09-04
1005,서울,노원구,6,0,4,10,6,0,2018-10-04
1006,서울,노원구,3,0,2,5,4,0,2018-11-04
1007,서울,노원구,7,0,0,7,3,0,2018-12-04
1008,서울,도봉구,0,0,0,0,0,0,2018-01-04
1009,서울,도봉구,4,1,0,5,4,0,2018-02-04
1010,서울,도봉구,2,0,1,3,3,0,2018-03-04
1011,서울,도봉구,4,0,0,4,2,0,2018-04-04
1012,서울,도봉구,1,0,2,3,3,0,2018-05-04
1013,서울,도봉구,2,0,2,4,4,0,2018-06-04
1014,서울,도봉구,2,0,0,2,2,0,2018-07-04
1015,서울,도봉구,1,0,1,2,2,0,2018-08-04
1016,서울,도봉구,4,0,1,5,5,0,2018-09-04
1017,서울,도봉구,1,1,1,3,3,0,2018-10-04
1018,서울,도봉구,2,0,0,2,2,0,2018-11-04
1019,서울,도봉구,3,1,1,5,3,0,2018-12-04
1020,서울,동대문구,0,0,2,2,1,0,2018-01-04
1021,서울,동대문구,1,0,2,3,3,0,2018-02-04
1022,서울,동대문구,5,0,0,5,3,0,2018-03-04
1023,서울,동대문구,2,2,4,8,4,0,2018-04-04
1024,서울,동대문구,7,1,4,12,6,0,2018-05-04
1025,서울,동대문구,7,0,1,8,7,0,2018-06-04
1026,서울,동대문구,5,0,0,5,4,0,2018-07-04
1027,서울,동대문구,7,1,4,12,10,0,2018-08-04
1028,서울,동대문구,7,0,3,10,9,0,2018-09-04
1029,서울,동대문구,3,1,0,4,4,0,2018-10-04
1030,서울,동대문구,7,0,1,8,4,0,2018-11-04
1031,서울,동대문구,4,0,5,9,5,0,2018-12-04
1032,서울,동작구,3,0,1,4,5,1,2018-01-04
1033,서울,동작구,3,0,3,6,5,0,2018-02-04
1034,서울,동작구,7,0,1,8,4,0,2018-03-04
1035,서울,동작구,5,0,0,5,4,0,2018-04-04
1036,서울,동작구,4,0,1,5,3,0,2018-05-04
1037,서울,동작구,5,0,1,6,5,0,2018-06-04
1038,서울,동작구,1,1,0,2,2,0,2018-07-04
1039,서울,동작구,4,0,0,4,3,0,2018-08-04
1040,서울,동작구,4,2,1,7,5,0,2018-09-04
1041,서울,동작구,3,1,5,9,5,0,2018-10-04
1042,서울,동작구,5,0,2,7,5,0,2018-11-04
1043,서울,동작구,4,1,3,8,8,0,2018-12-04
1044,서울,마포구,2,0,1,3,2,0,2018-01-04
1045,서울,마포구,8,1,0,9,7,1,2018-02-04
1046,서울,마포구,3,0,0,3,3,0,2018-03-04
1047,서울,마포구,3,0,1,4,3,0,2018-04-04
1048,서울,마포구,2,0,1,3,3,0,2018-05-04
1049,서울,마포구,6,3,3,12,10,0,2018-06-04
1050,서울,마포구,6,1,2,9,5,0,2018-07-04
1051,서울,마포구,12,0,1,13,7,0,2018-08-04
1052,서울,마포구,3,0,1,4,4,0,2018-09-04
1053,서울,마포구,5,0,1,6,3,0,2018-10-04
1054,서울,마포구,8,0,4,12,5,0,2018-11-04
1055,서울,마포구,6,1,2,9,8,0,2018-12-04
1056,서울,서대문구,2,0,0,2,1,0,2018-01-04
1057,서울,서대문구,8,1,0,9,5,0,2018-02-04
1058,서울,서대문구,2,0,0,2,1,0,2018-03-04
1059,서울,서대문구,3,0,2,5,5,0,2018-04-04
1060,서울,서대문구,3,1,1,5,4,0,2018-05-04
1061,서울,서대문구,1,0,0,1,1,0,2018-06-04
1062,서울,서대문구,0,0,1,1,1,0,2018-07-04
1063,서울,서대문구,3,1,0,4,3,0,2018-08-04
1064,서울,서대문구,2,0,2,4,3,0,2018-09-04
1065,서울,서대문구,5,0,1,6,5,0,2018-10-04
1066,서울,서대문구,2,0,3,5,2,0,2018-11-04
1067,서울,서대문구,0,0,0,0,0,0,2018-12-04
1068,서울,서초구,5,1,1,7,6,1,2018-01-04
1069,서울,서초구,9,0,3,12,7,0,2018-02-04
1070,서울,서초구,10,4,9,23,7,0,2018-03-04
1071,서울,서초구,5,0,2,7,6,0,2018-04-04
1072,서울,서초구,5,0,0,5,5,0,2018-05-04
1073,서울,서초구,14,3,2,19,15,0,2018-06-04
1074,서울,서초구,6,0,0,6,4,0,2018-07-04
1075,서울,서초구,3,0,1,4,3,0,2018-08-04
1076,서울,서초구,5,0,3,8,8,0,2018-09-04
1077,서울,서초구,9,1,0,10,7,0,2018-10-04
1078,서울,서초구,8,0,0,8,7,0,2018-11-04
1079,서울,서초구,5,0,6,11,6,0,2018-12-04
1080,서울,성동구,5,1,1,7,6,0,2018-01-04
1081,서울,성동구,4,1,1,6,4,0,2018-02-04
1082,서울,성동구,2,0,0,2,1,0,2018-03-04
1083,서울,성동구,1,0,0,1,1,0,2018-04-04
1084,서울,성동구,2,0,1,3,3,0,2018-05-04
1085,서울,성동구,1,0,0,1,1,0,2018-06-04
1086,서울,성동구,4,0,1,5,4,0,2018-07-04
1087,서울,성동구,1,1,0,2,2,0,2018-08-04
1088,서울,성동구,2,0,1,3,3,0,2018-09-04
1089,서울,성동구,2,2,2,6,6,0,2018-10-04
1090,서울,성동구,0,0,0,0,0,0,2018-11-04
1091,서울,성동구,1,0,0,1,1,0,2018-12-04
1092,서울,성북구,2,0,0,2,2,0,2018-01-04
1093,서울,성북구,5,0,1,6,4,1,2018-02-04
1094,서울,성북구,8,0,3,11,5,0,2018-03-04
1095,서울,성북구,2,0,0,2,2,0,2018-04-04
1096,서울,성북구,11,0,0,11,9,0,2018-05-04
1097,서울,성북구,2,1,2,5,5,1,2018-06-04
1098,서울,성북구,1,0,0,1,1,0,2018-07-04
1099,서울,성북구,3,2,0,5,3,0,2018-08-04
1100,서울,성북구,1,0,4,5,3,0,2018-09-04
1101,서울,성북구,4,1,0,5,3,0,2018-10-04
1102,서울,성북구,5,0,0,5,4,0,2018-11-04
1103,서울,성북구,2,0,1,3,3,0,2018-12-04
1104,서울,송파구,9,1,0,10,6,0,2018-01-04
1105,서울,송파구,8,1,2,11,6,0,2018-02-04
1106,서울,송파구,2,0,2,4,3,1,2018-03-04
1107,서울,송파구,6,3,6,15,12,0,2018-04-04
1108,서울,송파구,1,1,3,5,5,0,2018-05-04
1109,서울,송파구,8,1,1,10,8,0,2018-06-04
1110,서울,송파구,14,3,2,19,12,0,2018-07-04
1111,서울,송파구,7,2,0,9,6,0,2018-08-04
1112,서울,송파구,7,1,2,10,9,0,2018-09-04
1113,서울,송파구,18,0,0,18,14,0,2018-10-04
1114,서울,송파구,7,0,1,8,7,1,2018-11-04
1115,서울,송파구,6,1,1,8,4,0,2018-12-04
1116,서울,양천구,0,0,1,1,1,0,2018-01-04
1117,서울,양천구,4,0,0,4,3,0,2018-02-04
1118,서울,양천구,8,1,3,12,7,0,2018-03-04
1119,서울,양천구,3,0,3,6,5,0,2018-04-04
1120,서울,양천구,5,0,1,6,6,0,2018-05-04
1121,서울,양천구,2,0,2,4,3,0,2018-06-04
1122,서울,양천구,7,0,1,8,7,0,2018-07-04
1123,서울,양천구,3,2,0,5,4,0,2018-08-04
1124,서울,양천구,1,0,0,1,1,0,2018-09-04
1125,서울,양천구,4,0,1,5,4,0,2018-10-04
1126,서울,양천구,2,0,0,2,2,0,2018-11-04
1127,서울,양천구,6,1,0,7,6,0,2018-12-04
1128,서울,영등포구,4,0,2,6,5,0,2018-01-04
1129,서울,영등포구,12,1,2,15,11,2,2018-02-04
1130,서울,영등포구,2,0,1,3,2,0,2018-03-04
1131,서울,영등포구,5,0,1,6,6,0,2018-04-04
1132,서울,영등포구,6,0,1,7,5,0,2018-05-04
1133,서울,영등포구,10,0,2,12,8,0,2018-06-04
1134,서울,영등포구,10,1,2,13,10,0,2018-07-04
1135,서울,영등포구,5,1,1,7,6,0,2018-08-04
1136,서울,영등포구,9,1,0,10,7,0,2018-09-04
1137,서울,영등포구,11,3,2,16,8,0,2018-10-04
1138,서울,영등포구,6,0,1,7,6,0,2018-11-04
1139,서울,영등포구,15,0,1,16,11,0,2018-12-04
1140,서울,용산구,3,0,2,5,3,0,2018-01-04
1141,서울,용산구,7,0,3,10,5,0,2018-02-04
1142,서울,용산구,4,0,1,5,4,0,2018-03-04
1143,서울,용산구,6,0,0,6,5,0,2018-04-04
1144,서울,용산구,4,1,2,7,7,0,2018-05-04
1145,서울,용산구,2,1,1,4,2,0,2018-06-04
1146,서울,용산구,9,0,3,12,8,0,2018-07-04
1147,서울,용산구,2,2,0,4,3,0,2018-08-04
1148,서울,용산구,1,0,0,1,1,0,2018-09-04
1149,서울,용산구,4,0,2,6,6,0,2018-10-04
1150,서울,용산구,3,1,2,6,4,0,2018-11-04
1151,서울,용산구,2,1,0,3,3,0,2018-12-04
1152,서울,은평구,1,0,2,3,3,0,2018-01-04
1153,서울,은평구,1,0,0,1,1,0,2018-02-04
1154,서울,은평구,3,0,0,3,1,0,2018-03-04
1155,서울,은평구,2,0,0,2,2,0,2018-04-04
1156,서울,은평구,2,1,1,4,3,0,2018-05-04
1157,서울,은평구,2,0,0,2,2,0,2018-06-04
1158,서울,은평구,3,0,0,3,2,0,2018-07-04
1159,서울,은평구,1,0,0,1,1,0,2018-08-04
1160,서울,은평구,2,1,1,4,4,0,2018-09-04
1161,서울,은평구,3,1,0,4,4,0,2018-10-04
1162,서울,은평구,0,0,1,1,1,0,2018-11-04
1163,서울,은평구,2,0,4,6,5,0,2018-12-04
1164,서울,종로구,3,0,3,6,5,0,2018-01-04
1165,서울,종로구,1,0,3,4,2,0,2018-02-04
1166,서울,종로구,1,0,0,1,1,0,2018-03-04
1167,서울,종로구,1,1,0,2,1,0,2018-04-04
1168,서울,종로구,4,0,1,5,2,0,2018-05-04
1169,서울,종로구,3,0,0,3,2,0,2018-06-04
1170,서울,종로구,1,1,4,6,2,0,2018-07-04
1171,서울,종로구,1,3,1,5,3,0,2018-08-04
1172,서울,종로구,4,1,0,5,3,0,2018-09-04
1173,서울,종로구,1,1,0,2,2,0,2018-10-04
1174,서울,종로구,0,0,2,2,2,0,2018-11-04
1175,서울,종로구,1,0,2,3,3,0,2018-12-04
1176,서울,중구,1,0,1,2,2,0,2018-01-04
1177,서울,중구,6,1,0,7,6,1,2018-02-04
1178,서울,중구,3,1,2,6,3,0,2018-03-04
1179,서울,중구,1,0,0,1,1,0,2018-04-04
1180,서울,중구,1,0,4,5,4,0,2018-05-04
1181,서울,중구,6,1,0,7,5,0,2018-06-04
1182,서울,중구,4,0,3,7,5,0,2018-07-04
1183,서울,중구,2,0,0,2,1,0,2018-08-04
1184,서울,중구,3,0,3,6,4,0,2018-09-04
1185,서울,중구,0,0,1,1,1,0,2018-10-04
1186,서울,중구,3,0,0,3,2,0,2018-11-04
1187,서울,중구,1,0,0,1,1,0,2018-12-04
1188,서울,중랑구,1,0,2,3,4,1,2018-01-04
1189,서울,중랑구,11,0,1,12,4,0,2018-02-04
1190,서울,중랑구,1,0,0,1,1,0,2018-03-04
1191,서울,중랑구,3,1,0,4,4,0,2018-04-04
1192,서울,중랑구,6,2,1,9,6,0,2018-05-04
1193,서울,중랑구,0,1,1,2,2,0,2018-06-04
1194,서울,중랑구,0,0,1,1,1,0,2018-07-04
1195,서울,중랑구,4,1,1,6,6,1,2018-08-04
1196,서울,중랑구,0,0,3,3,1,0,2018-09-04
1197,서울,중랑구,4,1,0,5,3,0,2018-10-04
1198,서울,중랑구,0,0,1,1,1,0,2018-11-04
1199,서울,중랑구,0,1,0,1,1,0,2018-12-04
1200,서울,강남구,12,1,5,18,14,0,2018-01-05
1201,서울,강남구,5,0,0,5,4,0,2018-02-05
1202,서울,강남구,9,1,5,15,10,0,2018-03-05
1203,서울,강남구,13,2,5,20,13,0,2018-04-05
1204,서울,강남구,7,1,2,10,7,0,2018-05-05
1205,서울,강남구,9,1,4,14,12,0,2018-06-05
1206,서울,강남구,5,2,4,11,9,0,2018-07-05
1207,서울,강남구,10,5,2,17,8,0,2018-08-05
1208,서울,강남구,18,2,4,24,15,0,2018-09-05
1209,서울,강남구,20,3,6,29,18,0,2018-10-05
1210,서울,강남구,11,0,2,13,7,1,2018-11-05
1211,서울,강남구,8,1,0,9,4,0,2018-12-05
1212,서울,강동구,1,1,1,3,3,0,2018-01-05
1213,서울,강동구,1,0,1,2,2,0,2018-02-05
1214,서울,강동구,9,0,4,13,7,0,2018-03-05
1215,서울,강동구,3,1,3,7,6,0,2018-04-05
1216,서울,강동구,3,0,0,3,3,0,2018-05-05
1217,서울,강동구,2,1,1,4,3,0,2018-06-05
1218,서울,강동구,1,0,3,4,4,0,2018-07-05
1219,서울,강동구,4,0,0,4,4,0,2018-08-05
1220,서울,강동구,2,1,2,5,5,0,2018-09-05
1221,서울,강동구,8,0,3,11,6,0,2018-10-05
1222,서울,강동구,1,0,0,1,1,0,2018-11-05
1223,서울,강동구,3,5,1,9,5,0,2018-12-05
1224,서울,강북구,0,2,0,2,2,0,2018-01-05
1225,서울,강북구,6,0,3,9,6,0,2018-02-05
1226,서울,강북구,3,0,0,3,3,0,2018-03-05
1227,서울,강북구,1,0,0,1,1,0,2018-04-05
1228,서울,강북구,2,0,0,2,2,0,2018-05-05
1229,서울,강북구,3,0,1,4,4,0,2018-06-05
1230,서울,강북구,2,0,0,2,1,0,2018-07-05
1231,서울,강북구,1,0,1,2,1,0,2018-08-05
1232,서울,강북구,1,0,0,1,1,0,2018-09-05
1233,서울,강북구,3,0,2,5,6,1,2018-10-05
1234,서울,강북구,2,0,2,4,3,0,2018-11-05
1235,서울,강북구,2,0,0,2,1,0,2018-12-05
1236,서울,강서구,4,0,3,7,6,1,2018-01-05
1237,서울,강서구,4,0,1,5,4,0,2018-02-05
1238,서울,강서구,2,0,2,4,4,0,2018-03-05
1239,서울,강서구,4,1,0,5,4,0,2018-04-05
1240,서울,강서구,9,0,1,10,3,0,2018-05-05
1241,서울,강서구,1,0,1,2,2,0,2018-06-05
1242,서울,강서구,3,0,0,3,3,0,2018-07-05
1243,서울,강서구,2,0,0,2,2,0,2018-08-05
1244,서울,강서구,6,0,3,9,6,0,2018-09-05
1245,서울,강서구,4,0,1,5,4,0,2018-10-05
1246,서울,강서구,8,1,1,10,6,0,2018-11-05
1247,서울,강서구,4,0,1,5,5,0,2018-12-05
1248,서울,관악구,1,0,1,2,2,0,2018-01-05
1249,서울,관악구,7,1,0,8,7,0,2018-02-05
1250,서울,관악구,3,0,0,3,2,0,2018-03-05
1251,서울,관악구,3,0,1,4,3,0,2018-04-05
1252,서울,관악구,4,1,0,5,5,0,2018-05-05
1253,서울,관악구,0,0,1,1,1,0,2018-06-05
1254,서울,관악구,7,0,0,7,3,0,2018-07-05
1255,서울,관악구,3,0,0,3,2,0,2018-08-05
1256,서울,관악구,5,2,0,7,6,0,2018-09-05
1257,서울,관악구,10,0,2,12,8,0,2018-10-05
1258,서울,관악구,7,0,1,8,6,0,2018-11-05
1259,서울,관악구,5,0,0,5,5,0,2018-12-05
1260,서울,광진구,5,0,0,5,4,0,2018-01-05
1261,서울,광진구,9,0,1,10,5,0,2018-02-05
1262,서울,광진구,2,0,1,3,3,0,2018-03-05
1263,서울,광진구,4,0,4,8,6,0,2018-04-05
1264,서울,광진구,5,0,1,6,5,0,2018-05-05
1265,서울,광진구,9,0,1,10,9,0,2018-06-05
1266,서울,광진구,2,0,1,3,3,0,2018-07-05
1267,서울,광진구,0,0,1,1,1,0,2018-08-05
1268,서울,광진구,1,0,0,1,1,0,2018-09-05
1269,서울,광진구,3,0,1,4,4,0,2018-10-05
1270,서울,광진구,1,1,0,2,2,0,2018-11-05
1271,서울,광진구,3,0,0,3,3,0,2018-12-05
1272,서울,구로구,1,0,0,1,1,0,2018-01-05
1273,서울,구로구,4,1,1,6,4,0,2018-02-05
1274,서울,구로구,4,0,1,5,3,0,2018-03-05
1275,서울,구로구,2,0,0,2,2,0,2018-04-05
1276,서울,구로구,1,0,5,6,4,0,2018-05-05
1277,서울,구로구,5,0,3,8,5,0,2018-06-05
1278,서울,구로구,1,1,1,3,3,0,2018-07-05
1279,서울,구로구,2,2,2,6,5,0,2018-08-05
1280,서울,구로구,6,1,3,10,10,0,2018-09-05
1281,서울,구로구,1,0,3,4,4,0,2018-10-05
1282,서울,구로구,2,0,1,3,3,0,2018-11-05
1283,서울,구로구,5,0,2,7,7,0,2018-12-05
1284,서울,금천구,4,2,2,8,4,0,2018-01-05
1285,서울,금천구,3,0,0,3,1,0,2018-02-05
1286,서울,금천구,2,0,0,2,2,0,2018-03-05
1287,서울,금천구,2,2,1,5,5,0,2018-04-05
1288,서울,금천구,2,0,1,3,3,0,2018-05-05
1289,서울,금천구,0,0,0,0,0,0,2018-06-05
1290,서울,금천구,2,1,0,3,3,0,2018-07-05
1291,서울,금천구,6,0,0,6,2,0,2018-08-05
1292,서울,금천구,1,0,0,1,1,0,2018-09-05
1293,서울,금천구,2,1,2,5,4,0,2018-10-05
1294,서울,금천구,2,0,1,3,3,0,2018-11-05
1295,서울,금천구,1,0,0,1,1,0,2018-12-05
1296,서울,노원구,2,0,1,3,3,0,2018-01-05
1297,서울,노원구,2,0,1,3,3,0,2018-02-05
1298,서울,노원구,0,1,0,1,1,0,2018-03-05
1299,서울,노원구,6,2,2,10,6,0,2018-04-05
1300,서울,노원구,3,5,3,11,5,0,2018-05-05
1301,서울,노원구,4,1,1,6,5,0,2018-06-05
1302,서울,노원구,8,4,1,13,7,0,2018-07-05
1303,서울,노원구,3,0,0,3,2,0,2018-08-05
1304,서울,노원구,3,0,1,4,3,0,2018-09-05
1305,서울,노원구,8,0,2,10,6,0,2018-10-05
1306,서울,노원구,2,0,1,3,3,0,2018-11-05
1307,서울,노원구,4,0,1,5,3,0,2018-12-05
1308,서울,도봉구,2,0,3,5,2,0,2018-01-05
1309,서울,도봉구,3,0,0,3,3,0,2018-02-05
1310,서울,도봉구,1,2,0,3,1,0,2018-03-05
1311,서울,도봉구,1,0,1,2,2,0,2018-04-05
1312,서울,도봉구,3,0,0,3,3,0,2018-05-05
1313,서울,도봉구,1,0,1,2,2,0,2018-06-05
1314,서울,도봉구,0,0,2,2,2,0,2018-07-05
1315,서울,도봉구,0,1,0,1,1,0,2018-08-05
1316,서울,도봉구,3,0,2,5,2,0,2018-09-05
1317,서울,도봉구,2,1,0,3,4,1,2018-10-05
1318,서울,도봉구,1,0,0,1,1,0,2018-11-05
1319,서울,도봉구,0,0,0,0,0,0,2018-12-05
1320,서울,동대문구,5,1,1,7,5,0,2018-01-05
1321,서울,동대문구,1,0,1,2,2,0,2018-02-05
1322,서울,동대문구,3,1,1,5,4,0,2018-03-05
1323,서울,동대문구,3,0,2,5,5,0,2018-04-05
1324,서울,동대문구,10,1,0,11,8,0,2018-05-05
1325,서울,동대문구,5,1,1,7,7,0,2018-06-05
1326,서울,동대문구,3,0,2,5,5,0,2018-07-05
1327,서울,동대문구,0,1,1,2,2,0,2018-08-05
1328,서울,동대문구,3,0,2,5,4,0,2018-09-05
1329,서울,동대문구,14,0,4,18,12,0,2018-10-05
1330,서울,동대문구,5,0,3,8,8,0,2018-11-05
1331,서울,동대문구,5,0,1,6,6,0,2018-12-05
1332,서울,동작구,1,0,1,2,2,0,2018-01-05
1333,서울,동작구,6,1,5,12,10,0,2018-02-05
1334,서울,동작구,2,0,2,4,4,0,2018-03-05
1335,서울,동작구,4,1,0,5,5,0,2018-04-05
1336,서울,동작구,1,2,0,3,3,0,2018-05-05
1337,서울,동작구,4,0,1,5,5,1,2018-06-05
1338,서울,동작구,2,1,4,7,6,0,2018-07-05
1339,서울,동작구,6,0,1,7,5,0,2018-08-05
1340,서울,동작구,4,2,2,8,6,0,2018-09-05
1341,서울,동작구,8,2,1,11,6,0,2018-10-05
1342,서울,동작구,0,0,2,2,2,0,2018-11-05
1343,서울,동작구,3,1,1,5,5,0,2018-12-05
1344,서울,마포구,7,1,2,10,4,0,2018-01-05
1345,서울,마포구,1,0,3,4,3,0,2018-02-05
1346,서울,마포구,7,0,2,9,5,0,2018-03-05
1347,서울,마포구,5,3,2,10,5,0,2018-04-05
1348,서울,마포구,4,0,0,4,4,0,2018-05-05
1349,서울,마포구,5,0,2,7,6,0,2018-06-05
1350,서울,마포구,8,0,1,9,6,0,2018-07-05
1351,서울,마포구,5,1,0,6,3,0,2018-08-05
1352,서울,마포구,8,1,0,9,5,0,2018-09-05
1353,서울,마포구,14,2,5,21,12,0,2018-10-05
1354,서울,마포구,2,1,1,4,3,1,2018-11-05
1355,서울,마포구,2,0,1,3,3,0,2018-12-05
1356,서울,서대문구,7,0,3,10,4,0,2018-01-05
1357,서울,서대문구,1,2,3,6,6,0,2018-02-05
1358,서울,서대문구,2,0,2,4,3,0,2018-03-05
1359,서울,서대문구,1,0,1,2,2,0,2018-04-05
1360,서울,서대문구,5,0,0,5,2,0,2018-05-05
1361,서울,서대문구,6,0,3,9,4,0,2018-06-05
1362,서울,서대문구,0,2,0,2,2,0,2018-07-05
1363,서울,서대문구,7,0,0,7,5,0,2018-08-05
1364,서울,서대문구,5,0,0,5,2,0,2018-09-05
1365,서울,서대문구,2,0,2,4,3,0,2018-10-05
1366,서울,서대문구,1,0,2,3,3,0,2018-11-05
1367,서울,서대문구,2,0,0,2,2,0,2018-12-05
1368,서울,서초구,1,3,0,4,2,0,2018-01-05
1369,서울,서초구,14,0,4,18,12,0,2018-02-05
1370,서울,서초구,7,2,0,9,6,0,2018-03-05
1371,서울,서초구,10,0,4,14,11,1,2018-04-05
1372,서울,서초구,4,2,0,6,3,0,2018-05-05
1373,서울,서초구,8,0,2,10,8,0,2018-06-05
1374,서울,서초구,4,2,1,7,5,0,2018-07-05
1375,서울,서초구,2,0,0,2,2,0,2018-08-05
1376,서울,서초구,10,2,0,12,8,0,2018-09-05
1377,서울,서초구,3,0,4,7,7,0,2018-10-05
1378,서울,서초구,14,1,0,15,7,0,2018-11-05
1379,서울,서초구,7,0,2,9,6,0,2018-12-05
1380,서울,성동구,4,0,1,5,3,0,2018-01-05
1381,서울,성동구,4,0,1,5,4,0,2018-02-05
1382,서울,성동구,2,0,3,5,4,0,2018-03-05
1383,서울,성동구,3,0,0,3,2,0,2018-04-05
1384,서울,성동구,11,3,0,14,4,0,2018-05-05
1385,서울,성동구,2,1,1,4,3,0,2018-06-05
1386,서울,성동구,1,0,1,2,2,0,2018-07-05
1387,서울,성동구,2,0,0,2,2,0,2018-08-05
1388,서울,성동구,5,0,1,6,5,0,2018-09-05
1389,서울,성동구,1,1,0,2,1,0,2018-10-05
1390,서울,성동구,0,0,2,2,2,0,2018-11-05
1391,서울,성동구,0,0,0,0,0,0,2018-12-05
1392,서울,성북구,5,0,1,6,4,0,2018-01-05
1393,서울,성북구,3,0,0,3,2,0,2018-02-05
1394,서울,성북구,2,1,2,5,4,0,2018-03-05
1395,서울,성북구,6,0,4,10,5,0,2018-04-05
1396,서울,성북구,1,0,1,2,2,0,2018-05-05
1397,서울,성북구,2,0,0,2,2,0,2018-06-05
1398,서울,성북구,2,0,3,5,3,0,2018-07-05
1399,서울,성북구,3,0,2,5,5,0,2018-08-05
1400,서울,성북구,1,1,1,3,3,0,2018-09-05
1401,서울,성북구,4,1,2,7,6,0,2018-10-05
1402,서울,성북구,6,1,0,7,5,0,2018-11-05
1403,서울,성북구,3,2,1,6,6,0,2018-12-05
1404,서울,송파구,3,0,0,3,2,0,2018-01-05
1405,서울,송파구,10,2,3,15,9,0,2018-02-05
1406,서울,송파구,4,0,6,10,8,0,2018-03-05
1407,서울,송파구,6,0,3,9,8,0,2018-04-05
1408,서울,송파구,5,1,2,8,7,0,2018-05-05
1409,서울,송파구,4,0,1,5,5,0,2018-06-05
1410,서울,송파구,8,2,2,12,8,0,2018-07-05
1411,서울,송파구,9,0,1,10,6,0,2018-08-05
1412,서울,송파구,4,3,2,9,8,0,2018-09-05
1413,서울,송파구,17,2,5,24,16,0,2018-10-05
1414,서울,송파구,5,1,2,8,6,0,2018-11-05
1415,서울,송파구,4,0,0,4,3,0,2018-12-05
1416,서울,양천구,4,0,1,5,5,0,2018-01-05
1417,서울,양천구,1,0,1,2,2,0,2018-02-05
1418,서울,양천구,8,2,1,11,8,0,2018-03-05
1419,서울,양천구,3,1,3,7,6,0,2018-04-05
1420,서울,양천구,4,0,3,7,4,0,2018-05-05
1421,서울,양천구,4,0,1,5,3,0,2018-06-05
1422,서울,양천구,4,0,1,5,4,0,2018-07-05
1423,서울,양천구,1,1,0,2,2,0,2018-08-05
1424,서울,양천구,4,0,1,5,3,0,2018-09-05
1425,서울,양천구,9,0,2,11,8,0,2018-10-05
1426,서울,양천구,7,1,0,8,7,0,2018-11-05
1427,서울,양천구,6,1,2,9,7,0,2018-12-05
1428,서울,영등포구,4,3,4,11,10,0,2018-01-05
1429,서울,영등포구,5,0,3,8,5,0,2018-02-05
1430,서울,영등포구,6,0,5,11,7,0,2018-03-05
1431,서울,영등포구,11,0,0,11,6,0,2018-04-05
1432,서울,영등포구,7,2,1,10,7,0,2018-05-05
1433,서울,영등포구,13,4,2,19,11,0,2018-06-05
1434,서울,영등포구,7,0,0,7,5,0,2018-07-05
1435,서울,영등포구,0,1,0,1,1,0,2018-08-05
1436,서울,영등포구,14,1,3,18,15,0,2018-09-05
1437,서울,영등포구,5,0,3,8,6,0,2018-10-05
1438,서울,영등포구,9,2,0,11,6,0,2018-11-05
1439,서울,영등포구,8,0,1,9,8,0,2018-12-05
1440,서울,용산구,2,0,2,4,2,0,2018-01-05
1441,서울,용산구,3,0,1,4,4,0,2018-02-05
1442,서울,용산구,0,1,3,4,4,0,2018-03-05
1443,서울,용산구,3,0,4,7,6,0,2018-04-05
1444,서울,용산구,4,0,1,5,5,0,2018-05-05
1445,서울,용산구,3,0,1,4,4,0,2018-06-05
1446,서울,용산구,4,1,1,6,6,0,2018-07-05
1447,서울,용산구,9,0,2,11,7,0,2018-08-05
1448,서울,용산구,6,0,4,10,5,0,2018-09-05
1449,서울,용산구,4,1,4,9,6,0,2018-10-05
1450,서울,용산구,0,0,1,1,1,0,2018-11-05
1451,서울,용산구,1,0,0,1,1,0,2018-12-05
1452,서울,은평구,1,0,0,1,1,0,2018-01-05
1453,서울,은평구,3,1,1,5,3,0,2018-02-05
1454,서울,은평구,1,1,0,2,1,0,2018-03-05
1455,서울,은평구,3,0,1,4,3,0,2018-04-05
1456,서울,은평구,1,0,1,2,2,0,2018-05-05
1457,서울,은평구,2,2,0,4,4,0,2018-06-05
1458,서울,은평구,1,0,0,1,1,0,2018-07-05
1459,서울,은평구,6,3,0,9,4,0,2018-08-05
1460,서울,은평구,2,0,1,3,3,0,2018-09-05
1461,서울,은평구,1,0,0,1,1,0,2018-10-05
1462,서울,은평구,4,1,2,7,5,0,2018-11-05
1463,서울,은평구,1,0,0,1,1,0,2018-12-05
1464,서울,종로구,4,1,1,6,4,0,2018-01-05
1465,서울,종로구,3,0,2,5,4,0,2018-02-05
1466,서울,종로구,2,1,3,6,3,0,2018-03-05
1467,서울,종로구,4,1,1,6,4,0,2018-04-05
1468,서울,종로구,3,0,0,3,2,0,2018-05-05
1469,서울,종로구,6,1,2,9,8,0,2018-06-05
1470,서울,종로구,1,0,0,1,1,0,2018-07-05
1471,서울,종로구,0,0,0,0,0,0,2018-08-05
1472,서울,종로구,2,0,0,2,1,0,2018-09-05
1473,서울,종로구,6,1,0,7,3,0,2018-10-05
1474,서울,종로구,3,0,0,3,3,0,2018-11-05
1475,서울,종로구,3,0,0,3,3,0,2018-12-05
1476,서울,중구,1,1,1,3,3,0,2018-01-05
1477,서울,중구,4,0,2,6,5,0,2018-02-05
1478,서울,중구,0,0,1,1,1,0,2018-03-05
1479,서울,중구,5,0,0,5,4,0,2018-04-05
1480,서울,중구,1,0,1,2,2,0,2018-05-05
1481,서울,중구,1,1,2,4,4,0,2018-06-05
1482,서울,중구,2,2,2,6,3,0,2018-07-05
1483,서울,중구,3,0,1,4,3,0,2018-08-05
1484,서울,중구,1,2,1,4,2,0,2018-09-05
1485,서울,중구,4,2,0,6,3,0,2018-10-05
1486,서울,중구,3,1,1,5,5,0,2018-11-05
1487,서울,중구,2,0,1,3,3,0,2018-12-05
1488,서울,중랑구,1,0,1,2,2,0,2018-01-05
1489,서울,중랑구,5,0,1,6,3,0,2018-02-05
1490,서울,중랑구,0,0,1,1,1,0,2018-03-05
1491,서울,중랑구,5,0,3,8,6,0,2018-04-05
1492,서울,중랑구,2,1,1,4,4,0,2018-05-05
1493,서울,중랑구,4,0,1,5,4,0,2018-06-05
1494,서울,중랑구,8,0,1,9,8,0,2018-07-05
1495,서울,중랑구,2,1,0,3,3,0,2018-08-05
1496,서울,중랑구,9,0,1,10,6,0,2018-09-05
1497,서울,중랑구,6,1,3,10,6,0,2018-10-05
1498,서울,중랑구,0,1,2,3,3,0,2018-11-05
1499,서울,중랑구,7,0,3,10,7,0,2018-12-05
1500,서울,강남구,9,0,0,9,9,0,2018-01-06
1501,서울,강남구,11,0,4,15,10,0,2018-02-06
1502,서울,강남구,10,0,3,13,8,0,2018-03-06
1503,서울,강남구,3,3,4,10,8,1,2018-04-06
1504,서울,강남구,2,0,0,2,2,0,2018-05-06
1505,서울,강남구,14,0,2,16,11,0,2018-06-06
1506,서울,강남구,11,0,2,13,11,0,2018-07-06
1507,서울,강남구,7,0,2,9,5,0,2018-08-06
1508,서울,강남구,9,1,3,13,11,0,2018-09-06
1509,서울,강남구,11,3,5,19,14,0,2018-10-06
1510,서울,강남구,7,1,4,12,8,0,2018-11-06
1511,서울,강남구,13,3,0,16,14,0,2018-12-06
1512,서울,강동구,1,0,2,3,3,0,2018-01-06
1513,서울,강동구,1,0,1,2,2,0,2018-02-06
1514,서울,강동구,8,0,0,8,4,0,2018-03-06
1515,서울,강동구,4,1,3,8,7,0,2018-04-06
1516,서울,강동구,4,0,0,4,3,0,2018-05-06
1517,서울,강동구,3,0,2,5,3,0,2018-06-06
1518,서울,강동구,9,0,2,11,5,0,2018-07-06
1519,서울,강동구,8,0,0,8,2,0,2018-08-06
1520,서울,강동구,4,1,0,5,5,0,2018-09-06
1521,서울,강동구,3,0,0,3,3,0,2018-10-06
1522,서울,강동구,2,1,0,3,3,0,2018-11-06
1523,서울,강동구,7,0,2,9,6,0,2018-12-06
1524,서울,강북구,1,0,0,1,1,0,2018-01-06
1525,서울,강북구,3,0,1,4,3,0,2018-02-06
1526,서울,강북구,0,0,1,1,1,0,2018-03-06
1527,서울,강북구,4,0,1,5,2,0,2018-04-06
1528,서울,강북구,7,0,2,9,5,0,2018-05-06
1529,서울,강북구,1,0,1,2,2,0,2018-06-06
1530,서울,강북구,3,0,1,4,4,0,2018-07-06
1531,서울,강북구,1,0,0,1,1,0,2018-08-06
1532,서울,강북구,1,1,1,3,3,0,2018-09-06
1533,서울,강북구,1,0,1,2,2,0,2018-10-06
1534,서울,강북구,0,0,2,2,2,0,2018-11-06
1535,서울,강북구,3,0,0,3,2,0,2018-12-06
1536,서울,강서구,7,0,2,9,7,1,2018-01-06
1537,서울,강서구,2,0,4,6,6,0,2018-02-06
1538,서울,강서구,5,0,3,8,4,0,2018-03-06
1539,서울,강서구,7,0,1,8,7,0,2018-04-06
1540,서울,강서구,1,1,1,3,2,0,2018-05-06
1541,서울,강서구,10,1,1,12,7,0,2018-06-06
1542,서울,강서구,4,0,3,7,6,0,2018-07-06
1543,서울,강서구,2,0,1,3,2,0,2018-08-06
1544,서울,강서구,2,1,1,4,4,0,2018-09-06
1545,서울,강서구,5,1,2,8,8,0,2018-10-06
1546,서울,강서구,0,0,0,0,0,0,2018-11-06
1547,서울,강서구,0,0,1,1,1,0,2018-12-06
1548,서울,관악구,0,0,0,0,0,0,2018-01-06
1549,서울,관악구,4,1,1,6,5,0,2018-02-06
1550,서울,관악구,5,0,0,5,2,0,2018-03-06
1551,서울,관악구,4,0,1,5,5,0,2018-04-06
1552,서울,관악구,5,0,1,6,3,0,2018-05-06
1553,서울,관악구,2,0,0,2,1,0,2018-06-06
1554,서울,관악구,2,0,0,2,1,0,2018-07-06
1555,서울,관악구,1,0,1,2,2,0,2018-08-06
1556,서울,관악구,4,0,1,5,4,0,2018-09-06
1557,서울,관악구,3,0,1,4,4,0,2018-10-06
1558,서울,관악구,7,0,0,7,3,0,2018-11-06
1559,서울,관악구,1,0,0,1,1,0,2018-12-06
1560,서울,광진구,2,0,1,3,3,0,2018-01-06
1561,서울,광진구,3,0,0,3,3,0,2018-02-06
1562,서울,광진구,2,0,2,4,1,0,2018-03-06
1563,서울,광진구,5,0,1,6,6,0,2018-04-06
1564,서울,광진구,3,0,1,4,4,0,2018-05-06
1565,서울,광진구,5,0,1,6,3,0,2018-06-06
1566,서울,광진구,1,0,0,1,1,0,2018-07-06
1567,서울,광진구,1,0,1,2,2,0,2018-08-06
1568,서울,광진구,6,0,2,8,6,0,2018-09-06
1569,서울,광진구,5,0,3,8,6,0,2018-10-06
1570,서울,광진구,2,1,2,5,4,0,2018-11-06
1571,서울,광진구,3,2,0,5,3,1,2018-12-06
1572,서울,구로구,2,0,2,4,2,0,2018-01-06
1573,서울,구로구,5,0,1,6,5,0,2018-02-06
1574,서울,구로구,4,0,1,5,3,0,2018-03-06
1575,서울,구로구,8,0,2,10,6,0,2018-04-06
1576,서울,구로구,5,0,1,6,6,0,2018-05-06
1577,서울,구로구,5,0,2,7,5,0,2018-06-06
1578,서울,구로구,5,0,0,5,3,0,2018-07-06
1579,서울,구로구,1,0,1,2,2,0,2018-08-06
1580,서울,구로구,1,0,0,1,1,0,2018-09-06
1581,서울,구로구,8,1,0,9,6,0,2018-10-06
1582,서울,구로구,1,0,1,2,2,0,2018-11-06
1583,서울,구로구,4,0,2,6,7,1,2018-12-06
1584,서울,금천구,5,1,1,7,4,0,2018-01-06
1585,서울,금천구,2,0,1,3,2,0,2018-02-06
1586,서울,금천구,2,1,0,3,3,0,2018-03-06
1587,서울,금천구,4,0,1,5,3,0,2018-04-06
1588,서울,금천구,0,0,0,0,0,0,2018-05-06
1589,서울,금천구,3,1,0,4,3,0,2018-06-06
1590,서울,금천구,1,1,1,3,3,0,2018-07-06
1591,서울,금천구,4,0,0,4,3,0,2018-08-06
1592,서울,금천구,7,0,0,7,5,0,2018-09-06
1593,서울,금천구,3,0,2,5,2,0,2018-10-06
1594,서울,금천구,1,0,0,1,1,0,2018-11-06
1595,서울,금천구,3,3,2,8,4,0,2018-12-06
1596,서울,노원구,7,0,3,10,3,0,2018-01-06
1597,서울,노원구,1,0,0,1,1,0,2018-02-06
1598,서울,노원구,5,1,1,7,2,0,2018-03-06
1599,서울,노원구,7,0,0,7,5,0,2018-04-06
1600,서울,노원구,1,0,1,2,2,0,2018-05-06
1601,서울,노원구,3,0,3,6,4,0,2018-06-06
1602,서울,노원구,6,1,1,8,7,0,2018-07-06
1603,서울,노원구,1,1,1,3,3,0,2018-08-06
1604,서울,노원구,4,1,1,6,5,0,2018-09-06
1605,서울,노원구,2,1,1,4,3,0,2018-10-06
1606,서울,노원구,0,0,0,0,0,0,2018-11-06
1607,서울,노원구,5,0,1,6,4,0,2018-12-06
1608,서울,도봉구,2,0,2,4,4,0,2018-01-06
1609,서울,도봉구,3,0,0,3,2,0,2018-02-06
1610,서울,도봉구,0,0,0,0,0,0,2018-03-06
1611,서울,도봉구,1,1,0,2,2,0,2018-04-06
1612,서울,도봉구,7,0,3,10,5,0,2018-05-06
1613,서울,도봉구,2,0,0,2,2,0,2018-06-06
1614,서울,도봉구,1,0,1,2,2,1,2018-07-06
1615,서울,도봉구,0,0,0,0,0,0,2018-08-06
1616,서울,도봉구,0,1,0,1,1,0,2018-09-06
1617,서울,도봉구,0,0,0,0,0,0,2018-10-06
1618,서울,도봉구,0,1,2,3,3,0,2018-11-06
1619,서울,도봉구,1,0,1,2,2,0,2018-12-06
1620,서울,동대문구,8,1,3,12,11,0,2018-01-06
1621,서울,동대문구,2,0,1,3,3,0,2018-02-06
1622,서울,동대문구,4,0,0,4,3,0,2018-03-06
1623,서울,동대문구,3,0,3,6,6,1,2018-04-06
1624,서울,동대문구,1,0,1,2,2,0,2018-05-06
1625,서울,동대문구,8,1,0,9,5,0,2018-06-06
1626,서울,동대문구,5,0,3,8,7,0,2018-07-06
1627,서울,동대문구,2,0,0,2,2,0,2018-08-06
1628,서울,동대문구,1,0,1,2,2,0,2018-09-06
1629,서울,동대문구,3,0,0,3,3,0,2018-10-06
1630,서울,동대문구,5,0,2,7,6,0,2018-11-06
1631,서울,동대문구,9,1,6,16,11,0,2018-12-06
1632,서울,동작구,1,1,1,3,3,0,2018-01-06
1633,서울,동작구,3,1,1,5,6,1,2018-02-06
1634,서울,동작구,5,1,1,7,4,0,2018-03-06
1635,서울,동작구,2,0,1,3,3,0,2018-04-06
1636,서울,동작구,5,0,1,6,2,0,2018-05-06
1637,서울,동작구,5,2,1,8,7,0,2018-06-06
1638,서울,동작구,4,1,2,7,6,0,2018-07-06
1639,서울,동작구,4,1,1,6,6,0,2018-08-06
1640,서울,동작구,2,0,0,2,2,0,2018-09-06
1641,서울,동작구,5,1,1,7,6,0,2018-10-06
1642,서울,동작구,6,1,1,8,3,0,2018-11-06
1643,서울,동작구,2,0,2,4,3,0,2018-12-06
1644,서울,마포구,6,0,1,7,6,0,2018-01-06
1645,서울,마포구,20,2,8,30,11,0,2018-02-06
1646,서울,마포구,3,0,3,6,6,0,2018-03-06
1647,서울,마포구,8,4,1,13,8,0,2018-04-06
1648,서울,마포구,1,0,0,1,1,0,2018-05-06
1649,서울,마포구,13,0,0,13,5,0,2018-06-06
1650,서울,마포구,5,1,0,6,5,0,2018-07-06
1651,서울,마포구,4,1,1,6,5,0,2018-08-06
1652,서울,마포구,8,0,1,9,6,0,2018-09-06
1653,서울,마포구,8,0,2,10,6,0,2018-10-06
1654,서울,마포구,4,0,1,5,5,0,2018-11-06
1655,서울,마포구,5,0,1,6,4,0,2018-12-06
1656,서울,서대문구,0,1,0,1,1,0,2018-01-06
1657,서울,서대문구,2,0,0,2,2,0,2018-02-06
1658,서울,서대문구,1,0,0,1,1,0,2018-03-06
1659,서울,서대문구,3,1,2,6,5,0,2018-04-06
1660,서울,서대문구,2,0,0,2,2,0,2018-05-06
1661,서울,서대문구,1,0,0,1,1,0,2018-06-06
1662,서울,서대문구,3,1,1,5,5,0,2018-07-06
1663,서울,서대문구,1,1,1,3,3,0,2018-08-06
1664,서울,서대문구,1,0,0,1,1,0,2018-09-06
1665,서울,서대문구,4,3,1,8,7,0,2018-10-06
1666,서울,서대문구,0,0,0,0,0,0,2018-11-06
1667,서울,서대문구,0,0,0,0,0,0,2018-12-06
1668,서울,서초구,3,0,3,6,5,0,2018-01-06
1669,서울,서초구,6,0,3,9,4,0,2018-02-06
1670,서울,서초구,4,0,2,6,4,0,2018-03-06
1671,서울,서초구,5,1,4,10,9,0,2018-04-06
1672,서울,서초구,7,2,0,9,7,0,2018-05-06
1673,서울,서초구,1,0,0,1,1,0,2018-06-06
1674,서울,서초구,3,0,1,4,4,0,2018-07-06
1675,서울,서초구,9,1,0,10,9,0,2018-08-06
1676,서울,서초구,6,5,2,13,8,0,2018-09-06
1677,서울,서초구,11,0,6,17,10,0,2018-10-06
1678,서울,서초구,5,0,1,6,5,0,2018-11-06
1679,서울,서초구,11,0,0,11,5,0,2018-12-06
1680,서울,성동구,4,0,1,5,4,0,2018-01-06
1681,서울,성동구,3,2,0,5,3,0,2018-02-06
1682,서울,성동구,3,0,0,3,3,0,2018-03-06
1683,서울,성동구,5,0,1,6,4,0,2018-04-06
1684,서울,성동구,1,0,0,1,1,0,2018-05-06
1685,서울,성동구,2,0,0,2,2,0,2018-06-06
1686,서울,성동구,2,3,2,7,5,0,2018-07-06
1687,서울,성동구,4,0,0,4,2,0,2018-08-06
1688,서울,성동구,1,0,0,1,1,0,2018-09-06
1689,서울,성동구,1,0,1,2,2,0,2018-10-06
1690,서울,성동구,4,0,2,6,6,0,2018-11-06
1691,서울,성동구,6,0,1,7,5,0,2018-12-06
1692,서울,성북구,2,0,0,2,2,0,2018-01-06
1693,서울,성북구,9,0,5,14,8,0,2018-02-06
1694,서울,성북구,3,0,1,4,4,0,2018-03-06
1695,서울,성북구,4,0,2,6,5,0,2018-04-06
1696,서울,성북구,5,2,3,10,3,0,2018-05-06
1697,서울,성북구,9,1,1,11,6,0,2018-06-06
1698,서울,성북구,4,2,1,7,5,0,2018-07-06
1699,서울,성북구,0,0,1,1,1,0,2018-08-06
1700,서울,성북구,6,0,2,8,4,0,2018-09-06
1701,서울,성북구,4,0,1,5,4,0,2018-10-06
1702,서울,성북구,6,1,1,8,5,0,2018-11-06
1703,서울,성북구,2,0,1,3,3,0,2018-12-06
1704,서울,송파구,9,3,3,15,9,0,2018-01-06
1705,서울,송파구,0,0,2,2,2,0,2018-02-06
1706,서울,송파구,6,0,0,6,4,0,2018-03-06
1707,서울,송파구,6,4,4,14,12,0,2018-04-06
1708,서울,송파구,6,3,6,15,8,0,2018-05-06
1709,서울,송파구,5,2,3,10,6,0,2018-06-06
1710,서울,송파구,8,1,0,9,7,0,2018-07-06
1711,서울,송파구,6,1,2,9,8,1,2018-08-06
1712,서울,송파구,5,4,1,10,9,0,2018-09-06
1713,서울,송파구,9,0,2,11,5,0,2018-10-06
1714,서울,송파구,18,1,2,21,11,0,2018-11-06
1715,서울,송파구,4,0,4,8,8,0,2018-12-06
1716,서울,양천구,4,0,1,5,4,0,2018-01-06
1717,서울,양천구,8,0,1,9,6,0,2018-02-06
1718,서울,양천구,5,1,2,8,6,0,2018-03-06
1719,서울,양천구,3,0,0,3,3,0,2018-04-06
1720,서울,양천구,5,1,0,6,4,0,2018-05-06
1721,서울,양천구,6,0,1,7,7,0,2018-06-06
1722,서울,양천구,1,2,1,4,4,0,2018-07-06
1723,서울,양천구,9,0,1,10,4,0,2018-08-06
1724,서울,양천구,1,1,0,2,2,0,2018-09-06
1725,서울,양천구,3,0,0,3,2,0,2018-10-06
1726,서울,양천구,5,0,0,5,4,0,2018-11-06
1727,서울,양천구,5,2,2,9,5,0,2018-12-06
1728,서울,영등포구,13,2,1,16,9,0,2018-01-06
1729,서울,영등포구,12,2,2,16,10,0,2018-02-06
1730,서울,영등포구,4,1,0,5,4,0,2018-03-06
1731,서울,영등포구,11,2,2,15,10,0,2018-04-06
1732,서울,영등포구,3,0,0,3,2,0,2018-05-06
1733,서울,영등포구,10,2,3,15,10,0,2018-06-06
1734,서울,영등포구,3,1,1,5,4,0,2018-07-06
1735,서울,영등포구,10,0,1,11,9,0,2018-08-06
1736,서울,영등포구,4,0,2,6,5,0,2018-09-06
1737,서울,영등포구,6,2,2,10,8,0,2018-10-06
1738,서울,영등포구,3,1,1,5,4,0,2018-11-06
1739,서울,영등포구,2,2,2,6,6,0,2018-12-06
1740,서울,용산구,7,0,2,9,9,1,2018-01-06
1741,서울,용산구,7,0,0,7,6,0,2018-02-06
1742,서울,용산구,6,0,0,6,3,0,2018-03-06
1743,서울,용산구,2,0,0,2,2,0,2018-04-06
1744,서울,용산구,3,0,0,3,2,0,2018-05-06
1745,서울,용산구,2,0,2,4,4,0,2018-06-06
1746,서울,용산구,1,0,1,2,2,0,2018-07-06
1747,서울,용산구,3,0,0,3,3,0,2018-08-06
1748,서울,용산구,4,0,1,5,3,0,2018-09-06
1749,서울,용산구,9,4,3,16,9,0,2018-10-06
1750,서울,용산구,0,0,2,2,2,0,2018-11-06
1751,서울,용산구,4,2,2,8,7,0,2018-12-06
1752,서울,은평구,1,0,1,2,2,0,2018-01-06
1753,서울,은평구,3,0,1,4,5,1,2018-02-06
1754,서울,은평구,0,0,3,3,3,0,2018-03-06
1755,서울,은평구,1,0,1,2,2,0,2018-04-06
1756,서울,은평구,1,0,1,2,2,0,2018-05-06
1757,서울,은평구,1,0,2,3,3,0,2018-06-06
1758,서울,은평구,1,0,1,2,2,0,2018-07-06
1759,서울,은평구,2,1,1,4,3,0,2018-08-06
1760,서울,은평구,2,0,0,2,2,0,2018-09-06
1761,서울,은평구,8,1,0,9,5,0,2018-10-06
1762,서울,은평구,2,0,1,3,3,0,2018-11-06
1763,서울,은평구,7,1,2,10,2,0,2018-12-06
1764,서울,종로구,10,1,0,11,4,0,2018-01-06
1765,서울,종로구,6,0,3,9,9,0,2018-02-06
1766,서울,종로구,1,0,1,2,2,0,2018-03-06
1767,서울,종로구,2,0,0,2,2,0,2018-04-06
1768,서울,종로구,1,0,0,1,1,0,2018-05-06
1769,서울,종로구,1,0,1,2,2,0,2018-06-06
1770,서울,종로구,1,0,1,2,2,0,2018-07-06
1771,서울,종로구,0,0,0,0,0,0,2018-08-06
1772,서울,종로구,2,0,1,3,3,0,2018-09-06
1773,서울,종로구,5,1,1,7,5,0,2018-10-06
1774,서울,종로구,2,1,1,4,4,0,2018-11-06
1775,서울,종로구,1,0,1,2,1,0,2018-12-06
1776,서울,중구,4,0,0,4,2,0,2018-01-06
1777,서울,중구,0,0,1,1,1,0,2018-02-06
1778,서울,중구,2,0,3,5,5,0,2018-03-06
1779,서울,중구,4,0,1,5,3,0,2018-04-06
1780,서울,중구,3,1,3,7,6,0,2018-05-06
1781,서울,중구,3,0,0,3,3,0,2018-06-06
1782,서울,중구,5,0,2,7,5,0,2018-07-06
1783,서울,중구,0,0,2,2,2,0,2018-08-06
1784,서울,중구,1,0,0,1,1,0,2018-09-06
1785,서울,중구,5,0,3,8,6,0,2018-10-06
1786,서울,중구,3,0,1,4,4,0,2018-11-06
1787,서울,중구,7,0,2,9,8,0,2018-12-06
1788,서울,중랑구,5,0,1,6,4,0,2018-01-06
1789,서울,중랑구,12,0,5,17,7,0,2018-02-06
1790,서울,중랑구,8,0,0,8,8,0,2018-03-06
1791,서울,중랑구,1,0,3,4,4,0,2018-04-06
1792,서울,중랑구,6,2,1,9,4,0,2018-05-06
1793,서울,중랑구,4,0,1,5,5,0,2018-06-06
1794,서울,중랑구,3,2,0,5,5,0,2018-07-06
1795,서울,중랑구,0,0,2,2,2,0,2018-08-06
1796,서울,중랑구,5,0,1,6,5,0,2018-09-06
1797,서울,중랑구,6,2,2,10,10,0,2018-10-06
1798,서울,중랑구,2,0,0,2,1,0,2018-11-06
1799,서울,중랑구,0,0,0,0,0,0,2018-12-06
1800,서울,강남구,4,0,1,5,4,0,2018-01-07
1801,서울,강남구,12,2,2,16,11,0,2018-02-07
1802,서울,강남구,9,1,1,11,9,0,2018-03-07
1803,서울,강남구,7,0,8,15,10,0,2018-04-07
1804,서울,강남구,4,0,2,6,6,0,2018-05-07
1805,서울,강남구,11,1,1,13,12,0,2018-06-07
1806,서울,강남구,2,0,3,5,5,0,2018-07-07
1807,서울,강남구,3,0,4,7,4,0,2018-08-07
1808,서울,강남구,4,0,2,6,6,0,2018-09-07
1809,서울,강남구,6,1,1,8,6,0,2018-10-07
1810,서울,강남구,11,1,4,16,10,0,2018-11-07
1811,서울,강남구,12,1,3,16,13,0,2018-12-07
1812,서울,강동구,1,0,0,1,1,0,2018-01-07
1813,서울,강동구,4,2,0,6,4,1,2018-02-07
1814,서울,강동구,5,1,1,7,6,0,2018-03-07
1815,서울,강동구,2,1,5,8,7,0,2018-04-07
1816,서울,강동구,1,0,0,1,1,0,2018-05-07
1817,서울,강동구,4,0,2,6,4,0,2018-06-07
1818,서울,강동구,2,0,3,5,6,1,2018-07-07
1819,서울,강동구,1,1,1,3,3,0,2018-08-07
1820,서울,강동구,2,0,1,3,3,0,2018-09-07
1821,서울,강동구,2,0,1,3,3,0,2018-10-07
1822,서울,강동구,3,2,2,7,7,0,2018-11-07
1823,서울,강동구,6,0,2,8,6,0,2018-12-07
1824,서울,강북구,1,0,0,1,1,0,2018-01-07
1825,서울,강북구,3,0,2,5,4,0,2018-02-07
1826,서울,강북구,6,0,1,7,3,0,2018-03-07
1827,서울,강북구,1,0,0,1,1,0,2018-04-07
1828,서울,강북구,3,0,0,3,3,0,2018-05-07
1829,서울,강북구,2,0,0,2,2,0,2018-06-07
1830,서울,강북구,4,0,0,4,3,0,2018-07-07
1831,서울,강북구,1,0,0,1,1,0,2018-08-07
1832,서울,강북구,5,0,0,5,4,0,2018-09-07
1833,서울,강북구,6,1,0,7,5,0,2018-10-07
1834,서울,강북구,3,0,0,3,3,0,2018-11-07
1835,서울,강북구,3,0,0,3,3,0,2018-12-07
1836,서울,강서구,3,0,0,3,2,0,2018-01-07
1837,서울,강서구,11,1,0,12,8,0,2018-02-07
1838,서울,강서구,2,0,1,3,3,0,2018-03-07
1839,서울,강서구,9,0,5,14,8,0,2018-04-07
1840,서울,강서구,2,0,1,3,3,0,2018-05-07
1841,서울,강서구,5,0,1,6,6,0,2018-06-07
1842,서울,강서구,18,0,1,19,8,0,2018-07-07
1843,서울,강서구,2,0,1,3,3,0,2018-08-07
1844,서울,강서구,3,0,2,5,5,0,2018-09-07
1845,서울,강서구,2,0,1,3,3,0,2018-10-07
1846,서울,강서구,0,0,1,1,1,0,2018-11-07
1847,서울,강서구,4,1,0,5,4,0,2018-12-07
1848,서울,관악구,0,0,0,0,0,0,2018-01-07
1849,서울,관악구,3,0,1,4,4,0,2018-02-07
1850,서울,관악구,6,0,0,6,6,1,2018-03-07
1851,서울,관악구,2,2,0,4,4,0,2018-04-07
1852,서울,관악구,3,0,1,4,3,0,2018-05-07
1853,서울,관악구,0,0,0,0,0,0,2018-06-07
1854,서울,관악구,8,0,7,15,9,0,2018-07-07
1855,서울,관악구,1,1,1,3,3,0,2018-08-07
1856,서울,관악구,7,1,1,9,6,0,2018-09-07
1857,서울,관악구,0,0,1,1,1,0,2018-10-07
1858,서울,관악구,2,1,1,4,4,0,2018-11-07
1859,서울,관악구,3,1,1,5,5,0,2018-12-07
1860,서울,광진구,5,0,2,7,5,0,2018-01-07
1861,서울,광진구,0,0,1,1,1,0,2018-02-07
1862,서울,광진구,5,0,0,5,4,0,2018-03-07
1863,서울,광진구,8,0,1,9,7,0,2018-04-07
1864,서울,광진구,3,0,0,3,3,0,2018-05-07
1865,서울,광진구,2,0,0,2,2,0,2018-06-07
1866,서울,광진구,3,0,0,3,1,0,2018-07-07
1867,서울,광진구,3,1,1,5,4,0,2018-08-07
1868,서울,광진구,1,1,1,3,3,0,2018-09-07
1869,서울,광진구,4,1,0,5,3,0,2018-10-07
1870,서울,광진구,1,1,1,3,3,0,2018-11-07
1871,서울,광진구,4,0,0,4,4,0,2018-12-07
1872,서울,구로구,2,1,0,3,2,0,2018-01-07
1873,서울,구로구,6,0,1,7,4,0,2018-02-07
1874,서울,구로구,3,0,0,3,3,0,2018-03-07
1875,서울,구로구,6,1,0,7,6,0,2018-04-07
1876,서울,구로구,1,0,0,1,1,0,2018-05-07
1877,서울,구로구,3,1,1,5,5,0,2018-06-07
1878,서울,구로구,2,0,2,4,4,0,2018-07-07
1879,서울,구로구,4,0,0,4,3,0,2018-08-07
1880,서울,구로구,2,2,0,4,3,0,2018-09-07
1881,서울,구로구,1,1,0,2,2,0,2018-10-07
1882,서울,구로구,3,0,2,5,4,0,2018-11-07
1883,서울,구로구,5,0,2,7,7,0,2018-12-07
1884,서울,금천구,1,0,1,2,2,0,2018-01-07
1885,서울,금천구,4,0,0,4,3,0,2018-02-07
1886,서울,금천구,3,0,2,5,4,0,2018-03-07
1887,서울,금천구,4,0,1,5,4,1,2018-04-07
1888,서울,금천구,5,0,2,7,4,0,2018-05-07
1889,서울,금천구,4,0,1,5,4,0,2018-06-07
1890,서울,금천구,0,0,1,1,1,0,2018-07-07
1891,서울,금천구,1,0,0,1,1,0,2018-08-07
1892,서울,금천구,4,0,0,4,3,0,2018-09-07
1893,서울,금천구,5,0,1,6,5,0,2018-10-07
1894,서울,금천구,0,0,1,1,1,0,2018-11-07
1895,서울,금천구,4,0,0,4,4,0,2018-12-07
1896,서울,노원구,1,1,3,5,4,0,2018-01-07
1897,서울,노원구,3,1,1,5,5,0,2018-02-07
1898,서울,노원구,9,0,0,9,6,0,2018-03-07
1899,서울,노원구,4,1,0,5,5,0,2018-04-07
1900,서울,노원구,2,0,1,3,3,0,2018-05-07
1901,서울,노원구,6,1,0,7,5,0,2018-06-07
1902,서울,노원구,8,0,2,10,7,0,2018-07-07
1903,서울,노원구,5,0,0,5,6,1,2018-08-07
1904,서울,노원구,5,0,1,6,6,0,2018-09-07
1905,서울,노원구,2,0,1,3,3,0,2018-10-07
1906,서울,노원구,4,0,2,6,6,0,2018-11-07
1907,서울,노원구,8,0,0,8,4,0,2018-12-07
1908,서울,도봉구,3,0,0,3,1,0,2018-01-07
1909,서울,도봉구,0,0,1,1,2,1,2018-02-07
1910,서울,도봉구,1,0,0,1,1,0,2018-03-07
1911,서울,도봉구,2,0,1,3,2,0,2018-04-07
1912,서울,도봉구,1,0,1,2,2,0,2018-05-07
1913,서울,도봉구,1,0,1,2,2,0,2018-06-07
1914,서울,도봉구,3,0,1,4,4,0,2018-07-07
1915,서울,도봉구,4,0,0,4,3,0,2018-08-07
1916,서울,도봉구,3,3,2,8,5,0,2018-09-07
1917,서울,도봉구,1,3,1,5,5,0,2018-10-07
1918,서울,도봉구,0,0,0,0,0,0,2018-11-07
1919,서울,도봉구,7,0,2,9,7,0,2018-12-07
1920,서울,동대문구,0,0,0,0,0,0,2018-01-07
1921,서울,동대문구,13,2,1,16,9,0,2018-02-07
1922,서울,동대문구,6,0,3,9,9,2,2018-03-07
1923,서울,동대문구,6,2,0,8,5,0,2018-04-07
1924,서울,동대문구,5,1,3,9,6,0,2018-05-07
1925,서울,동대문구,2,0,0,2,2,0,2018-06-07
1926,서울,동대문구,0,1,0,1,1,0,2018-07-07
1927,서울,동대문구,2,0,0,2,2,0,2018-08-07
1928,서울,동대문구,4,1,1,6,5,0,2018-09-07
1929,서울,동대문구,4,0,1,5,5,0,2018-10-07
1930,서울,동대문구,3,1,1,5,3,0,2018-11-07
1931,서울,동대문구,9,0,1,10,8,0,2018-12-07
1932,서울,동작구,4,0,0,4,3,0,2018-01-07
1933,서울,동작구,4,1,3,8,6,0,2018-02-07
1934,서울,동작구,2,0,0,2,1,0,2018-03-07
1935,서울,동작구,1,0,1,2,1,0,2018-04-07
1936,서울,동작구,1,0,0,1,1,0,2018-05-07
1937,서울,동작구,2,2,0,4,3,0,2018-06-07
1938,서울,동작구,7,0,5,12,5,0,2018-07-07
1939,서울,동작구,6,2,1,9,7,0,2018-08-07
1940,서울,동작구,9,3,3,15,9,0,2018-09-07
1941,서울,동작구,3,0,2,5,5,0,2018-10-07
1942,서울,동작구,3,0,5,8,7,0,2018-11-07
1943,서울,동작구,5,0,0,5,4,0,2018-12-07
1944,서울,마포구,0,1,0,1,1,0,2018-01-07
1945,서울,마포구,4,0,2,6,5,0,2018-02-07
1946,서울,마포구,3,1,1,5,4,0,2018-03-07
1947,서울,마포구,8,0,0,8,6,0,2018-04-07
1948,서울,마포구,3,0,0,3,3,0,2018-05-07
1949,서울,마포구,3,0,0,3,3,0,2018-06-07
1950,서울,마포구,9,0,1,10,6,0,2018-07-07
1951,서울,마포구,1,0,0,1,1,0,2018-08-07
1952,서울,마포구,1,1,0,2,2,0,2018-09-07
1953,서울,마포구,7,0,0,7,6,0,2018-10-07
1954,서울,마포구,5,0,1,6,6,0,2018-11-07
1955,서울,마포구,1,0,2,3,3,0,2018-12-07
1956,서울,서대문구,1,0,2,3,3,0,2018-01-07
1957,서울,서대문구,5,0,0,5,4,0,2018-02-07
1958,서울,서대문구,6,3,0,9,4,0,2018-03-07
1959,서울,서대문구,7,1,1,9,4,0,2018-04-07
1960,서울,서대문구,2,1,1,4,3,0,2018-05-07
1961,서울,서대문구,6,1,0,7,4,0,2018-06-07
1962,서울,서대문구,2,1,2,5,4,0,2018-07-07
1963,서울,서대문구,5,0,1,6,4,0,2018-08-07
1964,서울,서대문구,2,0,1,3,2,0,2018-09-07
1965,서울,서대문구,13,0,2,15,7,0,2018-10-07
1966,서울,서대문구,2,0,3,5,5,0,2018-11-07
1967,서울,서대문구,2,0,2,4,4,0,2018-12-07
1968,서울,서초구,1,0,0,1,1,0,2018-01-07
1969,서울,서초구,17,1,1,19,13,0,2018-02-07
1970,서울,서초구,5,2,4,11,9,0,2018-03-07
1971,서울,서초구,6,1,0,7,5,0,2018-04-07
1972,서울,서초구,7,0,1,8,4,0,2018-05-07
1973,서울,서초구,5,1,3,9,7,0,2018-06-07
1974,서울,서초구,7,1,1,9,7,0,2018-07-07
1975,서울,서초구,5,0,0,5,3,0,2018-08-07
1976,서울,서초구,9,1,5,15,9,0,2018-09-07
1977,서울,서초구,5,0,2,7,2,0,2018-10-07
1978,서울,서초구,4,1,2,7,7,0,2018-11-07
1979,서울,서초구,19,1,1,21,12,0,2018-12-07
1980,서울,성동구,1,0,0,1,1,0,2018-01-07
1981,서울,성동구,5,1,1,7,5,0,2018-02-07
1982,서울,성동구,5,0,0,5,2,0,2018-03-07
1983,서울,성동구,0,1,2,3,2,0,2018-04-07
1984,서울,성동구,4,0,2,6,3,0,2018-05-07
1985,서울,성동구,6,0,1,7,4,0,2018-06-07
1986,서울,성동구,1,0,0,1,1,0,2018-07-07
1987,서울,성동구,0,0,1,1,1,0,2018-08-07
1988,서울,성동구,3,1,1,5,5,0,2018-09-07
1989,서울,성동구,6,0,3,9,3,0,2018-10-07
1990,서울,성동구,3,1,1,5,5,0,2018-11-07
1991,서울,성동구,3,0,0,3,3,0,2018-12-07
1992,서울,성북구,0,0,2,2,2,0,2018-01-07
1993,서울,성북구,8,0,3,11,9,0,2018-02-07
1994,서울,성북구,4,0,1,5,4,0,2018-03-07
1995,서울,성북구,2,1,1,4,4,0,2018-04-07
1996,서울,성북구,1,0,1,2,2,0,2018-05-07
1997,서울,성북구,2,0,0,2,2,0,2018-06-07
1998,서울,성북구,1,0,2,3,3,0,2018-07-07
1999,서울,성북구,2,0,1,3,3,0,2018-08-07
2000,서울,성북구,4,1,0,5,5,0,2018-09-07
2001,서울,성북구,5,1,2,8,6,0,2018-10-07
2002,서울,성북구,1,1,3,5,4,0,2018-11-07
2003,서울,성북구,0,0,1,1,1,0,2018-12-07
2004,서울,송파구,2,1,0,3,3,0,2018-01-07
2005,서울,송파구,8,0,2,10,9,0,2018-02-07
2006,서울,송파구,4,1,4,9,9,0,2018-03-07
2007,서울,송파구,16,5,7,28,17,0,2018-04-07
2008,서울,송파구,3,1,3,7,7,0,2018-05-07
2009,서울,송파구,4,1,1,6,4,0,2018-06-07
2010,서울,송파구,12,3,2,17,13,0,2018-07-07
2011,서울,송파구,6,1,2,9,8,0,2018-08-07
2012,서울,송파구,6,3,2,11,8,0,2018-09-07
2013,서울,송파구,4,2,0,6,6,0,2018-10-07
2014,서울,송파구,10,1,3,14,9,0,2018-11-07
2015,서울,송파구,12,1,2,15,12,0,2018-12-07
2016,서울,양천구,0,0,1,1,1,0,2018-01-07
2017,서울,양천구,8,0,2,10,7,0,2018-02-07
2018,서울,양천구,0,0,1,1,1,0,2018-03-07
2019,서울,양천구,3,1,0,4,3,0,2018-04-07
2020,서울,양천구,2,0,0,2,2,0,2018-05-07
2021,서울,양천구,2,1,0,3,3,0,2018-06-07
2022,서울,양천구,12,2,0,14,6,0,2018-07-07
2023,서울,양천구,2,0,1,3,3,0,2018-08-07
2024,서울,양천구,1,1,2,4,4,0,2018-09-07
2025,서울,양천구,1,0,0,1,1,0,2018-10-07
2026,서울,양천구,6,1,1,8,5,0,2018-11-07
2027,서울,양천구,3,0,1,4,4,0,2018-12-07
2028,서울,영등포구,3,1,1,5,5,1,2018-01-07
2029,서울,영등포구,8,1,1,10,8,0,2018-02-07
2030,서울,영등포구,6,1,3,10,8,0,2018-03-07
2031,서울,영등포구,4,1,1,6,4,0,2018-04-07
2032,서울,영등포구,7,0,0,7,5,0,2018-05-07
2033,서울,영등포구,8,0,0,8,6,0,2018-06-07
2034,서울,영등포구,4,2,1,7,4,0,2018-07-07
2035,서울,영등포구,7,0,3,10,8,0,2018-08-07
2036,서울,영등포구,7,0,0,7,6,0,2018-09-07
2037,서울,영등포구,3,1,4,8,7,1,2018-10-07
2038,서울,영등포구,20,0,6,26,14,0,2018-11-07
2039,서울,영등포구,10,1,3,14,12,0,2018-12-07
2040,서울,용산구,3,0,0,3,1,0,2018-01-07
2041,서울,용산구,2,0,0,2,2,0,2018-02-07
2042,서울,용산구,3,0,0,3,3,0,2018-03-07
2043,서울,용산구,2,1,5,8,6,0,2018-04-07
2044,서울,용산구,4,0,2,6,4,0,2018-05-07
2045,서울,용산구,1,0,1,2,1,0,2018-06-07
2046,서울,용산구,3,0,1,4,3,0,2018-07-07
2047,서울,용산구,5,0,0,5,3,0,2018-08-07
2048,서울,용산구,2,0,1,3,3,0,2018-09-07
2049,서울,용산구,6,0,2,8,6,0,2018-10-07
2050,서울,용산구,2,0,3,5,4,0,2018-11-07
2051,서울,용산구,3,1,1,5,5,0,2018-12-07
2052,서울,은평구,0,0,0,0,0,0,2018-01-07
2053,서울,은평구,2,0,0,2,2,0,2018-02-07
2054,서울,은평구,2,0,0,2,2,0,2018-03-07
2055,서울,은평구,5,1,0,6,3,0,2018-04-07
2056,서울,은평구,4,1,0,5,4,0,2018-05-07
2057,서울,은평구,3,0,0,3,3,0,2018-06-07
2058,서울,은평구,3,0,0,3,3,0,2018-07-07
2059,서울,은평구,2,0,2,4,4,0,2018-08-07
2060,서울,은평구,1,3,2,6,6,0,2018-09-07
2061,서울,은평구,2,0,1,3,3,0,2018-10-07
2062,서울,은평구,6,1,2,9,4,0,2018-11-07
2063,서울,은평구,1,1,0,2,2,0,2018-12-07
2064,서울,종로구,4,1,0,5,4,0,2018-01-07
2065,서울,종로구,7,2,0,9,5,1,2018-02-07
2066,서울,종로구,2,1,0,3,2,0,2018-03-07
2067,서울,종로구,9,1,5,15,11,0,2018-04-07
2068,서울,종로구,3,3,0,6,3,0,2018-05-07
2069,서울,종로구,1,0,2,3,3,0,2018-06-07
2070,서울,종로구,7,2,0,9,6,0,2018-07-07
2071,서울,종로구,4,1,0,5,4,0,2018-08-07
2072,서울,종로구,3,2,2,7,6,0,2018-09-07
2073,서울,종로구,2,0,0,2,2,0,2018-10-07
2074,서울,종로구,2,0,0,2,2,0,2018-11-07
2075,서울,종로구,1,0,3,4,4,0,2018-12-07
2076,서울,중구,0,0,0,0,0,0,2018-01-07
2077,서울,중구,4,0,2,6,6,0,2018-02-07
2078,서울,중구,1,0,2,3,3,0,2018-03-07
2079,서울,중구,7,1,1,9,4,0,2018-04-07
2080,서울,중구,2,0,0,2,2,0,2018-05-07
2081,서울,중구,1,1,3,5,5,0,2018-06-07
2082,서울,중구,0,0,0,0,0,0,2018-07-07
2083,서울,중구,4,0,0,4,3,0,2018-08-07
2084,서울,중구,2,0,0,2,2,0,2018-09-07
2085,서울,중구,3,1,2,6,6,0,2018-10-07
2086,서울,중구,1,0,2,3,3,0,2018-11-07
2087,서울,중구,2,0,0,2,2,0,2018-12-07
2088,서울,중랑구,14,0,1,15,7,0,2018-01-07
2089,서울,중랑구,5,1,2,8,7,0,2018-02-07
2090,서울,중랑구,1,0,0,1,1,0,2018-03-07
2091,서울,중랑구,4,0,2,6,4,0,2018-04-07
2092,서울,중랑구,6,1,0,7,4,0,2018-05-07
2093,서울,중랑구,7,0,0,7,4,0,2018-06-07
2094,서울,중랑구,2,1,1,4,3,0,2018-07-07
2095,서울,중랑구,4,0,0,4,3,0,2018-08-07
2096,서울,중랑구,6,0,2,8,6,0,2018-09-07
2097,서울,중랑구,2,1,0,3,2,0,2018-10-07
2098,서울,중랑구,1,1,1,3,3,0,2018-11-07
2099,서울,중랑구,3,0,2,5,4,0,2018-12-07
2100,서울,강남구,11,2,2,15,10,1,2018-01-08
2101,서울,강남구,4,2,3,9,8,0,2018-02-08
2102,서울,강남구,17,1,3,21,12,0,2018-03-08
2103,서울,강남구,17,1,2,20,13,0,2018-04-08
2104,서울,강남구,8,0,3,11,9,0,2018-05-08
2105,서울,강남구,19,2,2,23,17,0,2018-06-08
2106,서울,강남구,0,2,0,2,2,0,2018-07-08
2107,서울,강남구,7,1,1,9,8,0,2018-08-08
2108,서울,강남구,12,0,1,13,11,0,2018-09-08
2109,서울,강남구,4,0,1,5,5,0,2018-10-08
2110,서울,강남구,13,1,5,19,14,0,2018-11-08
2111,서울,강남구,7,0,1,8,7,1,2018-12-08
2112,서울,강동구,4,1,1,6,6,0,2018-01-08
2113,서울,강동구,9,0,1,10,7,0,2018-02-08
2114,서울,강동구,2,1,0,3,3,0,2018-03-08
2115,서울,강동구,0,0,0,0,1,1,2018-04-08
2116,서울,강동구,4,0,1,5,3,0,2018-05-08
2117,서울,강동구,1,0,1,2,2,0,2018-06-08
2118,서울,강동구,0,0,0,0,0,0,2018-07-08
2119,서울,강동구,3,0,0,3,2,0,2018-08-08
2120,서울,강동구,3,0,2,5,5,0,2018-09-08
2121,서울,강동구,3,1,0,4,3,0,2018-10-08
2122,서울,강동구,3,1,0,4,3,0,2018-11-08
2123,서울,강동구,6,0,2,8,7,0,2018-12-08
2124,서울,강북구,5,0,2,7,5,0,2018-01-08
2125,서울,강북구,3,0,2,5,5,0,2018-02-08
2126,서울,강북구,5,0,1,6,4,0,2018-03-08
2127,서울,강북구,9,0,2,11,5,0,2018-04-08
2128,서울,강북구,3,0,0,3,3,0,2018-05-08
2129,서울,강북구,5,0,3,8,4,0,2018-06-08
2130,서울,강북구,0,0,2,2,2,0,2018-07-08
2131,서울,강북구,2,0,0,2,2,0,2018-08-08
2132,서울,강북구,5,0,1,6,3,0,2018-09-08
2133,서울,강북구,4,0,0,4,4,0,2018-10-08
2134,서울,강북구,3,0,1,4,4,0,2018-11-08
2135,서울,강북구,2,1,0,3,3,0,2018-12-08
2136,서울,강서구,3,2,3,8,7,0,2018-01-08
2137,서울,강서구,3,0,3,6,6,0,2018-02-08
2138,서울,강서구,0,2,1,3,3,0,2018-03-08
2139,서울,강서구,4,1,2,7,2,0,2018-04-08
2140,서울,강서구,1,0,2,3,3,0,2018-05-08
2141,서울,강서구,3,2,2,7,7,0,2018-06-08
2142,서울,강서구,1,0,1,2,2,0,2018-07-08
2143,서울,강서구,0,0,1,1,1,0,2018-08-08
2144,서울,강서구,3,0,1,4,4,0,2018-09-08
2145,서울,강서구,4,0,0,4,4,0,2018-10-08
2146,서울,강서구,13,1,2,16,10,0,2018-11-08
2147,서울,강서구,3,0,4,7,5,0,2018-12-08
2148,서울,관악구,4,0,1,5,3,0,2018-01-08
2149,서울,관악구,1,1,2,4,4,0,2018-02-08
2150,서울,관악구,1,0,2,3,3,0,2018-03-08
2151,서울,관악구,4,0,1,5,4,0,2018-04-08
2152,서울,관악구,1,0,1,2,2,0,2018-05-08
2153,서울,관악구,2,0,1,3,2,0,2018-06-08
2154,서울,관악구,0,2,0,2,2,0,2018-07-08
2155,서울,관악구,1,0,2,3,3,0,2018-08-08
2156,서울,관악구,6,0,1,7,6,0,2018-09-08
2157,서울,관악구,3,0,1,4,4,0,2018-10-08
2158,서울,관악구,3,0,0,3,2,0,2018-11-08
2159,서울,관악구,12,1,0,13,9,0,2018-12-08
2160,서울,광진구,0,0,0,0,0,0,2018-01-08
2161,서울,광진구,9,0,5,14,10,0,2018-02-08
2162,서울,광진구,1,0,1,2,2,0,2018-03-08
2163,서울,광진구,0,0,2,2,2,0,2018-04-08
2164,서울,광진구,4,0,0,4,4,0,2018-05-08
2165,서울,광진구,3,0,1,4,4,0,2018-06-08
2166,서울,광진구,2,0,1,3,2,0,2018-07-08
2167,서울,광진구,2,0,0,2,2,1,2018-08-08
2168,서울,광진구,1,0,1,2,2,0,2018-09-08
2169,서울,광진구,12,0,3,15,5,0,2018-10-08
2170,서울,광진구,3,0,1,4,3,0,2018-11-08
2171,서울,광진구,3,0,1,4,3,1,2018-12-08
2172,서울,구로구,3,0,0,3,3,0,2018-01-08
2173,서울,구로구,2,0,2,4,3,0,2018-02-08
2174,서울,구로구,4,0,1,5,3,0,2018-03-08
2175,서울,구로구,2,0,0,2,2,0,2018-04-08
2176,서울,구로구,3,0,2,5,5,0,2018-05-08
2177,서울,구로구,7,0,1,8,6,0,2018-06-08
2178,서울,구로구,1,0,2,3,3,0,2018-07-08
2179,서울,구로구,4,0,1,5,4,0,2018-08-08
2180,서울,구로구,3,0,3,6,5,0,2018-09-08
2181,서울,구로구,7,0,1,8,7,0,2018-10-08
2182,서울,구로구,9,0,4,13,6,0,2018-11-08
2183,서울,구로구,4,1,3,8,4,0,2018-12-08
2184,서울,금천구,3,0,2,5,4,0,2018-01-08
2185,서울,금천구,4,0,1,5,3,0,2018-02-08
2186,서울,금천구,0,1,1,2,2,0,2018-03-08
2187,서울,금천구,6,0,0,6,6,0,2018-04-08
2188,서울,금천구,3,0,4,7,4,0,2018-05-08
2189,서울,금천구,0,1,0,1,1,0,2018-06-08
2190,서울,금천구,2,0,0,2,2,0,2018-07-08
2191,서울,금천구,2,2,0,4,3,0,2018-08-08
2192,서울,금천구,2,0,0,2,1,0,2018-09-08
2193,서울,금천구,0,0,0,0,0,0,2018-10-08
2194,서울,금천구,3,0,2,5,5,0,2018-11-08
2195,서울,금천구,2,0,3,5,4,0,2018-12-08
2196,서울,노원구,0,0,2,2,2,0,2018-01-08
2197,서울,노원구,15,0,4,19,13,0,2018-02-08
2198,서울,노원구,5,0,2,7,4,0,2018-03-08
2199,서울,노원구,1,1,1,3,3,0,2018-04-08
2200,서울,노원구,2,0,3,5,5,0,2018-05-08
2201,서울,노원구,2,1,2,5,4,0,2018-06-08
2202,서울,노원구,3,0,2,5,5,0,2018-07-08
2203,서울,노원구,2,0,1,3,3,0,2018-08-08
2204,서울,노원구,1,0,3,4,4,0,2018-09-08
2205,서울,노원구,6,0,1,7,6,0,2018-10-08
2206,서울,노원구,12,0,4,16,11,0,2018-11-08
2207,서울,노원구,9,0,1,10,7,0,2018-12-08
2208,서울,도봉구,1,1,1,3,3,0,2018-01-08
2209,서울,도봉구,4,0,5,9,7,0,2018-02-08
2210,서울,도봉구,0,0,0,0,0,0,2018-03-08
2211,서울,도봉구,3,3,1,7,3,0,2018-04-08
2212,서울,도봉구,8,1,1,10,5,0,2018-05-08
2213,서울,도봉구,1,1,0,2,2,0,2018-06-08
2214,서울,도봉구,1,0,1,2,2,0,2018-07-08
2215,서울,도봉구,3,0,2,5,4,0,2018-08-08
2216,서울,도봉구,5,1,0,6,4,0,2018-09-08
2217,서울,도봉구,0,0,1,1,1,0,2018-10-08
2218,서울,도봉구,4,0,1,5,4,0,2018-11-08
2219,서울,도봉구,0,0,1,1,1,0,2018-12-08
2220,서울,동대문구,4,0,4,8,6,0,2018-01-08
2221,서울,동대문구,7,0,3,10,9,0,2018-02-08
2222,서울,동대문구,2,0,1,3,3,0,2018-03-08
2223,서울,동대문구,5,0,1,6,5,0,2018-04-08
2224,서울,동대문구,4,0,3,7,5,0,2018-05-08
2225,서울,동대문구,3,0,1,4,4,0,2018-06-08
2226,서울,동대문구,3,0,1,4,2,0,2018-07-08
2227,서울,동대문구,8,1,1,10,5,0,2018-08-08
2228,서울,동대문구,3,1,5,9,8,0,2018-09-08
2229,서울,동대문구,2,0,5,7,7,0,2018-10-08
2230,서울,동대문구,6,0,2,8,5,0,2018-11-08
2231,서울,동대문구,5,0,2,7,6,0,2018-12-08
2232,서울,동작구,3,0,0,3,3,0,2018-01-08
2233,서울,동작구,3,3,1,7,5,0,2018-02-08
2234,서울,동작구,3,0,1,4,3,0,2018-03-08
2235,서울,동작구,4,1,3,8,5,0,2018-04-08
2236,서울,동작구,1,0,1,2,2,0,2018-05-08
2237,서울,동작구,7,1,0,8,4,0,2018-06-08
2238,서울,동작구,0,0,0,0,0,0,2018-07-08
2239,서울,동작구,5,1,0,6,5,0,2018-08-08
2240,서울,동작구,2,0,2,4,4,0,2018-09-08
2241,서울,동작구,5,3,0,8,5,0,2018-10-08
2242,서울,동작구,1,0,4,5,5,0,2018-11-08
2243,서울,동작구,1,1,4,6,6,0,2018-12-08
2244,서울,마포구,3,0,0,3,1,0,2018-01-08
2245,서울,마포구,11,1,1,13,9,0,2018-02-08
2246,서울,마포구,2,0,1,3,3,0,2018-03-08
2247,서울,마포구,3,1,0,4,3,0,2018-04-08
2248,서울,마포구,4,0,0,4,4,0,2018-05-08
2249,서울,마포구,5,1,0,6,3,0,2018-06-08
2250,서울,마포구,5,0,0,5,3,0,2018-07-08
2251,서울,마포구,6,0,1,7,5,0,2018-08-08
2252,서울,마포구,6,2,1,9,8,0,2018-09-08
2253,서울,마포구,2,0,1,3,3,0,2018-10-08
2254,서울,마포구,8,1,2,11,9,0,2018-11-08
2255,서울,마포구,1,2,1,4,4,0,2018-12-08
2256,서울,서대문구,0,1,0,1,1,0,2018-01-08
2257,서울,서대문구,1,0,1,2,2,0,2018-02-08
2258,서울,서대문구,3,0,0,3,2,0,2018-03-08
2259,서울,서대문구,2,0,0,2,2,0,2018-04-08
2260,서울,서대문구,2,0,1,3,3,0,2018-05-08
2261,서울,서대문구,2,2,0,4,4,0,2018-06-08
2262,서울,서대문구,2,2,0,4,3,0,2018-07-08
2263,서울,서대문구,1,0,1,2,2,0,2018-08-08
2264,서울,서대문구,3,0,1,4,4,0,2018-09-08
2265,서울,서대문구,5,0,1,6,4,0,2018-10-08
2266,서울,서대문구,6,0,1,7,3,0,2018-11-08
2267,서울,서대문구,4,0,1,5,3,0,2018-12-08
2268,서울,서초구,5,2,2,9,8,0,2018-01-08
2269,서울,서초구,5,2,2,9,9,0,2018-02-08
2270,서울,서초구,4,0,2,6,6,0,2018-03-08
2271,서울,서초구,2,0,0,2,1,0,2018-04-08
2272,서울,서초구,11,1,2,14,11,1,2018-05-08
2273,서울,서초구,9,8,1,18,6,0,2018-06-08
2274,서울,서초구,7,0,2,9,4,0,2018-07-08
2275,서울,서초구,14,0,5,19,11,0,2018-08-08
2276,서울,서초구,16,2,1,19,8,0,2018-09-08
2277,서울,서초구,3,0,8,11,6,0,2018-10-08
2278,서울,서초구,9,0,1,10,9,0,2018-11-08
2279,서울,서초구,6,1,0,7,5,0,2018-12-08
2280,서울,성동구,2,0,1,3,3,0,2018-01-08
2281,서울,성동구,10,1,0,11,9,0,2018-02-08
2282,서울,성동구,2,0,1,3,2,0,2018-03-08
2283,서울,성동구,2,0,0,2,2,0,2018-04-08
2284,서울,성동구,7,0,0,7,4,0,2018-05-08
2285,서울,성동구,5,1,0,6,5,0,2018-06-08
2286,서울,성동구,4,0,0,4,4,0,2018-07-08
2287,서울,성동구,4,0,1,5,5,0,2018-08-08
2288,서울,성동구,5,0,2,7,5,0,2018-09-08
2289,서울,성동구,2,1,0,3,3,0,2018-10-08
2290,서울,성동구,5,0,2,7,5,0,2018-11-08
2291,서울,성동구,0,0,1,1,1,0,2018-12-08
2292,서울,성북구,4,1,1,6,5,0,2018-01-08
2293,서울,성북구,4,0,0,4,4,0,2018-02-08
2294,서울,성북구,2,0,0,2,2,0,2018-03-08
2295,서울,성북구,5,0,0,5,3,0,2018-04-08
2296,서울,성북구,6,2,1,9,8,0,2018-05-08
2297,서울,성북구,1,1,2,4,4,0,2018-06-08
2298,서울,성북구,2,1,0,3,3,0,2018-07-08
2299,서울,성북구,3,0,1,4,4,0,2018-08-08
2300,서울,성북구,6,1,0,7,4,0,2018-09-08
2301,서울,성북구,5,0,1,6,6,0,2018-10-08
2302,서울,성북구,5,1,2,8,6,0,2018-11-08
2303,서울,성북구,4,0,0,4,4,0,2018-12-08
2304,서울,송파구,0,0,0,0,1,1,2018-01-08
2305,서울,송파구,9,1,5,15,9,0,2018-02-08
2306,서울,송파구,4,2,1,7,6,0,2018-03-08
2307,서울,송파구,7,0,3,10,8,0,2018-04-08
2308,서울,송파구,5,1,1,7,7,0,2018-05-08
2309,서울,송파구,11,1,5,17,13,0,2018-06-08
2310,서울,송파구,11,1,1,13,9,0,2018-07-08
2311,서울,송파구,6,1,0,7,6,0,2018-08-08
2312,서울,송파구,6,2,6,14,11,0,2018-09-08
2313,서울,송파구,3,0,2,5,4,0,2018-10-08
2314,서울,송파구,7,0,2,9,6,0,2018-11-08
2315,서울,송파구,15,2,4,21,14,0,2018-12-08
2316,서울,양천구,1,1,0,2,2,0,2018-01-08
2317,서울,양천구,6,0,5,11,5,0,2018-02-08
2318,서울,양천구,2,1,1,4,3,0,2018-03-08
2319,서울,양천구,5,0,1,6,3,0,2018-04-08
2320,서울,양천구,8,0,2,10,6,0,2018-05-08
2321,서울,양천구,3,1,1,5,3,0,2018-06-08
2322,서울,양천구,2,0,1,3,3,0,2018-07-08
2323,서울,양천구,2,0,0,2,2,0,2018-08-08
2324,서울,양천구,4,0,0,4,3,0,2018-09-08
2325,서울,양천구,7,0,0,7,2,0,2018-10-08
2326,서울,양천구,6,0,1,7,7,0,2018-11-08
2327,서울,양천구,6,1,0,7,6,0,2018-12-08
2328,서울,영등포구,12,0,2,14,11,0,2018-01-08
2329,서울,영등포구,8,1,5,14,10,0,2018-02-08
2330,서울,영등포구,9,0,3,12,9,0,2018-03-08
2331,서울,영등포구,5,0,6,11,8,0,2018-04-08
2332,서울,영등포구,5,0,0,5,4,0,2018-05-08
2333,서울,영등포구,10,1,1,12,7,0,2018-06-08
2334,서울,영등포구,5,1,1,7,6,0,2018-07-08
2335,서울,영등포구,8,0,1,9,7,0,2018-08-08
2336,서울,영등포구,14,0,2,16,11,0,2018-09-08
2337,서울,영등포구,5,0,3,8,7,0,2018-10-08
2338,서울,영등포구,7,3,2,12,6,0,2018-11-08
2339,서울,영등포구,16,1,1,18,9,0,2018-12-08
2340,서울,용산구,2,0,0,2,2,0,2018-01-08
2341,서울,용산구,1,0,2,3,3,0,2018-02-08
2342,서울,용산구,2,0,2,4,4,0,2018-03-08
2343,서울,용산구,8,0,1,9,4,0,2018-04-08
2344,서울,용산구,3,0,0,3,3,0,2018-05-08
2345,서울,용산구,1,0,1,2,2,0,2018-06-08
2346,서울,용산구,2,0,1,3,3,0,2018-07-08
2347,서울,용산구,4,0,0,4,3,0,2018-08-08
2348,서울,용산구,4,1,0,5,4,0,2018-09-08
2349,서울,용산구,13,0,4,17,7,0,2018-10-08
2350,서울,용산구,4,1,2,7,6,0,2018-11-08
2351,서울,용산구,0,0,1,1,1,0,2018-12-08
2352,서울,은평구,1,0,1,2,2,0,2018-01-08
2353,서울,은평구,7,0,1,8,4,0,2018-02-08
2354,서울,은평구,2,0,1,3,3,0,2018-03-08
2355,서울,은평구,1,0,1,2,2,0,2018-04-08
2356,서울,은평구,2,0,0,2,2,0,2018-05-08
2357,서울,은평구,5,0,1,6,3,0,2018-06-08
2358,서울,은평구,2,0,0,2,1,0,2018-07-08
2359,서울,은평구,1,0,1,2,1,0,2018-08-08
2360,서울,은평구,3,0,1,4,2,0,2018-09-08
2361,서울,은평구,8,1,0,9,8,0,2018-10-08
2362,서울,은평구,2,0,2,4,2,0,2018-11-08
2363,서울,은평구,5,0,2,7,4,0,2018-12-08
2364,서울,종로구,1,1,1,3,3,0,2018-01-08
2365,서울,종로구,2,3,1,6,4,0,2018-02-08
2366,서울,종로구,4,1,0,5,4,0,2018-03-08
2367,서울,종로구,0,1,2,3,2,0,2018-04-08
2368,서울,종로구,2,0,1,3,3,0,2018-05-08
2369,서울,종로구,3,0,0,3,3,0,2018-06-08
2370,서울,종로구,0,0,0,0,0,0,2018-07-08
2371,서울,종로구,0,1,1,2,2,0,2018-08-08
2372,서울,종로구,3,0,0,3,1,0,2018-09-08
2373,서울,종로구,2,0,1,3,3,0,2018-10-08
2374,서울,종로구,7,1,0,8,4,0,2018-11-08
2375,서울,종로구,2,1,1,4,3,0,2018-12-08
2376,서울,중구,4,0,0,4,3,0,2018-01-08
2377,서울,중구,3,1,1,5,5,0,2018-02-08
2378,서울,중구,2,0,1,3,2,0,2018-03-08
2379,서울,중구,2,0,0,2,1,0,2018-04-08
2380,서울,중구,3,4,2,9,6,0,2018-05-08
2381,서울,중구,7,1,2,10,5,0,2018-06-08
2382,서울,중구,0,0,1,1,1,0,2018-07-08
2383,서울,중구,2,1,8,11,5,0,2018-08-08
2384,서울,중구,4,2,1,7,6,0,2018-09-08
2385,서울,중구,1,0,1,2,2,0,2018-10-08
2386,서울,중구,4,0,0,4,4,0,2018-11-08
2387,서울,중구,1,4,4,9,7,0,2018-12-08
2388,서울,중랑구,2,0,1,3,3,0,2018-01-08
2389,서울,중랑구,5,0,1,6,5,0,2018-02-08
2390,서울,중랑구,3,1,0,4,5,1,2018-03-08
2391,서울,중랑구,3,0,0,3,3,0,2018-04-08
2392,서울,중랑구,5,0,2,7,4,0,2018-05-08
2393,서울,중랑구,3,1,3,7,6,0,2018-06-08
2394,서울,중랑구,7,0,2,9,7,0,2018-07-08
2395,서울,중랑구,1,2,3,6,5,0,2018-08-08
2396,서울,중랑구,2,1,2,5,4,0,2018-09-08
2397,서울,중랑구,7,2,3,12,7,0,2018-10-08
2398,서울,중랑구,2,1,5,8,6,0,2018-11-08
2399,서울,중랑구,6,0,0,6,6,0,2018-12-08
2400,서울,강남구,7,0,1,8,8,0,2018-01-09
2401,서울,강남구,19,2,1,22,18,0,2018-02-09
2402,서울,강남구,12,2,1,15,11,0,2018-03-09
2403,서울,강남구,4,2,1,7,5,0,2018-04-09
2404,서울,강남구,9,1,1,11,9,0,2018-05-09
2405,서울,강남구,22,1,3,26,12,0,2018-06-09
2406,서울,강남구,12,0,7,19,15,0,2018-07-09
2407,서울,강남구,15,3,5,23,18,0,2018-08-09
2408,서울,강남구,6,1,0,7,5,0,2018-09-09
2409,서울,강남구,2,0,3,5,4,0,2018-10-09
2410,서울,강남구,19,3,1,23,18,0,2018-11-09
2411,서울,강남구,24,0,1,25,9,0,2018-12-09
2412,서울,강동구,1,0,1,2,2,0,2018-01-09
2413,서울,강동구,2,0,6,8,3,0,2018-02-09
2414,서울,강동구,3,0,1,4,3,0,2018-03-09
2415,서울,강동구,2,0,3,5,4,0,2018-04-09
2416,서울,강동구,4,0,1,5,5,1,2018-05-09
2417,서울,강동구,8,0,1,9,4,0,2018-06-09
2418,서울,강동구,5,1,5,11,9,0,2018-07-09
2419,서울,강동구,2,0,0,2,2,0,2018-08-09
2420,서울,강동구,0,0,0,0,0,0,2018-09-09
2421,서울,강동구,7,1,0,8,3,0,2018-10-09
2422,서울,강동구,3,0,1,4,4,0,2018-11-09
2423,서울,강동구,7,0,2,9,5,0,2018-12-09
2424,서울,강북구,3,0,0,3,3,0,2018-01-09
2425,서울,강북구,3,1,0,4,2,0,2018-02-09
2426,서울,강북구,1,0,2,3,2,0,2018-03-09
2427,서울,강북구,0,0,0,0,0,0,2018-04-09
2428,서울,강북구,2,0,3,5,5,0,2018-05-09
2429,서울,강북구,1,0,1,2,1,0,2018-06-09
2430,서울,강북구,6,0,0,6,6,1,2018-07-09
2431,서울,강북구,4,0,1,5,4,0,2018-08-09
2432,서울,강북구,7,0,3,10,7,0,2018-09-09
2433,서울,강북구,1,0,2,3,3,0,2018-10-09
2434,서울,강북구,4,0,0,4,3,0,2018-11-09
2435,서울,강북구,3,1,1,5,2,0,2018-12-09
2436,서울,강서구,10,0,5,15,8,0,2018-01-09
2437,서울,강서구,4,0,2,6,6,0,2018-02-09
2438,서울,강서구,1,0,0,1,1,0,2018-03-09
2439,서울,강서구,2,0,0,2,1,0,2018-04-09
2440,서울,강서구,4,0,2,6,5,0,2018-05-09
2441,서울,강서구,8,5,4,17,7,0,2018-06-09
2442,서울,강서구,5,0,1,6,3,0,2018-07-09
2443,서울,강서구,2,2,1,5,3,0,2018-08-09
2444,서울,강서구,4,1,0,5,3,0,2018-09-09
2445,서울,강서구,3,0,1,4,2,0,2018-10-09
2446,서울,강서구,6,0,1,7,4,0,2018-11-09
2447,서울,강서구,7,1,0,8,4,0,2018-12-09
2448,서울,관악구,2,0,0,2,2,0,2018-01-09
2449,서울,관악구,7,0,2,9,5,0,2018-02-09
2450,서울,관악구,2,0,3,5,4,0,2018-03-09
2451,서울,관악구,8,0,0,8,6,0,2018-04-09
2452,서울,관악구,9,0,4,13,10,0,2018-05-09
2453,서울,관악구,8,2,3,13,12,0,2018-06-09
2454,서울,관악구,0,1,0,1,1,0,2018-07-09
2455,서울,관악구,3,0,1,4,3,1,2018-08-09
2456,서울,관악구,5,1,0,6,5,0,2018-09-09
2457,서울,관악구,4,0,0,4,1,0,2018-10-09
2458,서울,관악구,1,0,0,1,1,0,2018-11-09
2459,서울,관악구,4,1,1,6,4,0,2018-12-09
2460,서울,광진구,1,0,0,1,1,0,2018-01-09
2461,서울,광진구,6,0,2,8,7,0,2018-02-09
2462,서울,광진구,2,0,1,3,3,0,2018-03-09
2463,서울,광진구,1,1,3,5,4,0,2018-04-09
2464,서울,광진구,1,0,1,2,2,0,2018-05-09
2465,서울,광진구,4,1,1,6,5,0,2018-06-09
2466,서울,광진구,3,0,0,3,2,0,2018-07-09
2467,서울,광진구,1,0,1,2,2,0,2018-08-09
2468,서울,광진구,3,0,0,3,1,0,2018-09-09
2469,서울,광진구,6,0,0,6,4,0,2018-10-09
2470,서울,광진구,4,1,2,7,5,0,2018-11-09
2471,서울,광진구,7,0,1,8,3,0,2018-12-09
2472,서울,구로구,5,1,1,7,5,0,2018-01-09
2473,서울,구로구,6,1,4,11,4,0,2018-02-09
2474,서울,구로구,9,0,1,10,6,0,2018-03-09
2475,서울,구로구,11,2,3,16,8,0,2018-04-09
2476,서울,구로구,4,0,1,5,5,0,2018-05-09
2477,서울,구로구,3,1,0,4,4,0,2018-06-09
2478,서울,구로구,6,1,6,13,9,0,2018-07-09
2479,서울,구로구,1,1,1,3,2,0,2018-08-09
2480,서울,구로구,9,0,3,12,8,0,2018-09-09
2481,서울,구로구,4,2,1,7,6,0,2018-10-09
2482,서울,구로구,5,2,0,7,5,0,2018-11-09
2483,서울,구로구,4,0,1,5,4,0,2018-12-09
2484,서울,금천구,7,0,3,10,4,0,2018-01-09
2485,서울,금천구,5,0,2,7,5,0,2018-02-09
2486,서울,금천구,2,0,0,2,2,0,2018-03-09
2487,서울,금천구,2,0,1,3,3,0,2018-04-09
2488,서울,금천구,2,1,1,4,4,0,2018-05-09
2489,서울,금천구,1,0,1,2,2,0,2018-06-09
2490,서울,금천구,2,0,1,3,4,1,2018-07-09
2491,서울,금천구,3,0,1,4,3,0,2018-08-09
2492,서울,금천구,2,0,0,2,2,0,2018-09-09
2493,서울,금천구,4,0,0,4,3,0,2018-10-09
2494,서울,금천구,3,0,0,3,3,0,2018-11-09
2495,서울,금천구,1,0,1,2,2,0,2018-12-09
2496,서울,노원구,8,0,3,11,10,0,2018-01-09
2497,서울,노원구,1,1,1,3,3,0,2018-02-09
2498,서울,노원구,4,1,0,5,3,0,2018-03-09
2499,서울,노원구,6,0,0,6,6,0,2018-04-09
2500,서울,노원구,5,0,2,7,6,0,2018-05-09
2501,서울,노원구,2,0,2,4,4,1,2018-06-09
2502,서울,노원구,6,0,1,7,3,0,2018-07-09
2503,서울,노원구,5,2,1,8,6,0,2018-08-09
2504,서울,노원구,4,0,1,5,4,0,2018-09-09
2505,서울,노원구,9,3,0,12,6,0,2018-10-09
2506,서울,노원구,10,1,1,12,8,0,2018-11-09
2507,서울,노원구,3,1,3,7,6,0,2018-12-09
2508,서울,도봉구,2,0,0,2,1,0,2018-01-09
2509,서울,도봉구,2,0,2,4,4,0,2018-02-09
2510,서울,도봉구,1,0,0,1,1,0,2018-03-09
2511,서울,도봉구,3,0,0,3,2,0,2018-04-09
2512,서울,도봉구,2,1,0,3,4,1,2018-05-09
2513,서울,도봉구,2,0,2,4,2,0,2018-06-09
2514,서울,도봉구,0,0,0,0,0,0,2018-07-09
2515,서울,도봉구,4,1,1,6,4,0,2018-08-09
2516,서울,도봉구,1,0,0,1,1,0,2018-09-09
2517,서울,도봉구,9,0,1,10,4,0,2018-10-09
2518,서울,도봉구,1,1,1,3,3,0,2018-11-09
2519,서울,도봉구,0,0,1,1,1,0,2018-12-09
2520,서울,동대문구,2,0,0,2,2,0,2018-01-09
2521,서울,동대문구,2,0,2,4,4,0,2018-02-09
2522,서울,동대문구,2,0,2,4,4,0,2018-03-09
2523,서울,동대문구,0,0,3,3,3,0,2018-04-09
2524,서울,동대문구,2,1,1,4,4,0,2018-05-09
2525,서울,동대문구,5,2,1,8,5,0,2018-06-09
2526,서울,동대문구,1,0,1,2,2,0,2018-07-09
2527,서울,동대문구,14,0,5,19,8,0,2018-08-09
2528,서울,동대문구,2,2,0,4,3,0,2018-09-09
2529,서울,동대문구,5,0,0,5,5,1,2018-10-09
2530,서울,동대문구,5,0,1,6,5,0,2018-11-09
2531,서울,동대문구,0,0,1,1,1,0,2018-12-09
2532,서울,동작구,1,0,1,2,2,0,2018-01-09
2533,서울,동작구,4,0,2,6,4,0,2018-02-09
2534,서울,동작구,3,2,0,5,4,0,2018-03-09
2535,서울,동작구,6,0,1,7,6,0,2018-04-09
2536,서울,동작구,5,0,1,6,5,0,2018-05-09
2537,서울,동작구,0,0,0,0,0,0,2018-06-09
2538,서울,동작구,0,0,0,0,0,0,2018-07-09
2539,서울,동작구,3,0,2,5,3,0,2018-08-09
2540,서울,동작구,4,1,1,6,4,0,2018-09-09
2541,서울,동작구,2,1,0,3,2,0,2018-10-09
2542,서울,동작구,8,0,0,8,6,0,2018-11-09
2543,서울,동작구,5,0,0,5,1,0,2018-12-09
2544,서울,마포구,2,1,1,4,3,0,2018-01-09
2545,서울,마포구,9,1,3,13,9,0,2018-02-09
2546,서울,마포구,0,0,0,0,1,1,2018-03-09
2547,서울,마포구,3,0,0,3,3,0,2018-04-09
2548,서울,마포구,7,0,1,8,7,0,2018-05-09
2549,서울,마포구,8,0,1,9,5,0,2018-06-09
2550,서울,마포구,1,0,1,2,2,0,2018-07-09
2551,서울,마포구,6,1,0,7,5,0,2018-08-09
2552,서울,마포구,3,1,0,4,3,0,2018-09-09
2553,서울,마포구,0,1,2,3,4,1,2018-10-09
2554,서울,마포구,9,0,0,9,7,0,2018-11-09
2555,서울,마포구,3,0,2,5,2,0,2018-12-09
2556,서울,서대문구,0,0,1,1,1,0,2018-01-09
2557,서울,서대문구,5,0,3,8,4,0,2018-02-09
2558,서울,서대문구,2,0,0,2,2,0,2018-03-09
2559,서울,서대문구,3,1,2,6,6,0,2018-04-09
2560,서울,서대문구,0,0,1,1,1,0,2018-05-09
2561,서울,서대문구,6,0,5,11,9,0,2018-06-09
2562,서울,서대문구,3,0,2,5,4,0,2018-07-09
2563,서울,서대문구,0,0,1,1,1,0,2018-08-09
2564,서울,서대문구,2,0,0,2,2,0,2018-09-09
2565,서울,서대문구,2,0,2,4,3,0,2018-10-09
2566,서울,서대문구,2,2,0,4,4,0,2018-11-09
2567,서울,서대문구,6,1,1,8,5,0,2018-12-09
2568,서울,서초구,4,0,3,7,7,0,2018-01-09
2569,서울,서초구,9,2,2,13,11,0,2018-02-09
2570,서울,서초구,7,2,1,10,8,0,2018-03-09
2571,서울,서초구,3,2,1,6,4,0,2018-04-09
2572,서울,서초구,4,1,3,8,6,0,2018-05-09
2573,서울,서초구,4,1,0,5,4,0,2018-06-09
2574,서울,서초구,1,1,1,3,3,0,2018-07-09
2575,서울,서초구,16,0,0,16,10,1,2018-08-09
2576,서울,서초구,3,0,1,4,3,0,2018-09-09
2577,서울,서초구,1,0,1,2,2,0,2018-10-09
2578,서울,서초구,14,2,4,20,13,0,2018-11-09
2579,서울,서초구,7,0,0,7,3,0,2018-12-09
2580,서울,성동구,0,0,0,0,1,1,2018-01-09
2581,서울,성동구,3,0,3,6,4,0,2018-02-09
2582,서울,성동구,1,0,0,1,1,0,2018-03-09
2583,서울,성동구,3,0,0,3,3,0,2018-04-09
2584,서울,성동구,2,0,0,2,2,0,2018-05-09
2585,서울,성동구,3,0,1,4,2,0,2018-06-09
2586,서울,성동구,1,0,1,2,2,0,2018-07-09
2587,서울,성동구,5,0,2,7,6,0,2018-08-09
2588,서울,성동구,4,0,2,6,5,0,2018-09-09
2589,서울,성동구,2,1,1,4,3,0,2018-10-09
2590,서울,성동구,7,0,3,10,6,0,2018-11-09
2591,서울,성동구,0,0,1,1,1,0,2018-12-09
2592,서울,성북구,3,0,0,3,2,0,2018-01-09
2593,서울,성북구,8,0,0,8,6,0,2018-02-09
2594,서울,성북구,4,0,3,7,6,0,2018-03-09
2595,서울,성북구,2,0,1,3,3,0,2018-04-09
2596,서울,성북구,2,0,3,5,4,0,2018-05-09
2597,서울,성북구,4,0,0,4,4,0,2018-06-09
2598,서울,성북구,2,0,2,4,3,0,2018-07-09
2599,서울,성북구,5,1,1,7,4,0,2018-08-09
2600,서울,성북구,3,0,2,5,4,0,2018-09-09
2601,서울,성북구,4,0,0,4,3,0,2018-10-09
2602,서울,성북구,4,0,2,6,6,0,2018-11-09
2603,서울,성북구,3,0,1,4,3,0,2018-12-09
2604,서울,송파구,2,2,0,4,4,0,2018-01-09
2605,서울,송파구,9,4,3,16,11,0,2018-02-09
2606,서울,송파구,4,0,0,4,3,0,2018-03-09
2607,서울,송파구,11,0,2,13,8,0,2018-04-09
2608,서울,송파구,1,3,7,11,8,0,2018-05-09
2609,서울,송파구,7,1,2,10,9,0,2018-06-09
2610,서울,송파구,5,1,3,9,7,0,2018-07-09
2611,서울,송파구,9,1,0,10,7,0,2018-08-09
2612,서울,송파구,4,2,2,8,5,0,2018-09-09
2613,서울,송파구,5,1,1,7,6,0,2018-10-09
2614,서울,송파구,7,1,1,9,8,0,2018-11-09
2615,서울,송파구,0,0,1,1,1,0,2018-12-09
2616,서울,양천구,3,0,0,3,2,0,2018-01-09
2617,서울,양천구,4,0,3,7,4,0,2018-02-09
2618,서울,양천구,2,0,2,4,4,0,2018-03-09
2619,서울,양천구,3,0,0,3,3,0,2018-04-09
2620,서울,양천구,10,1,2,13,8,0,2018-05-09
2621,서울,양천구,6,0,4,10,4,0,2018-06-09
2622,서울,양천구,3,0,1,4,3,0,2018-07-09
2623,서울,양천구,3,3,0,6,4,0,2018-08-09
2624,서울,양천구,0,0,0,0,0,0,2018-09-09
2625,서울,양천구,1,0,2,3,3,1,2018-10-09
2626,서울,양천구,4,1,0,5,3,0,2018-11-09
2627,서울,양천구,0,0,0,0,0,0,2018-12-09
2628,서울,영등포구,6,1,1,8,7,0,2018-01-09
2629,서울,영등포구,3,1,4,8,7,0,2018-02-09
2630,서울,영등포구,10,0,1,11,5,0,2018-03-09
2631,서울,영등포구,9,0,0,9,6,0,2018-04-09
2632,서울,영등포구,8,2,2,12,9,0,2018-05-09
2633,서울,영등포구,8,2,5,15,11,0,2018-06-09
2634,서울,영등포구,6,0,1,7,5,0,2018-07-09
2635,서울,영등포구,4,1,2,7,8,2,2018-08-09
2636,서울,영등포구,10,2,3,15,10,0,2018-09-09
2637,서울,영등포구,4,0,0,4,3,0,2018-10-09
2638,서울,영등포구,5,0,3,8,6,0,2018-11-09
2639,서울,영등포구,3,2,2,7,5,0,2018-12-09
2640,서울,용산구,1,1,2,4,4,0,2018-01-09
2641,서울,용산구,2,0,3,5,4,1,2018-02-09
2642,서울,용산구,5,3,0,8,2,0,2018-03-09
2643,서울,용산구,4,0,2,6,5,0,2018-04-09
2644,서울,용산구,2,0,2,4,4,0,2018-05-09
2645,서울,용산구,7,1,1,9,7,2,2018-06-09
2646,서울,용산구,1,0,1,2,2,0,2018-07-09
2647,서울,용산구,3,0,2,5,4,0,2018-08-09
2648,서울,용산구,1,0,1,2,2,0,2018-09-09
2649,서울,용산구,7,0,1,8,5,0,2018-10-09
2650,서울,용산구,4,1,0,5,5,0,2018-11-09
2651,서울,용산구,1,0,1,2,2,0,2018-12-09
2652,서울,은평구,11,1,3,15,6,0,2018-01-09
2653,서울,은평구,2,0,1,3,2,0,2018-02-09
2654,서울,은평구,2,0,0,2,2,0,2018-03-09
2655,서울,은평구,7,0,1,8,4,0,2018-04-09
2656,서울,은평구,4,0,0,4,3,0,2018-05-09
2657,서울,은평구,2,0,1,3,3,0,2018-06-09
2658,서울,은평구,6,1,1,8,5,0,2018-07-09
2659,서울,은평구,2,1,0,3,3,0,2018-08-09
2660,서울,은평구,4,0,2,6,5,1,2018-09-09
2661,서울,은평구,0,0,3,3,3,1,2018-10-09
2662,서울,은평구,0,0,0,0,0,0,2018-11-09
2663,서울,은평구,0,0,1,1,1,0,2018-12-09
2664,서울,종로구,4,1,0,5,4,0,2018-01-09
2665,서울,종로구,2,1,0,3,3,0,2018-02-09
2666,서울,종로구,0,0,3,3,3,0,2018-03-09
2667,서울,종로구,5,1,1,7,5,0,2018-04-09
2668,서울,종로구,10,1,0,11,7,0,2018-05-09
2669,서울,종로구,1,1,2,4,3,0,2018-06-09
2670,서울,종로구,3,1,1,5,3,0,2018-07-09
2671,서울,종로구,8,0,1,9,5,0,2018-08-09
2672,서울,종로구,8,0,1,9,5,0,2018-09-09
2673,서울,종로구,2,0,0,2,2,0,2018-10-09
2674,서울,종로구,2,2,0,4,3,0,2018-11-09
2675,서울,종로구,1,0,0,1,1,0,2018-12-09
2676,서울,중구,5,2,4,11,7,0,2018-01-09
2677,서울,중구,2,0,1,3,3,0,2018-02-09
2678,서울,중구,4,1,1,6,4,0,2018-03-09
2679,서울,중구,5,0,1,6,5,0,2018-04-09
2680,서울,중구,2,2,2,6,5,0,2018-05-09
2681,서울,중구,4,1,0,5,4,0,2018-06-09
2682,서울,중구,3,0,2,5,4,0,2018-07-09
2683,서울,중구,4,0,1,5,3,0,2018-08-09
2684,서울,중구,3,0,1,4,3,0,2018-09-09
2685,서울,중구,1,1,1,3,3,0,2018-10-09
2686,서울,중구,4,1,3,8,6,0,2018-11-09
2687,서울,중구,2,0,0,2,2,0,2018-12-09
2688,서울,중랑구,8,0,0,8,4,0,2018-01-09
2689,서울,중랑구,13,0,0,13,7,0,2018-02-09
2690,서울,중랑구,2,0,0,2,2,0,2018-03-09
2691,서울,중랑구,4,0,4,8,8,0,2018-04-09
2692,서울,중랑구,2,1,2,5,3,0,2018-05-09
2693,서울,중랑구,6,1,2,9,7,0,2018-06-09
2694,서울,중랑구,1,0,0,1,1,0,2018-07-09
2695,서울,중랑구,5,2,2,9,5,0,2018-08-09
2696,서울,중랑구,2,2,0,4,4,0,2018-09-09
2697,서울,중랑구,3,0,3,6,5,0,2018-10-09
2698,서울,중랑구,3,0,0,3,3,0,2018-11-09
2699,서울,중랑구,6,1,0,7,2,0,2018-12-09
2700,서울,강남구,17,1,4,22,16,0,2018-01-10
2701,서울,강남구,9,1,7,17,11,0,2018-02-10
2702,서울,강남구,9,0,3,12,9,0,2018-03-10
2703,서울,강남구,4,0,3,7,5,0,2018-04-10
2704,서울,강남구,14,2,2,18,14,0,2018-05-10
2705,서울,강남구,12,0,3,15,10,0,2018-06-10
2706,서울,강남구,11,1,2,14,10,0,2018-07-10
2707,서울,강남구,5,0,4,9,9,0,2018-08-10
2708,서울,강남구,10,0,0,10,6,0,2018-09-10
2709,서울,강남구,12,0,1,13,11,0,2018-10-10
2710,서울,강남구,10,1,0,11,6,0,2018-11-10
2711,서울,강남구,9,1,1,11,10,0,2018-12-10
2712,서울,강동구,1,0,1,2,2,0,2018-01-10
2713,서울,강동구,6,0,2,8,6,0,2018-02-10
2714,서울,강동구,12,0,3,15,8,0,2018-03-10
2715,서울,강동구,3,1,2,6,5,0,2018-04-10
2716,서울,강동구,4,1,3,8,7,0,2018-05-10
2717,서울,강동구,0,2,1,3,3,0,2018-06-10
2718,서울,강동구,2,0,1,3,3,0,2018-07-10
2719,서울,강동구,1,0,2,3,3,0,2018-08-10
2720,서울,강동구,1,0,0,1,1,0,2018-09-10
2721,서울,강동구,1,0,3,4,3,0,2018-10-10
2722,서울,강동구,0,2,2,4,3,0,2018-11-10
2723,서울,강동구,1,0,2,3,2,0,2018-12-10
2724,서울,강북구,2,0,2,4,4,0,2018-01-10
2725,서울,강북구,1,0,3,4,3,0,2018-02-10
2726,서울,강북구,11,0,2,13,6,0,2018-03-10
2727,서울,강북구,2,0,0,2,3,1,2018-04-10
2728,서울,강북구,5,0,1,6,5,0,2018-05-10
2729,서울,강북구,5,0,1,6,4,0,2018-06-10
2730,서울,강북구,2,0,4,6,5,0,2018-07-10
2731,서울,강북구,2,0,1,3,3,0,2018-08-10
2732,서울,강북구,5,0,3,8,5,0,2018-09-10
2733,서울,강북구,3,0,2,5,3,0,2018-10-10
2734,서울,강북구,4,0,1,5,5,0,2018-11-10
2735,서울,강북구,6,0,0,6,4,0,2018-12-10
2736,서울,강서구,6,0,0,6,5,0,2018-01-10
2737,서울,강서구,1,0,3,4,4,0,2018-02-10
2738,서울,강서구,3,1,0,4,4,0,2018-03-10
2739,서울,강서구,4,0,1,5,4,0,2018-04-10
2740,서울,강서구,1,0,0,1,1,0,2018-05-10
2741,서울,강서구,0,1,0,1,1,0,2018-06-10
2742,서울,강서구,5,0,0,5,4,0,2018-07-10
2743,서울,강서구,0,2,2,4,4,0,2018-08-10
2744,서울,강서구,3,1,2,6,5,0,2018-09-10
2745,서울,강서구,3,1,1,5,5,0,2018-10-10
2746,서울,강서구,7,1,0,8,5,0,2018-11-10
2747,서울,강서구,7,2,0,9,6,0,2018-12-10
2748,서울,관악구,2,1,0,3,3,0,2018-01-10
2749,서울,관악구,3,1,0,4,4,0,2018-02-10
2750,서울,관악구,3,0,0,3,4,1,2018-03-10
2751,서울,관악구,0,0,1,1,1,0,2018-04-10
2752,서울,관악구,1,0,3,4,4,0,2018-05-10
2753,서울,관악구,4,0,3,7,5,0,2018-06-10
2754,서울,관악구,4,0,0,4,3,0,2018-07-10
2755,서울,관악구,6,0,3,9,6,0,2018-08-10
2756,서울,관악구,2,0,3,5,4,0,2018-09-10
2757,서울,관악구,3,0,0,3,1,0,2018-10-10
2758,서울,관악구,5,3,1,9,7,0,2018-11-10
2759,서울,관악구,4,0,1,5,5,0,2018-12-10
2760,서울,광진구,5,0,2,7,6,0,2018-01-10
2761,서울,광진구,7,1,0,8,3,0,2018-02-10
2762,서울,광진구,2,0,0,2,1,0,2018-03-10
2763,서울,광진구,0,0,1,1,1,0,2018-04-10
2764,서울,광진구,2,0,1,3,3,0,2018-05-10
2765,서울,광진구,6,2,2,10,6,0,2018-06-10
2766,서울,광진구,1,0,1,2,2,0,2018-07-10
2767,서울,광진구,3,0,1,4,3,0,2018-08-10
2768,서울,광진구,1,0,0,1,1,0,2018-09-10
2769,서울,광진구,2,0,0,2,2,0,2018-10-10
2770,서울,광진구,3,0,3,6,5,0,2018-11-10
2771,서울,광진구,1,0,1,2,2,0,2018-12-10
2772,서울,구로구,3,0,1,4,4,1,2018-01-10
2773,서울,구로구,3,0,0,3,2,0,2018-02-10
2774,서울,구로구,1,0,0,1,1,0,2018-03-10
2775,서울,구로구,5,1,2,8,6,0,2018-04-10
2776,서울,구로구,6,0,0,6,4,0,2018-05-10
2777,서울,구로구,5,1,1,7,5,0,2018-06-10
2778,서울,구로구,4,0,0,4,3,0,2018-07-10
2779,서울,구로구,2,0,0,2,2,0,2018-08-10
2780,서울,구로구,5,2,3,10,7,0,2018-09-10
2781,서울,구로구,2,0,1,3,2,0,2018-10-10
2782,서울,구로구,4,0,0,4,4,0,2018-11-10
2783,서울,구로구,0,0,2,2,2,0,2018-12-10
2784,서울,금천구,6,0,0,6,3,0,2018-01-10
2785,서울,금천구,3,1,1,5,5,0,2018-02-10
2786,서울,금천구,0,0,1,1,1,0,2018-03-10
2787,서울,금천구,3,0,0,3,2,0,2018-04-10
2788,서울,금천구,4,0,1,5,5,0,2018-05-10
2789,서울,금천구,0,0,0,0,0,0,2018-06-10
2790,서울,금천구,3,1,0,4,4,0,2018-07-10
2791,서울,금천구,1,0,2,3,3,0,2018-08-10
2792,서울,금천구,3,0,0,3,1,0,2018-09-10
2793,서울,금천구,2,0,0,2,2,0,2018-10-10
2794,서울,금천구,1,0,0,1,1,0,2018-11-10
2795,서울,금천구,0,0,0,0,0,0,2018-12-10
2796,서울,노원구,9,0,0,9,9,0,2018-01-10
2797,서울,노원구,1,1,0,2,2,0,2018-02-10
2798,서울,노원구,6,1,1,8,4,0,2018-03-10
2799,서울,노원구,8,0,1,9,5,0,2018-04-10
2800,서울,노원구,0,1,1,2,2,0,2018-05-10
2801,서울,노원구,4,2,0,6,4,0,2018-06-10
2802,서울,노원구,0,0,1,1,1,0,2018-07-10
2803,서울,노원구,4,0,0,4,3,0,2018-08-10
2804,서울,노원구,11,0,1,12,9,0,2018-09-10
2805,서울,노원구,2,0,1,3,3,0,2018-10-10
2806,서울,노원구,8,2,0,10,6,0,2018-11-10
2807,서울,노원구,8,0,0,8,6,0,2018-12-10
2808,서울,도봉구,5,0,1,6,6,0,2018-01-10
2809,서울,도봉구,0,1,0,1,1,0,2018-02-10
2810,서울,도봉구,2,0,0,2,2,0,2018-03-10
2811,서울,도봉구,1,0,0,1,1,0,2018-04-10
2812,서울,도봉구,2,2,0,4,4,0,2018-05-10
2813,서울,도봉구,0,0,0,0,0,0,2018-06-10
2814,서울,도봉구,5,1,1,7,3,0,2018-07-10
2815,서울,도봉구,2,0,0,2,2,0,2018-08-10
2816,서울,도봉구,1,1,2,4,3,0,2018-09-10
2817,서울,도봉구,2,0,2,4,4,0,2018-10-10
2818,서울,도봉구,2,0,0,2,2,0,2018-11-10
2819,서울,도봉구,3,0,1,4,3,0,2018-12-10
2820,서울,동대문구,8,0,6,14,7,0,2018-01-10
2821,서울,동대문구,5,0,0,5,3,0,2018-02-10
2822,서울,동대문구,5,0,4,9,4,0,2018-03-10
2823,서울,동대문구,2,0,2,4,3,0,2018-04-10
2824,서울,동대문구,4,2,3,9,6,0,2018-05-10
2825,서울,동대문구,5,1,4,10,6,0,2018-06-10
2826,서울,동대문구,7,0,0,7,6,0,2018-07-10
2827,서울,동대문구,3,0,3,6,4,0,2018-08-10
2828,서울,동대문구,4,0,4,8,8,0,2018-09-10
2829,서울,동대문구,6,1,1,8,6,0,2018-10-10
2830,서울,동대문구,4,0,0,4,3,0,2018-11-10
2831,서울,동대문구,3,0,2,5,5,0,2018-12-10
2832,서울,동작구,3,0,0,3,2,0,2018-01-10
2833,서울,동작구,7,0,2,9,8,0,2018-02-10
2834,서울,동작구,9,0,3,12,8,0,2018-03-10
2835,서울,동작구,3,0,0,3,3,0,2018-04-10
2836,서울,동작구,8,1,1,10,6,0,2018-05-10
2837,서울,동작구,0,0,0,0,0,0,2018-06-10
2838,서울,동작구,1,0,1,2,2,0,2018-07-10
2839,서울,동작구,4,0,1,5,5,0,2018-08-10
2840,서울,동작구,9,2,1,12,8,0,2018-09-10
2841,서울,동작구,0,0,0,0,0,0,2018-10-10
2842,서울,동작구,7,2,2,11,5,0,2018-11-10
2843,서울,동작구,7,1,1,9,6,0,2018-12-10
2844,서울,마포구,4,0,2,6,5,0,2018-01-10
2845,서울,마포구,2,0,0,2,2,0,2018-02-10
2846,서울,마포구,13,0,2,15,9,0,2018-03-10
2847,서울,마포구,2,2,1,5,4,1,2018-04-10
2848,서울,마포구,1,1,1,3,3,0,2018-05-10
2849,서울,마포구,4,0,2,6,3,0,2018-06-10
2850,서울,마포구,2,0,0,2,2,0,2018-07-10
2851,서울,마포구,3,2,1,6,4,0,2018-08-10
2852,서울,마포구,5,1,1,7,6,0,2018-09-10
2853,서울,마포구,4,0,1,5,3,0,2018-10-10
2854,서울,마포구,6,7,1,14,7,0,2018-11-10
2855,서울,마포구,4,2,1,7,5,0,2018-12-10
2856,서울,서대문구,6,0,1,7,4,0,2018-01-10
2857,서울,서대문구,1,0,1,2,2,0,2018-02-10
2858,서울,서대문구,1,0,2,3,3,0,2018-03-10
2859,서울,서대문구,2,1,5,8,6,0,2018-04-10
2860,서울,서대문구,8,3,2,13,5,0,2018-05-10
2861,서울,서대문구,1,1,1,3,1,0,2018-06-10
2862,서울,서대문구,1,0,1,2,2,0,2018-07-10
2863,서울,서대문구,2,0,0,2,2,0,2018-08-10
2864,서울,서대문구,6,2,6,14,9,0,2018-09-10
2865,서울,서대문구,1,2,2,5,5,0,2018-10-10
2866,서울,서대문구,3,0,0,3,3,0,2018-11-10
2867,서울,서대문구,4,0,1,5,5,0,2018-12-10
2868,서울,서초구,7,0,0,7,5,0,2018-01-10
2869,서울,서초구,6,2,0,8,6,0,2018-02-10
2870,서울,서초구,6,2,2,10,6,0,2018-03-10
2871,서울,서초구,3,2,1,6,6,0,2018-04-10
2872,서울,서초구,2,0,0,2,2,0,2018-05-10
2873,서울,서초구,5,0,2,7,5,0,2018-06-10
2874,서울,서초구,4,1,1,6,5,0,2018-07-10
2875,서울,서초구,11,0,4,15,9,0,2018-08-10
2876,서울,서초구,9,0,1,10,10,0,2018-09-10
2877,서울,서초구,8,2,2,12,6,0,2018-10-10
2878,서울,서초구,14,0,0,14,8,0,2018-11-10
2879,서울,서초구,5,0,1,6,5,0,2018-12-10
2880,서울,성동구,10,4,0,14,9,0,2018-01-10
2881,서울,성동구,1,0,0,1,1,0,2018-02-10
2882,서울,성동구,1,0,0,1,1,0,2018-03-10
2883,서울,성동구,2,0,1,3,3,0,2018-04-10
2884,서울,성동구,6,2,1,9,5,0,2018-05-10
2885,서울,성동구,8,0,2,10,5,0,2018-06-10
2886,서울,성동구,2,0,1,3,2,0,2018-07-10
2887,서울,성동구,2,0,0,2,2,0,2018-08-10
2888,서울,성동구,8,0,2,10,7,0,2018-09-10
2889,서울,성동구,1,0,1,2,2,0,2018-10-10
2890,서울,성동구,4,0,1,5,2,0,2018-11-10
2891,서울,성동구,4,0,0,4,2,0,2018-12-10
2892,서울,성북구,10,1,1,12,10,0,2018-01-10
2893,서울,성북구,2,0,0,2,2,0,2018-02-10
2894,서울,성북구,3,0,0,3,3,1,2018-03-10
2895,서울,성북구,4,0,1,5,5,0,2018-04-10
2896,서울,성북구,6,0,1,7,5,0,2018-05-10
2897,서울,성북구,4,1,2,7,5,0,2018-06-10
2898,서울,성북구,1,0,2,3,3,0,2018-07-10
2899,서울,성북구,7,0,1,8,5,0,2018-08-10
2900,서울,성북구,3,2,2,7,4,0,2018-09-10
2901,서울,성북구,0,0,0,0,0,0,2018-10-10
2902,서울,성북구,4,0,1,5,4,0,2018-11-10
2903,서울,성북구,2,0,1,3,3,0,2018-12-10
2904,서울,송파구,11,3,2,16,9,0,2018-01-10
2905,서울,송파구,8,1,1,10,8,0,2018-02-10
2906,서울,송파구,9,3,3,15,9,1,2018-03-10
2907,서울,송파구,12,2,8,22,18,0,2018-04-10
2908,서울,송파구,16,2,3,21,14,0,2018-05-10
2909,서울,송파구,7,3,4,14,8,0,2018-06-10
2910,서울,송파구,8,2,0,10,9,0,2018-07-10
2911,서울,송파구,7,1,2,10,9,0,2018-08-10
2912,서울,송파구,3,1,2,6,6,0,2018-09-10
2913,서울,송파구,5,1,1,7,6,0,2018-10-10
2914,서울,송파구,4,0,3,7,6,0,2018-11-10
2915,서울,송파구,6,0,2,8,8,0,2018-12-10
2916,서울,양천구,5,0,2,7,7,0,2018-01-10
2917,서울,양천구,5,0,1,6,4,0,2018-02-10
2918,서울,양천구,2,0,3,5,4,0,2018-03-10
2919,서울,양천구,1,1,2,4,4,0,2018-04-10
2920,서울,양천구,5,0,0,5,4,0,2018-05-10
2921,서울,양천구,4,0,0,4,3,0,2018-06-10
2922,서울,양천구,3,0,0,3,3,0,2018-07-10
2923,서울,양천구,4,1,1,6,4,0,2018-08-10
2924,서울,양천구,6,1,0,7,6,0,2018-09-10
2925,서울,양천구,5,0,1,6,5,0,2018-10-10
2926,서울,양천구,5,1,2,8,6,0,2018-11-10
2927,서울,양천구,3,0,0,3,3,0,2018-12-10
2928,서울,영등포구,4,0,3,7,3,0,2018-01-10
2929,서울,영등포구,3,2,1,6,4,0,2018-02-10
2930,서울,영등포구,11,0,0,11,6,0,2018-03-10
2931,서울,영등포구,9,0,2,11,8,0,2018-04-10
2932,서울,영등포구,8,1,1,10,6,0,2018-05-10
2933,서울,영등포구,3,1,6,10,5,0,2018-06-10
2934,서울,영등포구,9,0,1,10,9,0,2018-07-10
2935,서울,영등포구,8,0,4,12,9,0,2018-08-10
2936,서울,영등포구,7,0,1,8,8,0,2018-09-10
2937,서울,영등포구,3,0,1,4,4,0,2018-10-10
2938,서울,영등포구,14,1,2,17,8,0,2018-11-10
2939,서울,영등포구,2,1,1,4,4,0,2018-12-10
2940,서울,용산구,11,0,3,14,9,0,2018-01-10
2941,서울,용산구,4,0,1,5,4,0,2018-02-10
2942,서울,용산구,4,2,0,6,2,0,2018-03-10
2943,서울,용산구,4,0,0,4,3,0,2018-04-10
2944,서울,용산구,4,0,2,6,5,0,2018-05-10
2945,서울,용산구,2,0,0,2,1,0,2018-06-10
2946,서울,용산구,5,0,1,6,5,0,2018-07-10
2947,서울,용산구,4,0,3,7,7,0,2018-08-10
2948,서울,용산구,4,0,0,4,3,0,2018-09-10
2949,서울,용산구,4,0,0,4,4,0,2018-10-10
2950,서울,용산구,3,0,1,4,3,0,2018-11-10
2951,서울,용산구,3,0,1,4,3,0,2018-12-10
2952,서울,은평구,4,0,1,5,3,0,2018-01-10
2953,서울,은평구,10,0,1,11,6,0,2018-02-10
2954,서울,은평구,3,2,1,6,3,0,2018-03-10
2955,서울,은평구,6,0,0,6,5,0,2018-04-10
2956,서울,은평구,4,0,1,5,4,0,2018-05-10
2957,서울,은평구,1,0,2,3,3,0,2018-06-10
2958,서울,은평구,3,0,0,3,3,0,2018-07-10
2959,서울,은평구,1,0,2,3,3,0,2018-08-10
2960,서울,은평구,2,0,1,3,4,1,2018-09-10
2961,서울,은평구,1,0,3,4,4,0,2018-10-10
2962,서울,은평구,4,1,0,5,4,0,2018-11-10
2963,서울,은평구,10,0,2,12,5,0,2018-12-10
2964,서울,종로구,5,0,2,7,5,0,2018-01-10
2965,서울,종로구,4,0,0,4,3,0,2018-02-10
2966,서울,종로구,2,0,1,3,2,0,2018-03-10
2967,서울,종로구,0,0,0,0,0,0,2018-04-10
2968,서울,종로구,0,0,0,0,0,0,2018-05-10
2969,서울,종로구,3,0,2,5,4,0,2018-06-10
2970,서울,종로구,4,2,0,6,4,0,2018-07-10
2971,서울,종로구,0,0,0,0,0,0,2018-08-10
2972,서울,종로구,11,2,0,13,7,1,2018-09-10
2973,서울,종로구,5,1,0,6,4,0,2018-10-10
2974,서울,종로구,1,0,0,1,1,0,2018-11-10
2975,서울,종로구,2,0,0,2,2,0,2018-12-10
2976,서울,중구,3,2,1,6,6,1,2018-01-10
2977,서울,중구,0,1,0,1,1,0,2018-02-10
2978,서울,중구,6,0,1,7,2,0,2018-03-10
2979,서울,중구,3,1,1,5,3,0,2018-04-10
2980,서울,중구,6,1,0,7,4,0,2018-05-10
2981,서울,중구,2,0,1,3,2,0,2018-06-10
2982,서울,중구,1,0,4,5,2,0,2018-07-10
2983,서울,중구,2,2,0,4,3,0,2018-08-10
2984,서울,중구,6,0,1,7,6,0,2018-09-10
2985,서울,중구,1,0,1,2,2,0,2018-10-10
2986,서울,중구,4,2,1,7,4,0,2018-11-10
2987,서울,중구,3,0,0,3,2,0,2018-12-10
2988,서울,중랑구,3,0,1,4,4,0,2018-01-10
2989,서울,중랑구,3,0,1,4,4,0,2018-02-10
2990,서울,중랑구,8,1,0,9,7,0,2018-03-10
2991,서울,중랑구,6,0,0,6,5,0,2018-04-10
2992,서울,중랑구,2,2,3,7,5,0,2018-05-10
2993,서울,중랑구,2,7,0,9,5,0,2018-06-10
2994,서울,중랑구,1,1,1,3,3,0,2018-07-10
2995,서울,중랑구,2,0,1,3,3,0,2018-08-10
2996,서울,중랑구,1,1,1,3,3,0,2018-09-10
2997,서울,중랑구,1,1,2,4,4,0,2018-10-10
2998,서울,중랑구,1,1,3,5,5,0,2018-11-10
2999,서울,중랑구,2,0,1,3,3,0,2018-12-10
3000,서울,강남구,18,1,12,31,19,0,2018-01-11
3001,서울,강남구,2,0,1,3,3,0,2018-02-11
3002,서울,강남구,5,3,8,16,9,0,2018-03-11
3003,서울,강남구,7,0,2,9,9,0,2018-04-11
3004,서울,강남구,18,4,6,28,10,0,2018-05-11
3005,서울,강남구,6,1,1,8,6,0,2018-06-11
3006,서울,강남구,6,1,2,9,6,0,2018-07-11
3007,서울,강남구,11,1,2,14,9,0,2018-08-11
3008,서울,강남구,6,0,0,6,6,0,2018-09-11
3009,서울,강남구,8,1,2,11,10,0,2018-10-11
3010,서울,강남구,7,0,3,10,7,0,2018-11-11
3011,서울,강남구,8,1,3,12,9,0,2018-12-11
3012,서울,강동구,0,0,1,1,1,0,2018-01-11
3013,서울,강동구,1,0,1,2,2,0,2018-02-11
3014,서울,강동구,0,0,0,0,0,0,2018-03-11
3015,서울,강동구,2,1,1,4,4,0,2018-04-11
3016,서울,강동구,8,0,2,10,6,0,2018-05-11
3017,서울,강동구,4,0,0,4,2,0,2018-06-11
3018,서울,강동구,2,1,0,3,3,0,2018-07-11
3019,서울,강동구,1,0,1,2,2,0,2018-08-11
3020,서울,강동구,4,0,3,7,6,0,2018-09-11
3021,서울,강동구,2,0,0,2,2,0,2018-10-11
3022,서울,강동구,0,0,0,0,0,0,2018-11-11
3023,서울,강동구,1,1,1,3,3,0,2018-12-11
3024,서울,강북구,2,0,0,2,2,0,2018-01-11
3025,서울,강북구,2,1,0,3,3,0,2018-02-11
3026,서울,강북구,3,0,0,3,2,0,2018-03-11
3027,서울,강북구,1,0,2,3,3,0,2018-04-11
3028,서울,강북구,2,0,1,3,3,0,2018-05-11
3029,서울,강북구,3,0,0,3,3,0,2018-06-11
3030,서울,강북구,2,0,0,2,2,0,2018-07-11
3031,서울,강북구,11,1,3,15,7,0,2018-08-11
3032,서울,강북구,3,0,1,4,4,0,2018-09-11
3033,서울,강북구,0,0,3,3,2,0,2018-10-11
3034,서울,강북구,0,0,0,0,0,0,2018-11-11
3035,서울,강북구,4,0,0,4,2,0,2018-12-11
3036,서울,강서구,4,0,1,5,3,0,2018-01-11
3037,서울,강서구,4,1,2,7,5,0,2018-02-11
3038,서울,강서구,7,2,0,9,4,0,2018-03-11
3039,서울,강서구,4,0,2,6,3,0,2018-04-11
3040,서울,강서구,0,1,2,3,1,0,2018-05-11
3041,서울,강서구,5,0,1,6,6,0,2018-06-11
3042,서울,강서구,7,0,0,7,3,0,2018-07-11
3043,서울,강서구,4,1,0,5,3,0,2018-08-11
3044,서울,강서구,4,0,2,6,4,0,2018-09-11
3045,서울,강서구,5,1,1,7,5,0,2018-10-11
3046,서울,강서구,2,0,0,2,2,0,2018-11-11
3047,서울,강서구,5,1,0,6,4,0,2018-12-11
3048,서울,관악구,5,0,0,5,4,0,2018-01-11
3049,서울,관악구,4,0,0,4,3,0,2018-02-11
3050,서울,관악구,3,1,0,4,3,0,2018-03-11
3051,서울,관악구,3,0,1,4,3,0,2018-04-11
3052,서울,관악구,0,0,1,1,1,0,2018-05-11
3053,서울,관악구,4,2,0,6,3,0,2018-06-11
3054,서울,관악구,6,0,0,6,5,0,2018-07-11
3055,서울,관악구,8,0,2,10,7,0,2018-08-11
3056,서울,관악구,2,0,0,2,2,0,2018-09-11
3057,서울,관악구,2,0,0,2,2,0,2018-10-11
3058,서울,관악구,4,1,0,5,2,0,2018-11-11
3059,서울,관악구,4,5,0,9,3,0,2018-12-11
3060,서울,광진구,5,0,2,7,4,0,2018-01-11
3061,서울,광진구,4,0,2,6,6,0,2018-02-11
3062,서울,광진구,1,0,0,1,1,0,2018-03-11
3063,서울,광진구,6,0,0,6,4,0,2018-04-11
3064,서울,광진구,2,0,1,3,3,0,2018-05-11
3065,서울,광진구,2,0,2,4,3,0,2018-06-11
3066,서울,광진구,0,0,0,0,1,1,2018-07-11
3067,서울,광진구,1,2,1,4,3,0,2018-08-11
3068,서울,광진구,2,0,0,2,2,0,2018-09-11
3069,서울,광진구,0,0,1,1,1,0,2018-10-11
3070,서울,광진구,5,0,3,8,3,0,2018-11-11
3071,서울,광진구,3,0,1,4,3,0,2018-12-11
3072,서울,구로구,9,0,2,11,7,0,2018-01-11
3073,서울,구로구,3,0,1,4,3,0,2018-02-11
3074,서울,구로구,4,0,0,4,3,0,2018-03-11
3075,서울,구로구,2,0,0,2,2,0,2018-04-11
3076,서울,구로구,5,1,3,9,7,0,2018-05-11
3077,서울,구로구,4,0,2,6,5,0,2018-06-11
3078,서울,구로구,6,1,2,9,4,0,2018-07-11
3079,서울,구로구,2,0,0,2,2,0,2018-08-11
3080,서울,구로구,8,0,1,9,4,0,2018-09-11
3081,서울,구로구,4,1,2,7,7,0,2018-10-11
3082,서울,구로구,5,0,0,5,2,0,2018-11-11
3083,서울,구로구,4,1,1,6,4,0,2018-12-11
3084,서울,금천구,3,0,0,3,3,0,2018-01-11
3085,서울,금천구,1,0,1,2,2,0,2018-02-11
3086,서울,금천구,0,0,2,2,2,0,2018-03-11
3087,서울,금천구,2,1,1,4,3,0,2018-04-11
3088,서울,금천구,2,0,0,2,2,0,2018-05-11
3089,서울,금천구,1,0,0,1,1,0,2018-06-11
3090,서울,금천구,0,0,0,0,0,0,2018-07-11
3091,서울,금천구,2,0,1,3,3,0,2018-08-11
3092,서울,금천구,2,0,0,2,2,0,2018-09-11
3093,서울,금천구,0,0,0,0,0,0,2018-10-11
3094,서울,금천구,29,2,14,45,2,0,2018-11-11
3095,서울,금천구,5,0,1,6,4,0,2018-12-11
3096,서울,노원구,10,3,0,13,9,0,2018-01-11
3097,서울,노원구,5,0,1,6,5,0,2018-02-11
3098,서울,노원구,5,1,0,6,5,1,2018-03-11
3099,서울,노원구,2,1,0,3,3,0,2018-04-11
3100,서울,노원구,6,0,1,7,5,0,2018-05-11
3101,서울,노원구,2,0,2,4,4,0,2018-06-11
3102,서울,노원구,0,0,0,0,0,0,2018-07-11
3103,서울,노원구,1,0,1,2,2,0,2018-08-11
3104,서울,노원구,6,1,0,7,6,0,2018-09-11
3105,서울,노원구,3,0,0,3,2,0,2018-10-11
3106,서울,노원구,0,1,0,1,1,0,2018-11-11
3107,서울,노원구,2,0,0,2,2,0,2018-12-11
3108,서울,도봉구,1,0,2,3,3,0,2018-01-11
3109,서울,도봉구,0,2,0,2,2,0,2018-02-11
3110,서울,도봉구,0,0,0,0,0,0,2018-03-11
3111,서울,도봉구,1,0,1,2,2,0,2018-04-11
3112,서울,도봉구,0,0,0,0,0,0,2018-05-11
3113,서울,도봉구,1,0,5,6,4,0,2018-06-11
3114,서울,도봉구,2,0,3,5,5,0,2018-07-11
3115,서울,도봉구,1,0,1,2,2,0,2018-08-11
3116,서울,도봉구,2,2,0,4,4,0,2018-09-11
3117,서울,도봉구,8,0,1,9,5,1,2018-10-11
3118,서울,도봉구,1,0,0,1,1,0,2018-11-11
3119,서울,도봉구,4,0,1,5,2,0,2018-12-11
3120,서울,동대문구,6,0,3,9,8,0,2018-01-11
3121,서울,동대문구,1,0,2,3,3,0,2018-02-11
3122,서울,동대문구,3,0,3,6,4,0,2018-03-11
3123,서울,동대문구,2,0,1,3,3,0,2018-04-11
3124,서울,동대문구,5,1,6,12,8,0,2018-05-11
3125,서울,동대문구,8,3,3,14,8,0,2018-06-11
3126,서울,동대문구,3,1,0,4,4,0,2018-07-11
3127,서울,동대문구,3,1,1,5,4,0,2018-08-11
3128,서울,동대문구,2,0,2,4,4,0,2018-09-11
3129,서울,동대문구,5,1,2,8,7,0,2018-10-11
3130,서울,동대문구,4,1,1,6,5,0,2018-11-11
3131,서울,동대문구,3,0,0,3,4,1,2018-12-11
3132,서울,동작구,6,0,2,8,7,0,2018-01-11
3133,서울,동작구,1,0,1,2,2,0,2018-02-11
3134,서울,동작구,1,0,0,1,1,0,2018-03-11
3135,서울,동작구,2,0,2,4,3,0,2018-04-11
3136,서울,동작구,6,1,5,12,9,0,2018-05-11
3137,서울,동작구,2,0,2,4,4,0,2018-06-11
3138,서울,동작구,4,0,0,4,4,0,2018-07-11
3139,서울,동작구,0,0,1,1,1,0,2018-08-11
3140,서울,동작구,2,1,2,5,5,0,2018-09-11
3141,서울,동작구,5,0,2,7,4,0,2018-10-11
3142,서울,동작구,0,0,0,0,0,0,2018-11-11
3143,서울,동작구,2,0,3,5,4,0,2018-12-11
3144,서울,마포구,5,0,2,7,6,0,2018-01-11
3145,서울,마포구,1,0,1,2,2,0,2018-02-11
3146,서울,마포구,2,0,0,2,2,0,2018-03-11
3147,서울,마포구,0,0,0,0,0,0,2018-04-11
3148,서울,마포구,1,0,4,5,6,1,2018-05-11
3149,서울,마포구,1,1,1,3,3,0,2018-06-11
3150,서울,마포구,2,1,0,3,3,0,2018-07-11
3151,서울,마포구,6,0,1,7,5,0,2018-08-11
3152,서울,마포구,3,1,1,5,5,0,2018-09-11
3153,서울,마포구,3,0,2,5,4,0,2018-10-11
3154,서울,마포구,5,1,1,7,6,0,2018-11-11
3155,서울,마포구,4,1,1,6,3,0,2018-12-11
3156,서울,서대문구,1,1,0,2,2,0,2018-01-11
3157,서울,서대문구,1,0,0,1,1,0,2018-02-11
3158,서울,서대문구,0,1,0,1,1,0,2018-03-11
3159,서울,서대문구,1,1,1,3,1,0,2018-04-11
3160,서울,서대문구,4,1,0,5,5,0,2018-05-11
3161,서울,서대문구,3,0,1,4,4,0,2018-06-11
3162,서울,서대문구,2,0,1,3,3,0,2018-07-11
3163,서울,서대문구,1,0,2,3,3,0,2018-08-11
3164,서울,서대문구,6,4,1,11,6,0,2018-09-11
3165,서울,서대문구,0,0,3,3,1,0,2018-10-11
3166,서울,서대문구,0,1,0,1,1,0,2018-11-11
3167,서울,서대문구,0,0,2,2,1,0,2018-12-11
3168,서울,서초구,12,1,5,18,11,0,2018-01-11
3169,서울,서초구,8,9,1,18,5,0,2018-02-11
3170,서울,서초구,5,1,1,7,7,0,2018-03-11
3171,서울,서초구,4,0,2,6,5,0,2018-04-11
3172,서울,서초구,9,1,1,11,7,0,2018-05-11
3173,서울,서초구,11,0,2,13,9,0,2018-06-11
3174,서울,서초구,2,1,3,6,6,0,2018-07-11
3175,서울,서초구,17,1,0,18,11,0,2018-08-11
3176,서울,서초구,4,0,1,5,4,0,2018-09-11
3177,서울,서초구,8,1,3,12,7,0,2018-10-11
3178,서울,서초구,2,0,2,4,4,0,2018-11-11
3179,서울,서초구,9,0,1,10,7,0,2018-12-11
3180,서울,성동구,1,0,1,2,2,0,2018-01-11
3181,서울,성동구,8,0,3,11,5,0,2018-02-11
3182,서울,성동구,3,0,0,3,3,1,2018-03-11
3183,서울,성동구,2,0,1,3,2,0,2018-04-11
3184,서울,성동구,7,0,1,8,4,0,2018-05-11
3185,서울,성동구,0,0,2,2,2,0,2018-06-11
3186,서울,성동구,0,0,1,1,1,0,2018-07-11
3187,서울,성동구,4,1,0,5,5,0,2018-08-11
3188,서울,성동구,3,0,2,5,3,0,2018-09-11
3189,서울,성동구,1,1,1,3,3,0,2018-10-11
3190,서울,성동구,7,0,3,10,4,0,2018-11-11
3191,서울,성동구,1,0,0,1,1,0,2018-12-11
3192,서울,성북구,7,0,2,9,6,0,2018-01-11
3193,서울,성북구,1,1,0,2,2,0,2018-02-11
3194,서울,성북구,1,0,0,1,1,0,2018-03-11
3195,서울,성북구,0,0,0,0,0,0,2018-04-11
3196,서울,성북구,9,0,1,10,4,0,2018-05-11
3197,서울,성북구,5,0,0,5,3,0,2018-06-11
3198,서울,성북구,5,1,1,7,5,0,2018-07-11
3199,서울,성북구,0,0,2,2,2,1,2018-08-11
3200,서울,성북구,2,0,0,2,2,0,2018-09-11
3201,서울,성북구,6,2,2,10,7,1,2018-10-11
3202,서울,성북구,5,0,0,5,5,0,2018-11-11
3203,서울,성북구,2,0,1,3,3,0,2018-12-11
3204,서울,송파구,10,0,4,14,10,0,2018-01-11
3205,서울,송파구,2,0,1,3,3,0,2018-02-11
3206,서울,송파구,4,0,2,6,5,0,2018-03-11
3207,서울,송파구,3,2,1,6,4,0,2018-04-11
3208,서울,송파구,6,2,2,10,8,0,2018-05-11
3209,서울,송파구,4,5,0,9,7,0,2018-06-11
3210,서울,송파구,6,1,1,8,6,0,2018-07-11
3211,서울,송파구,3,0,0,3,3,0,2018-08-11
3212,서울,송파구,4,0,2,6,4,0,2018-09-11
3213,서울,송파구,12,3,5,20,12,0,2018-10-11
3214,서울,송파구,5,2,4,11,4,2,2018-11-11
3215,서울,송파구,5,2,4,11,11,0,2018-12-11
3216,서울,양천구,4,0,1,5,4,0,2018-01-11
3217,서울,양천구,1,0,2,3,3,0,2018-02-11
3218,서울,양천구,3,0,1,4,4,0,2018-03-11
3219,서울,양천구,7,0,1,8,4,0,2018-04-11
3220,서울,양천구,3,1,0,4,4,0,2018-05-11
3221,서울,양천구,6,0,2,8,4,0,2018-06-11
3222,서울,양천구,7,2,2,11,9,0,2018-07-11
3223,서울,양천구,3,1,0,4,4,0,2018-08-11
3224,서울,양천구,3,0,1,4,3,0,2018-09-11
3225,서울,양천구,3,0,0,3,3,0,2018-10-11
3226,서울,양천구,2,0,0,2,2,0,2018-11-11
3227,서울,양천구,0,0,0,0,0,0,2018-12-11
3228,서울,영등포구,5,1,2,8,7,0,2018-01-11
3229,서울,영등포구,3,0,1,4,3,0,2018-02-11
3230,서울,영등포구,4,0,3,7,5,0,2018-03-11
3231,서울,영등포구,5,0,0,5,3,0,2018-04-11
3232,서울,영등포구,12,4,1,17,10,0,2018-05-11
3233,서울,영등포구,9,0,2,11,7,0,2018-06-11
3234,서울,영등포구,10,0,0,10,6,0,2018-07-11
3235,서울,영등포구,3,1,1,5,3,0,2018-08-11
3236,서울,영등포구,19,1,3,23,12,0,2018-09-11
3237,서울,영등포구,4,0,1,5,4,0,2018-10-11
3238,서울,영등포구,6,0,1,7,5,0,2018-11-11
3239,서울,영등포구,6,15,2,23,6,0,2018-12-11
3240,서울,용산구,4,0,1,5,3,0,2018-01-11
3241,서울,용산구,5,0,0,5,2,0,2018-02-11
3242,서울,용산구,2,0,0,2,2,0,2018-03-11
3243,서울,용산구,5,0,1,6,6,0,2018-04-11
3244,서울,용산구,3,0,1,4,2,0,2018-05-11
3245,서울,용산구,4,0,1,5,5,0,2018-06-11
3246,서울,용산구,3,0,0,3,3,0,2018-07-11
3247,서울,용산구,1,1,2,4,5,1,2018-08-11
3248,서울,용산구,3,0,2,5,4,0,2018-09-11
3249,서울,용산구,5,0,2,7,4,0,2018-10-11
3250,서울,용산구,3,0,3,6,4,0,2018-11-11
3251,서울,용산구,3,0,1,4,4,0,2018-12-11
3252,서울,은평구,1,0,0,1,1,0,2018-01-11
3253,서울,은평구,11,0,1,12,4,0,2018-02-11
3254,서울,은평구,1,0,2,3,2,0,2018-03-11
3255,서울,은평구,3,0,1,4,4,0,2018-04-11
3256,서울,은평구,8,0,1,9,5,0,2018-05-11
3257,서울,은평구,0,0,0,0,0,0,2018-06-11
3258,서울,은평구,3,0,0,3,2,0,2018-07-11
3259,서울,은평구,1,1,0,2,2,0,2018-08-11
3260,서울,은평구,3,0,1,4,4,0,2018-09-11
3261,서울,은평구,7,0,0,7,2,0,2018-10-11
3262,서울,은평구,4,0,1,5,3,0,2018-11-11
3263,서울,은평구,3,0,1,4,5,1,2018-12-11
3264,서울,종로구,3,0,2,5,4,0,2018-01-11
3265,서울,종로구,1,0,0,1,1,0,2018-02-11
3266,서울,종로구,5,0,2,7,2,0,2018-03-11
3267,서울,종로구,0,0,2,2,2,0,2018-04-11
3268,서울,종로구,1,1,0,2,2,0,2018-05-11
3269,서울,종로구,6,0,1,7,6,0,2018-06-11
3270,서울,종로구,5,0,2,7,6,0,2018-07-11
3271,서울,종로구,2,0,0,2,1,0,2018-08-11
3272,서울,종로구,5,0,2,7,6,0,2018-09-11
3273,서울,종로구,1,0,0,1,1,0,2018-10-11
3274,서울,종로구,0,0,1,1,1,0,2018-11-11
3275,서울,종로구,3,0,0,3,3,0,2018-12-11
3276,서울,중구,1,2,2,5,5,0,2018-01-11
3277,서울,중구,3,0,0,3,2,0,2018-02-11
3278,서울,중구,0,0,2,2,1,0,2018-03-11
3279,서울,중구,2,0,2,4,4,0,2018-04-11
3280,서울,중구,1,1,0,2,2,0,2018-05-11
3281,서울,중구,2,0,1,3,3,0,2018-06-11
3282,서울,중구,0,2,2,4,2,0,2018-07-11
3283,서울,중구,2,0,1,3,3,0,2018-08-11
3284,서울,중구,3,0,1,4,3,0,2018-09-11
3285,서울,중구,3,1,2,6,3,0,2018-10-11
3286,서울,중구,1,0,0,1,1,0,2018-11-11
3287,서울,중구,2,1,0,3,3,0,2018-12-11
3288,서울,중랑구,2,0,1,3,3,0,2018-01-11
3289,서울,중랑구,5,0,1,6,4,0,2018-02-11
3290,서울,중랑구,2,0,1,3,1,0,2018-03-11
3291,서울,중랑구,4,0,1,5,3,0,2018-04-11
3292,서울,중랑구,4,0,0,4,3,0,2018-05-11
3293,서울,중랑구,2,0,3,5,4,0,2018-06-11
3294,서울,중랑구,0,0,3,3,3,0,2018-07-11
3295,서울,중랑구,1,0,2,3,3,0,2018-08-11
3296,서울,중랑구,6,2,2,10,6,0,2018-09-11
3297,서울,중랑구,4,1,1,6,4,0,2018-10-11
3298,서울,중랑구,2,0,1,3,2,0,2018-11-11
3299,서울,중랑구,4,1,1,6,4,0,2018-12-11
3300,서울,강남구,17,5,4,26,19,0,2018-01-12
3301,서울,강남구,24,0,5,29,18,0,2018-02-12
3302,서울,강남구,7,2,1,10,9,0,2018-03-12
3303,서울,강남구,15,1,5,21,14,0,2018-04-12
3304,서울,강남구,13,2,0,15,9,0,2018-05-12
3305,서울,강남구,4,3,1,8,6,0,2018-06-12
3306,서울,강남구,7,1,5,13,9,0,2018-07-12
3307,서울,강남구,5,0,2,7,5,1,2018-08-12
3308,서울,강남구,9,2,4,15,12,0,2018-09-12
3309,서울,강남구,6,0,0,6,5,0,2018-10-12
3310,서울,강남구,21,3,1,25,13,0,2018-11-12
3311,서울,강남구,8,0,2,10,8,0,2018-12-12
3312,서울,강동구,2,0,1,3,1,0,2018-01-12
3313,서울,강동구,4,0,1,5,4,0,2018-02-12
3314,서울,강동구,0,0,1,1,1,0,2018-03-12
3315,서울,강동구,3,5,4,12,4,0,2018-04-12
3316,서울,강동구,5,0,0,5,4,0,2018-05-12
3317,서울,강동구,3,0,0,3,3,0,2018-06-12
3318,서울,강동구,4,0,3,7,6,0,2018-07-12
3319,서울,강동구,3,0,0,3,2,0,2018-08-12
3320,서울,강동구,4,3,3,10,7,0,2018-09-12
3321,서울,강동구,2,0,1,3,3,0,2018-10-12
3322,서울,강동구,1,1,1,3,3,0,2018-11-12
3323,서울,강동구,3,0,1,4,3,0,2018-12-12
3324,서울,강북구,8,1,1,10,8,0,2018-01-12
3325,서울,강북구,1,0,0,1,1,0,2018-02-12
3326,서울,강북구,4,0,0,4,3,1,2018-03-12
3327,서울,강북구,3,0,0,3,2,0,2018-04-12
3328,서울,강북구,6,0,6,12,4,0,2018-05-12
3329,서울,강북구,2,0,0,2,2,0,2018-06-12
3330,서울,강북구,1,0,1,2,2,0,2018-07-12
3331,서울,강북구,8,0,1,9,6,0,2018-08-12
3332,서울,강북구,3,0,0,3,3,0,2018-09-12
3333,서울,강북구,0,0,0,0,0,0,2018-10-12
3334,서울,강북구,3,0,0,3,3,0,2018-11-12
3335,서울,강북구,3,0,1,4,3,0,2018-12-12
3336,서울,강서구,3,1,2,6,6,1,2018-01-12
3337,서울,강서구,4,0,4,8,6,0,2018-02-12
3338,서울,강서구,3,0,0,3,2,0,2018-03-12
3339,서울,강서구,2,0,0,2,2,0,2018-04-12
3340,서울,강서구,1,0,1,2,2,0,2018-05-12
3341,서울,강서구,2,0,2,4,4,0,2018-06-12
3342,서울,강서구,1,0,0,1,1,0,2018-07-12
3343,서울,강서구,2,0,1,3,3,0,2018-08-12
3344,서울,강서구,4,3,1,8,7,0,2018-09-12
3345,서울,강서구,5,0,0,5,3,0,2018-10-12
3346,서울,강서구,5,0,2,7,7,0,2018-11-12
3347,서울,강서구,2,0,1,3,3,0,2018-12-12
3348,서울,관악구,6,0,1,7,6,0,2018-01-12
3349,서울,관악구,4,0,3,7,7,0,2018-02-12
3350,서울,관악구,1,1,1,3,2,0,2018-03-12
3351,서울,관악구,3,0,2,5,3,0,2018-04-12
3352,서울,관악구,6,0,1,7,5,0,2018-05-12
3353,서울,관악구,5,0,1,6,4,0,2018-06-12
3354,서울,관악구,1,1,3,5,5,0,2018-07-12
3355,서울,관악구,8,0,2,10,6,0,2018-08-12
3356,서울,관악구,2,2,1,5,3,0,2018-09-12
3357,서울,관악구,2,0,0,2,2,0,2018-10-12
3358,서울,관악구,2,0,0,2,1,0,2018-11-12
3359,서울,관악구,3,0,1,4,4,0,2018-12-12
3360,서울,광진구,4,0,1,5,4,0,2018-01-12
3361,서울,광진구,2,0,1,3,3,0,2018-02-12
3362,서울,광진구,1,1,0,2,2,0,2018-03-12
3363,서울,광진구,2,0,2,4,3,0,2018-04-12
3364,서울,광진구,5,0,2,7,4,0,2018-05-12
3365,서울,광진구,2,0,0,2,2,0,2018-06-12
3366,서울,광진구,6,2,3,11,6,2,2018-07-12
3367,서울,광진구,1,0,0,1,1,0,2018-08-12
3368,서울,광진구,0,0,1,1,1,0,2018-09-12
3369,서울,광진구,3,0,2,5,5,0,2018-10-12
3370,서울,광진구,0,0,1,1,1,0,2018-11-12
3371,서울,광진구,6,0,2,8,5,0,2018-12-12
3372,서울,구로구,9,4,7,20,11,0,2018-01-12
3373,서울,구로구,10,0,1,11,6,0,2018-02-12
3374,서울,구로구,0,0,1,1,1,0,2018-03-12
3375,서울,구로구,3,0,3,6,3,0,2018-04-12
3376,서울,구로구,0,0,1,1,1,0,2018-05-12
3377,서울,구로구,9,0,2,11,4,0,2018-06-12
3378,서울,구로구,12,2,4,18,8,0,2018-07-12
3379,서울,구로구,1,1,2,4,4,0,2018-08-12
3380,서울,구로구,5,0,2,7,5,0,2018-09-12
3381,서울,구로구,4,1,1,6,4,0,2018-10-12
3382,서울,구로구,0,0,1,1,1,0,2018-11-12
3383,서울,구로구,3,0,0,3,3,0,2018-12-12
3384,서울,금천구,7,0,2,9,3,0,2018-01-12
3385,서울,금천구,3,0,1,4,4,0,2018-02-12
3386,서울,금천구,0,1,2,3,3,0,2018-03-12
3387,서울,금천구,1,0,2,3,3,0,2018-04-12
3388,서울,금천구,4,0,0,4,3,0,2018-05-12
3389,서울,금천구,1,0,1,2,2,0,2018-06-12
3390,서울,금천구,4,0,1,5,3,0,2018-07-12
3391,서울,금천구,0,0,0,0,0,0,2018-08-12
3392,서울,금천구,0,0,1,1,1,0,2018-09-12
3393,서울,금천구,2,0,3,5,3,0,2018-10-12
3394,서울,금천구,4,0,2,6,4,0,2018-11-12
3395,서울,금천구,0,0,1,1,1,0,2018-12-12
3396,서울,노원구,3,0,2,5,5,0,2018-01-12
3397,서울,노원구,6,0,2,8,7,0,2018-02-12
3398,서울,노원구,0,1,0,1,1,0,2018-03-12
3399,서울,노원구,1,0,0,1,1,0,2018-04-12
3400,서울,노원구,7,1,2,10,8,0,2018-05-12
3401,서울,노원구,9,0,0,9,8,0,2018-06-12
3402,서울,노원구,1,0,0,1,1,0,2018-07-12
3403,서울,노원구,6,0,3,9,1,0,2018-08-12
3404,서울,노원구,5,0,1,6,5,0,2018-09-12
3405,서울,노원구,4,0,4,8,6,0,2018-10-12
3406,서울,노원구,4,0,2,6,6,0,2018-11-12
3407,서울,노원구,4,0,1,5,4,0,2018-12-12
3408,서울,도봉구,6,2,0,8,4,0,2018-01-12
3409,서울,도봉구,0,0,0,0,0,0,2018-02-12
3410,서울,도봉구,1,0,0,1,1,0,2018-03-12
3411,서울,도봉구,1,1,0,2,2,0,2018-04-12
3412,서울,도봉구,1,0,0,1,1,0,2018-05-12
3413,서울,도봉구,3,2,1,6,5,0,2018-06-12
3414,서울,도봉구,2,0,1,3,3,0,2018-07-12
3415,서울,도봉구,4,1,1,6,2,0,2018-08-12
3416,서울,도봉구,4,1,0,5,5,0,2018-09-12
3417,서울,도봉구,1,0,2,3,3,0,2018-10-12
3418,서울,도봉구,1,0,2,3,3,0,2018-11-12
3419,서울,도봉구,3,0,0,3,1,0,2018-12-12
3420,서울,동대문구,1,0,1,2,2,0,2018-01-12
3421,서울,동대문구,6,0,2,8,7,0,2018-02-12
3422,서울,동대문구,5,0,1,6,5,0,2018-03-12
3423,서울,동대문구,4,0,1,5,5,0,2018-04-12
3424,서울,동대문구,3,0,2,5,4,0,2018-05-12
3425,서울,동대문구,0,0,2,2,2,0,2018-06-12
3426,서울,동대문구,2,1,4,7,7,0,2018-07-12
3427,서울,동대문구,6,0,4,10,3,0,2018-08-12
3428,서울,동대문구,8,0,1,9,7,0,2018-09-12
3429,서울,동대문구,3,0,2,5,4,0,2018-10-12
3430,서울,동대문구,1,0,4,5,5,0,2018-11-12
3431,서울,동대문구,7,0,1,8,7,0,2018-12-12
3432,서울,동작구,3,1,0,4,4,0,2018-01-12
3433,서울,동작구,4,0,0,4,3,0,2018-02-12
3434,서울,동작구,9,0,1,10,6,0,2018-03-12
3435,서울,동작구,2,0,2,4,3,0,2018-04-12
3436,서울,동작구,3,1,1,5,3,0,2018-05-12
3437,서울,동작구,3,0,1,4,3,0,2018-06-12
3438,서울,동작구,2,2,3,7,7,1,2018-07-12
3439,서울,동작구,1,0,1,2,2,0,2018-08-12
3440,서울,동작구,2,0,0,2,2,0,2018-09-12
3441,서울,동작구,4,0,0,4,2,0,2018-10-12
3442,서울,동작구,1,0,1,2,2,0,2018-11-12
3443,서울,동작구,2,0,0,2,2,0,2018-12-12
3444,서울,마포구,11,3,2,16,9,0,2018-01-12
3445,서울,마포구,6,0,3,9,5,0,2018-02-12
3446,서울,마포구,5,0,0,5,4,0,2018-03-12
3447,서울,마포구,5,1,1,7,5,0,2018-04-12
3448,서울,마포구,7,3,2,12,6,0,2018-05-12
3449,서울,마포구,6,0,2,8,7,0,2018-06-12
3450,서울,마포구,8,0,0,8,7,0,2018-07-12
3451,서울,마포구,3,0,2,5,2,0,2018-08-12
3452,서울,마포구,6,0,0,6,4,0,2018-09-12
3453,서울,마포구,7,0,1,8,4,0,2018-10-12
3454,서울,마포구,2,0,1,3,3,0,2018-11-12
3455,서울,마포구,5,1,0,6,4,0,2018-12-12
3456,서울,서대문구,2,0,0,2,2,0,2018-01-12
3457,서울,서대문구,0,0,0,0,0,0,2018-02-12
3458,서울,서대문구,2,2,1,5,3,0,2018-03-12
3459,서울,서대문구,2,2,1,5,3,0,2018-04-12
3460,서울,서대문구,2,0,0,2,2,0,2018-05-12
3461,서울,서대문구,3,0,0,3,3,0,2018-06-12
3462,서울,서대문구,1,1,0,2,2,0,2018-07-12
3463,서울,서대문구,1,0,1,2,2,0,2018-08-12
3464,서울,서대문구,2,1,0,3,3,0,2018-09-12
3465,서울,서대문구,2,0,0,2,2,0,2018-10-12
3466,서울,서대문구,6,3,0,9,4,0,2018-11-12
3467,서울,서대문구,1,1,2,4,4,0,2018-12-12
3468,서울,서초구,12,1,3,16,10,0,2018-01-12
3469,서울,서초구,10,5,3,18,9,1,2018-02-12
3470,서울,서초구,9,1,1,11,9,0,2018-03-12
3471,서울,서초구,13,0,1,14,11,0,2018-04-12
3472,서울,서초구,8,0,2,10,7,0,2018-05-12
3473,서울,서초구,6,0,2,8,6,0,2018-06-12
3474,서울,서초구,7,1,2,10,9,0,2018-07-12
3475,서울,서초구,10,0,0,10,7,0,2018-08-12
3476,서울,서초구,9,2,1,12,9,0,2018-09-12
3477,서울,서초구,11,0,6,17,14,0,2018-10-12
3478,서울,서초구,4,0,0,4,3,0,2018-11-12
3479,서울,서초구,9,1,1,11,8,0,2018-12-12
3480,서울,성동구,1,0,3,4,3,0,2018-01-12
3481,서울,성동구,5,0,3,8,5,0,2018-02-12
3482,서울,성동구,6,0,1,7,5,0,2018-03-12
3483,서울,성동구,2,0,0,2,2,0,2018-04-12
3484,서울,성동구,3,0,1,4,4,0,2018-05-12
3485,서울,성동구,1,0,2,3,3,0,2018-06-12
3486,서울,성동구,1,0,0,1,1,0,2018-07-12
3487,서울,성동구,2,0,4,6,3,0,2018-08-12
3488,서울,성동구,8,0,0,8,5,0,2018-09-12
3489,서울,성동구,1,0,2,3,3,0,2018-10-12
3490,서울,성동구,1,0,0,1,1,0,2018-11-12
3491,서울,성동구,0,1,1,2,2,0,2018-12-12
3492,서울,성북구,5,0,3,8,7,0,2018-01-12
3493,서울,성북구,6,0,2,8,7,0,2018-02-12
3494,서울,성북구,3,2,1,6,6,0,2018-03-12
3495,서울,성북구,2,0,0,2,1,0,2018-04-12
3496,서울,성북구,2,0,0,2,2,0,2018-05-12
3497,서울,성북구,5,0,0,5,3,0,2018-06-12
3498,서울,성북구,1,0,1,2,2,0,2018-07-12
3499,서울,성북구,7,0,1,8,3,0,2018-08-12
3500,서울,성북구,5,0,0,5,2,0,2018-09-12
3501,서울,성북구,2,0,0,2,2,0,2018-10-12
3502,서울,성북구,3,0,0,3,2,0,2018-11-12
3503,서울,성북구,3,1,0,4,3,0,2018-12-12
3504,서울,송파구,9,2,0,11,8,0,2018-01-12
3505,서울,송파구,1,3,3,7,4,0,2018-02-12
3506,서울,송파구,8,1,1,10,9,0,2018-03-12
3507,서울,송파구,8,1,4,13,8,1,2018-04-12
3508,서울,송파구,3,1,1,5,5,0,2018-05-12
3509,서울,송파구,4,0,1,5,5,0,2018-06-12
3510,서울,송파구,19,2,3,24,16,0,2018-07-12
3511,서울,송파구,5,3,3,11,9,0,2018-08-12
3512,서울,송파구,12,3,1,16,11,0,2018-09-12
3513,서울,송파구,4,2,1,7,7,0,2018-10-12
3514,서울,송파구,3,0,3,6,6,0,2018-11-12
3515,서울,송파구,5,4,2,11,9,0,2018-12-12
3516,서울,양천구,11,1,1,13,9,0,2018-01-12
3517,서울,양천구,7,0,1,8,5,0,2018-02-12
3518,서울,양천구,6,0,0,6,5,0,2018-03-12
3519,서울,양천구,3,0,1,4,3,0,2018-04-12
3520,서울,양천구,9,1,0,10,6,0,2018-05-12
3521,서울,양천구,6,0,0,6,5,0,2018-06-12
3522,서울,양천구,3,0,0,3,3,0,2018-07-12
3523,서울,양천구,0,0,0,0,0,0,2018-08-12
3524,서울,양천구,1,0,3,4,5,1,2018-09-12
3525,서울,양천구,15,0,0,15,10,0,2018-10-12
3526,서울,양천구,3,1,1,5,3,0,2018-11-12
3527,서울,양천구,6,1,0,7,5,0,2018-12-12
3528,서울,영등포구,6,0,3,9,9,0,2018-01-12
3529,서울,영등포구,8,3,0,11,10,0,2018-02-12
3530,서울,영등포구,5,0,1,6,4,0,2018-03-12
3531,서울,영등포구,8,3,2,13,6,0,2018-04-12
3532,서울,영등포구,6,0,3,9,6,0,2018-05-12
3533,서울,영등포구,8,1,0,9,8,0,2018-06-12
3534,서울,영등포구,9,1,2,12,11,0,2018-07-12
3535,서울,영등포구,12,0,2,14,5,0,2018-08-12
3536,서울,영등포구,8,0,2,10,6,0,2018-09-12
3537,서울,영등포구,8,2,0,10,4,0,2018-10-12
3538,서울,영등포구,5,1,0,6,2,0,2018-11-12
3539,서울,영등포구,2,0,3,5,4,0,2018-12-12
3540,서울,용산구,3,1,3,7,6,0,2018-01-12
3541,서울,용산구,2,0,0,2,2,0,2018-02-12
3542,서울,용산구,2,0,2,4,4,0,2018-03-12
3543,서울,용산구,2,0,1,3,3,0,2018-04-12
3544,서울,용산구,1,0,3,4,4,0,2018-05-12
3545,서울,용산구,5,0,1,6,5,0,2018-06-12
3546,서울,용산구,4,1,0,5,3,1,2018-07-12
3547,서울,용산구,3,0,0,3,3,0,2018-08-12
3548,서울,용산구,4,1,1,6,4,0,2018-09-12
3549,서울,용산구,6,0,2,8,6,0,2018-10-12
3550,서울,용산구,1,0,1,2,2,0,2018-11-12
3551,서울,용산구,6,0,0,6,6,0,2018-12-12
3552,서울,은평구,2,0,0,2,1,0,2018-01-12
3553,서울,은평구,1,1,0,2,2,0,2018-02-12
3554,서울,은평구,1,0,2,3,3,0,2018-03-12
3555,서울,은평구,0,1,0,1,1,0,2018-04-12
3556,서울,은평구,2,1,2,5,4,0,2018-05-12
3557,서울,은평구,3,0,1,4,4,0,2018-06-12
3558,서울,은평구,1,0,3,4,3,0,2018-07-12
3559,서울,은평구,1,0,0,1,1,0,2018-08-12
3560,서울,은평구,6,0,2,8,6,0,2018-09-12
3561,서울,은평구,3,1,1,5,4,0,2018-10-12
3562,서울,은평구,0,1,0,1,1,0,2018-11-12
3563,서울,은평구,0,0,0,0,0,0,2018-12-12
3564,서울,종로구,5,1,1,7,6,0,2018-01-12
3565,서울,종로구,3,1,0,4,3,0,2018-02-12
3566,서울,종로구,0,0,0,0,0,0,2018-03-12
3567,서울,종로구,3,0,3,6,5,0,2018-04-12
3568,서울,종로구,4,0,0,4,2,0,2018-05-12
3569,서울,종로구,6,0,2,8,7,0,2018-06-12
3570,서울,종로구,2,0,0,2,1,0,2018-07-12
3571,서울,종로구,4,0,0,4,2,0,2018-08-12
3572,서울,종로구,1,0,0,1,1,0,2018-09-12
3573,서울,종로구,4,3,1,8,6,0,2018-10-12
3574,서울,종로구,3,0,1,4,3,0,2018-11-12
3575,서울,종로구,8,0,1,9,4,0,2018-12-12
3576,서울,중구,14,1,5,20,8,0,2018-01-12
3577,서울,중구,2,1,1,4,3,0,2018-02-12
3578,서울,중구,0,0,1,1,1,0,2018-03-12
3579,서울,중구,5,2,2,9,3,0,2018-04-12
3580,서울,중구,7,1,0,8,5,0,2018-05-12
3581,서울,중구,4,1,0,5,4,0,2018-06-12
3582,서울,중구,3,0,3,6,4,0,2018-07-12
3583,서울,중구,6,0,0,6,2,0,2018-08-12
3584,서울,중구,2,1,0,3,3,0,2018-09-12
3585,서울,중구,5,0,2,7,4,0,2018-10-12
3586,서울,중구,1,0,0,1,1,0,2018-11-12
3587,서울,중구,4,1,3,8,3,0,2018-12-12
3588,서울,중랑구,6,0,0,6,6,0,2018-01-12
3589,서울,중랑구,4,0,1,5,5,0,2018-02-12
3590,서울,중랑구,5,2,0,7,6,0,2018-03-12
3591,서울,중랑구,2,1,3,6,6,0,2018-04-12
3592,서울,중랑구,3,0,3,6,6,1,2018-05-12
3593,서울,중랑구,2,0,0,2,2,0,2018-06-12
3594,서울,중랑구,2,1,1,4,3,0,2018-07-12
3595,서울,중랑구,3,0,5,8,2,0,2018-08-12
3596,서울,중랑구,0,0,1,1,1,0,2018-09-12
3597,서울,중랑구,11,1,0,12,10,0,2018-10-12
3598,서울,중랑구,7,0,3,10,8,0,2018-11-12
3599,서울,중랑구,4,0,1,5,3,0,2018-12-12
3600,서울,강남구,11,4,6,21,14,0,2018-01-13
3601,서울,강남구,13,0,6,19,14,0,2018-02-13
3602,서울,강남구,13,0,0,13,10,0,2018-03-13
3603,서울,강남구,12,0,0,12,8,0,2018-04-13
3604,서울,강남구,15,0,5,20,11,0,2018-05-13
3605,서울,강남구,6,0,3,9,7,0,2018-06-13
3606,서울,강남구,12,1,2,15,13,0,2018-07-13
3607,서울,강남구,7,0,1,8,9,1,2018-08-13
3608,서울,강남구,11,1,1,13,10,0,2018-09-13
3609,서울,강남구,22,1,2,25,14,0,2018-10-13
3610,서울,강남구,13,1,2,16,9,0,2018-11-13
3611,서울,강남구,10,0,4,14,7,0,2018-12-13
3612,서울,강동구,2,0,0,2,2,0,2018-01-13
3613,서울,강동구,2,0,2,4,4,0,2018-02-13
3614,서울,강동구,3,0,0,3,3,0,2018-03-13
3615,서울,강동구,2,0,3,5,5,0,2018-04-13
3616,서울,강동구,0,0,1,1,1,0,2018-05-13
3617,서울,강동구,1,0,1,2,2,0,2018-06-13
3618,서울,강동구,5,1,0,6,5,0,2018-07-13
3619,서울,강동구,4,0,0,4,2,0,2018-08-13
3620,서울,강동구,6,1,1,8,6,0,2018-09-13
3621,서울,강동구,7,4,1,12,6,0,2018-10-13
3622,서울,강동구,6,0,1,7,5,0,2018-11-13
3623,서울,강동구,5,1,1,7,6,0,2018-12-13
3624,서울,강북구,7,0,0,7,4,0,2018-01-13
3625,서울,강북구,6,0,2,8,4,0,2018-02-13
3626,서울,강북구,5,0,2,7,6,0,2018-03-13
3627,서울,강북구,2,1,1,4,2,0,2018-04-13
3628,서울,강북구,6,0,0,6,5,0,2018-05-13
3629,서울,강북구,4,0,1,5,4,0,2018-06-13
3630,서울,강북구,2,0,0,2,2,0,2018-07-13
3631,서울,강북구,3,0,1,4,4,0,2018-08-13
3632,서울,강북구,0,0,0,0,0,0,2018-09-13
3633,서울,강북구,1,0,1,2,2,0,2018-10-13
3634,서울,강북구,3,0,3,6,5,0,2018-11-13
3635,서울,강북구,1,0,2,3,3,0,2018-12-13
3636,서울,강서구,5,0,0,5,3,0,2018-01-13
3637,서울,강서구,8,0,3,11,7,0,2018-02-13
3638,서울,강서구,1,1,6,8,5,0,2018-03-13
3639,서울,강서구,3,0,1,4,4,0,2018-04-13
3640,서울,강서구,0,0,0,0,0,0,2018-05-13
3641,서울,강서구,2,0,1,3,2,0,2018-06-13
3642,서울,강서구,4,0,3,7,5,0,2018-07-13
3643,서울,강서구,2,1,1,4,3,1,2018-08-13
3644,서울,강서구,0,0,0,0,0,0,2018-09-13
3645,서울,강서구,1,0,0,1,1,0,2018-10-13
3646,서울,강서구,10,0,5,15,7,0,2018-11-13
3647,서울,강서구,3,1,2,6,5,0,2018-12-13
3648,서울,관악구,10,0,0,10,6,0,2018-01-13
3649,서울,관악구,3,0,2,5,4,0,2018-02-13
3650,서울,관악구,1,0,1,2,2,0,2018-03-13
3651,서울,관악구,3,0,2,5,4,0,2018-04-13
3652,서울,관악구,5,0,0,5,4,0,2018-05-13
3653,서울,관악구,3,0,1,4,4,0,2018-06-13
3654,서울,관악구,0,0,0,0,0,0,2018-07-13
3655,서울,관악구,4,0,0,4,2,0,2018-08-13
3656,서울,관악구,1,0,0,1,1,0,2018-09-13
3657,서울,관악구,9,1,1,11,2,0,2018-10-13
3658,서울,관악구,12,0,0,12,9,0,2018-11-13
3659,서울,관악구,3,0,1,4,2,0,2018-12-13
3660,서울,광진구,4,1,3,8,5,0,2018-01-13
3661,서울,광진구,0,0,1,1,1,0,2018-02-13
3662,서울,광진구,1,0,0,1,1,0,2018-03-13
3663,서울,광진구,3,2,1,6,4,0,2018-04-13
3664,서울,광진구,6,0,3,9,5,0,2018-05-13
3665,서울,광진구,1,0,1,2,2,0,2018-06-13
3666,서울,광진구,7,0,1,8,6,0,2018-07-13
3667,서울,광진구,0,1,0,1,1,0,2018-08-13
3668,서울,광진구,0,0,1,1,1,0,2018-09-13
3669,서울,광진구,4,1,0,5,3,0,2018-10-13
3670,서울,광진구,4,0,1,5,5,0,2018-11-13
3671,서울,광진구,3,0,0,3,3,0,2018-12-13
3672,서울,구로구,3,0,1,4,2,0,2018-01-13
3673,서울,구로구,5,0,2,7,6,0,2018-02-13
3674,서울,구로구,8,0,0,8,5,0,2018-03-13
3675,서울,구로구,9,0,0,9,7,0,2018-04-13
3676,서울,구로구,1,0,0,1,1,0,2018-05-13
3677,서울,구로구,3,2,1,6,4,0,2018-06-13
3678,서울,구로구,5,0,1,6,3,0,2018-07-13
3679,서울,구로구,5,1,2,8,5,0,2018-08-13
3680,서울,구로구,5,1,1,7,5,0,2018-09-13
3681,서울,구로구,2,0,4,6,3,0,2018-10-13
3682,서울,구로구,8,2,1,11,10,0,2018-11-13
3683,서울,구로구,6,0,0,6,4,0,2018-12-13
3684,서울,금천구,7,1,0,8,3,0,2018-01-13
3685,서울,금천구,4,0,1,5,1,0,2018-02-13
3686,서울,금천구,2,0,0,2,1,0,2018-03-13
3687,서울,금천구,5,0,0,5,3,0,2018-04-13
3688,서울,금천구,4,0,1,5,3,0,2018-05-13
3689,서울,금천구,6,0,2,8,4,0,2018-06-13
3690,서울,금천구,2,0,2,4,2,0,2018-07-13
3691,서울,금천구,4,0,1,5,4,0,2018-08-13
3692,서울,금천구,1,0,0,1,1,0,2018-09-13
3693,서울,금천구,1,0,0,1,1,0,2018-10-13
3694,서울,금천구,3,0,1,4,3,0,2018-11-13
3695,서울,금천구,3,0,0,3,3,0,2018-12-13
3696,서울,노원구,5,0,2,7,6,0,2018-01-13
3697,서울,노원구,5,0,2,7,7,0,2018-02-13
3698,서울,노원구,5,0,4,9,7,0,2018-03-13
3699,서울,노원구,3,0,3,6,6,0,2018-04-13
3700,서울,노원구,9,0,1,10,6,0,2018-05-13
3701,서울,노원구,6,2,2,10,10,1,2018-06-13
3702,서울,노원구,6,1,0,7,4,0,2018-07-13
3703,서울,노원구,2,0,0,2,2,0,2018-08-13
3704,서울,노원구,10,0,1,11,6,0,2018-09-13
3705,서울,노원구,1,0,1,2,2,0,2018-10-13
3706,서울,노원구,7,2,0,9,7,0,2018-11-13
3707,서울,노원구,9,2,4,15,10,0,2018-12-13
3708,서울,도봉구,1,0,1,2,2,0,2018-01-13
3709,서울,도봉구,1,0,1,2,2,0,2018-02-13
3710,서울,도봉구,1,0,0,1,1,0,2018-03-13
3711,서울,도봉구,0,0,1,1,1,0,2018-04-13
3712,서울,도봉구,4,1,0,5,5,0,2018-05-13
3713,서울,도봉구,1,0,0,1,1,0,2018-06-13
3714,서울,도봉구,0,0,0,0,0,0,2018-07-13
3715,서울,도봉구,0,0,1,1,1,0,2018-08-13
3716,서울,도봉구,1,1,3,5,3,0,2018-09-13
3717,서울,도봉구,1,0,0,1,1,0,2018-10-13
3718,서울,도봉구,0,0,0,0,0,0,2018-11-13
3719,서울,도봉구,1,0,1,2,2,0,2018-12-13
3720,서울,동대문구,4,0,5,9,6,0,2018-01-13
3721,서울,동대문구,10,2,1,13,8,0,2018-02-13
3722,서울,동대문구,2,0,2,4,3,0,2018-03-13
3723,서울,동대문구,4,1,3,8,8,0,2018-04-13
3724,서울,동대문구,1,0,2,3,2,0,2018-05-13
3725,서울,동대문구,2,1,2,5,4,0,2018-06-13
3726,서울,동대문구,4,0,1,5,4,0,2018-07-13
3727,서울,동대문구,5,1,1,7,6,0,2018-08-13
3728,서울,동대문구,3,2,1,6,6,0,2018-09-13
3729,서울,동대문구,2,1,0,3,3,0,2018-10-13
3730,서울,동대문구,2,0,2,4,4,0,2018-11-13
3731,서울,동대문구,3,0,1,4,4,0,2018-12-13
3732,서울,동작구,2,1,1,4,4,0,2018-01-13
3733,서울,동작구,4,1,4,9,7,0,2018-02-13
3734,서울,동작구,0,0,1,1,1,0,2018-03-13
3735,서울,동작구,2,1,0,3,4,1,2018-04-13
3736,서울,동작구,2,0,3,5,5,0,2018-05-13
3737,서울,동작구,2,1,1,4,2,0,2018-06-13
3738,서울,동작구,8,2,4,14,7,0,2018-07-13
3739,서울,동작구,4,0,3,7,7,0,2018-08-13
3740,서울,동작구,1,0,0,1,1,0,2018-09-13
3741,서울,동작구,2,2,1,5,2,0,2018-10-13
3742,서울,동작구,3,0,1,4,4,0,2018-11-13
3743,서울,동작구,6,3,4,13,11,0,2018-12-13
3744,서울,마포구,10,0,2,12,6,0,2018-01-13
3745,서울,마포구,6,0,2,8,6,0,2018-02-13
3746,서울,마포구,1,1,0,2,2,0,2018-03-13
3747,서울,마포구,7,1,3,11,8,0,2018-04-13
3748,서울,마포구,3,0,3,6,5,0,2018-05-13
3749,서울,마포구,9,0,1,10,5,0,2018-06-13
3750,서울,마포구,5,0,2,7,5,0,2018-07-13
3751,서울,마포구,1,0,0,1,1,0,2018-08-13
3752,서울,마포구,10,0,2,12,10,0,2018-09-13
3753,서울,마포구,9,0,1,10,7,0,2018-10-13
3754,서울,마포구,2,1,0,3,3,0,2018-11-13
3755,서울,마포구,5,0,2,7,6,0,2018-12-13
3756,서울,서대문구,6,5,2,13,5,0,2018-01-13
3757,서울,서대문구,2,1,3,6,3,0,2018-02-13
3758,서울,서대문구,0,0,1,1,1,0,2018-03-13
3759,서울,서대문구,1,0,3,4,5,1,2018-04-13
3760,서울,서대문구,3,0,0,3,4,1,2018-05-13
3761,서울,서대문구,1,0,0,1,1,0,2018-06-13
3762,서울,서대문구,0,2,0,2,2,0,2018-07-13
3763,서울,서대문구,3,1,1,5,4,0,2018-08-13
3764,서울,서대문구,6,0,2,8,6,0,2018-09-13
3765,서울,서대문구,2,1,0,3,2,0,2018-10-13
3766,서울,서대문구,4,0,0,4,2,0,2018-11-13
3767,서울,서대문구,2,0,1,3,3,0,2018-12-13
3768,서울,서초구,10,2,2,14,8,0,2018-01-13
3769,서울,서초구,10,0,1,11,9,0,2018-02-13
3770,서울,서초구,3,0,0,3,2,0,2018-03-13
3771,서울,서초구,2,0,2,4,4,0,2018-04-13
3772,서울,서초구,1,0,1,2,2,0,2018-05-13
3773,서울,서초구,3,0,0,3,1,0,2018-06-13
3774,서울,서초구,4,1,0,5,4,0,2018-07-13
3775,서울,서초구,2,1,2,5,5,0,2018-08-13
3776,서울,서초구,5,2,5,12,12,0,2018-09-13
3777,서울,서초구,9,1,0,10,6,0,2018-10-13
3778,서울,서초구,17,0,2,19,12,0,2018-11-13
3779,서울,서초구,10,0,2,12,7,0,2018-12-13
3780,서울,성동구,3,0,1,4,3,0,2018-01-13
3781,서울,성동구,2,0,1,3,3,0,2018-02-13
3782,서울,성동구,2,0,0,2,1,0,2018-03-13
3783,서울,성동구,4,0,3,7,6,0,2018-04-13
3784,서울,성동구,3,3,3,9,7,0,2018-05-13
3785,서울,성동구,3,2,0,5,3,0,2018-06-13
3786,서울,성동구,4,1,0,5,5,0,2018-07-13
3787,서울,성동구,3,0,1,4,4,0,2018-08-13
3788,서울,성동구,1,0,2,3,3,1,2018-09-13
3789,서울,성동구,5,0,0,5,5,0,2018-10-13
3790,서울,성동구,2,0,3,5,4,0,2018-11-13
3791,서울,성동구,7,0,2,9,6,0,2018-12-13
3792,서울,성북구,6,0,3,9,5,0,2018-01-13
3793,서울,성북구,6,1,0,7,6,1,2018-02-13
3794,서울,성북구,1,0,1,2,2,0,2018-03-13
3795,서울,성북구,0,0,0,0,0,0,2018-04-13
3796,서울,성북구,6,1,2,9,5,0,2018-05-13
3797,서울,성북구,0,1,1,2,2,0,2018-06-13
3798,서울,성북구,3,0,0,3,2,0,2018-07-13
3799,서울,성북구,3,1,1,5,4,0,2018-08-13
3800,서울,성북구,3,0,0,3,3,0,2018-09-13
3801,서울,성북구,3,0,0,3,3,0,2018-10-13
3802,서울,성북구,5,1,1,7,6,0,2018-11-13
3803,서울,성북구,4,0,1,5,5,1,2018-12-13
3804,서울,송파구,7,6,1,14,10,0,2018-01-13
3805,서울,송파구,7,0,4,11,10,0,2018-02-13
3806,서울,송파구,10,0,1,11,8,0,2018-03-13
3807,서울,송파구,11,3,1,15,9,0,2018-04-13
3808,서울,송파구,8,0,2,10,7,0,2018-05-13
3809,서울,송파구,4,3,1,8,7,0,2018-06-13
3810,서울,송파구,6,3,1,10,8,0,2018-07-13
3811,서울,송파구,5,0,1,6,4,0,2018-08-13
3812,서울,송파구,7,0,1,8,7,0,2018-09-13
3813,서울,송파구,4,0,0,4,5,1,2018-10-13
3814,서울,송파구,10,2,2,14,11,0,2018-11-13
3815,서울,송파구,7,0,2,9,5,0,2018-12-13
3816,서울,양천구,2,2,2,6,4,0,2018-01-13
3817,서울,양천구,8,1,0,9,8,0,2018-02-13
3818,서울,양천구,6,0,1,7,6,0,2018-03-13
3819,서울,양천구,4,0,2,6,6,0,2018-04-13
3820,서울,양천구,3,0,0,3,3,0,2018-05-13
3821,서울,양천구,3,0,1,4,2,0,2018-06-13
3822,서울,양천구,5,0,1,6,4,0,2018-07-13
3823,서울,양천구,1,1,1,3,3,0,2018-08-13
3824,서울,양천구,4,0,2,6,6,0,2018-09-13
3825,서울,양천구,5,1,0,6,5,0,2018-10-13
3826,서울,양천구,1,1,1,3,3,0,2018-11-13
3827,서울,양천구,0,0,0,0,0,0,2018-12-13
3828,서울,영등포구,17,1,0,18,13,1,2018-01-13
3829,서울,영등포구,11,3,4,18,13,0,2018-02-13
3830,서울,영등포구,5,1,1,7,4,0,2018-03-13
3831,서울,영등포구,9,2,1,12,12,0,2018-04-13
3832,서울,영등포구,9,1,1,11,5,0,2018-05-13
3833,서울,영등포구,3,1,2,6,6,0,2018-06-13
3834,서울,영등포구,3,1,2,6,5,1,2018-07-13
3835,서울,영등포구,7,1,3,11,9,0,2018-08-13
3836,서울,영등포구,16,1,3,20,11,0,2018-09-13
3837,서울,영등포구,9,0,3,12,5,0,2018-10-13
3838,서울,영등포구,11,0,4,15,13,0,2018-11-13
3839,서울,영등포구,7,0,2,9,5,0,2018-12-13
3840,서울,용산구,16,0,0,16,9,0,2018-01-13
3841,서울,용산구,4,0,2,6,3,0,2018-02-13
3842,서울,용산구,4,1,0,5,3,0,2018-03-13
3843,서울,용산구,1,0,0,1,1,0,2018-04-13
3844,서울,용산구,5,0,2,7,6,0,2018-05-13
3845,서울,용산구,1,3,1,5,4,0,2018-06-13
3846,서울,용산구,3,1,0,4,4,0,2018-07-13
3847,서울,용산구,5,0,0,5,4,0,2018-08-13
3848,서울,용산구,4,1,0,5,5,0,2018-09-13
3849,서울,용산구,1,0,3,4,4,0,2018-10-13
3850,서울,용산구,2,0,1,3,3,0,2018-11-13
3851,서울,용산구,0,0,0,0,0,0,2018-12-13
3852,서울,은평구,2,0,0,2,2,0,2018-01-13
3853,서울,은평구,4,1,2,7,5,0,2018-02-13
3854,서울,은평구,2,0,1,3,2,1,2018-03-13
3855,서울,은평구,2,0,0,2,2,0,2018-04-13
3856,서울,은평구,6,0,1,7,3,0,2018-05-13
3857,서울,은평구,0,0,0,0,0,0,2018-06-13
3858,서울,은평구,6,0,0,6,5,1,2018-07-13
3859,서울,은평구,3,0,0,3,2,0,2018-08-13
3860,서울,은평구,2,0,0,2,2,0,2018-09-13
3861,서울,은평구,6,0,1,7,4,0,2018-10-13
3862,서울,은평구,1,0,1,2,2,0,2018-11-13
3863,서울,은평구,4,0,2,6,3,0,2018-12-13
3864,서울,종로구,1,0,0,1,1,0,2018-01-13
3865,서울,종로구,2,0,0,2,1,0,2018-02-13
3866,서울,종로구,1,0,1,2,2,0,2018-03-13
3867,서울,종로구,1,0,1,2,2,0,2018-04-13
3868,서울,종로구,2,1,2,5,4,0,2018-05-13
3869,서울,종로구,0,0,0,0,0,0,2018-06-13
3870,서울,종로구,3,1,0,4,4,0,2018-07-13
3871,서울,종로구,3,1,3,7,5,0,2018-08-13
3872,서울,종로구,4,0,1,5,4,0,2018-09-13
3873,서울,종로구,10,4,3,17,8,0,2018-10-13
3874,서울,종로구,4,0,2,6,3,0,2018-11-13
3875,서울,종로구,3,0,1,4,3,0,2018-12-13
3876,서울,중구,1,0,0,1,1,0,2018-01-13
3877,서울,중구,1,2,1,4,3,0,2018-02-13
3878,서울,중구,5,1,0,6,6,0,2018-03-13
3879,서울,중구,4,3,3,10,8,0,2018-04-13
3880,서울,중구,4,1,1,6,4,0,2018-05-13
3881,서울,중구,2,0,0,2,1,0,2018-06-13
3882,서울,중구,2,0,0,2,1,0,2018-07-13
3883,서울,중구,3,0,0,3,3,0,2018-08-13
3884,서울,중구,1,0,0,1,1,0,2018-09-13
3885,서울,중구,2,0,1,3,3,0,2018-10-13
3886,서울,중구,0,1,0,1,2,1,2018-11-13
3887,서울,중구,4,0,0,4,2,0,2018-12-13
3888,서울,중랑구,7,0,4,11,9,0,2018-01-13
3889,서울,중랑구,7,1,1,9,9,0,2018-02-13
3890,서울,중랑구,2,1,2,5,5,0,2018-03-13
3891,서울,중랑구,4,1,0,5,4,0,2018-04-13
3892,서울,중랑구,3,2,3,8,8,0,2018-05-13
3893,서울,중랑구,7,0,0,7,5,0,2018-06-13
3894,서울,중랑구,1,2,0,3,3,0,2018-07-13
3895,서울,중랑구,5,0,2,7,7,1,2018-08-13
3896,서울,중랑구,6,1,0,7,6,0,2018-09-13
3897,서울,중랑구,2,0,0,2,1,0,2018-10-13
3898,서울,중랑구,0,0,1,1,1,0,2018-11-13
3899,서울,중랑구,4,0,1,5,3,0,2018-12-13
3900,서울,강남구,13,2,2,17,9,0,2018-01-14
3901,서울,강남구,13,0,4,17,9,0,2018-02-14
3902,서울,강남구,8,0,4,12,10,0,2018-03-14
3903,서울,강남구,16,4,3,23,11,0,2018-04-14
3904,서울,강남구,5,2,2,9,9,0,2018-05-14
3905,서울,강남구,8,3,0,11,8,0,2018-06-14
3906,서울,강남구,9,0,1,10,5,0,2018-07-14
3907,서울,강남구,9,0,1,10,9,0,2018-08-14
3908,서울,강남구,14,0,3,17,12,0,2018-09-14
3909,서울,강남구,8,0,2,10,8,0,2018-10-14
3910,서울,강남구,8,2,3,13,12,1,2018-11-14
3911,서울,강남구,8,1,1,10,9,0,2018-12-14
3912,서울,강동구,0,0,1,1,1,0,2018-01-14
3913,서울,강동구,3,0,3,6,5,0,2018-02-14
3914,서울,강동구,4,0,0,4,3,0,2018-03-14
3915,서울,강동구,2,1,0,3,3,0,2018-04-14
3916,서울,강동구,3,0,1,4,4,0,2018-05-14
3917,서울,강동구,7,0,2,9,6,0,2018-06-14
3918,서울,강동구,6,3,1,10,8,0,2018-07-14
3919,서울,강동구,6,2,0,8,7,0,2018-08-14
3920,서울,강동구,0,1,2,3,3,0,2018-09-14
3921,서울,강동구,9,0,1,10,6,0,2018-10-14
3922,서울,강동구,4,1,0,5,5,1,2018-11-14
3923,서울,강동구,2,1,1,4,4,0,2018-12-14
3924,서울,강북구,0,0,0,0,0,0,2018-01-14
3925,서울,강북구,7,1,0,8,6,0,2018-02-14
3926,서울,강북구,1,2,1,4,4,0,2018-03-14
3927,서울,강북구,3,0,0,3,3,0,2018-04-14
3928,서울,강북구,6,0,2,8,6,0,2018-05-14
3929,서울,강북구,1,0,2,3,3,0,2018-06-14
3930,서울,강북구,7,0,0,7,2,0,2018-07-14
3931,서울,강북구,0,0,1,1,1,0,2018-08-14
3932,서울,강북구,1,0,2,3,2,0,2018-09-14
3933,서울,강북구,13,0,2,15,10,0,2018-10-14
3934,서울,강북구,1,1,1,3,3,0,2018-11-14
3935,서울,강북구,2,1,2,5,4,0,2018-12-14
3936,서울,강서구,7,0,2,9,5,0,2018-01-14
3937,서울,강서구,4,0,1,5,4,0,2018-02-14
3938,서울,강서구,2,0,1,3,3,0,2018-03-14
3939,서울,강서구,2,0,0,2,2,0,2018-04-14
3940,서울,강서구,7,0,2,9,4,0,2018-05-14
3941,서울,강서구,7,1,4,12,4,0,2018-06-14
3942,서울,강서구,2,2,0,4,1,0,2018-07-14
3943,서울,강서구,12,3,1,16,13,0,2018-08-14
3944,서울,강서구,5,1,1,7,4,0,2018-09-14
3945,서울,강서구,2,0,1,3,3,0,2018-10-14
3946,서울,강서구,7,0,1,8,3,0,2018-11-14
3947,서울,강서구,4,0,6,10,7,0,2018-12-14
3948,서울,관악구,3,0,1,4,3,0,2018-01-14
3949,서울,관악구,5,2,0,7,4,0,2018-02-14
3950,서울,관악구,2,0,2,4,4,0,2018-03-14
3951,서울,관악구,0,0,1,1,1,0,2018-04-14
3952,서울,관악구,0,0,0,0,0,0,2018-05-14
3953,서울,관악구,4,0,1,5,4,0,2018-06-14
3954,서울,관악구,1,0,0,1,1,0,2018-07-14
3955,서울,관악구,3,2,1,6,4,0,2018-08-14
3956,서울,관악구,9,2,2,13,7,0,2018-09-14
3957,서울,관악구,5,0,2,7,3,0,2018-10-14
3958,서울,관악구,6,0,4,10,9,0,2018-11-14
3959,서울,관악구,1,1,2,4,3,0,2018-12-14
3960,서울,광진구,4,0,1,5,4,0,2018-01-14
3961,서울,광진구,5,1,1,7,5,0,2018-02-14
3962,서울,광진구,0,0,0,0,0,0,2018-03-14
3963,서울,광진구,2,0,0,2,2,0,2018-04-14
3964,서울,광진구,2,0,1,3,3,0,2018-05-14
3965,서울,광진구,3,1,4,8,6,0,2018-06-14
3966,서울,광진구,4,1,0,5,4,0,2018-07-14
3967,서울,광진구,2,0,2,4,2,0,2018-08-14
3968,서울,광진구,4,0,1,5,4,0,2018-09-14
3969,서울,광진구,3,0,2,5,4,0,2018-10-14
3970,서울,광진구,5,0,2,7,7,1,2018-11-14
3971,서울,광진구,0,1,2,3,3,0,2018-12-14
3972,서울,구로구,4,0,1,5,3,0,2018-01-14
3973,서울,구로구,8,0,3,11,10,0,2018-02-14
3974,서울,구로구,4,0,2,6,5,0,2018-03-14
3975,서울,구로구,3,0,3,6,5,0,2018-04-14
3976,서울,구로구,5,0,2,7,4,0,2018-05-14
3977,서울,구로구,4,2,0,6,4,0,2018-06-14
3978,서울,구로구,1,0,0,1,1,0,2018-07-14
3979,서울,구로구,3,0,1,4,3,0,2018-08-14
3980,서울,구로구,3,0,1,4,3,0,2018-09-14
3981,서울,구로구,2,1,3,6,4,0,2018-10-14
3982,서울,구로구,4,0,0,4,3,0,2018-11-14
3983,서울,구로구,4,0,1,5,5,0,2018-12-14
3984,서울,금천구,5,0,1,6,1,0,2018-01-14
3985,서울,금천구,2,0,3,5,5,0,2018-02-14
3986,서울,금천구,6,0,0,6,4,0,2018-03-14
3987,서울,금천구,2,0,4,6,4,0,2018-04-14
3988,서울,금천구,4,0,0,4,4,0,2018-05-14
3989,서울,금천구,3,0,0,3,3,0,2018-06-14
3990,서울,금천구,4,1,2,7,6,0,2018-07-14
3991,서울,금천구,4,0,0,4,4,0,2018-08-14
3992,서울,금천구,7,1,1,9,5,0,2018-09-14
3993,서울,금천구,0,0,0,0,0,0,2018-10-14
3994,서울,금천구,1,0,1,2,2,0,2018-11-14
3995,서울,금천구,3,2,1,6,5,0,2018-12-14
3996,서울,노원구,5,1,2,8,6,0,2018-01-14
3997,서울,노원구,10,0,2,12,9,0,2018-02-14
3998,서울,노원구,6,0,0,6,3,0,2018-03-14
3999,서울,노원구,7,0,3,10,8,0,2018-04-14
4000,서울,노원구,6,0,2,8,3,0,2018-05-14
4001,서울,노원구,2,1,0,3,3,0,2018-06-14
4002,서울,노원구,6,2,0,8,3,0,2018-07-14
4003,서울,노원구,2,0,0,2,2,0,2018-08-14
4004,서울,노원구,8,0,1,9,4,0,2018-09-14
4005,서울,노원구,2,0,1,3,1,0,2018-10-14
4006,서울,노원구,6,0,0,6,4,1,2018-11-14
4007,서울,노원구,5,1,1,7,3,0,2018-12-14
4008,서울,도봉구,3,0,4,7,5,0,2018-01-14
4009,서울,도봉구,3,0,0,3,3,0,2018-02-14
4010,서울,도봉구,0,0,2,2,2,0,2018-03-14
4011,서울,도봉구,6,0,1,7,3,0,2018-04-14
4012,서울,도봉구,0,0,0,0,0,0,2018-05-14
4013,서울,도봉구,3,0,0,3,3,0,2018-06-14
4014,서울,도봉구,1,0,0,1,1,0,2018-07-14
4015,서울,도봉구,3,0,0,3,2,0,2018-08-14
4016,서울,도봉구,1,0,0,1,1,0,2018-09-14
4017,서울,도봉구,1,1,2,4,2,0,2018-10-14
4018,서울,도봉구,3,1,0,4,3,0,2018-11-14
4019,서울,도봉구,4,0,0,4,3,0,2018-12-14
4020,서울,동대문구,2,0,0,2,2,0,2018-01-14
4021,서울,동대문구,2,1,3,6,6,0,2018-02-14
4022,서울,동대문구,6,1,0,7,5,0,2018-03-14
4023,서울,동대문구,3,1,3,7,5,0,2018-04-14
4024,서울,동대문구,6,0,1,7,5,0,2018-05-14
4025,서울,동대문구,2,2,2,6,6,0,2018-06-14
4026,서울,동대문구,4,1,3,8,8,0,2018-07-14
4027,서울,동대문구,5,0,1,6,4,0,2018-08-14
4028,서울,동대문구,5,0,1,6,5,0,2018-09-14
4029,서울,동대문구,5,0,0,5,3,0,2018-10-14
4030,서울,동대문구,2,0,0,2,2,0,2018-11-14
4031,서울,동대문구,4,0,1,5,5,0,2018-12-14
4032,서울,동작구,1,0,1,2,2,0,2018-01-14
4033,서울,동작구,9,1,2,12,9,0,2018-02-14
4034,서울,동작구,1,0,0,1,1,0,2018-03-14
4035,서울,동작구,2,0,0,2,2,1,2018-04-14
4036,서울,동작구,2,0,1,3,2,0,2018-05-14
4037,서울,동작구,3,0,2,5,5,0,2018-06-14
4038,서울,동작구,4,1,0,5,3,0,2018-07-14
4039,서울,동작구,2,0,1,3,3,0,2018-08-14
4040,서울,동작구,1,0,1,2,2,0,2018-09-14
4041,서울,동작구,0,0,0,0,0,0,2018-10-14
4042,서울,동작구,2,0,2,4,3,0,2018-11-14
4043,서울,동작구,3,0,2,5,4,0,2018-12-14
4044,서울,마포구,4,1,0,5,5,0,2018-01-14
4045,서울,마포구,3,0,1,4,4,0,2018-02-14
4046,서울,마포구,1,0,2,3,3,0,2018-03-14
4047,서울,마포구,3,0,0,3,2,0,2018-04-14
4048,서울,마포구,1,0,3,4,4,1,2018-05-14
4049,서울,마포구,8,1,3,12,4,0,2018-06-14
4050,서울,마포구,5,2,1,8,4,0,2018-07-14
4051,서울,마포구,4,0,2,6,6,1,2018-08-14
4052,서울,마포구,6,2,0,8,5,0,2018-09-14
4053,서울,마포구,6,0,2,8,4,0,2018-10-14
4054,서울,마포구,4,0,1,5,4,0,2018-11-14
4055,서울,마포구,8,0,3,11,5,0,2018-12-14
4056,서울,서대문구,2,0,1,3,2,0,2018-01-14
4057,서울,서대문구,5,0,3,8,6,1,2018-02-14
4058,서울,서대문구,0,0,1,1,1,0,2018-03-14
4059,서울,서대문구,3,0,0,3,3,0,2018-04-14
4060,서울,서대문구,1,0,2,3,3,0,2018-05-14
4061,서울,서대문구,1,0,2,3,3,0,2018-06-14
4062,서울,서대문구,4,0,1,5,5,0,2018-07-14
4063,서울,서대문구,2,0,0,2,2,0,2018-08-14
4064,서울,서대문구,3,0,2,5,4,0,2018-09-14
4065,서울,서대문구,6,0,0,6,2,0,2018-10-14
4066,서울,서대문구,2,2,0,4,3,0,2018-11-14
4067,서울,서대문구,3,0,1,4,3,0,2018-12-14
4068,서울,서초구,18,0,4,22,9,0,2018-01-14
4069,서울,서초구,3,0,4,7,6,0,2018-02-14
4070,서울,서초구,3,0,1,4,3,0,2018-03-14
4071,서울,서초구,5,0,1,6,3,0,2018-04-14
4072,서울,서초구,4,1,4,9,5,0,2018-05-14
4073,서울,서초구,17,0,1,18,8,0,2018-06-14
4074,서울,서초구,15,0,1,16,7,0,2018-07-14
4075,서울,서초구,10,2,2,14,4,0,2018-08-14
4076,서울,서초구,4,0,2,6,4,0,2018-09-14
4077,서울,서초구,4,3,1,8,4,0,2018-10-14
4078,서울,서초구,4,0,2,6,3,0,2018-11-14
4079,서울,서초구,10,0,3,13,9,0,2018-12-14
4080,서울,성동구,2,0,2,4,1,0,2018-01-14
4081,서울,성동구,3,0,0,3,3,0,2018-02-14
4082,서울,성동구,0,0,0,0,0,0,2018-03-14
4083,서울,성동구,3,0,0,3,1,0,2018-04-14
4084,서울,성동구,0,1,0,1,1,0,2018-05-14
4085,서울,성동구,5,0,1,6,4,0,2018-06-14
4086,서울,성동구,4,0,1,5,5,0,2018-07-14
4087,서울,성동구,8,2,0,10,6,0,2018-08-14
4088,서울,성동구,0,0,0,0,0,0,2018-09-14
4089,서울,성동구,4,0,0,4,2,0,2018-10-14
4090,서울,성동구,3,0,0,3,3,0,2018-11-14
4091,서울,성동구,5,0,0,5,3,0,2018-12-14
4092,서울,성북구,6,1,2,9,5,0,2018-01-14
4093,서울,성북구,2,0,2,4,4,0,2018-02-14
4094,서울,성북구,2,0,2,4,4,0,2018-03-14
4095,서울,성북구,5,1,1,7,4,0,2018-04-14
4096,서울,성북구,7,1,2,10,5,0,2018-05-14
4097,서울,성북구,4,1,2,7,5,0,2018-06-14
4098,서울,성북구,4,1,1,6,4,0,2018-07-14
4099,서울,성북구,3,2,0,5,3,0,2018-08-14
4100,서울,성북구,5,1,1,7,6,0,2018-09-14
4101,서울,성북구,5,0,2,7,3,0,2018-10-14
4102,서울,성북구,2,0,0,2,2,0,2018-11-14
4103,서울,성북구,5,0,2,7,7,0,2018-12-14
4104,서울,송파구,1,2,1,4,3,0,2018-01-14
4105,서울,송파구,6,0,2,8,6,0,2018-02-14
4106,서울,송파구,2,0,0,2,2,0,2018-03-14
4107,서울,송파구,9,3,2,14,10,0,2018-04-14
4108,서울,송파구,5,0,0,5,5,0,2018-05-14
4109,서울,송파구,0,1,4,5,5,0,2018-06-14
4110,서울,송파구,1,0,1,2,2,0,2018-07-14
4111,서울,송파구,7,1,0,8,7,0,2018-08-14
4112,서울,송파구,13,0,0,13,10,0,2018-09-14
4113,서울,송파구,7,5,1,13,7,0,2018-10-14
4114,서울,송파구,6,1,0,7,6,0,2018-11-14
4115,서울,송파구,7,0,0,7,7,0,2018-12-14
4116,서울,양천구,3,1,1,5,5,0,2018-01-14
4117,서울,양천구,4,0,1,5,3,0,2018-02-14
4118,서울,양천구,1,1,0,2,2,0,2018-03-14
4119,서울,양천구,0,0,1,1,1,0,2018-04-14
4120,서울,양천구,6,1,2,9,4,0,2018-05-14
4121,서울,양천구,2,0,1,3,4,1,2018-06-14
4122,서울,양천구,7,1,2,10,7,0,2018-07-14
4123,서울,양천구,2,1,0,3,2,0,2018-08-14
4124,서울,양천구,3,0,0,3,3,0,2018-09-14
4125,서울,양천구,4,1,2,7,5,0,2018-10-14
4126,서울,양천구,5,0,0,5,5,0,2018-11-14
4127,서울,양천구,9,0,2,11,7,0,2018-12-14
4128,서울,영등포구,4,1,0,5,3,0,2018-01-14
4129,서울,영등포구,12,0,2,14,12,0,2018-02-14
4130,서울,영등포구,4,0,0,4,3,0,2018-03-14
4131,서울,영등포구,4,2,1,7,5,0,2018-04-14
4132,서울,영등포구,5,0,0,5,4,0,2018-05-14
4133,서울,영등포구,9,1,3,13,8,0,2018-06-14
4134,서울,영등포구,6,1,0,7,6,0,2018-07-14
4135,서울,영등포구,10,4,0,14,10,0,2018-08-14
4136,서울,영등포구,8,2,5,15,10,0,2018-09-14
4137,서울,영등포구,4,1,2,7,4,0,2018-10-14
4138,서울,영등포구,11,0,3,14,12,0,2018-11-14
4139,서울,영등포구,18,0,3,21,13,0,2018-12-14
4140,서울,용산구,9,0,0,9,6,0,2018-01-14
4141,서울,용산구,13,0,2,15,9,0,2018-02-14
4142,서울,용산구,1,0,0,1,1,0,2018-03-14
4143,서울,용산구,1,0,3,4,3,0,2018-04-14
4144,서울,용산구,6,0,0,6,2,0,2018-05-14
4145,서울,용산구,1,0,0,1,1,0,2018-06-14
4146,서울,용산구,0,0,1,1,1,0,2018-07-14
4147,서울,용산구,2,2,2,6,4,0,2018-08-14
4148,서울,용산구,8,1,1,10,9,0,2018-09-14
4149,서울,용산구,2,1,2,5,4,0,2018-10-14
4150,서울,용산구,1,0,3,4,3,0,2018-11-14
4151,서울,용산구,12,0,0,12,2,0,2018-12-14
4152,서울,은평구,4,0,0,4,3,0,2018-01-14
4153,서울,은평구,4,0,1,5,4,0,2018-02-14
4154,서울,은평구,3,0,0,3,2,0,2018-03-14
4155,서울,은평구,4,1,2,7,5,0,2018-04-14
4156,서울,은평구,4,0,0,4,3,0,2018-05-14
4157,서울,은평구,2,0,1,3,2,0,2018-06-14
4158,서울,은평구,6,0,3,9,5,0,2018-07-14
4159,서울,은평구,8,0,3,11,8,0,2018-08-14
4160,서울,은평구,2,0,1,3,3,0,2018-09-14
4161,서울,은평구,1,0,2,3,3,0,2018-10-14
4162,서울,은평구,2,0,1,3,3,0,2018-11-14
4163,서울,은평구,3,0,0,3,3,0,2018-12-14
4164,서울,종로구,2,0,0,2,2,0,2018-01-14
4165,서울,종로구,6,2,1,9,6,0,2018-02-14
4166,서울,종로구,2,0,0,2,2,0,2018-03-14
4167,서울,종로구,3,1,0,4,3,0,2018-04-14
4168,서울,종로구,5,0,1,6,5,0,2018-05-14
4169,서울,종로구,4,0,2,6,3,0,2018-06-14
4170,서울,종로구,1,0,3,4,4,0,2018-07-14
4171,서울,종로구,4,1,0,5,3,0,2018-08-14
4172,서울,종로구,0,0,0,0,0,0,2018-09-14
4173,서울,종로구,1,1,3,5,4,0,2018-10-14
4174,서울,종로구,3,0,0,3,3,0,2018-11-14
4175,서울,종로구,4,0,1,5,5,0,2018-12-14
4176,서울,중구,0,0,1,1,1,0,2018-01-14
4177,서울,중구,4,0,2,6,5,0,2018-02-14
4178,서울,중구,0,0,4,4,4,0,2018-03-14
4179,서울,중구,0,0,0,0,0,0,2018-04-14
4180,서울,중구,0,0,0,0,0,0,2018-05-14
4181,서울,중구,2,1,0,3,3,0,2018-06-14
4182,서울,중구,5,0,0,5,4,0,2018-07-14
4183,서울,중구,3,0,1,4,2,0,2018-08-14
4184,서울,중구,3,0,1,4,3,0,2018-09-14
4185,서울,중구,0,0,0,0,0,0,2018-10-14
4186,서울,중구,8,1,2,11,6,0,2018-11-14
4187,서울,중구,1,0,2,3,3,0,2018-12-14
4188,서울,중랑구,2,2,3,7,6,0,2018-01-14
4189,서울,중랑구,7,0,0,7,5,0,2018-02-14
4190,서울,중랑구,6,0,1,7,6,0,2018-03-14
4191,서울,중랑구,2,0,1,3,3,0,2018-04-14
4192,서울,중랑구,9,1,2,12,7,0,2018-05-14
4193,서울,중랑구,5,1,0,6,5,0,2018-06-14
4194,서울,중랑구,1,0,1,2,2,0,2018-07-14
4195,서울,중랑구,8,0,0,8,7,0,2018-08-14
4196,서울,중랑구,4,0,2,6,3,0,2018-09-14
4197,서울,중랑구,3,1,1,5,5,0,2018-10-14
4198,서울,중랑구,8,0,3,11,8,0,2018-11-14
4199,서울,중랑구,2,0,2,4,3,0,2018-12-14
4200,서울,강남구,13,1,2,16,10,0,2018-01-15
4201,서울,강남구,2,0,1,3,2,0,2018-02-15
4202,서울,강남구,8,0,0,8,5,0,2018-03-15
4203,서울,강남구,3,0,2,5,5,0,2018-04-15
4204,서울,강남구,11,1,1,13,11,0,2018-05-15
4205,서울,강남구,9,1,4,14,9,0,2018-06-15
4206,서울,강남구,4,2,1,7,5,0,2018-07-15
4207,서울,강남구,14,3,2,19,7,0,2018-08-15
4208,서울,강남구,14,0,1,15,11,0,2018-09-15
4209,서울,강남구,8,0,0,8,4,0,2018-10-15
4210,서울,강남구,9,2,2,13,6,0,2018-11-15
4211,서울,강남구,20,3,3,26,16,0,2018-12-15
4212,서울,강동구,6,1,5,12,8,0,2018-01-15
4213,서울,강동구,0,0,2,2,2,0,2018-02-15
4214,서울,강동구,3,1,0,4,4,0,2018-03-15
4215,서울,강동구,2,0,1,3,3,0,2018-04-15
4216,서울,강동구,4,0,0,4,3,0,2018-05-15
4217,서울,강동구,6,1,2,9,6,0,2018-06-15
4218,서울,강동구,2,0,1,3,3,0,2018-07-15
4219,서울,강동구,5,0,1,6,5,0,2018-08-15
4220,서울,강동구,7,3,0,10,6,0,2018-09-15
4221,서울,강동구,3,0,1,4,4,0,2018-10-15
4222,서울,강동구,3,3,2,8,6,0,2018-11-15
4223,서울,강동구,4,2,4,10,6,0,2018-12-15
4224,서울,강북구,2,0,1,3,3,0,2018-01-15
4225,서울,강북구,5,0,2,7,3,0,2018-02-15
4226,서울,강북구,4,0,1,5,3,0,2018-03-15
4227,서울,강북구,1,0,0,1,1,0,2018-04-15
4228,서울,강북구,2,1,3,6,5,0,2018-05-15
4229,서울,강북구,3,0,0,3,3,0,2018-06-15
4230,서울,강북구,4,0,1,5,4,0,2018-07-15
4231,서울,강북구,3,1,0,4,3,0,2018-08-15
4232,서울,강북구,2,0,1,3,2,0,2018-09-15
4233,서울,강북구,0,0,1,1,1,0,2018-10-15
4234,서울,강북구,10,0,2,12,4,0,2018-11-15
4235,서울,강북구,7,0,1,8,6,0,2018-12-15
4236,서울,강서구,4,1,0,5,4,0,2018-01-15
4237,서울,강서구,6,0,0,6,3,0,2018-02-15
4238,서울,강서구,4,0,2,6,5,0,2018-03-15
4239,서울,강서구,4,0,1,5,3,0,2018-04-15
4240,서울,강서구,6,1,1,8,4,0,2018-05-15
4241,서울,강서구,2,0,0,2,2,0,2018-06-15
4242,서울,강서구,0,0,1,1,1,0,2018-07-15
4243,서울,강서구,6,0,2,8,4,0,2018-08-15
4244,서울,강서구,2,0,1,3,3,0,2018-09-15
4245,서울,강서구,4,0,0,4,3,0,2018-10-15
4246,서울,강서구,5,0,2,7,5,0,2018-11-15
4247,서울,강서구,5,0,1,6,5,1,2018-12-15
4248,서울,관악구,8,1,2,11,6,0,2018-01-15
4249,서울,관악구,3,0,1,4,3,0,2018-02-15
4250,서울,관악구,4,2,2,8,7,0,2018-03-15
4251,서울,관악구,3,0,2,5,5,0,2018-04-15
4252,서울,관악구,2,2,1,5,4,0,2018-05-15
4253,서울,관악구,2,2,0,4,3,0,2018-06-15
4254,서울,관악구,3,0,1,4,3,0,2018-07-15
4255,서울,관악구,4,0,1,5,5,0,2018-08-15
4256,서울,관악구,4,0,0,4,4,0,2018-09-15
4257,서울,관악구,1,0,1,2,2,0,2018-10-15
4258,서울,관악구,3,0,2,5,5,0,2018-11-15
4259,서울,관악구,3,0,2,5,4,0,2018-12-15
4260,서울,광진구,2,0,0,2,2,0,2018-01-15
4261,서울,광진구,0,0,0,0,0,0,2018-02-15
4262,서울,광진구,4,0,2,6,5,0,2018-03-15
4263,서울,광진구,1,0,0,1,1,0,2018-04-15
4264,서울,광진구,4,0,1,5,4,0,2018-05-15
4265,서울,광진구,2,0,0,2,2,0,2018-06-15
4266,서울,광진구,6,2,0,8,5,0,2018-07-15
4267,서울,광진구,3,1,3,7,4,0,2018-08-15
4268,서울,광진구,1,0,4,5,5,0,2018-09-15
4269,서울,광진구,2,0,1,3,2,0,2018-10-15
4270,서울,광진구,4,0,3,7,3,0,2018-11-15
4271,서울,광진구,2,0,1,3,3,0,2018-12-15
4272,서울,구로구,4,0,1,5,4,0,2018-01-15
4273,서울,구로구,1,0,1,2,2,0,2018-02-15
4274,서울,구로구,7,0,2,9,9,0,2018-03-15
4275,서울,구로구,0,0,0,0,0,0,2018-04-15
4276,서울,구로구,2,0,1,3,3,0,2018-05-15
4277,서울,구로구,2,0,0,2,2,0,2018-06-15
4278,서울,구로구,4,0,0,4,3,0,2018-07-15
4279,서울,구로구,5,0,1,6,5,0,2018-08-15
4280,서울,구로구,11,3,2,16,10,0,2018-09-15
4281,서울,구로구,4,0,0,4,4,0,2018-10-15
4282,서울,구로구,9,1,3,13,9,1,2018-11-15
4283,서울,구로구,4,0,0,4,4,0,2018-12-15
4284,서울,금천구,4,0,0,4,2,0,2018-01-15
4285,서울,금천구,0,1,2,3,3,0,2018-02-15
4286,서울,금천구,3,1,1,5,4,0,2018-03-15
4287,서울,금천구,5,0,2,7,3,0,2018-04-15
4288,서울,금천구,0,0,0,0,0,0,2018-05-15
4289,서울,금천구,5,0,0,5,2,0,2018-06-15
4290,서울,금천구,1,0,0,1,1,0,2018-07-15
4291,서울,금천구,0,0,0,0,0,0,2018-08-15
4292,서울,금천구,6,0,3,9,6,0,2018-09-15
4293,서울,금천구,4,0,2,6,3,0,2018-10-15
4294,서울,금천구,0,0,0,0,0,0,2018-11-15
4295,서울,금천구,1,0,1,2,2,0,2018-12-15
4296,서울,노원구,7,2,2,11,8,0,2018-01-15
4297,서울,노원구,4,0,0,4,3,0,2018-02-15
4298,서울,노원구,6,0,2,8,6,0,2018-03-15
4299,서울,노원구,0,0,0,0,0,0,2018-04-15
4300,서울,노원구,4,2,1,7,6,0,2018-05-15
4301,서울,노원구,6,2,3,11,10,0,2018-06-15
4302,서울,노원구,13,2,1,16,3,0,2018-07-15
4303,서울,노원구,3,0,1,4,4,0,2018-08-15
4304,서울,노원구,6,0,1,7,4,0,2018-09-15
4305,서울,노원구,2,1,1,4,5,1,2018-10-15
4306,서울,노원구,3,0,0,3,2,0,2018-11-15
4307,서울,노원구,6,1,0,7,7,0,2018-12-15
4308,서울,도봉구,1,0,0,1,1,0,2018-01-15
4309,서울,도봉구,1,2,0,3,2,0,2018-02-15
4310,서울,도봉구,1,0,0,1,1,0,2018-03-15
4311,서울,도봉구,0,0,0,0,0,0,2018-04-15
4312,서울,도봉구,0,1,1,2,2,0,2018-05-15
4313,서울,도봉구,4,0,1,5,5,0,2018-06-15
4314,서울,도봉구,1,0,1,2,2,0,2018-07-15
4315,서울,도봉구,1,0,0,1,1,0,2018-08-15
4316,서울,도봉구,0,2,2,4,2,0,2018-09-15
4317,서울,도봉구,1,1,0,2,1,0,2018-10-15
4318,서울,도봉구,1,0,0,1,1,0,2018-11-15
4319,서울,도봉구,1,0,1,2,2,0,2018-12-15
4320,서울,동대문구,5,1,3,9,7,0,2018-01-15
4321,서울,동대문구,6,0,5,11,5,0,2018-02-15
4322,서울,동대문구,3,0,0,3,3,0,2018-03-15
4323,서울,동대문구,1,3,3,7,5,0,2018-04-15
4324,서울,동대문구,2,0,0,2,2,0,2018-05-15
4325,서울,동대문구,4,0,2,6,5,0,2018-06-15
4326,서울,동대문구,2,0,1,3,3,0,2018-07-15
4327,서울,동대문구,4,0,0,4,4,0,2018-08-15
4328,서울,동대문구,6,2,2,10,6,0,2018-09-15
4329,서울,동대문구,11,1,2,14,8,0,2018-10-15
4330,서울,동대문구,0,0,2,2,2,0,2018-11-15
4331,서울,동대문구,11,1,1,13,9,0,2018-12-15
4332,서울,동작구,1,0,2,3,3,0,2018-01-15
4333,서울,동작구,1,0,1,2,2,0,2018-02-15
4334,서울,동작구,1,0,1,2,2,0,2018-03-15
4335,서울,동작구,5,1,1,7,5,0,2018-04-15
4336,서울,동작구,6,1,2,9,6,0,2018-05-15
4337,서울,동작구,5,1,2,8,6,0,2018-06-15
4338,서울,동작구,0,1,0,1,1,0,2018-07-15
4339,서울,동작구,3,0,0,3,3,0,2018-08-15
4340,서울,동작구,1,0,3,4,4,0,2018-09-15
4341,서울,동작구,0,1,0,1,1,0,2018-10-15
4342,서울,동작구,4,0,0,4,4,0,2018-11-15
4343,서울,동작구,3,0,0,3,2,0,2018-12-15
4344,서울,마포구,10,0,0,10,6,0,2018-01-15
4345,서울,마포구,7,0,2,9,3,0,2018-02-15
4346,서울,마포구,3,1,2,6,4,0,2018-03-15
4347,서울,마포구,1,0,1,2,2,0,2018-04-15
4348,서울,마포구,2,0,0,2,3,1,2018-05-15
4349,서울,마포구,6,0,2,8,6,0,2018-06-15
4350,서울,마포구,5,0,4,9,5,0,2018-07-15
4351,서울,마포구,2,0,1,3,2,0,2018-08-15
4352,서울,마포구,4,0,2,6,4,0,2018-09-15
4353,서울,마포구,4,0,1,5,3,0,2018-10-15
4354,서울,마포구,5,0,0,5,5,0,2018-11-15
4355,서울,마포구,1,0,3,4,3,0,2018-12-15
4356,서울,서대문구,0,1,2,3,3,0,2018-01-15
4357,서울,서대문구,6,1,0,7,4,0,2018-02-15
4358,서울,서대문구,1,0,1,2,2,0,2018-03-15
4359,서울,서대문구,0,1,0,1,1,0,2018-04-15
4360,서울,서대문구,1,0,1,2,1,0,2018-05-15
4361,서울,서대문구,3,1,1,5,3,0,2018-06-15
4362,서울,서대문구,2,1,0,3,3,0,2018-07-15
4363,서울,서대문구,7,4,1,12,7,0,2018-08-15
4364,서울,서대문구,2,0,0,2,1,0,2018-09-15
4365,서울,서대문구,0,0,0,0,0,0,2018-10-15
4366,서울,서대문구,5,1,1,7,5,0,2018-11-15
4367,서울,서대문구,7,4,1,12,5,0,2018-12-15
4368,서울,서초구,6,0,2,8,6,0,2018-01-15
4369,서울,서초구,9,0,1,10,4,0,2018-02-15
4370,서울,서초구,8,1,0,9,6,0,2018-03-15
4371,서울,서초구,2,0,0,2,2,0,2018-04-15
4372,서울,서초구,4,0,2,6,4,0,2018-05-15
4373,서울,서초구,13,1,1,15,12,0,2018-06-15
4374,서울,서초구,18,6,2,26,11,1,2018-07-15
4375,서울,서초구,6,1,2,9,7,0,2018-08-15
4376,서울,서초구,14,3,3,20,9,0,2018-09-15
4377,서울,서초구,5,1,0,6,6,0,2018-10-15
4378,서울,서초구,3,0,5,8,7,0,2018-11-15
4379,서울,서초구,12,4,0,16,11,0,2018-12-15
4380,서울,성동구,0,0,0,0,1,1,2018-01-15
4381,서울,성동구,2,0,1,3,2,0,2018-02-15
4382,서울,성동구,5,0,2,7,6,0,2018-03-15
4383,서울,성동구,2,0,1,3,3,0,2018-04-15
4384,서울,성동구,3,0,4,7,5,0,2018-05-15
4385,서울,성동구,1,0,2,3,3,0,2018-06-15
4386,서울,성동구,2,0,1,3,2,0,2018-07-15
4387,서울,성동구,2,1,1,4,3,0,2018-08-15
4388,서울,성동구,0,0,0,0,0,0,2018-09-15
4389,서울,성동구,2,0,0,2,2,0,2018-10-15
4390,서울,성동구,1,0,1,2,2,0,2018-11-15
4391,서울,성동구,2,2,2,6,5,0,2018-12-15
4392,서울,성북구,2,2,0,4,4,0,2018-01-15
4393,서울,성북구,1,0,2,3,2,0,2018-02-15
4394,서울,성북구,3,0,2,5,5,0,2018-03-15
4395,서울,성북구,13,0,4,17,4,0,2018-04-15
4396,서울,성북구,7,0,1,8,6,0,2018-05-15
4397,서울,성북구,0,1,0,1,1,0,2018-06-15
4398,서울,성북구,2,1,0,3,3,0,2018-07-15
4399,서울,성북구,3,0,0,3,2,0,2018-08-15
4400,서울,성북구,6,0,1,7,6,0,2018-09-15
4401,서울,성북구,8,0,5,13,11,0,2018-10-15
4402,서울,성북구,2,1,1,4,4,0,2018-11-15
4403,서울,성북구,14,2,2,18,10,1,2018-12-15
4404,서울,송파구,7,1,2,10,10,0,2018-01-15
4405,서울,송파구,4,0,3,7,5,0,2018-02-15
4406,서울,송파구,4,1,0,5,5,0,2018-03-15
4407,서울,송파구,7,1,0,8,6,1,2018-04-15
4408,서울,송파구,6,1,2,9,8,0,2018-05-15
4409,서울,송파구,11,4,0,15,14,0,2018-06-15
4410,서울,송파구,8,0,0,8,6,0,2018-07-15
4411,서울,송파구,11,0,1,12,6,0,2018-08-15
4412,서울,송파구,9,0,4,13,7,0,2018-09-15
4413,서울,송파구,7,1,1,9,6,0,2018-10-15
4414,서울,송파구,8,2,1,11,7,0,2018-11-15
4415,서울,송파구,4,0,0,4,3,0,2018-12-15
4416,서울,양천구,2,0,0,2,2,0,2018-01-15
4417,서울,양천구,3,0,1,4,3,0,2018-02-15
4418,서울,양천구,1,0,1,2,2,0,2018-03-15
4419,서울,양천구,0,0,0,0,0,0,2018-04-15
4420,서울,양천구,3,0,1,4,3,0,2018-05-15
4421,서울,양천구,9,0,1,10,5,0,2018-06-15
4422,서울,양천구,5,0,1,6,4,0,2018-07-15
4423,서울,양천구,4,0,3,7,4,0,2018-08-15
4424,서울,양천구,1,0,0,1,1,0,2018-09-15
4425,서울,양천구,1,1,0,2,1,0,2018-10-15
4426,서울,양천구,2,0,0,2,2,0,2018-11-15
4427,서울,양천구,4,2,1,7,7,0,2018-12-15
4428,서울,영등포구,11,0,3,14,11,0,2018-01-15
4429,서울,영등포구,4,0,1,5,3,0,2018-02-15
4430,서울,영등포구,7,6,3,16,10,1,2018-03-15
4431,서울,영등포구,7,0,1,8,3,0,2018-04-15
4432,서울,영등포구,3,2,1,6,5,0,2018-05-15
4433,서울,영등포구,4,1,0,5,5,0,2018-06-15
4434,서울,영등포구,5,2,2,9,5,0,2018-07-15
4435,서울,영등포구,8,0,3,11,8,0,2018-08-15
4436,서울,영등포구,13,2,2,17,6,0,2018-09-15
4437,서울,영등포구,5,0,0,5,4,0,2018-10-15
4438,서울,영등포구,5,0,1,6,5,0,2018-11-15
4439,서울,영등포구,6,0,6,12,8,0,2018-12-15
4440,서울,용산구,1,1,1,3,3,0,2018-01-15
4441,서울,용산구,3,0,0,3,2,0,2018-02-15
4442,서울,용산구,6,0,3,9,5,0,2018-03-15
4443,서울,용산구,1,0,1,2,2,0,2018-04-15
4444,서울,용산구,4,0,0,4,4,0,2018-05-15
4445,서울,용산구,5,1,1,7,6,0,2018-06-15
4446,서울,용산구,1,1,0,2,2,0,2018-07-15
4447,서울,용산구,6,0,7,13,3,0,2018-08-15
4448,서울,용산구,3,0,1,4,3,0,2018-09-15
4449,서울,용산구,6,0,1,7,4,0,2018-10-15
4450,서울,용산구,0,0,0,0,0,0,2018-11-15
4451,서울,용산구,7,0,2,9,5,0,2018-12-15
4452,서울,은평구,2,0,0,2,2,0,2018-01-15
4453,서울,은평구,1,0,1,2,2,0,2018-02-15
4454,서울,은평구,1,0,0,1,1,0,2018-03-15
4455,서울,은평구,2,0,0,2,2,0,2018-04-15
4456,서울,은평구,3,0,0,3,1,0,2018-05-15
4457,서울,은평구,4,1,1,6,6,0,2018-06-15
4458,서울,은평구,2,0,2,4,3,0,2018-07-15
4459,서울,은평구,2,1,0,3,2,0,2018-08-15
4460,서울,은평구,4,0,3,7,5,0,2018-09-15
4461,서울,은평구,2,0,1,3,3,0,2018-10-15
4462,서울,은평구,2,0,0,2,2,0,2018-11-15
4463,서울,은평구,1,2,1,4,4,0,2018-12-15
4464,서울,종로구,3,3,2,8,6,0,2018-01-15
4465,서울,종로구,0,0,0,0,0,0,2018-02-15
4466,서울,종로구,3,1,1,5,5,0,2018-03-15
4467,서울,종로구,1,0,1,2,2,0,2018-04-15
4468,서울,종로구,1,0,0,1,1,0,2018-05-15
4469,서울,종로구,1,0,2,3,3,0,2018-06-15
4470,서울,종로구,1,0,0,1,1,0,2018-07-15
4471,서울,종로구,4,1,1,6,5,0,2018-08-15
4472,서울,종로구,5,1,0,6,6,0,2018-09-15
4473,서울,종로구,6,0,2,8,5,0,2018-10-15
4474,서울,종로구,1,0,1,2,2,0,2018-11-15
4475,서울,종로구,3,1,0,4,2,0,2018-12-15
4476,서울,중구,3,1,1,5,3,0,2018-01-15
4477,서울,중구,4,0,0,4,4,1,2018-02-15
4478,서울,중구,2,1,2,5,3,0,2018-03-15
4479,서울,중구,0,0,0,0,0,0,2018-04-15
4480,서울,중구,2,0,0,2,2,0,2018-05-15
4481,서울,중구,3,0,2,5,5,0,2018-06-15
4482,서울,중구,3,0,1,4,2,0,2018-07-15
4483,서울,중구,4,0,2,6,3,0,2018-08-15
4484,서울,중구,1,0,0,1,1,0,2018-09-15
4485,서울,중구,0,0,1,1,1,0,2018-10-15
4486,서울,중구,3,1,0,4,2,0,2018-11-15
4487,서울,중구,4,0,0,4,3,0,2018-12-15
4488,서울,중랑구,4,0,0,4,2,0,2018-01-15
4489,서울,중랑구,5,0,2,7,6,0,2018-02-15
4490,서울,중랑구,1,2,0,3,3,0,2018-03-15
4491,서울,중랑구,1,0,2,3,3,0,2018-04-15
4492,서울,중랑구,0,1,2,3,2,0,2018-05-15
4493,서울,중랑구,1,0,0,1,1,0,2018-06-15
4494,서울,중랑구,5,0,0,5,2,0,2018-07-15
4495,서울,중랑구,0,0,1,1,1,0,2018-08-15
4496,서울,중랑구,5,0,0,5,3,0,2018-09-15
4497,서울,중랑구,6,0,1,7,5,0,2018-10-15
4498,서울,중랑구,3,0,2,5,5,0,2018-11-15
4499,서울,중랑구,6,0,1,7,6,0,2018-12-15
4500,서울,강남구,15,2,2,19,13,0,2018-01-16
4501,서울,강남구,7,0,0,7,3,0,2018-02-16
4502,서울,강남구,6,0,2,8,7,0,2018-03-16
4503,서울,강남구,3,0,3,6,6,0,2018-04-16
4504,서울,강남구,14,0,2,16,11,0,2018-05-16
4505,서울,강남구,12,0,3,15,10,0,2018-06-16
4506,서울,강남구,19,1,3,23,19,0,2018-07-16
4507,서울,강남구,10,1,2,13,6,0,2018-08-16
4508,서울,강남구,5,0,1,6,4,0,2018-09-16
4509,서울,강남구,8,1,6,15,10,0,2018-10-16
4510,서울,강남구,11,0,2,13,11,0,2018-11-16
4511,서울,강남구,8,0,7,15,7,0,2018-12-16
4512,서울,강동구,2,0,0,2,2,0,2018-01-16
4513,서울,강동구,9,0,1,10,3,0,2018-02-16
4514,서울,강동구,4,1,4,9,8,0,2018-03-16
4515,서울,강동구,1,1,0,2,2,0,2018-04-16
4516,서울,강동구,3,0,2,5,4,0,2018-05-16
4517,서울,강동구,6,2,7,15,8,0,2018-06-16
4518,서울,강동구,1,1,2,4,4,0,2018-07-16
4519,서울,강동구,5,1,0,6,5,0,2018-08-16
4520,서울,강동구,1,0,0,1,1,0,2018-09-16
4521,서울,강동구,1,1,1,3,3,0,2018-10-16
4522,서울,강동구,7,0,0,7,6,0,2018-11-16
4523,서울,강동구,5,0,1,6,3,0,2018-12-16
4524,서울,강북구,3,1,1,5,5,0,2018-01-16
4525,서울,강북구,3,1,2,6,5,0,2018-02-16
4526,서울,강북구,2,0,1,3,2,0,2018-03-16
4527,서울,강북구,6,0,2,8,6,0,2018-04-16
4528,서울,강북구,2,0,1,3,3,0,2018-05-16
4529,서울,강북구,9,1,1,11,8,0,2018-06-16
4530,서울,강북구,9,1,2,12,7,1,2018-07-16
4531,서울,강북구,3,0,2,5,5,0,2018-08-16
4532,서울,강북구,4,0,0,4,2,0,2018-09-16
4533,서울,강북구,3,0,1,4,3,0,2018-10-16
4534,서울,강북구,1,0,2,3,2,0,2018-11-16
4535,서울,강북구,3,0,0,3,2,0,2018-12-16
4536,서울,강서구,6,0,0,6,2,0,2018-01-16
4537,서울,강서구,2,0,2,4,4,0,2018-02-16
4538,서울,강서구,2,0,2,4,4,0,2018-03-16
4539,서울,강서구,4,1,0,5,2,0,2018-04-16
4540,서울,강서구,6,0,1,7,5,0,2018-05-16
4541,서울,강서구,5,1,1,7,5,0,2018-06-16
4542,서울,강서구,6,0,0,6,4,0,2018-07-16
4543,서울,강서구,7,1,1,9,6,0,2018-08-16
4544,서울,강서구,2,2,0,4,3,0,2018-09-16
4545,서울,강서구,1,0,1,2,2,0,2018-10-16
4546,서울,강서구,0,1,3,4,4,0,2018-11-16
4547,서울,강서구,8,2,2,12,5,0,2018-12-16
4548,서울,관악구,1,2,0,3,3,0,2018-01-16
4549,서울,관악구,1,0,0,1,1,0,2018-02-16
4550,서울,관악구,4,0,2,6,4,0,2018-03-16
4551,서울,관악구,8,0,2,10,8,0,2018-04-16
4552,서울,관악구,5,0,0,5,4,0,2018-05-16
4553,서울,관악구,3,0,0,3,3,0,2018-06-16
4554,서울,관악구,1,1,1,3,3,0,2018-07-16
4555,서울,관악구,3,1,0,4,3,0,2018-08-16
4556,서울,관악구,3,0,0,3,3,0,2018-09-16
4557,서울,관악구,2,0,1,3,3,0,2018-10-16
4558,서울,관악구,5,0,1,6,3,0,2018-11-16
4559,서울,관악구,3,0,0,3,3,0,2018-12-16
4560,서울,광진구,3,0,0,3,2,0,2018-01-16
4561,서울,광진구,2,0,0,2,1,0,2018-02-16
4562,서울,광진구,0,0,3,3,3,0,2018-03-16
4563,서울,광진구,3,1,1,5,4,0,2018-04-16
4564,서울,광진구,1,0,1,2,1,0,2018-05-16
4565,서울,광진구,5,1,1,7,4,0,2018-06-16
4566,서울,광진구,1,0,0,1,1,0,2018-07-16
4567,서울,광진구,1,1,1,3,3,0,2018-08-16
4568,서울,광진구,2,0,1,3,2,0,2018-09-16
4569,서울,광진구,2,0,1,3,2,0,2018-10-16
4570,서울,광진구,2,0,1,3,3,0,2018-11-16
4571,서울,광진구,1,0,0,1,1,0,2018-12-16
4572,서울,구로구,7,0,3,10,5,0,2018-01-16
4573,서울,구로구,1,0,0,1,1,0,2018-02-16
4574,서울,구로구,8,0,2,10,6,0,2018-03-16
4575,서울,구로구,7,0,1,8,6,0,2018-04-16
4576,서울,구로구,7,0,1,8,5,0,2018-05-16
4577,서울,구로구,2,1,0,3,1,0,2018-06-16
4578,서울,구로구,12,0,1,13,8,1,2018-07-16
4579,서울,구로구,0,0,0,0,0,0,2018-08-16
4580,서울,구로구,1,1,3,5,5,0,2018-09-16
4581,서울,구로구,4,2,1,7,3,0,2018-10-16
4582,서울,구로구,2,0,3,5,5,0,2018-11-16
4583,서울,구로구,3,0,1,4,3,0,2018-12-16
4584,서울,금천구,4,0,0,4,2,0,2018-01-16
4585,서울,금천구,14,1,2,17,5,0,2018-02-16
4586,서울,금천구,4,0,1,5,5,0,2018-03-16
4587,서울,금천구,0,0,2,2,2,0,2018-04-16
4588,서울,금천구,2,1,1,4,4,0,2018-05-16
4589,서울,금천구,0,0,1,1,1,0,2018-06-16
4590,서울,금천구,2,0,0,2,2,0,2018-07-16
4591,서울,금천구,1,0,0,1,1,0,2018-08-16
4592,서울,금천구,0,0,0,0,0,0,2018-09-16
4593,서울,금천구,1,0,0,1,1,0,2018-10-16
4594,서울,금천구,2,2,1,5,4,0,2018-11-16
4595,서울,금천구,0,0,0,0,0,0,2018-12-16
4596,서울,노원구,2,0,3,5,5,0,2018-01-16
4597,서울,노원구,4,0,1,5,2,0,2018-02-16
4598,서울,노원구,2,0,1,3,3,0,2018-03-16
4599,서울,노원구,4,3,2,9,8,0,2018-04-16
4600,서울,노원구,4,0,0,4,3,0,2018-05-16
4601,서울,노원구,4,4,0,8,4,0,2018-06-16
4602,서울,노원구,11,3,1,15,9,0,2018-07-16
4603,서울,노원구,3,1,0,4,4,0,2018-08-16
4604,서울,노원구,2,1,3,6,5,0,2018-09-16
4605,서울,노원구,4,0,1,5,5,0,2018-10-16
4606,서울,노원구,8,0,2,10,6,0,2018-11-16
4607,서울,노원구,3,0,1,4,3,0,2018-12-16
4608,서울,도봉구,1,0,1,2,2,0,2018-01-16
4609,서울,도봉구,0,0,0,0,0,0,2018-02-16
4610,서울,도봉구,2,0,1,3,3,0,2018-03-16
4611,서울,도봉구,1,2,0,3,3,0,2018-04-16
4612,서울,도봉구,4,0,1,5,4,0,2018-05-16
4613,서울,도봉구,0,1,1,2,2,0,2018-06-16
4614,서울,도봉구,1,0,0,1,1,0,2018-07-16
4615,서울,도봉구,4,1,1,6,6,0,2018-08-16
4616,서울,도봉구,5,1,0,6,3,0,2018-09-16
4617,서울,도봉구,6,1,1,8,5,0,2018-10-16
4618,서울,도봉구,0,0,0,0,0,0,2018-11-16
4619,서울,도봉구,3,0,0,3,2,0,2018-12-16
4620,서울,동대문구,3,0,1,4,4,0,2018-01-16
4621,서울,동대문구,0,0,1,1,1,0,2018-02-16
4622,서울,동대문구,2,0,3,5,5,0,2018-03-16
4623,서울,동대문구,0,1,1,2,2,0,2018-04-16
4624,서울,동대문구,1,1,1,3,3,0,2018-05-16
4625,서울,동대문구,5,0,2,7,5,0,2018-06-16
4626,서울,동대문구,5,0,1,6,5,0,2018-07-16
4627,서울,동대문구,1,1,2,4,4,0,2018-08-16
4628,서울,동대문구,2,1,1,4,2,0,2018-09-16
4629,서울,동대문구,1,0,3,4,4,0,2018-10-16
4630,서울,동대문구,8,0,1,9,7,0,2018-11-16
4631,서울,동대문구,2,0,0,2,2,0,2018-12-16
4632,서울,동작구,1,2,0,3,1,0,2018-01-16
4633,서울,동작구,0,0,0,0,0,0,2018-02-16
4634,서울,동작구,8,0,0,8,5,0,2018-03-16
4635,서울,동작구,3,0,0,3,2,0,2018-04-16
4636,서울,동작구,2,0,1,3,3,0,2018-05-16
4637,서울,동작구,3,0,2,5,4,0,2018-06-16
4638,서울,동작구,4,0,0,4,3,0,2018-07-16
4639,서울,동작구,5,1,2,8,5,0,2018-08-16
4640,서울,동작구,3,1,1,5,4,0,2018-09-16
4641,서울,동작구,0,2,2,4,3,0,2018-10-16
4642,서울,동작구,2,0,0,2,2,0,2018-11-16
4643,서울,동작구,2,2,1,5,5,0,2018-12-16
4644,서울,마포구,4,0,1,5,5,0,2018-01-16
4645,서울,마포구,4,0,0,4,2,0,2018-02-16
4646,서울,마포구,5,0,2,7,6,0,2018-03-16
4647,서울,마포구,13,0,0,13,10,0,2018-04-16
4648,서울,마포구,8,0,0,8,6,0,2018-05-16
4649,서울,마포구,6,1,0,7,4,0,2018-06-16
4650,서울,마포구,3,0,1,4,2,0,2018-07-16
4651,서울,마포구,3,0,0,3,3,0,2018-08-16
4652,서울,마포구,5,2,3,10,8,0,2018-09-16
4653,서울,마포구,2,0,0,2,2,0,2018-10-16
4654,서울,마포구,9,1,4,14,9,0,2018-11-16
4655,서울,마포구,1,0,1,2,2,0,2018-12-16
4656,서울,서대문구,3,1,0,4,3,0,2018-01-16
4657,서울,서대문구,1,0,3,4,2,0,2018-02-16
4658,서울,서대문구,2,0,1,3,3,0,2018-03-16
4659,서울,서대문구,0,0,0,0,0,0,2018-04-16
4660,서울,서대문구,2,0,0,2,1,0,2018-05-16
4661,서울,서대문구,3,0,1,4,3,0,2018-06-16
4662,서울,서대문구,2,0,1,3,3,0,2018-07-16
4663,서울,서대문구,2,0,1,3,2,0,2018-08-16
4664,서울,서대문구,5,0,1,6,3,0,2018-09-16
4665,서울,서대문구,3,0,1,4,3,0,2018-10-16
4666,서울,서대문구,4,1,1,6,5,0,2018-11-16
4667,서울,서대문구,3,0,2,5,4,0,2018-12-16
4668,서울,서초구,15,3,6,24,13,0,2018-01-16
4669,서울,서초구,9,1,0,10,5,0,2018-02-16
4670,서울,서초구,3,0,4,7,7,0,2018-03-16
4671,서울,서초구,4,1,0,5,3,0,2018-04-16
4672,서울,서초구,8,3,0,11,9,0,2018-05-16
4673,서울,서초구,3,0,1,4,3,0,2018-06-16
4674,서울,서초구,7,0,2,9,7,0,2018-07-16
4675,서울,서초구,17,0,4,21,9,0,2018-08-16
4676,서울,서초구,5,1,3,9,9,0,2018-09-16
4677,서울,서초구,3,0,2,5,4,0,2018-10-16
4678,서울,서초구,7,1,4,12,11,0,2018-11-16
4679,서울,서초구,3,0,1,4,4,0,2018-12-16
4680,서울,성동구,3,0,1,4,4,0,2018-01-16
4681,서울,성동구,0,1,0,1,1,0,2018-02-16
4682,서울,성동구,4,1,2,7,3,0,2018-03-16
4683,서울,성동구,5,0,0,5,5,0,2018-04-16
4684,서울,성동구,3,0,1,4,3,0,2018-05-16
4685,서울,성동구,4,0,4,8,5,0,2018-06-16
4686,서울,성동구,3,0,1,4,4,0,2018-07-16
4687,서울,성동구,1,0,0,1,1,0,2018-08-16
4688,서울,성동구,3,0,2,5,4,0,2018-09-16
4689,서울,성동구,5,2,1,8,3,0,2018-10-16
4690,서울,성동구,3,0,3,6,6,0,2018-11-16
4691,서울,성동구,2,0,0,2,1,0,2018-12-16
4692,서울,성북구,3,0,2,5,4,0,2018-01-16
4693,서울,성북구,2,0,1,3,2,0,2018-02-16
4694,서울,성북구,2,2,5,9,3,0,2018-03-16
4695,서울,성북구,10,0,1,11,10,0,2018-04-16
4696,서울,성북구,5,0,2,7,4,0,2018-05-16
4697,서울,성북구,1,0,0,1,1,0,2018-06-16
4698,서울,성북구,5,0,3,8,6,0,2018-07-16
4699,서울,성북구,5,0,0,5,4,0,2018-08-16
4700,서울,성북구,11,0,2,13,8,0,2018-09-16
4701,서울,성북구,0,0,0,0,0,0,2018-10-16
4702,서울,성북구,2,0,1,3,3,0,2018-11-16
4703,서울,성북구,9,0,0,9,6,0,2018-12-16
4704,서울,송파구,5,0,2,7,6,0,2018-01-16
4705,서울,송파구,0,1,1,2,2,0,2018-02-16
4706,서울,송파구,5,3,1,9,7,0,2018-03-16
4707,서울,송파구,14,1,3,18,11,1,2018-04-16
4708,서울,송파구,6,1,1,8,7,0,2018-05-16
4709,서울,송파구,14,1,2,17,13,0,2018-06-16
4710,서울,송파구,9,0,4,13,10,0,2018-07-16
4711,서울,송파구,5,2,2,9,9,0,2018-08-16
4712,서울,송파구,3,0,1,4,3,0,2018-09-16
4713,서울,송파구,3,1,1,5,5,0,2018-10-16
4714,서울,송파구,7,2,2,11,10,0,2018-11-16
4715,서울,송파구,6,0,0,6,3,0,2018-12-16
4716,서울,양천구,7,0,2,9,6,0,2018-01-16
4717,서울,양천구,1,0,0,1,1,0,2018-02-16
4718,서울,양천구,8,1,0,9,6,0,2018-03-16
4719,서울,양천구,0,0,4,4,4,0,2018-04-16
4720,서울,양천구,2,0,2,4,3,0,2018-05-16
4721,서울,양천구,2,0,1,3,3,0,2018-06-16
4722,서울,양천구,4,1,0,5,5,0,2018-07-16
4723,서울,양천구,3,1,1,5,4,0,2018-08-16
4724,서울,양천구,1,0,0,1,1,0,2018-09-16
4725,서울,양천구,3,0,3,6,6,0,2018-10-16
4726,서울,양천구,1,0,7,8,1,0,2018-11-16
4727,서울,양천구,0,0,0,0,0,0,2018-12-16
4728,서울,영등포구,3,1,0,4,3,0,2018-01-16
4729,서울,영등포구,9,0,1,10,4,0,2018-02-16
4730,서울,영등포구,10,1,6,17,15,1,2018-03-16
4731,서울,영등포구,10,1,3,14,11,0,2018-04-16
4732,서울,영등포구,7,0,1,8,5,0,2018-05-16
4733,서울,영등포구,10,0,2,12,8,0,2018-06-16
4734,서울,영등포구,5,0,4,9,6,0,2018-07-16
4735,서울,영등포구,5,2,4,11,6,0,2018-08-16
4736,서울,영등포구,10,0,2,12,8,0,2018-09-16
4737,서울,영등포구,5,0,4,9,8,0,2018-10-16
4738,서울,영등포구,10,1,2,13,9,0,2018-11-16
4739,서울,영등포구,8,0,0,8,6,0,2018-12-16
4740,서울,용산구,1,0,0,1,1,0,2018-01-16
4741,서울,용산구,2,0,1,3,2,0,2018-02-16
4742,서울,용산구,3,0,1,4,4,0,2018-03-16
4743,서울,용산구,3,0,0,3,3,0,2018-04-16
4744,서울,용산구,2,0,4,6,5,0,2018-05-16
4745,서울,용산구,2,0,1,3,1,0,2018-06-16
4746,서울,용산구,2,1,0,3,2,0,2018-07-16
4747,서울,용산구,6,0,1,7,6,0,2018-08-16
4748,서울,용산구,0,0,0,0,0,0,2018-09-16
4749,서울,용산구,0,0,0,0,0,0,2018-10-16
4750,서울,용산구,6,0,0,6,4,0,2018-11-16
4751,서울,용산구,1,0,0,1,1,0,2018-12-16
4752,서울,은평구,3,0,0,3,3,0,2018-01-16
4753,서울,은평구,2,0,0,2,2,0,2018-02-16
4754,서울,은평구,4,0,2,6,4,0,2018-03-16
4755,서울,은평구,6,0,1,7,3,0,2018-04-16
4756,서울,은평구,7,0,0,7,4,0,2018-05-16
4757,서울,은평구,5,2,2,9,6,0,2018-06-16
4758,서울,은평구,2,0,1,3,2,0,2018-07-16
4759,서울,은평구,4,0,1,5,3,0,2018-08-16
4760,서울,은평구,1,2,0,3,2,0,2018-09-16
4761,서울,은평구,3,2,1,6,5,0,2018-10-16
4762,서울,은평구,4,0,4,8,5,0,2018-11-16
4763,서울,은평구,1,0,0,1,1,0,2018-12-16
4764,서울,종로구,2,0,0,2,2,0,2018-01-16
4765,서울,종로구,0,0,0,0,0,0,2018-02-16
4766,서울,종로구,1,2,1,4,4,0,2018-03-16
4767,서울,종로구,2,1,1,4,4,0,2018-04-16
4768,서울,종로구,2,0,0,2,2,0,2018-05-16
4769,서울,종로구,5,1,0,6,4,0,2018-06-16
4770,서울,종로구,3,1,0,4,2,0,2018-07-16
4771,서울,종로구,5,0,1,6,5,0,2018-08-16
4772,서울,종로구,3,0,0,3,2,0,2018-09-16
4773,서울,종로구,1,0,3,4,3,0,2018-10-16
4774,서울,종로구,6,1,0,7,6,0,2018-11-16
4775,서울,종로구,0,1,0,1,1,0,2018-12-16
4776,서울,중구,3,1,0,4,3,0,2018-01-16
4777,서울,중구,1,0,0,1,1,0,2018-02-16
4778,서울,중구,4,1,1,6,5,0,2018-03-16
4779,서울,중구,2,0,0,2,1,0,2018-04-16
4780,서울,중구,2,0,3,5,4,0,2018-05-16
4781,서울,중구,4,0,1,5,5,0,2018-06-16
4782,서울,중구,2,0,0,2,2,0,2018-07-16
4783,서울,중구,6,0,1,7,3,0,2018-08-16
4784,서울,중구,1,1,0,2,2,0,2018-09-16
4785,서울,중구,4,0,2,6,4,0,2018-10-16
4786,서울,중구,5,3,2,10,4,0,2018-11-16
4787,서울,중구,0,0,0,0,0,0,2018-12-16
4788,서울,중랑구,1,0,3,4,4,0,2018-01-16
4789,서울,중랑구,3,0,0,3,2,0,2018-02-16
4790,서울,중랑구,6,0,3,9,7,0,2018-03-16
4791,서울,중랑구,2,0,0,2,2,0,2018-04-16
4792,서울,중랑구,0,0,0,0,0,0,2018-05-16
4793,서울,중랑구,3,1,3,7,3,0,2018-06-16
4794,서울,중랑구,14,3,4,21,12,0,2018-07-16
4795,서울,중랑구,6,0,0,6,4,0,2018-08-16
4796,서울,중랑구,6,1,1,8,6,0,2018-09-16
4797,서울,중랑구,2,0,4,6,3,0,2018-10-16
4798,서울,중랑구,1,0,3,4,4,0,2018-11-16
4799,서울,중랑구,7,2,2,11,7,0,2018-12-16
4800,서울,강남구,15,4,4,23,17,0,2018-01-17
4801,서울,강남구,1,0,0,1,1,0,2018-02-17
4802,서울,강남구,10,1,7,18,12,1,2018-03-17
4803,서울,강남구,14,1,2,17,10,0,2018-04-17
4804,서울,강남구,9,0,3,12,9,0,2018-05-17
4805,서울,강남구,10,0,1,11,8,0,2018-06-17
4806,서울,강남구,14,1,3,18,14,0,2018-07-17
4807,서울,강남구,17,1,2,20,10,0,2018-08-17
4808,서울,강남구,7,0,1,8,5,0,2018-09-17
4809,서울,강남구,9,1,2,12,11,0,2018-10-17
4810,서울,강남구,14,2,4,20,14,0,2018-11-17
4811,서울,강남구,10,0,5,15,11,0,2018-12-17
4812,서울,강동구,0,0,0,0,0,0,2018-01-17
4813,서울,강동구,1,0,1,2,1,0,2018-02-17
4814,서울,강동구,10,0,4,14,8,0,2018-03-17
4815,서울,강동구,3,0,2,5,3,0,2018-04-17
4816,서울,강동구,6,1,0,7,4,0,2018-05-17
4817,서울,강동구,1,0,2,3,2,0,2018-06-17
4818,서울,강동구,2,1,1,4,3,0,2018-07-17
4819,서울,강동구,4,1,1,6,4,0,2018-08-17
4820,서울,강동구,4,0,0,4,4,0,2018-09-17
4821,서울,강동구,2,2,5,9,9,0,2018-10-17
4822,서울,강동구,5,1,2,8,6,0,2018-11-17
4823,서울,강동구,8,0,2,10,9,0,2018-12-17
4824,서울,강북구,1,1,3,5,5,0,2018-01-17
4825,서울,강북구,5,0,0,5,4,0,2018-02-17
4826,서울,강북구,5,0,1,6,5,0,2018-03-17
4827,서울,강북구,4,0,0,4,4,0,2018-04-17
4828,서울,강북구,0,0,3,3,3,0,2018-05-17
4829,서울,강북구,3,0,0,3,3,0,2018-06-17
4830,서울,강북구,3,0,1,4,3,0,2018-07-17
4831,서울,강북구,3,0,4,7,5,0,2018-08-17
4832,서울,강북구,7,1,0,8,8,0,2018-09-17
4833,서울,강북구,1,0,0,1,1,0,2018-10-17
4834,서울,강북구,9,1,0,10,6,0,2018-11-17
4835,서울,강북구,3,0,2,5,5,0,2018-12-17
4836,서울,강서구,4,0,4,8,7,0,2018-01-17
4837,서울,강서구,2,0,0,2,2,0,2018-02-17
4838,서울,강서구,3,1,0,4,1,0,2018-03-17
4839,서울,강서구,18,3,2,23,7,0,2018-04-17
4840,서울,강서구,4,2,2,8,6,0,2018-05-17
4841,서울,강서구,5,0,0,5,4,0,2018-06-17
4842,서울,강서구,3,0,1,4,3,0,2018-07-17
4843,서울,강서구,6,1,3,10,5,0,2018-08-17
4844,서울,강서구,5,1,2,8,5,0,2018-09-17
4845,서울,강서구,3,0,1,4,3,0,2018-10-17
4846,서울,강서구,4,0,4,8,7,0,2018-11-17
4847,서울,강서구,6,0,4,10,6,0,2018-12-17
4848,서울,관악구,0,0,0,0,0,0,2018-01-17
4849,서울,관악구,3,0,0,3,2,0,2018-02-17
4850,서울,관악구,4,0,1,5,3,0,2018-03-17
4851,서울,관악구,10,1,1,12,7,0,2018-04-17
4852,서울,관악구,4,1,0,5,3,0,2018-05-17
4853,서울,관악구,1,0,1,2,2,0,2018-06-17
4854,서울,관악구,7,1,1,9,6,0,2018-07-17
4855,서울,관악구,7,0,1,8,5,0,2018-08-17
4856,서울,관악구,6,0,0,6,3,0,2018-09-17
4857,서울,관악구,1,0,0,1,1,0,2018-10-17
4858,서울,관악구,7,0,2,9,6,0,2018-11-17
4859,서울,관악구,2,0,1,3,2,0,2018-12-17
4860,서울,광진구,1,1,0,2,1,0,2018-01-17
4861,서울,광진구,4,0,3,7,3,0,2018-02-17
4862,서울,광진구,2,0,1,3,2,0,2018-03-17
4863,서울,광진구,1,1,3,5,4,0,2018-04-17
4864,서울,광진구,11,1,2,14,5,0,2018-05-17
4865,서울,광진구,0,0,0,0,0,0,2018-06-17
4866,서울,광진구,1,0,3,4,3,0,2018-07-17
4867,서울,광진구,2,0,1,3,3,0,2018-08-17
4868,서울,광진구,1,0,2,3,3,0,2018-09-17
4869,서울,광진구,4,1,0,5,3,0,2018-10-17
4870,서울,광진구,6,0,1,7,3,0,2018-11-17
4871,서울,광진구,2,0,0,2,2,0,2018-12-17
4872,서울,구로구,1,1,1,3,2,0,2018-01-17
4873,서울,구로구,4,0,0,4,3,1,2018-02-17
4874,서울,구로구,11,0,2,13,7,0,2018-03-17
4875,서울,구로구,6,0,5,11,8,0,2018-04-17
4876,서울,구로구,3,0,3,6,4,0,2018-05-17
4877,서울,구로구,0,0,0,0,0,0,2018-06-17
4878,서울,구로구,1,0,0,1,1,0,2018-07-17
4879,서울,구로구,10,1,2,13,11,0,2018-08-17
4880,서울,구로구,3,0,2,5,5,1,2018-09-17
4881,서울,구로구,5,1,2,8,7,0,2018-10-17
4882,서울,구로구,3,0,2,5,4,0,2018-11-17
4883,서울,구로구,4,0,0,4,3,0,2018-12-17
4884,서울,금천구,3,1,1,5,4,0,2018-01-17
4885,서울,금천구,0,0,0,0,0,0,2018-02-17
4886,서울,금천구,0,0,1,1,1,0,2018-03-17
4887,서울,금천구,2,0,0,2,2,0,2018-04-17
4888,서울,금천구,6,0,1,7,6,0,2018-05-17
4889,서울,금천구,0,0,0,0,0,0,2018-06-17
4890,서울,금천구,2,0,0,2,2,0,2018-07-17
4891,서울,금천구,1,0,2,3,3,0,2018-08-17
4892,서울,금천구,1,0,1,2,2,0,2018-09-17
4893,서울,금천구,0,0,1,1,1,0,2018-10-17
4894,서울,금천구,1,1,3,5,4,0,2018-11-17
4895,서울,금천구,1,0,1,2,1,0,2018-12-17
4896,서울,노원구,9,2,5,16,11,0,2018-01-17
4897,서울,노원구,0,1,0,1,1,0,2018-02-17
4898,서울,노원구,4,0,0,4,2,0,2018-03-17
4899,서울,노원구,4,0,1,5,5,0,2018-04-17
4900,서울,노원구,6,0,0,6,4,0,2018-05-17
4901,서울,노원구,2,1,0,3,2,0,2018-06-17
4902,서울,노원구,0,1,2,3,2,0,2018-07-17
4903,서울,노원구,2,1,0,3,3,0,2018-08-17
4904,서울,노원구,3,1,1,5,5,0,2018-09-17
4905,서울,노원구,9,1,1,11,4,0,2018-10-17
4906,서울,노원구,8,0,3,11,7,0,2018-11-17
4907,서울,노원구,4,2,2,8,6,0,2018-12-17
4908,서울,도봉구,4,0,0,4,4,0,2018-01-17
4909,서울,도봉구,0,0,0,0,0,0,2018-02-17
4910,서울,도봉구,2,0,0,2,2,0,2018-03-17
4911,서울,도봉구,0,0,0,0,0,0,2018-04-17
4912,서울,도봉구,1,0,0,1,1,0,2018-05-17
4913,서울,도봉구,0,0,0,0,0,0,2018-06-17
4914,서울,도봉구,4,1,2,7,5,0,2018-07-17
4915,서울,도봉구,6,0,0,6,4,0,2018-08-17
4916,서울,도봉구,1,0,0,1,1,0,2018-09-17
4917,서울,도봉구,2,0,4,6,6,0,2018-10-17
4918,서울,도봉구,5,0,1,6,1,0,2018-11-17
4919,서울,도봉구,1,1,0,2,2,0,2018-12-17
4920,서울,동대문구,7,0,2,9,8,0,2018-01-17
4921,서울,동대문구,1,0,0,1,1,0,2018-02-17
4922,서울,동대문구,1,0,0,1,1,0,2018-03-17
4923,서울,동대문구,4,1,2,7,4,0,2018-04-17
4924,서울,동대문구,4,1,1,6,4,0,2018-05-17
4925,서울,동대문구,4,0,1,5,3,0,2018-06-17
4926,서울,동대문구,6,0,1,7,7,0,2018-07-17
4927,서울,동대문구,7,0,0,7,6,0,2018-08-17
4928,서울,동대문구,4,0,2,6,5,0,2018-09-17
4929,서울,동대문구,0,0,3,3,3,0,2018-10-17
4930,서울,동대문구,18,0,5,23,6,1,2018-11-17
4931,서울,동대문구,8,1,1,10,7,0,2018-12-17
4932,서울,동작구,1,1,0,2,2,0,2018-01-17
4933,서울,동작구,0,0,1,1,1,0,2018-02-17
4934,서울,동작구,2,0,0,2,2,0,2018-03-17
4935,서울,동작구,3,0,0,3,4,1,2018-04-17
4936,서울,동작구,5,1,1,7,5,0,2018-05-17
4937,서울,동작구,2,0,1,3,3,0,2018-06-17
4938,서울,동작구,3,1,1,5,4,0,2018-07-17
4939,서울,동작구,2,2,0,4,3,0,2018-08-17
4940,서울,동작구,3,3,2,8,5,0,2018-09-17
4941,서울,동작구,7,1,0,8,6,0,2018-10-17
4942,서울,동작구,1,3,3,7,5,0,2018-11-17
4943,서울,동작구,2,0,0,2,1,0,2018-12-17
4944,서울,마포구,9,0,6,15,10,0,2018-01-17
4945,서울,마포구,5,1,0,6,3,0,2018-02-17
4946,서울,마포구,10,0,1,11,8,0,2018-03-17
4947,서울,마포구,10,1,0,11,6,0,2018-04-17
4948,서울,마포구,2,0,2,4,4,0,2018-05-17
4949,서울,마포구,3,0,0,3,2,0,2018-06-17
4950,서울,마포구,9,1,1,11,6,0,2018-07-17
4951,서울,마포구,4,0,2,6,3,0,2018-08-17
4952,서울,마포구,5,1,1,7,5,0,2018-09-17
4953,서울,마포구,1,0,1,2,2,0,2018-10-17
4954,서울,마포구,5,0,0,5,3,0,2018-11-17
4955,서울,마포구,5,0,1,6,5,0,2018-12-17
4956,서울,서대문구,4,1,1,6,5,0,2018-01-17
4957,서울,서대문구,0,1,0,1,1,0,2018-02-17
4958,서울,서대문구,3,0,0,3,2,0,2018-03-17
4959,서울,서대문구,7,1,1,9,4,0,2018-04-17
4960,서울,서대문구,2,1,1,4,3,0,2018-05-17
4961,서울,서대문구,0,0,1,1,1,0,2018-06-17
4962,서울,서대문구,3,0,1,4,3,0,2018-07-17
4963,서울,서대문구,5,2,0,7,7,0,2018-08-17
4964,서울,서대문구,2,1,0,3,3,0,2018-09-17
4965,서울,서대문구,2,0,1,3,3,0,2018-10-17
4966,서울,서대문구,7,0,1,8,4,0,2018-11-17
4967,서울,서대문구,5,1,1,7,7,0,2018-12-17
4968,서울,서초구,7,1,0,8,7,0,2018-01-17
4969,서울,서초구,0,0,2,2,1,0,2018-02-17
4970,서울,서초구,13,0,2,15,13,0,2018-03-17
4971,서울,서초구,3,0,4,7,6,0,2018-04-17
4972,서울,서초구,13,2,5,20,13,0,2018-05-17
4973,서울,서초구,6,0,3,9,6,0,2018-06-17
4974,서울,서초구,9,0,2,11,7,0,2018-07-17
4975,서울,서초구,7,1,1,9,8,0,2018-08-17
4976,서울,서초구,8,4,1,13,8,0,2018-09-17
4977,서울,서초구,9,0,2,11,7,0,2018-10-17
4978,서울,서초구,9,2,4,15,7,0,2018-11-17
4979,서울,서초구,7,0,0,7,6,0,2018-12-17
4980,서울,성동구,5,0,0,5,4,0,2018-01-17
4981,서울,성동구,0,0,0,0,0,0,2018-02-17
4982,서울,성동구,2,0,0,2,2,0,2018-03-17
4983,서울,성동구,2,0,1,3,3,0,2018-04-17
4984,서울,성동구,4,0,3,7,7,0,2018-05-17
4985,서울,성동구,0,0,0,0,1,1,2018-06-17
4986,서울,성동구,8,0,1,9,6,0,2018-07-17
4987,서울,성동구,3,0,0,3,3,0,2018-08-17
4988,서울,성동구,6,0,1,7,5,0,2018-09-17
4989,서울,성동구,2,0,0,2,2,0,2018-10-17
4990,서울,성동구,3,0,0,3,3,0,2018-11-17
4991,서울,성동구,3,0,1,4,3,0,2018-12-17
4992,서울,성북구,9,0,3,12,9,0,2018-01-17
4993,서울,성북구,0,0,1,1,1,0,2018-02-17
4994,서울,성북구,5,0,1,6,3,0,2018-03-17
4995,서울,성북구,2,0,5,7,5,0,2018-04-17
4996,서울,성북구,7,0,0,7,5,0,2018-05-17
4997,서울,성북구,1,0,2,3,2,0,2018-06-17
4998,서울,성북구,5,0,0,5,3,0,2018-07-17
4999,서울,성북구,2,0,0,2,2,0,2018-08-17
5000,서울,성북구,6,0,0,6,5,0,2018-09-17
5001,서울,성북구,1,0,2,3,4,1,2018-10-17
5002,서울,성북구,0,0,0,0,0,0,2018-11-17
5003,서울,성북구,5,1,1,7,5,0,2018-12-17
5004,서울,송파구,11,1,0,12,6,0,2018-01-17
5005,서울,송파구,6,0,3,9,7,1,2018-02-17
5006,서울,송파구,12,4,2,18,13,0,2018-03-17
5007,서울,송파구,10,0,0,10,7,0,2018-04-17
5008,서울,송파구,11,1,3,15,13,0,2018-05-17
5009,서울,송파구,2,0,3,5,4,0,2018-06-17
5010,서울,송파구,10,2,4,16,11,0,2018-07-17
5011,서울,송파구,11,3,2,16,12,0,2018-08-17
5012,서울,송파구,8,1,0,9,7,0,2018-09-17
5013,서울,송파구,11,2,4,17,16,0,2018-10-17
5014,서울,송파구,12,0,1,13,7,0,2018-11-17
5015,서울,송파구,15,0,3,18,13,0,2018-12-17
5016,서울,양천구,9,0,0,9,6,0,2018-01-17
5017,서울,양천구,1,0,0,1,1,0,2018-02-17
5018,서울,양천구,7,3,1,11,5,0,2018-03-17
5019,서울,양천구,5,0,0,5,3,0,2018-04-17
5020,서울,양천구,15,1,2,18,11,1,2018-05-17
5021,서울,양천구,4,2,3,9,7,0,2018-06-17
5022,서울,양천구,6,1,0,7,6,0,2018-07-17
5023,서울,양천구,6,0,2,8,6,0,2018-08-17
5024,서울,양천구,5,0,1,6,3,0,2018-09-17
5025,서울,양천구,1,0,1,2,2,0,2018-10-17
5026,서울,양천구,3,1,1,5,3,0,2018-11-17
5027,서울,양천구,4,0,2,6,5,0,2018-12-17
5028,서울,영등포구,12,1,1,14,13,0,2018-01-17
5029,서울,영등포구,2,0,2,4,3,0,2018-02-17
5030,서울,영등포구,6,1,1,8,8,0,2018-03-17
5031,서울,영등포구,12,0,2,14,6,0,2018-04-17
5032,서울,영등포구,5,1,2,8,7,1,2018-05-17
5033,서울,영등포구,4,1,0,5,5,1,2018-06-17
5034,서울,영등포구,7,0,0,7,4,0,2018-07-17
5035,서울,영등포구,8,0,3,11,8,0,2018-08-17
5036,서울,영등포구,10,0,0,10,6,0,2018-09-17
5037,서울,영등포구,6,1,1,8,6,0,2018-10-17
5038,서울,영등포구,15,2,2,19,13,1,2018-11-17
5039,서울,영등포구,10,1,0,11,11,0,2018-12-17
5040,서울,용산구,1,1,0,2,2,0,2018-01-17
5041,서울,용산구,0,0,1,1,1,0,2018-02-17
5042,서울,용산구,7,0,1,8,2,0,2018-03-17
5043,서울,용산구,2,1,0,3,3,0,2018-04-17
5044,서울,용산구,3,0,1,4,4,0,2018-05-17
5045,서울,용산구,3,0,1,4,4,0,2018-06-17
5046,서울,용산구,2,0,1,3,3,0,2018-07-17
5047,서울,용산구,5,0,1,6,5,0,2018-08-17
5048,서울,용산구,1,0,0,1,1,0,2018-09-17
5049,서울,용산구,3,0,0,3,3,0,2018-10-17
5050,서울,용산구,12,0,2,14,4,0,2018-11-17
5051,서울,용산구,1,0,1,2,2,0,2018-12-17
5052,서울,은평구,3,0,2,5,3,0,2018-01-17
5053,서울,은평구,1,0,0,1,1,0,2018-02-17
5054,서울,은평구,4,0,0,4,2,0,2018-03-17
5055,서울,은평구,1,0,2,3,3,0,2018-04-17
5056,서울,은평구,0,0,0,0,0,0,2018-05-17
5057,서울,은평구,2,0,1,3,3,0,2018-06-17
5058,서울,은평구,1,0,2,3,3,0,2018-07-17
5059,서울,은평구,8,3,3,14,8,0,2018-08-17
5060,서울,은평구,3,0,0,3,3,0,2018-09-17
5061,서울,은평구,1,0,1,2,2,0,2018-10-17
5062,서울,은평구,0,1,1,2,2,0,2018-11-17
5063,서울,은평구,0,2,1,3,2,0,2018-12-17
5064,서울,종로구,3,1,1,5,4,0,2018-01-17
5065,서울,종로구,0,0,0,0,0,0,2018-02-17
5066,서울,종로구,10,1,1,12,7,0,2018-03-17
5067,서울,종로구,2,0,0,2,2,0,2018-04-17
5068,서울,종로구,9,6,0,15,5,0,2018-05-17
5069,서울,종로구,1,0,1,2,1,0,2018-06-17
5070,서울,종로구,5,1,1,7,6,0,2018-07-17
5071,서울,종로구,7,0,0,7,2,0,2018-08-17
5072,서울,종로구,4,1,2,7,4,0,2018-09-17
5073,서울,종로구,3,1,1,5,4,0,2018-10-17
5074,서울,종로구,0,1,2,3,2,0,2018-11-17
5075,서울,종로구,0,1,1,2,2,0,2018-12-17
5076,서울,중구,0,0,0,0,0,0,2018-01-17
5077,서울,중구,0,0,0,0,0,0,2018-02-17
5078,서울,중구,3,0,2,5,4,0,2018-03-17
5079,서울,중구,1,0,2,3,3,0,2018-04-17
5080,서울,중구,1,1,0,2,2,0,2018-05-17
5081,서울,중구,0,0,0,0,0,0,2018-06-17
5082,서울,중구,3,0,0,3,3,0,2018-07-17
5083,서울,중구,1,2,1,4,3,0,2018-08-17
5084,서울,중구,2,0,1,3,3,0,2018-09-17
5085,서울,중구,2,0,2,4,4,0,2018-10-17
5086,서울,중구,2,0,0,2,2,0,2018-11-17
5087,서울,중구,3,0,0,3,3,0,2018-12-17
5088,서울,중랑구,16,0,1,17,9,0,2018-01-17
5089,서울,중랑구,0,0,0,0,0,0,2018-02-17
5090,서울,중랑구,5,0,2,7,6,0,2018-03-17
5091,서울,중랑구,2,1,1,4,4,0,2018-04-17
5092,서울,중랑구,5,0,3,8,3,0,2018-05-17
5093,서울,중랑구,4,0,0,4,2,0,2018-06-17
5094,서울,중랑구,2,0,2,4,4,0,2018-07-17
5095,서울,중랑구,2,0,3,5,5,0,2018-08-17
5096,서울,중랑구,2,2,1,5,4,0,2018-09-17
5097,서울,중랑구,2,0,0,2,1,0,2018-10-17
5098,서울,중랑구,1,1,3,5,5,0,2018-11-17
5099,서울,중랑구,5,1,2,8,8,0,2018-12-17
5100,서울,강남구,21,1,8,30,14,0,2018-01-18
5101,서울,강남구,1,1,1,3,2,0,2018-02-18
5102,서울,강남구,3,1,3,7,4,1,2018-03-18
5103,서울,강남구,8,5,3,16,12,0,2018-04-18
5104,서울,강남구,5,1,2,8,6,0,2018-05-18
5105,서울,강남구,15,3,5,23,13,0,2018-06-18
5106,서울,강남구,15,1,2,18,13,0,2018-07-18
5107,서울,강남구,13,1,3,17,13,0,2018-08-18
5108,서울,강남구,12,1,3,16,9,0,2018-09-18
5109,서울,강남구,12,3,2,17,13,0,2018-10-18
5110,서울,강남구,13,0,2,15,9,0,2018-11-18
5111,서울,강남구,7,0,1,8,7,0,2018-12-18
5112,서울,강동구,3,1,0,4,2,0,2018-01-18
5113,서울,강동구,1,1,1,3,3,0,2018-02-18
5114,서울,강동구,2,1,0,3,3,0,2018-03-18
5115,서울,강동구,1,0,0,1,1,0,2018-04-18
5116,서울,강동구,4,0,2,6,6,0,2018-05-18
5117,서울,강동구,7,0,4,11,8,0,2018-06-18
5118,서울,강동구,5,0,0,5,3,0,2018-07-18
5119,서울,강동구,1,3,2,6,6,0,2018-08-18
5120,서울,강동구,10,1,0,11,8,0,2018-09-18
5121,서울,강동구,3,1,1,5,5,0,2018-10-18
5122,서울,강동구,2,0,0,2,2,0,2018-11-18
5123,서울,강동구,3,0,1,4,4,0,2018-12-18
5124,서울,강북구,1,0,0,1,1,0,2018-01-18
5125,서울,강북구,1,0,0,1,1,0,2018-02-18
5126,서울,강북구,1,0,0,1,1,0,2018-03-18
5127,서울,강북구,6,0,1,7,7,0,2018-04-18
5128,서울,강북구,8,0,1,9,8,0,2018-05-18
5129,서울,강북구,2,0,1,3,3,0,2018-06-18
5130,서울,강북구,1,0,0,1,1,0,2018-07-18
5131,서울,강북구,1,0,2,3,3,0,2018-08-18
5132,서울,강북구,4,0,1,5,5,0,2018-09-18
5133,서울,강북구,2,0,2,4,4,0,2018-10-18
5134,서울,강북구,0,0,1,1,1,0,2018-11-18
5135,서울,강북구,12,0,2,14,8,0,2018-12-18
5136,서울,강서구,6,0,1,7,5,0,2018-01-18
5137,서울,강서구,3,0,0,3,1,0,2018-02-18
5138,서울,강서구,6,1,2,9,4,0,2018-03-18
5139,서울,강서구,5,3,5,13,9,0,2018-04-18
5140,서울,강서구,0,0,0,0,0,0,2018-05-18
5141,서울,강서구,5,0,0,5,1,0,2018-06-18
5142,서울,강서구,3,0,0,3,3,0,2018-07-18
5143,서울,강서구,8,5,0,13,4,0,2018-08-18
5144,서울,강서구,3,0,0,3,3,1,2018-09-18
5145,서울,강서구,5,1,2,8,6,0,2018-10-18
5146,서울,강서구,3,0,2,5,4,0,2018-11-18
5147,서울,강서구,3,0,0,3,3,0,2018-12-18
5148,서울,관악구,1,0,0,1,1,0,2018-01-18
5149,서울,관악구,0,0,1,1,1,0,2018-02-18
5150,서울,관악구,3,0,0,3,3,0,2018-03-18
5151,서울,관악구,5,0,1,6,6,0,2018-04-18
5152,서울,관악구,3,2,2,7,5,0,2018-05-18
5153,서울,관악구,2,0,2,4,4,0,2018-06-18
5154,서울,관악구,5,0,0,5,5,0,2018-07-18
5155,서울,관악구,2,0,0,2,2,0,2018-08-18
5156,서울,관악구,0,0,1,1,1,0,2018-09-18
5157,서울,관악구,8,2,1,11,6,0,2018-10-18
5158,서울,관악구,3,1,2,6,5,0,2018-11-18
5159,서울,관악구,4,0,1,5,5,0,2018-12-18
5160,서울,광진구,3,0,0,3,3,0,2018-01-18
5161,서울,광진구,2,0,0,2,2,0,2018-02-18
5162,서울,광진구,4,0,0,4,2,0,2018-03-18
5163,서울,광진구,5,0,0,5,4,0,2018-04-18
5164,서울,광진구,6,0,3,9,8,0,2018-05-18
5165,서울,광진구,3,2,1,6,5,0,2018-06-18
5166,서울,광진구,0,0,0,0,0,0,2018-07-18
5167,서울,광진구,3,0,2,5,2,0,2018-08-18
5168,서울,광진구,7,1,1,9,5,0,2018-09-18
5169,서울,광진구,0,0,1,1,1,0,2018-10-18
5170,서울,광진구,4,0,1,5,5,0,2018-11-18
5171,서울,광진구,1,1,0,2,2,0,2018-12-18
5172,서울,구로구,4,0,1,5,3,0,2018-01-18
5173,서울,구로구,3,0,0,3,3,0,2018-02-18
5174,서울,구로구,3,2,0,5,4,0,2018-03-18
5175,서울,구로구,1,0,0,1,1,0,2018-04-18
5176,서울,구로구,4,0,0,4,4,0,2018-05-18
5177,서울,구로구,1,1,1,3,3,0,2018-06-18
5178,서울,구로구,3,2,0,5,5,0,2018-07-18
5179,서울,구로구,5,2,2,9,8,0,2018-08-18
5180,서울,구로구,7,0,0,7,6,0,2018-09-18
5181,서울,구로구,10,1,0,11,8,0,2018-10-18
5182,서울,구로구,4,0,2,6,5,0,2018-11-18
5183,서울,구로구,2,0,1,3,4,1,2018-12-18
5184,서울,금천구,1,0,0,1,1,0,2018-01-18
5185,서울,금천구,2,0,1,3,3,0,2018-02-18
5186,서울,금천구,2,0,2,4,4,0,2018-03-18
5187,서울,금천구,3,0,2,5,5,0,2018-04-18
5188,서울,금천구,2,0,1,3,3,0,2018-05-18
5189,서울,금천구,1,0,0,1,1,0,2018-06-18
5190,서울,금천구,2,0,2,4,2,0,2018-07-18
5191,서울,금천구,4,0,3,7,2,0,2018-08-18
5192,서울,금천구,3,0,2,5,5,0,2018-09-18
5193,서울,금천구,4,0,2,6,6,0,2018-10-18
5194,서울,금천구,2,0,1,3,2,0,2018-11-18
5195,서울,금천구,5,0,3,8,6,0,2018-12-18
5196,서울,노원구,0,1,0,1,1,0,2018-01-18
5197,서울,노원구,0,0,1,1,1,0,2018-02-18
5198,서울,노원구,5,0,0,5,3,0,2018-03-18
5199,서울,노원구,1,0,2,3,3,0,2018-04-18
5200,서울,노원구,10,0,1,11,7,0,2018-05-18
5201,서울,노원구,2,0,0,2,2,0,2018-06-18
5202,서울,노원구,3,0,1,4,4,1,2018-07-18
5203,서울,노원구,4,0,1,5,3,0,2018-08-18
5204,서울,노원구,4,0,1,5,5,0,2018-09-18
5205,서울,노원구,7,0,1,8,8,0,2018-10-18
5206,서울,노원구,2,0,1,3,3,0,2018-11-18
5207,서울,노원구,2,0,3,5,5,0,2018-12-18
5208,서울,도봉구,0,0,1,1,1,0,2018-01-18
5209,서울,도봉구,1,0,0,1,1,0,2018-02-18
5210,서울,도봉구,1,0,1,2,2,0,2018-03-18
5211,서울,도봉구,1,0,1,2,2,0,2018-04-18
5212,서울,도봉구,3,0,1,4,4,0,2018-05-18
5213,서울,도봉구,6,0,0,6,4,0,2018-06-18
5214,서울,도봉구,2,0,1,3,2,0,2018-07-18
5215,서울,도봉구,1,0,1,2,2,0,2018-08-18
5216,서울,도봉구,2,2,0,4,3,0,2018-09-18
5217,서울,도봉구,1,2,0,3,3,0,2018-10-18
5218,서울,도봉구,4,0,3,7,3,0,2018-11-18
5219,서울,도봉구,0,1,1,2,2,0,2018-12-18
5220,서울,동대문구,2,0,1,3,3,0,2018-01-18
5221,서울,동대문구,0,0,1,1,1,0,2018-02-18
5222,서울,동대문구,8,0,0,8,4,0,2018-03-18
5223,서울,동대문구,4,0,1,5,5,0,2018-04-18
5224,서울,동대문구,1,1,7,9,9,0,2018-05-18
5225,서울,동대문구,9,2,2,13,8,0,2018-06-18
5226,서울,동대문구,4,0,2,6,3,0,2018-07-18
5227,서울,동대문구,10,1,1,12,8,0,2018-08-18
5228,서울,동대문구,3,0,1,4,3,0,2018-09-18
5229,서울,동대문구,6,0,1,7,6,0,2018-10-18
5230,서울,동대문구,1,1,2,4,4,0,2018-11-18
5231,서울,동대문구,7,1,1,9,7,0,2018-12-18
5232,서울,동작구,3,0,2,5,4,0,2018-01-18
5233,서울,동작구,0,0,0,0,0,0,2018-02-18
5234,서울,동작구,4,0,0,4,2,0,2018-03-18
5235,서울,동작구,11,1,1,13,9,0,2018-04-18
5236,서울,동작구,4,1,1,6,6,0,2018-05-18
5237,서울,동작구,3,0,2,5,4,0,2018-06-18
5238,서울,동작구,4,0,1,5,5,0,2018-07-18
5239,서울,동작구,6,1,1,8,6,0,2018-08-18
5240,서울,동작구,2,0,0,2,1,0,2018-09-18
5241,서울,동작구,3,2,0,5,5,0,2018-10-18
5242,서울,동작구,0,0,1,1,1,0,2018-11-18
5243,서울,동작구,2,2,0,4,4,0,2018-12-18
5244,서울,마포구,4,0,2,6,4,0,2018-01-18
5245,서울,마포구,5,3,1,9,6,0,2018-02-18
5246,서울,마포구,7,2,0,9,6,0,2018-03-18
5247,서울,마포구,4,0,1,5,5,0,2018-04-18
5248,서울,마포구,6,0,2,8,6,0,2018-05-18
5249,서울,마포구,2,0,0,2,2,0,2018-06-18
5250,서울,마포구,13,0,2,15,9,0,2018-07-18
5251,서울,마포구,8,3,1,12,7,0,2018-08-18
5252,서울,마포구,4,0,1,5,4,0,2018-09-18
5253,서울,마포구,1,0,2,3,3,0,2018-10-18
5254,서울,마포구,0,0,0,0,0,0,2018-11-18
5255,서울,마포구,3,0,1,4,4,0,2018-12-18
5256,서울,서대문구,0,0,1,1,1,0,2018-01-18
5257,서울,서대문구,1,0,1,2,2,0,2018-02-18
5258,서울,서대문구,0,0,0,0,0,0,2018-03-18
5259,서울,서대문구,10,0,3,13,4,0,2018-04-18
5260,서울,서대문구,6,0,0,6,5,1,2018-05-18
5261,서울,서대문구,1,0,2,3,3,0,2018-06-18
5262,서울,서대문구,1,1,0,2,2,0,2018-07-18
5263,서울,서대문구,0,0,0,0,0,0,2018-08-18
5264,서울,서대문구,2,0,0,2,2,0,2018-09-18
5265,서울,서대문구,3,0,0,3,3,0,2018-10-18
5266,서울,서대문구,0,0,2,2,2,0,2018-11-18
5267,서울,서대문구,5,3,3,11,7,0,2018-12-18
5268,서울,서초구,4,0,0,4,3,0,2018-01-18
5269,서울,서초구,2,0,0,2,2,0,2018-02-18
5270,서울,서초구,1,0,1,2,2,0,2018-03-18
5271,서울,서초구,20,1,3,24,8,0,2018-04-18
5272,서울,서초구,9,0,6,15,11,0,2018-05-18
5273,서울,서초구,5,0,1,6,5,0,2018-06-18
5274,서울,서초구,1,0,3,4,4,0,2018-07-18
5275,서울,서초구,6,2,6,14,9,0,2018-08-18
5276,서울,서초구,13,1,3,17,12,0,2018-09-18
5277,서울,서초구,5,0,3,8,7,0,2018-10-18
5278,서울,서초구,2,0,2,4,2,0,2018-11-18
5279,서울,서초구,8,0,4,12,7,0,2018-12-18
5280,서울,성동구,0,0,0,0,1,1,2018-01-18
5281,서울,성동구,0,0,0,0,0,0,2018-02-18
5282,서울,성동구,16,0,3,19,7,1,2018-03-18
5283,서울,성동구,3,0,0,3,3,0,2018-04-18
5284,서울,성동구,3,2,1,6,3,0,2018-05-18
5285,서울,성동구,3,0,0,3,3,0,2018-06-18
5286,서울,성동구,8,3,2,13,8,0,2018-07-18
5287,서울,성동구,1,0,0,1,1,0,2018-08-18
5288,서울,성동구,1,0,0,1,1,0,2018-09-18
5289,서울,성동구,3,0,0,3,3,0,2018-10-18
5290,서울,성동구,1,0,1,2,2,0,2018-11-18
5291,서울,성동구,4,0,2,6,5,0,2018-12-18
5292,서울,성북구,7,0,3,10,8,0,2018-01-18
5293,서울,성북구,0,0,0,0,0,0,2018-02-18
5294,서울,성북구,3,1,1,5,4,0,2018-03-18
5295,서울,성북구,2,0,1,3,2,0,2018-04-18
5296,서울,성북구,2,0,0,2,2,0,2018-05-18
5297,서울,성북구,3,1,3,7,4,0,2018-06-18
5298,서울,성북구,1,0,0,1,1,0,2018-07-18
5299,서울,성북구,1,0,6,7,3,0,2018-08-18
5300,서울,성북구,3,2,2,7,7,0,2018-09-18
5301,서울,성북구,5,1,2,8,6,0,2018-10-18
5302,서울,성북구,2,0,0,2,2,0,2018-11-18
5303,서울,성북구,7,0,3,10,6,0,2018-12-18
5304,서울,송파구,11,2,3,16,13,0,2018-01-18
5305,서울,송파구,6,0,1,7,3,0,2018-02-18
5306,서울,송파구,6,1,1,8,6,0,2018-03-18
5307,서울,송파구,6,1,2,9,5,0,2018-04-18
5308,서울,송파구,11,1,3,15,12,1,2018-05-18
5309,서울,송파구,2,1,0,3,3,0,2018-06-18
5310,서울,송파구,6,0,2,8,8,1,2018-07-18
5311,서울,송파구,1,1,1,3,3,0,2018-08-18
5312,서울,송파구,2,0,2,4,4,0,2018-09-18
5313,서울,송파구,12,2,4,18,16,0,2018-10-18
5314,서울,송파구,1,2,2,5,5,0,2018-11-18
5315,서울,송파구,13,1,1,15,12,0,2018-12-18
5316,서울,양천구,1,0,0,1,1,0,2018-01-18
5317,서울,양천구,1,0,1,2,2,0,2018-02-18
5318,서울,양천구,4,0,1,5,4,0,2018-03-18
5319,서울,양천구,3,0,0,3,3,0,2018-04-18
5320,서울,양천구,4,0,4,8,4,0,2018-05-18
5321,서울,양천구,5,0,4,9,6,0,2018-06-18
5322,서울,양천구,0,0,0,0,0,0,2018-07-18
5323,서울,양천구,6,1,0,7,2,0,2018-08-18
5324,서울,양천구,7,0,1,8,4,0,2018-09-18
5325,서울,양천구,1,0,2,3,3,0,2018-10-18
5326,서울,양천구,2,0,0,2,2,0,2018-11-18
5327,서울,양천구,2,0,1,3,3,0,2018-12-18
5328,서울,영등포구,6,2,1,9,8,0,2018-01-18
5329,서울,영등포구,0,0,1,1,1,0,2018-02-18
5330,서울,영등포구,8,0,0,8,3,0,2018-03-18
5331,서울,영등포구,7,0,0,7,7,0,2018-04-18
5332,서울,영등포구,13,0,1,14,9,0,2018-05-18
5333,서울,영등포구,7,3,1,11,8,0,2018-06-18
5334,서울,영등포구,7,2,2,11,9,0,2018-07-18
5335,서울,영등포구,9,2,1,12,6,0,2018-08-18
5336,서울,영등포구,8,1,1,10,7,0,2018-09-18
5337,서울,영등포구,8,2,1,11,9,0,2018-10-18
5338,서울,영등포구,4,1,3,8,5,0,2018-11-18
5339,서울,영등포구,6,1,2,9,7,0,2018-12-18
5340,서울,용산구,1,0,0,1,1,0,2018-01-18
5341,서울,용산구,4,0,0,4,3,0,2018-02-18
5342,서울,용산구,2,1,2,5,3,0,2018-03-18
5343,서울,용산구,2,1,1,4,3,0,2018-04-18
5344,서울,용산구,11,0,1,12,8,0,2018-05-18
5345,서울,용산구,3,0,0,3,2,0,2018-06-18
5346,서울,용산구,4,0,0,4,2,0,2018-07-18
5347,서울,용산구,4,0,0,4,3,0,2018-08-18
5348,서울,용산구,2,0,0,2,2,0,2018-09-18
5349,서울,용산구,2,1,0,3,2,0,2018-10-18
5350,서울,용산구,6,0,0,6,3,0,2018-11-18
5351,서울,용산구,4,0,0,4,2,0,2018-12-18
5352,서울,은평구,3,1,1,5,4,0,2018-01-18
5353,서울,은평구,4,1,2,7,1,0,2018-02-18
5354,서울,은평구,1,0,0,1,1,0,2018-03-18
5355,서울,은평구,1,1,1,3,3,0,2018-04-18
5356,서울,은평구,2,0,1,3,2,0,2018-05-18
5357,서울,은평구,1,0,0,1,1,0,2018-06-18
5358,서울,은평구,6,0,2,8,4,0,2018-07-18
5359,서울,은평구,4,0,1,5,3,0,2018-08-18
5360,서울,은평구,6,1,1,8,7,0,2018-09-18
5361,서울,은평구,7,0,0,7,4,0,2018-10-18
5362,서울,은평구,4,0,1,5,2,0,2018-11-18
5363,서울,은평구,3,0,0,3,4,1,2018-12-18
5364,서울,종로구,6,2,2,10,9,0,2018-01-18
5365,서울,종로구,0,0,1,1,1,0,2018-02-18
5366,서울,종로구,3,0,1,4,3,0,2018-03-18
5367,서울,종로구,1,1,0,2,2,0,2018-04-18
5368,서울,종로구,1,1,2,4,4,0,2018-05-18
5369,서울,종로구,2,0,1,3,3,0,2018-06-18
5370,서울,종로구,4,2,0,6,5,0,2018-07-18
5371,서울,종로구,3,0,0,3,3,0,2018-08-18
5372,서울,종로구,1,1,1,3,3,0,2018-09-18
5373,서울,종로구,0,1,2,3,3,0,2018-10-18
5374,서울,종로구,3,0,0,3,3,0,2018-11-18
5375,서울,종로구,5,1,2,8,7,0,2018-12-18
5376,서울,중구,3,0,2,5,5,0,2018-01-18
5377,서울,중구,1,1,0,2,1,0,2018-02-18
5378,서울,중구,0,0,0,0,0,0,2018-03-18
5379,서울,중구,6,0,2,8,5,0,2018-04-18
5380,서울,중구,3,1,0,4,4,0,2018-05-18
5381,서울,중구,5,0,1,6,5,0,2018-06-18
5382,서울,중구,2,0,0,2,2,0,2018-07-18
5383,서울,중구,1,1,0,2,2,0,2018-08-18
5384,서울,중구,3,0,2,5,4,0,2018-09-18
5385,서울,중구,1,1,0,2,2,0,2018-10-18
5386,서울,중구,2,0,2,4,3,0,2018-11-18
5387,서울,중구,5,0,0,5,4,0,2018-12-18
5388,서울,중랑구,2,0,0,2,2,0,2018-01-18
5389,서울,중랑구,1,0,3,4,4,0,2018-02-18
5390,서울,중랑구,5,0,3,8,4,0,2018-03-18
5391,서울,중랑구,4,0,0,4,4,0,2018-04-18
5392,서울,중랑구,3,1,0,4,4,0,2018-05-18
5393,서울,중랑구,8,1,2,11,6,0,2018-06-18
5394,서울,중랑구,1,1,3,5,5,0,2018-07-18
5395,서울,중랑구,3,0,2,5,3,0,2018-08-18
5396,서울,중랑구,1,1,2,4,4,0,2018-09-18
5397,서울,중랑구,0,1,1,2,2,0,2018-10-18
5398,서울,중랑구,3,1,1,5,4,0,2018-11-18
5399,서울,중랑구,2,1,0,3,3,0,2018-12-18
5400,서울,강남구,12,4,6,22,9,0,2018-01-19
5401,서울,강남구,14,2,4,20,14,0,2018-02-19
5402,서울,강남구,12,0,5,17,12,0,2018-03-19
5403,서울,강남구,12,0,1,13,9,0,2018-04-19
5404,서울,강남구,12,0,3,15,9,0,2018-05-19
5405,서울,강남구,15,3,4,22,13,0,2018-06-19
5406,서울,강남구,11,0,1,12,12,1,2018-07-19
5407,서울,강남구,11,0,3,14,9,0,2018-08-19
5408,서울,강남구,7,2,2,11,10,0,2018-09-19
5409,서울,강남구,12,0,2,14,10,0,2018-10-19
5410,서울,강남구,13,1,1,15,9,0,2018-11-19
5411,서울,강남구,14,1,0,15,11,0,2018-12-19
5412,서울,강동구,2,0,1,3,3,0,2018-01-19
5413,서울,강동구,4,1,0,5,4,0,2018-02-19
5414,서울,강동구,0,0,0,0,0,0,2018-03-19
5415,서울,강동구,1,0,1,2,2,0,2018-04-19
5416,서울,강동구,1,2,0,3,2,0,2018-05-19
5417,서울,강동구,4,1,1,6,5,0,2018-06-19
5418,서울,강동구,4,1,0,5,3,0,2018-07-19
5419,서울,강동구,5,1,3,9,4,0,2018-08-19
5420,서울,강동구,5,1,1,7,7,0,2018-09-19
5421,서울,강동구,5,0,2,7,5,0,2018-10-19
5422,서울,강동구,4,1,0,5,6,1,2018-11-19
5423,서울,강동구,4,2,1,7,5,0,2018-12-19
5424,서울,강북구,8,0,1,9,3,0,2018-01-19
5425,서울,강북구,3,0,1,4,3,0,2018-02-19
5426,서울,강북구,5,0,0,5,4,0,2018-03-19
5427,서울,강북구,5,0,2,7,5,0,2018-04-19
5428,서울,강북구,0,0,2,2,2,0,2018-05-19
5429,서울,강북구,3,0,2,5,5,1,2018-06-19
5430,서울,강북구,3,0,0,3,3,0,2018-07-19
5431,서울,강북구,2,0,2,4,2,0,2018-08-19
5432,서울,강북구,8,0,0,8,5,0,2018-09-19
5433,서울,강북구,4,0,1,5,4,0,2018-10-19
5434,서울,강북구,5,0,0,5,4,0,2018-11-19
5435,서울,강북구,4,0,3,7,4,0,2018-12-19
5436,서울,강서구,11,3,1,15,5,0,2018-01-19
5437,서울,강서구,6,0,4,10,8,0,2018-02-19
5438,서울,강서구,1,0,0,1,1,0,2018-03-19
5439,서울,강서구,3,2,0,5,3,0,2018-04-19
5440,서울,강서구,3,2,4,9,7,0,2018-05-19
5441,서울,강서구,2,0,2,4,4,0,2018-06-19
5442,서울,강서구,2,0,0,2,2,0,2018-07-19
5443,서울,강서구,7,0,0,7,5,0,2018-08-19
5444,서울,강서구,1,0,1,2,2,0,2018-09-19
5445,서울,강서구,8,0,1,9,6,0,2018-10-19
5446,서울,강서구,4,0,2,6,5,0,2018-11-19
5447,서울,강서구,5,0,0,5,5,0,2018-12-19
5448,서울,관악구,5,0,1,6,5,0,2018-01-19
5449,서울,관악구,0,0,1,1,1,0,2018-02-19
5450,서울,관악구,5,0,0,5,5,0,2018-03-19
5451,서울,관악구,2,0,1,3,3,0,2018-04-19
5452,서울,관악구,4,2,1,7,6,0,2018-05-19
5453,서울,관악구,2,0,1,3,2,0,2018-06-19
5454,서울,관악구,2,0,2,4,4,0,2018-07-19
5455,서울,관악구,3,0,1,4,4,0,2018-08-19
5456,서울,관악구,2,1,0,3,3,0,2018-09-19
5457,서울,관악구,1,0,0,1,1,0,2018-10-19
5458,서울,관악구,4,0,0,4,4,0,2018-11-19
5459,서울,관악구,3,1,0,4,4,0,2018-12-19
5460,서울,광진구,3,1,0,4,4,0,2018-01-19
5461,서울,광진구,4,0,1,5,4,0,2018-02-19
5462,서울,광진구,1,0,2,3,2,0,2018-03-19
5463,서울,광진구,4,0,1,5,3,0,2018-04-19
5464,서울,광진구,1,0,0,1,1,0,2018-05-19
5465,서울,광진구,2,1,0,3,3,0,2018-06-19
5466,서울,광진구,3,0,2,5,5,0,2018-07-19
5467,서울,광진구,6,0,1,7,6,0,2018-08-19
5468,서울,광진구,5,0,1,6,5,0,2018-09-19
5469,서울,광진구,4,0,0,4,3,0,2018-10-19
5470,서울,광진구,1,1,0,2,2,0,2018-11-19
5471,서울,광진구,4,0,1,5,5,0,2018-12-19
5472,서울,구로구,0,0,1,1,1,0,2018-01-19
5473,서울,구로구,0,0,0,0,0,0,2018-02-19
5474,서울,구로구,2,0,2,4,4,0,2018-03-19
5475,서울,구로구,3,2,1,6,6,0,2018-04-19
5476,서울,구로구,2,0,2,4,4,0,2018-05-19
5477,서울,구로구,0,1,3,4,4,0,2018-06-19
5478,서울,구로구,4,0,0,4,2,0,2018-07-19
5479,서울,구로구,3,1,1,5,1,0,2018-08-19
5480,서울,구로구,0,0,2,2,2,0,2018-09-19
5481,서울,구로구,1,0,1,2,2,0,2018-10-19
5482,서울,구로구,7,1,2,10,8,0,2018-11-19
5483,서울,구로구,4,1,2,7,5,0,2018-12-19
5484,서울,금천구,2,0,0,2,2,1,2018-01-19
5485,서울,금천구,4,0,0,4,2,0,2018-02-19
5486,서울,금천구,1,0,1,2,2,0,2018-03-19
5487,서울,금천구,0,0,0,0,0,0,2018-04-19
5488,서울,금천구,3,0,2,5,5,0,2018-05-19
5489,서울,금천구,0,0,1,1,1,0,2018-06-19
5490,서울,금천구,1,2,1,4,2,0,2018-07-19
5491,서울,금천구,1,0,0,1,1,0,2018-08-19
5492,서울,금천구,3,0,0,3,1,0,2018-09-19
5493,서울,금천구,6,0,1,7,6,0,2018-10-19
5494,서울,금천구,1,0,2,3,3,0,2018-11-19
5495,서울,금천구,1,0,1,2,2,0,2018-12-19
5496,서울,노원구,0,0,0,0,0,0,2018-01-19
5497,서울,노원구,8,2,0,10,4,0,2018-02-19
5498,서울,노원구,3,0,0,3,3,0,2018-03-19
5499,서울,노원구,3,2,1,6,3,0,2018-04-19
5500,서울,노원구,3,0,3,6,5,0,2018-05-19
5501,서울,노원구,6,0,2,8,7,0,2018-06-19
5502,서울,노원구,7,0,0,7,6,1,2018-07-19
5503,서울,노원구,3,0,1,4,3,0,2018-08-19
5504,서울,노원구,6,1,1,8,4,0,2018-09-19
5505,서울,노원구,5,0,2,7,5,0,2018-10-19
5506,서울,노원구,2,1,0,3,3,0,2018-11-19
5507,서울,노원구,3,0,2,5,4,0,2018-12-19
5508,서울,도봉구,0,0,0,0,0,0,2018-01-19
5509,서울,도봉구,0,0,1,1,1,0,2018-02-19
5510,서울,도봉구,1,0,1,2,2,0,2018-03-19
5511,서울,도봉구,0,0,1,1,1,0,2018-04-19
5512,서울,도봉구,0,0,2,2,2,0,2018-05-19
5513,서울,도봉구,2,0,1,3,4,1,2018-06-19
5514,서울,도봉구,1,0,0,1,1,0,2018-07-19
5515,서울,도봉구,4,0,2,6,5,0,2018-08-19
5516,서울,도봉구,2,0,0,2,1,0,2018-09-19
5517,서울,도봉구,0,0,1,1,1,0,2018-10-19
5518,서울,도봉구,0,0,2,2,2,0,2018-11-19
5519,서울,도봉구,1,0,2,3,2,0,2018-12-19
5520,서울,동대문구,7,1,1,9,6,0,2018-01-19
5521,서울,동대문구,4,0,2,6,6,0,2018-02-19
5522,서울,동대문구,2,0,2,4,4,0,2018-03-19
5523,서울,동대문구,3,1,2,6,4,0,2018-04-19
5524,서울,동대문구,2,2,3,7,7,0,2018-05-19
5525,서울,동대문구,3,0,2,5,4,0,2018-06-19
5526,서울,동대문구,4,1,2,7,3,0,2018-07-19
5527,서울,동대문구,2,0,0,2,2,0,2018-08-19
5528,서울,동대문구,5,1,2,8,8,0,2018-09-19
5529,서울,동대문구,1,0,2,3,3,0,2018-10-19
5530,서울,동대문구,5,0,1,6,6,1,2018-11-19
5531,서울,동대문구,2,0,5,7,6,0,2018-12-19
5532,서울,동작구,2,0,2,4,4,0,2018-01-19
5533,서울,동작구,2,0,0,2,2,0,2018-02-19
5534,서울,동작구,2,0,0,2,2,0,2018-03-19
5535,서울,동작구,12,1,0,13,6,0,2018-04-19
5536,서울,동작구,4,0,0,4,2,0,2018-05-19
5537,서울,동작구,4,1,1,6,6,0,2018-06-19
5538,서울,동작구,4,0,0,4,3,0,2018-07-19
5539,서울,동작구,2,1,1,4,3,0,2018-08-19
5540,서울,동작구,4,3,2,9,8,0,2018-09-19
5541,서울,동작구,2,1,1,4,4,0,2018-10-19
5542,서울,동작구,4,0,0,4,3,0,2018-11-19
5543,서울,동작구,4,1,1,6,6,0,2018-12-19
5544,서울,마포구,3,0,4,7,6,0,2018-01-19
5545,서울,마포구,1,1,0,2,2,0,2018-02-19
5546,서울,마포구,1,0,1,2,2,0,2018-03-19
5547,서울,마포구,3,0,1,4,4,0,2018-04-19
5548,서울,마포구,3,0,1,4,4,0,2018-05-19
5549,서울,마포구,3,2,2,7,5,0,2018-06-19
5550,서울,마포구,7,0,1,8,6,0,2018-07-19
5551,서울,마포구,6,1,1,8,6,0,2018-08-19
5552,서울,마포구,6,0,2,8,5,0,2018-09-19
5553,서울,마포구,11,2,0,13,11,0,2018-10-19
5554,서울,마포구,3,0,0,3,3,0,2018-11-19
5555,서울,마포구,2,0,0,2,2,0,2018-12-19
5556,서울,서대문구,1,0,2,3,3,0,2018-01-19
5557,서울,서대문구,2,2,2,6,4,0,2018-02-19
5558,서울,서대문구,2,0,1,3,3,0,2018-03-19
5559,서울,서대문구,3,0,1,4,4,0,2018-04-19
5560,서울,서대문구,7,1,0,8,5,0,2018-05-19
5561,서울,서대문구,2,0,0,2,1,0,2018-06-19
5562,서울,서대문구,3,0,1,4,3,0,2018-07-19
5563,서울,서대문구,1,0,0,1,1,0,2018-08-19
5564,서울,서대문구,1,1,2,4,4,0,2018-09-19
5565,서울,서대문구,6,0,1,7,6,0,2018-10-19
5566,서울,서대문구,0,0,0,0,0,0,2018-11-19
5567,서울,서대문구,2,0,0,2,2,0,2018-12-19
5568,서울,서초구,4,0,0,4,4,0,2018-01-19
5569,서울,서초구,1,0,3,4,3,0,2018-02-19
5570,서울,서초구,8,1,2,11,8,0,2018-03-19
5571,서울,서초구,9,2,4,15,10,0,2018-04-19
5572,서울,서초구,8,19,5,32,10,0,2018-05-19
5573,서울,서초구,5,0,2,7,4,0,2018-06-19
5574,서울,서초구,5,1,2,8,6,0,2018-07-19
5575,서울,서초구,1,0,0,1,1,0,2018-08-19
5576,서울,서초구,7,2,2,11,9,0,2018-09-19
5577,서울,서초구,4,1,2,7,5,0,2018-10-19
5578,서울,서초구,11,1,2,14,7,0,2018-11-19
5579,서울,서초구,13,0,2,15,8,0,2018-12-19
5580,서울,성동구,0,0,1,1,1,0,2018-01-19
5581,서울,성동구,5,3,0,8,4,0,2018-02-19
5582,서울,성동구,1,0,0,1,1,0,2018-03-19
5583,서울,성동구,3,0,1,4,3,0,2018-04-19
5584,서울,성동구,1,1,2,4,4,0,2018-05-19
5585,서울,성동구,1,0,0,1,1,0,2018-06-19
5586,서울,성동구,4,3,1,8,5,0,2018-07-19
5587,서울,성동구,1,0,1,2,1,0,2018-08-19
5588,서울,성동구,3,0,2,5,5,0,2018-09-19
5589,서울,성동구,6,1,1,8,7,0,2018-10-19
5590,서울,성동구,1,0,1,2,2,0,2018-11-19
5591,서울,성동구,2,0,1,3,3,0,2018-12-19
5592,서울,성북구,9,0,1,10,7,0,2018-01-19
5593,서울,성북구,2,0,2,4,3,0,2018-02-19
5594,서울,성북구,3,0,0,3,2,0,2018-03-19
5595,서울,성북구,3,1,0,4,4,0,2018-04-19
5596,서울,성북구,11,0,2,13,3,0,2018-05-19
5597,서울,성북구,3,0,2,5,4,1,2018-06-19
5598,서울,성북구,4,1,0,5,5,0,2018-07-19
5599,서울,성북구,10,1,11,22,9,0,2018-08-19
5600,서울,성북구,4,0,2,6,5,0,2018-09-19
5601,서울,성북구,4,0,0,4,4,0,2018-10-19
5602,서울,성북구,1,0,2,3,2,0,2018-11-19
5603,서울,성북구,5,1,3,9,6,0,2018-12-19
5604,서울,송파구,14,3,6,23,16,1,2018-01-19
5605,서울,송파구,6,1,0,7,3,0,2018-02-19
5606,서울,송파구,5,1,5,11,10,0,2018-03-19
5607,서울,송파구,4,1,3,8,7,0,2018-04-19
5608,서울,송파구,7,1,3,11,8,0,2018-05-19
5609,서울,송파구,11,1,2,14,10,0,2018-06-19
5610,서울,송파구,8,1,1,10,8,0,2018-07-19
5611,서울,송파구,4,2,1,7,5,0,2018-08-19
5612,서울,송파구,24,3,4,31,9,0,2018-09-19
5613,서울,송파구,6,0,3,9,9,0,2018-10-19
5614,서울,송파구,5,4,0,9,6,0,2018-11-19
5615,서울,송파구,12,0,2,14,7,0,2018-12-19
5616,서울,양천구,8,1,1,10,6,0,2018-01-19
5617,서울,양천구,2,0,3,5,3,0,2018-02-19
5618,서울,양천구,2,1,2,5,4,0,2018-03-19
5619,서울,양천구,6,2,2,10,10,0,2018-04-19
5620,서울,양천구,7,0,2,9,8,0,2018-05-19
5621,서울,양천구,4,0,0,4,3,0,2018-06-19
5622,서울,양천구,7,0,0,7,5,0,2018-07-19
5623,서울,양천구,1,2,0,3,2,0,2018-08-19
5624,서울,양천구,3,0,0,3,3,0,2018-09-19
5625,서울,양천구,7,0,1,8,7,0,2018-10-19
5626,서울,양천구,3,0,0,3,3,0,2018-11-19
5627,서울,양천구,2,0,1,3,3,0,2018-12-19
5628,서울,영등포구,14,0,2,16,8,0,2018-01-19
5629,서울,영등포구,3,0,2,5,6,1,2018-02-19
5630,서울,영등포구,5,0,1,6,4,0,2018-03-19
5631,서울,영등포구,3,1,2,6,6,0,2018-04-19
5632,서울,영등포구,7,2,3,12,11,1,2018-05-19
5633,서울,영등포구,6,0,4,10,8,0,2018-06-19
5634,서울,영등포구,5,1,6,12,8,0,2018-07-19
5635,서울,영등포구,7,1,3,11,8,0,2018-08-19
5636,서울,영등포구,8,0,1,9,9,0,2018-09-19
5637,서울,영등포구,9,2,1,12,10,0,2018-10-19
5638,서울,영등포구,6,0,0,6,6,0,2018-11-19
5639,서울,영등포구,2,0,3,5,5,0,2018-12-19
5640,서울,용산구,2,0,2,4,4,0,2018-01-19
5641,서울,용산구,0,0,0,0,0,0,2018-02-19
5642,서울,용산구,6,0,0,6,4,0,2018-03-19
5643,서울,용산구,4,0,1,5,5,0,2018-04-19
5644,서울,용산구,9,0,2,11,7,0,2018-05-19
5645,서울,용산구,0,1,1,2,2,0,2018-06-19
5646,서울,용산구,5,0,0,5,3,0,2018-07-19
5647,서울,용산구,3,1,0,4,4,0,2018-08-19
5648,서울,용산구,4,0,0,4,3,0,2018-09-19
5649,서울,용산구,4,0,2,6,3,0,2018-10-19
5650,서울,용산구,2,0,2,4,4,0,2018-11-19
5651,서울,용산구,6,0,1,7,4,0,2018-12-19
5652,서울,은평구,1,0,3,4,2,0,2018-01-19
5653,서울,은평구,1,1,0,2,2,0,2018-02-19
5654,서울,은평구,1,0,0,1,1,0,2018-03-19
5655,서울,은평구,9,0,0,9,3,0,2018-04-19
5656,서울,은평구,1,2,1,4,4,0,2018-05-19
5657,서울,은평구,3,0,3,6,3,0,2018-06-19
5658,서울,은평구,5,1,0,6,5,0,2018-07-19
5659,서울,은평구,2,0,2,4,3,0,2018-08-19
5660,서울,은평구,3,1,2,6,5,0,2018-09-19
5661,서울,은평구,4,0,3,7,6,0,2018-10-19
5662,서울,은평구,4,0,0,4,3,0,2018-11-19
5663,서울,은평구,3,0,1,4,4,0,2018-12-19
5664,서울,종로구,1,2,1,4,3,0,2018-01-19
5665,서울,종로구,2,1,3,6,4,0,2018-02-19
5666,서울,종로구,5,0,0,5,4,0,2018-03-19
5667,서울,종로구,2,0,0,2,2,0,2018-04-19
5668,서울,종로구,3,0,2,5,5,0,2018-05-19
5669,서울,종로구,0,0,0,0,0,0,2018-06-19
5670,서울,종로구,5,1,0,6,3,0,2018-07-19
5671,서울,종로구,2,0,0,2,2,0,2018-08-19
5672,서울,종로구,4,0,1,5,4,0,2018-09-19
5673,서울,종로구,5,1,1,7,4,0,2018-10-19
5674,서울,종로구,2,0,1,3,3,0,2018-11-19
5675,서울,종로구,5,0,1,6,5,0,2018-12-19
5676,서울,중구,3,0,2,5,3,0,2018-01-19
5677,서울,중구,2,1,0,3,3,0,2018-02-19
5678,서울,중구,5,1,0,6,4,0,2018-03-19
5679,서울,중구,5,1,0,6,5,0,2018-04-19
5680,서울,중구,2,0,1,3,3,0,2018-05-19
5681,서울,중구,6,0,1,7,5,0,2018-06-19
5682,서울,중구,0,0,1,1,1,0,2018-07-19
5683,서울,중구,0,0,1,1,1,0,2018-08-19
5684,서울,중구,5,0,4,9,7,0,2018-09-19
5685,서울,중구,4,0,0,4,3,0,2018-10-19
5686,서울,중구,3,1,0,4,3,0,2018-11-19
5687,서울,중구,2,1,2,5,4,0,2018-12-19
5688,서울,중랑구,1,0,2,3,3,0,2018-01-19
5689,서울,중랑구,3,0,1,4,2,0,2018-02-19
5690,서울,중랑구,6,0,1,7,5,0,2018-03-19
5691,서울,중랑구,2,0,1,3,3,0,2018-04-19
5692,서울,중랑구,4,0,0,4,4,0,2018-05-19
5693,서울,중랑구,1,0,1,2,2,0,2018-06-19
5694,서울,중랑구,1,2,3,6,6,0,2018-07-19
5695,서울,중랑구,12,1,1,14,3,0,2018-08-19
5696,서울,중랑구,11,1,2,14,8,0,2018-09-19
5697,서울,중랑구,6,1,1,8,6,0,2018-10-19
5698,서울,중랑구,3,0,0,3,2,0,2018-11-19
5699,서울,중랑구,7,0,1,8,6,0,2018-12-19
5700,서울,강남구,14,0,2,16,10,0,2018-01-20
5701,서울,강남구,11,0,2,13,8,0,2018-02-20
5702,서울,강남구,9,1,4,14,12,1,2018-03-20
5703,서울,강남구,9,1,6,16,11,0,2018-04-20
5704,서울,강남구,7,1,1,9,8,0,2018-05-20
5705,서울,강남구,5,4,1,10,6,0,2018-06-20
5706,서울,강남구,12,1,5,18,15,0,2018-07-20
5707,서울,강남구,14,3,2,19,15,0,2018-08-20
5708,서울,강남구,27,1,4,32,17,1,2018-09-20
5709,서울,강남구,7,0,2,9,9,0,2018-10-20
5710,서울,강남구,18,11,4,33,10,0,2018-11-20
5711,서울,강남구,11,2,4,17,11,0,2018-12-20
5712,서울,강동구,0,1,1,2,1,0,2018-01-20
5713,서울,강동구,1,0,1,2,2,0,2018-02-20
5714,서울,강동구,5,2,0,7,6,1,2018-03-20
5715,서울,강동구,3,3,1,7,7,0,2018-04-20
5716,서울,강동구,0,0,2,2,2,0,2018-05-20
5717,서울,강동구,5,0,1,6,6,0,2018-06-20
5718,서울,강동구,4,0,3,7,7,0,2018-07-20
5719,서울,강동구,6,1,0,7,4,0,2018-08-20
5720,서울,강동구,6,1,1,8,5,0,2018-09-20
5721,서울,강동구,13,1,0,14,9,0,2018-10-20
5722,서울,강동구,3,0,0,3,3,0,2018-11-20
5723,서울,강동구,1,2,0,3,3,0,2018-12-20
5724,서울,강북구,1,0,1,2,2,0,2018-01-20
5725,서울,강북구,3,0,0,3,3,0,2018-02-20
5726,서울,강북구,1,0,0,1,1,0,2018-03-20
5727,서울,강북구,8,2,0,10,6,0,2018-04-20
5728,서울,강북구,7,0,0,7,5,0,2018-05-20
5729,서울,강북구,3,0,1,4,4,0,2018-06-20
5730,서울,강북구,5,1,1,7,4,0,2018-07-20
5731,서울,강북구,9,2,1,12,5,0,2018-08-20
5732,서울,강북구,2,0,0,2,2,0,2018-09-20
5733,서울,강북구,1,0,4,5,4,0,2018-10-20
5734,서울,강북구,2,0,1,3,3,0,2018-11-20
5735,서울,강북구,2,0,1,3,3,0,2018-12-20
5736,서울,강서구,2,0,1,3,3,0,2018-01-20
5737,서울,강서구,4,0,1,5,4,0,2018-02-20
5738,서울,강서구,8,0,1,9,4,0,2018-03-20
5739,서울,강서구,2,0,1,3,2,0,2018-04-20
5740,서울,강서구,6,0,2,8,6,0,2018-05-20
5741,서울,강서구,5,1,1,7,6,0,2018-06-20
5742,서울,강서구,1,0,1,2,2,0,2018-07-20
5743,서울,강서구,3,0,0,3,2,0,2018-08-20
5744,서울,강서구,8,0,1,9,6,0,2018-09-20
5745,서울,강서구,11,1,2,14,9,0,2018-10-20
5746,서울,강서구,4,0,0,4,3,0,2018-11-20
5747,서울,강서구,3,0,1,4,4,0,2018-12-20
5748,서울,관악구,1,1,2,4,5,1,2018-01-20
5749,서울,관악구,4,0,1,5,4,0,2018-02-20
5750,서울,관악구,0,1,0,1,1,0,2018-03-20
5751,서울,관악구,2,0,2,4,4,0,2018-04-20
5752,서울,관악구,3,1,0,4,4,0,2018-05-20
5753,서울,관악구,1,0,1,2,2,0,2018-06-20
5754,서울,관악구,4,0,0,4,4,0,2018-07-20
5755,서울,관악구,5,1,0,6,4,0,2018-08-20
5756,서울,관악구,1,4,1,6,3,0,2018-09-20
5757,서울,관악구,3,0,1,4,4,0,2018-10-20
5758,서울,관악구,3,0,0,3,1,0,2018-11-20
5759,서울,관악구,0,0,0,0,0,0,2018-12-20
5760,서울,광진구,3,0,2,5,3,0,2018-01-20
5761,서울,광진구,6,0,0,6,4,0,2018-02-20
5762,서울,광진구,1,0,1,2,1,0,2018-03-20
5763,서울,광진구,3,0,1,4,4,0,2018-04-20
5764,서울,광진구,2,0,0,2,2,0,2018-05-20
5765,서울,광진구,3,0,0,3,2,0,2018-06-20
5766,서울,광진구,7,0,0,7,5,0,2018-07-20
5767,서울,광진구,3,0,5,8,5,0,2018-08-20
5768,서울,광진구,5,0,0,5,3,0,2018-09-20
5769,서울,광진구,8,4,0,12,6,0,2018-10-20
5770,서울,광진구,5,0,1,6,5,0,2018-11-20
5771,서울,광진구,2,0,0,2,2,0,2018-12-20
5772,서울,구로구,1,0,1,2,2,0,2018-01-20
5773,서울,구로구,1,0,0,1,1,0,2018-02-20
5774,서울,구로구,4,0,0,4,3,0,2018-03-20
5775,서울,구로구,4,0,1,5,3,0,2018-04-20
5776,서울,구로구,2,0,1,3,3,0,2018-05-20
5777,서울,구로구,0,0,0,0,0,0,2018-06-20
5778,서울,구로구,1,1,2,4,4,0,2018-07-20
5779,서울,구로구,6,1,2,9,7,0,2018-08-20
5780,서울,구로구,6,0,3,9,6,0,2018-09-20
5781,서울,구로구,4,0,0,4,4,0,2018-10-20
5782,서울,구로구,7,0,0,7,3,0,2018-11-20
5783,서울,구로구,12,0,0,12,6,1,2018-12-20
5784,서울,금천구,4,0,0,4,2,0,2018-01-20
5785,서울,금천구,0,0,0,0,0,0,2018-02-20
5786,서울,금천구,1,0,1,2,2,0,2018-03-20
5787,서울,금천구,3,0,0,3,2,0,2018-04-20
5788,서울,금천구,6,2,1,9,4,0,2018-05-20
5789,서울,금천구,2,0,1,3,2,0,2018-06-20
5790,서울,금천구,3,1,1,5,4,0,2018-07-20
5791,서울,금천구,1,0,0,1,1,0,2018-08-20
5792,서울,금천구,1,0,1,2,2,0,2018-09-20
5793,서울,금천구,3,1,3,7,5,0,2018-10-20
5794,서울,금천구,4,1,0,5,2,0,2018-11-20
5795,서울,금천구,1,0,1,2,2,0,2018-12-20
5796,서울,노원구,4,0,0,4,2,0,2018-01-20
5797,서울,노원구,13,0,2,15,8,0,2018-02-20
5798,서울,노원구,2,0,3,5,5,0,2018-03-20
5799,서울,노원구,8,0,2,10,5,0,2018-04-20
5800,서울,노원구,2,0,1,3,2,0,2018-05-20
5801,서울,노원구,10,0,0,10,5,0,2018-06-20
5802,서울,노원구,4,2,3,9,5,0,2018-07-20
5803,서울,노원구,2,0,1,3,3,0,2018-08-20
5804,서울,노원구,4,0,2,6,4,0,2018-09-20
5805,서울,노원구,4,0,1,5,5,0,2018-10-20
5806,서울,노원구,5,0,0,5,4,0,2018-11-20
5807,서울,노원구,12,1,4,17,11,0,2018-12-20
5808,서울,도봉구,1,0,0,1,1,0,2018-01-20
5809,서울,도봉구,1,0,0,1,1,0,2018-02-20
5810,서울,도봉구,0,0,1,1,1,0,2018-03-20
5811,서울,도봉구,1,0,2,3,3,0,2018-04-20
5812,서울,도봉구,1,0,0,1,1,0,2018-05-20
5813,서울,도봉구,0,0,0,0,0,0,2018-06-20
5814,서울,도봉구,0,1,1,2,2,0,2018-07-20
5815,서울,도봉구,0,0,0,0,0,0,2018-08-20
5816,서울,도봉구,0,0,1,1,1,0,2018-09-20
5817,서울,도봉구,1,1,0,2,2,0,2018-10-20
5818,서울,도봉구,0,0,0,0,0,0,2018-11-20
5819,서울,도봉구,5,0,0,5,3,0,2018-12-20
5820,서울,동대문구,4,0,3,7,6,0,2018-01-20
5821,서울,동대문구,2,0,2,4,3,0,2018-02-20
5822,서울,동대문구,2,1,0,3,3,0,2018-03-20
5823,서울,동대문구,7,0,1,8,6,0,2018-04-20
5824,서울,동대문구,1,0,1,2,2,0,2018-05-20
5825,서울,동대문구,3,0,1,4,3,0,2018-06-20
5826,서울,동대문구,6,0,3,9,7,0,2018-07-20
5827,서울,동대문구,4,1,1,6,6,0,2018-08-20
5828,서울,동대문구,2,2,2,6,5,0,2018-09-20
5829,서울,동대문구,2,1,5,8,5,0,2018-10-20
5830,서울,동대문구,2,0,2,4,4,0,2018-11-20
5831,서울,동대문구,0,0,2,2,2,0,2018-12-20
5832,서울,동작구,5,0,2,7,5,0,2018-01-20
5833,서울,동작구,1,1,0,2,2,0,2018-02-20
5834,서울,동작구,1,0,1,2,2,0,2018-03-20
5835,서울,동작구,6,1,1,8,7,0,2018-04-20
5836,서울,동작구,6,1,3,10,2,0,2018-05-20
5837,서울,동작구,3,0,1,4,4,0,2018-06-20
5838,서울,동작구,5,1,3,9,5,0,2018-07-20
5839,서울,동작구,2,1,0,3,3,0,2018-08-20
5840,서울,동작구,8,1,1,10,7,0,2018-09-20
5841,서울,동작구,12,2,3,17,8,0,2018-10-20
5842,서울,동작구,4,0,1,5,3,0,2018-11-20
5843,서울,동작구,4,2,2,8,5,0,2018-12-20
5844,서울,마포구,9,0,1,10,6,0,2018-01-20
5845,서울,마포구,6,0,0,6,4,0,2018-02-20
5846,서울,마포구,11,0,0,11,7,0,2018-03-20
5847,서울,마포구,7,0,2,9,9,0,2018-04-20
5848,서울,마포구,8,0,2,10,5,0,2018-05-20
5849,서울,마포구,9,0,1,10,6,0,2018-06-20
5850,서울,마포구,4,0,3,7,6,0,2018-07-20
5851,서울,마포구,2,0,0,2,2,0,2018-08-20
5852,서울,마포구,12,0,4,16,9,0,2018-09-20
5853,서울,마포구,8,0,1,9,5,0,2018-10-20
5854,서울,마포구,3,0,2,5,5,0,2018-11-20
5855,서울,마포구,5,0,2,7,4,0,2018-12-20
5856,서울,서대문구,1,0,1,2,2,0,2018-01-20
5857,서울,서대문구,1,0,0,1,1,0,2018-02-20
5858,서울,서대문구,1,0,2,3,3,0,2018-03-20
5859,서울,서대문구,0,2,3,5,3,0,2018-04-20
5860,서울,서대문구,1,0,3,4,4,0,2018-05-20
5861,서울,서대문구,2,0,2,4,4,0,2018-06-20
5862,서울,서대문구,9,1,1,11,6,0,2018-07-20
5863,서울,서대문구,3,0,0,3,2,0,2018-08-20
5864,서울,서대문구,1,0,0,1,1,0,2018-09-20
5865,서울,서대문구,0,0,0,0,0,0,2018-10-20
5866,서울,서대문구,1,1,1,3,3,0,2018-11-20
5867,서울,서대문구,0,0,1,1,1,0,2018-12-20
5868,서울,서초구,6,1,2,9,9,0,2018-01-20
5869,서울,서초구,11,1,2,14,10,0,2018-02-20
5870,서울,서초구,5,0,1,6,6,0,2018-03-20
5871,서울,서초구,13,5,2,20,11,0,2018-04-20
5872,서울,서초구,9,0,1,10,6,0,2018-05-20
5873,서울,서초구,3,0,0,3,3,0,2018-06-20
5874,서울,서초구,10,3,6,19,11,0,2018-07-20
5875,서울,서초구,8,1,1,10,7,0,2018-08-20
5876,서울,서초구,8,1,1,10,7,0,2018-09-20
5877,서울,서초구,12,2,6,20,12,0,2018-10-20
5878,서울,서초구,9,2,0,11,8,0,2018-11-20
5879,서울,서초구,6,0,3,9,8,0,2018-12-20
5880,서울,성동구,3,1,2,6,3,0,2018-01-20
5881,서울,성동구,0,0,0,0,0,0,2018-02-20
5882,서울,성동구,5,1,1,7,4,0,2018-03-20
5883,서울,성동구,1,0,0,1,1,0,2018-04-20
5884,서울,성동구,2,1,1,4,3,0,2018-05-20
5885,서울,성동구,3,0,0,3,2,0,2018-06-20
5886,서울,성동구,8,0,0,8,7,0,2018-07-20
5887,서울,성동구,1,0,0,1,1,0,2018-08-20
5888,서울,성동구,10,2,2,14,5,0,2018-09-20
5889,서울,성동구,20,1,2,23,8,0,2018-10-20
5890,서울,성동구,4,0,0,4,4,0,2018-11-20
5891,서울,성동구,1,1,2,4,3,0,2018-12-20
5892,서울,성북구,7,0,3,10,6,0,2018-01-20
5893,서울,성북구,7,1,0,8,3,0,2018-02-20
5894,서울,성북구,2,0,4,6,4,0,2018-03-20
5895,서울,성북구,3,0,1,4,3,0,2018-04-20
5896,서울,성북구,2,0,0,2,2,0,2018-05-20
5897,서울,성북구,4,0,1,5,4,0,2018-06-20
5898,서울,성북구,1,1,2,4,4,0,2018-07-20
5899,서울,성북구,10,0,0,10,5,0,2018-08-20
5900,서울,성북구,2,1,1,4,4,1,2018-09-20
5901,서울,성북구,6,0,1,7,7,0,2018-10-20
5902,서울,성북구,2,1,1,4,3,0,2018-11-20
5903,서울,성북구,1,0,1,2,2,0,2018-12-20
5904,서울,송파구,10,1,2,13,9,0,2018-01-20
5905,서울,송파구,7,2,3,12,10,0,2018-02-20
5906,서울,송파구,5,0,3,8,6,0,2018-03-20
5907,서울,송파구,7,1,3,11,10,0,2018-04-20
5908,서울,송파구,12,2,1,15,11,0,2018-05-20
5909,서울,송파구,8,2,5,15,10,0,2018-06-20
5910,서울,송파구,5,1,2,8,7,2,2018-07-20
5911,서울,송파구,8,4,2,14,10,0,2018-08-20
5912,서울,송파구,8,1,2,11,10,0,2018-09-20
5913,서울,송파구,11,4,4,19,13,0,2018-10-20
5914,서울,송파구,8,0,5,13,10,0,2018-11-20
5915,서울,송파구,10,0,2,12,11,0,2018-12-20
5916,서울,양천구,2,0,1,3,3,0,2018-01-20
5917,서울,양천구,3,0,2,5,5,0,2018-02-20
5918,서울,양천구,1,0,2,3,3,0,2018-03-20
5919,서울,양천구,1,0,0,1,1,0,2018-04-20
5920,서울,양천구,5,1,1,7,4,0,2018-05-20
5921,서울,양천구,3,1,2,6,4,0,2018-06-20
5922,서울,양천구,10,1,0,11,6,0,2018-07-20
5923,서울,양천구,2,0,2,4,4,0,2018-08-20
5924,서울,양천구,1,0,2,3,3,0,2018-09-20
5925,서울,양천구,2,2,1,5,4,0,2018-10-20
5926,서울,양천구,1,0,1,2,3,1,2018-11-20
5927,서울,양천구,4,0,0,4,2,0,2018-12-20
5928,서울,영등포구,14,3,5,22,11,0,2018-01-20
5929,서울,영등포구,4,0,2,6,6,0,2018-02-20
5930,서울,영등포구,5,1,0,6,5,0,2018-03-20
5931,서울,영등포구,6,0,1,7,7,0,2018-04-20
5932,서울,영등포구,10,1,1,12,8,0,2018-05-20
5933,서울,영등포구,5,2,0,7,7,0,2018-06-20
5934,서울,영등포구,11,2,2,15,12,1,2018-07-20
5935,서울,영등포구,7,1,1,9,7,0,2018-08-20
5936,서울,영등포구,8,1,2,11,7,0,2018-09-20
5937,서울,영등포구,10,1,0,11,8,0,2018-10-20
5938,서울,영등포구,8,0,2,10,8,0,2018-11-20
5939,서울,영등포구,8,0,3,11,10,0,2018-12-20
5940,서울,용산구,4,0,3,7,4,0,2018-01-20
5941,서울,용산구,1,0,1,2,2,0,2018-02-20
5942,서울,용산구,1,0,3,4,3,0,2018-03-20
5943,서울,용산구,2,2,2,6,5,0,2018-04-20
5944,서울,용산구,5,0,0,5,4,0,2018-05-20
5945,서울,용산구,6,1,2,9,7,0,2018-06-20
5946,서울,용산구,2,1,0,3,2,0,2018-07-20
5947,서울,용산구,1,0,0,1,1,0,2018-08-20
5948,서울,용산구,5,0,3,8,5,0,2018-09-20
5949,서울,용산구,6,0,2,8,6,0,2018-10-20
5950,서울,용산구,0,0,1,1,1,0,2018-11-20
5951,서울,용산구,6,0,0,6,4,0,2018-12-20
5952,서울,은평구,5,0,0,5,3,0,2018-01-20
5953,서울,은평구,9,14,1,24,3,0,2018-02-20
5954,서울,은평구,4,1,1,6,1,0,2018-03-20
5955,서울,은평구,1,0,1,2,2,0,2018-04-20
5956,서울,은평구,3,0,2,5,5,0,2018-05-20
5957,서울,은평구,4,0,0,4,3,0,2018-06-20
5958,서울,은평구,5,1,3,9,7,0,2018-07-20
5959,서울,은평구,1,1,0,2,2,0,2018-08-20
5960,서울,은평구,7,1,0,8,6,0,2018-09-20
5961,서울,은평구,0,1,0,1,1,0,2018-10-20
5962,서울,은평구,5,0,2,7,5,0,2018-11-20
5963,서울,은평구,0,0,2,2,2,0,2018-12-20
5964,서울,종로구,1,0,1,2,2,0,2018-01-20
5965,서울,종로구,1,0,0,1,1,0,2018-02-20
5966,서울,종로구,1,0,1,2,2,0,2018-03-20
5967,서울,종로구,4,0,0,4,4,0,2018-04-20
5968,서울,종로구,3,2,1,6,2,0,2018-05-20
5969,서울,종로구,0,0,0,0,0,0,2018-06-20
5970,서울,종로구,5,4,1,10,6,0,2018-07-20
5971,서울,종로구,1,0,1,2,2,0,2018-08-20
5972,서울,종로구,2,0,0,2,2,0,2018-09-20
5973,서울,종로구,7,2,0,9,7,0,2018-10-20
5974,서울,종로구,2,0,0,2,2,0,2018-11-20
5975,서울,종로구,3,0,0,3,3,0,2018-12-20
5976,서울,중구,8,0,1,9,4,0,2018-01-20
5977,서울,중구,0,1,0,1,1,0,2018-02-20
5978,서울,중구,3,0,2,5,5,0,2018-03-20
5979,서울,중구,1,0,0,1,1,0,2018-04-20
5980,서울,중구,0,0,1,1,1,0,2018-05-20
5981,서울,중구,5,0,0,5,5,0,2018-06-20
5982,서울,중구,2,0,0,2,2,0,2018-07-20
5983,서울,중구,3,2,0,5,4,0,2018-08-20
5984,서울,중구,0,0,0,0,0,0,2018-09-20
5985,서울,중구,2,0,0,2,2,0,2018-10-20
5986,서울,중구,2,3,0,5,4,0,2018-11-20
5987,서울,중구,9,1,1,11,6,0,2018-12-20
5988,서울,중랑구,2,0,1,3,2,0,2018-01-20
5989,서울,중랑구,3,1,0,4,3,0,2018-02-20
5990,서울,중랑구,3,1,0,4,3,0,2018-03-20
5991,서울,중랑구,4,0,2,6,6,0,2018-04-20
5992,서울,중랑구,4,0,5,9,5,0,2018-05-20
5993,서울,중랑구,3,0,2,5,5,0,2018-06-20
5994,서울,중랑구,8,0,3,11,10,0,2018-07-20
5995,서울,중랑구,1,0,0,1,1,0,2018-08-20
5996,서울,중랑구,4,0,1,5,5,0,2018-09-20
5997,서울,중랑구,4,0,0,4,4,0,2018-10-20
5998,서울,중랑구,2,1,3,6,6,0,2018-11-20
5999,서울,중랑구,0,0,3,3,3,0,2018-12-20
6000,서울,강남구,8,0,1,9,7,0,2018-01-21
6001,서울,강남구,4,1,5,10,7,0,2018-02-21
6002,서울,강남구,5,0,0,5,5,0,2018-03-21
6003,서울,강남구,18,1,3,22,15,0,2018-04-21
6004,서울,강남구,9,1,3,13,9,0,2018-05-21
6005,서울,강남구,4,5,1,10,8,0,2018-06-21
6006,서울,강남구,13,0,3,16,10,0,2018-07-21
6007,서울,강남구,14,1,4,19,15,0,2018-08-21
6008,서울,강남구,12,0,1,13,10,0,2018-09-21
6009,서울,강남구,4,0,1,5,4,0,2018-10-21
6010,서울,강남구,6,1,0,7,5,0,2018-11-21
6011,서울,강남구,16,2,4,22,16,1,2018-12-21
6012,서울,강동구,0,0,2,2,2,0,2018-01-21
6013,서울,강동구,3,0,1,4,3,0,2018-02-21
6014,서울,강동구,3,0,1,4,4,0,2018-03-21
6015,서울,강동구,3,1,2,6,4,0,2018-04-21
6016,서울,강동구,6,0,1,7,4,0,2018-05-21
6017,서울,강동구,1,0,0,1,1,0,2018-06-21
6018,서울,강동구,0,1,2,3,2,0,2018-07-21
6019,서울,강동구,7,0,1,8,7,0,2018-08-21
6020,서울,강동구,8,2,3,13,7,0,2018-09-21
6021,서울,강동구,1,0,1,2,2,0,2018-10-21
6022,서울,강동구,1,0,0,1,1,0,2018-11-21
6023,서울,강동구,5,1,0,6,4,0,2018-12-21
6024,서울,강북구,1,0,1,2,2,0,2018-01-21
6025,서울,강북구,4,0,3,7,6,0,2018-02-21
6026,서울,강북구,3,0,0,3,1,0,2018-03-21
6027,서울,강북구,9,0,1,10,7,0,2018-04-21
6028,서울,강북구,6,0,0,6,5,0,2018-05-21
6029,서울,강북구,4,1,0,5,3,0,2018-06-21
6030,서울,강북구,3,0,1,4,2,0,2018-07-21
6031,서울,강북구,2,0,2,4,3,0,2018-08-21
6032,서울,강북구,0,0,1,1,1,0,2018-09-21
6033,서울,강북구,2,0,0,2,2,0,2018-10-21
6034,서울,강북구,1,0,3,4,4,0,2018-11-21
6035,서울,강북구,0,1,2,3,3,0,2018-12-21
6036,서울,강서구,3,0,0,3,2,0,2018-01-21
6037,서울,강서구,8,0,0,8,4,0,2018-02-21
6038,서울,강서구,7,0,0,7,6,0,2018-03-21
6039,서울,강서구,10,2,1,13,8,0,2018-04-21
6040,서울,강서구,5,0,3,8,4,0,2018-05-21
6041,서울,강서구,5,0,1,6,5,0,2018-06-21
6042,서울,강서구,7,0,6,13,8,0,2018-07-21
6043,서울,강서구,6,0,3,9,7,1,2018-08-21
6044,서울,강서구,6,1,1,8,5,0,2018-09-21
6045,서울,강서구,4,1,2,7,6,0,2018-10-21
6046,서울,강서구,7,1,1,9,6,0,2018-11-21
6047,서울,강서구,6,0,1,7,4,0,2018-12-21
6048,서울,관악구,3,2,1,6,4,0,2018-01-21
6049,서울,관악구,2,0,0,2,2,0,2018-02-21
6050,서울,관악구,1,0,0,1,1,0,2018-03-21
6051,서울,관악구,1,0,1,2,2,0,2018-04-21
6052,서울,관악구,3,0,1,4,3,0,2018-05-21
6053,서울,관악구,2,0,0,2,1,0,2018-06-21
6054,서울,관악구,1,1,0,2,2,0,2018-07-21
6055,서울,관악구,1,0,3,4,4,0,2018-08-21
6056,서울,관악구,4,0,4,8,5,0,2018-09-21
6057,서울,관악구,4,1,0,5,3,0,2018-10-21
6058,서울,관악구,4,0,1,5,5,0,2018-11-21
6059,서울,관악구,2,0,2,4,4,0,2018-12-21
6060,서울,광진구,0,0,0,0,0,0,2018-01-21
6061,서울,광진구,0,1,0,1,1,0,2018-02-21
6062,서울,광진구,6,0,1,7,6,0,2018-03-21
6063,서울,광진구,4,0,0,4,4,0,2018-04-21
6064,서울,광진구,4,2,1,7,6,0,2018-05-21
6065,서울,광진구,2,0,1,3,3,0,2018-06-21
6066,서울,광진구,5,0,1,6,3,0,2018-07-21
6067,서울,광진구,2,1,2,5,4,0,2018-08-21
6068,서울,광진구,3,0,2,5,4,0,2018-09-21
6069,서울,광진구,9,0,1,10,7,0,2018-10-21
6070,서울,광진구,3,0,3,6,5,0,2018-11-21
6071,서울,광진구,2,0,2,4,3,0,2018-12-21
6072,서울,구로구,3,0,1,4,3,0,2018-01-21
6073,서울,구로구,2,0,0,2,2,0,2018-02-21
6074,서울,구로구,2,0,3,5,4,0,2018-03-21
6075,서울,구로구,8,0,2,10,6,0,2018-04-21
6076,서울,구로구,2,1,3,6,6,0,2018-05-21
6077,서울,구로구,12,0,2,14,9,0,2018-06-21
6078,서울,구로구,5,0,1,6,5,0,2018-07-21
6079,서울,구로구,3,0,3,6,7,1,2018-08-21
6080,서울,구로구,1,0,2,3,3,0,2018-09-21
6081,서울,구로구,7,2,2,11,8,0,2018-10-21
6082,서울,구로구,2,0,0,2,2,0,2018-11-21
6083,서울,구로구,3,0,0,3,3,0,2018-12-21
6084,서울,금천구,4,0,1,5,4,0,2018-01-21
6085,서울,금천구,1,1,2,4,4,0,2018-02-21
6086,서울,금천구,2,0,0,2,2,0,2018-03-21
6087,서울,금천구,5,1,2,8,7,0,2018-04-21
6088,서울,금천구,4,0,0,4,2,0,2018-05-21
6089,서울,금천구,4,1,1,6,6,0,2018-06-21
6090,서울,금천구,1,0,0,1,1,0,2018-07-21
6091,서울,금천구,2,0,0,2,2,0,2018-08-21
6092,서울,금천구,3,0,0,3,2,0,2018-09-21
6093,서울,금천구,2,1,0,3,3,0,2018-10-21
6094,서울,금천구,1,0,0,1,1,0,2018-11-21
6095,서울,금천구,4,0,1,5,2,0,2018-12-21
6096,서울,노원구,10,0,0,10,7,0,2018-01-21
6097,서울,노원구,1,0,0,1,1,0,2018-02-21
6098,서울,노원구,5,0,0,5,2,0,2018-03-21
6099,서울,노원구,6,1,1,8,6,0,2018-04-21
6100,서울,노원구,12,3,2,17,6,0,2018-05-21
6101,서울,노원구,0,0,1,1,1,0,2018-06-21
6102,서울,노원구,0,0,2,2,2,0,2018-07-21
6103,서울,노원구,5,0,1,6,5,0,2018-08-21
6104,서울,노원구,7,0,2,9,4,0,2018-09-21
6105,서울,노원구,2,2,2,6,4,0,2018-10-21
6106,서울,노원구,2,0,0,2,2,0,2018-11-21
6107,서울,노원구,4,0,2,6,4,0,2018-12-21
6108,서울,도봉구,0,0,0,0,0,0,2018-01-21
6109,서울,도봉구,0,0,0,0,0,0,2018-02-21
6110,서울,도봉구,1,0,0,1,1,0,2018-03-21
6111,서울,도봉구,2,1,1,4,3,0,2018-04-21
6112,서울,도봉구,4,0,2,6,5,0,2018-05-21
6113,서울,도봉구,2,0,1,3,3,0,2018-06-21
6114,서울,도봉구,3,0,1,4,2,0,2018-07-21
6115,서울,도봉구,0,0,0,0,0,0,2018-08-21
6116,서울,도봉구,0,1,0,1,1,0,2018-09-21
6117,서울,도봉구,1,1,0,2,2,0,2018-10-21
6118,서울,도봉구,4,1,1,6,3,0,2018-11-21
6119,서울,도봉구,1,0,2,3,3,0,2018-12-21
6120,서울,동대문구,5,0,1,6,5,0,2018-01-21
6121,서울,동대문구,3,0,2,5,5,0,2018-02-21
6122,서울,동대문구,0,1,2,3,3,0,2018-03-21
6123,서울,동대문구,1,0,1,2,2,0,2018-04-21
6124,서울,동대문구,9,0,3,12,11,0,2018-05-21
6125,서울,동대문구,4,0,1,5,4,0,2018-06-21
6126,서울,동대문구,2,1,0,3,3,0,2018-07-21
6127,서울,동대문구,4,0,4,8,5,0,2018-08-21
6128,서울,동대문구,5,0,1,6,6,0,2018-09-21
6129,서울,동대문구,3,0,1,4,4,0,2018-10-21
6130,서울,동대문구,2,0,1,3,3,0,2018-11-21
6131,서울,동대문구,3,1,0,4,3,0,2018-12-21
6132,서울,동작구,1,0,2,3,2,0,2018-01-21
6133,서울,동작구,5,0,0,5,3,0,2018-02-21
6134,서울,동작구,3,0,2,5,5,0,2018-03-21
6135,서울,동작구,10,5,2,17,11,0,2018-04-21
6136,서울,동작구,4,0,1,5,4,0,2018-05-21
6137,서울,동작구,3,1,2,6,3,0,2018-06-21
6138,서울,동작구,5,1,2,8,6,0,2018-07-21
6139,서울,동작구,1,2,2,5,5,0,2018-08-21
6140,서울,동작구,8,0,1,9,8,0,2018-09-21
6141,서울,동작구,0,1,1,2,2,0,2018-10-21
6142,서울,동작구,1,1,1,3,3,0,2018-11-21
6143,서울,동작구,4,0,1,5,5,0,2018-12-21
6144,서울,마포구,6,2,0,8,5,0,2018-01-21
6145,서울,마포구,8,0,2,10,8,0,2018-02-21
6146,서울,마포구,2,0,0,2,2,0,2018-03-21
6147,서울,마포구,2,1,0,3,3,0,2018-04-21
6148,서울,마포구,3,0,3,6,5,0,2018-05-21
6149,서울,마포구,6,0,0,6,5,0,2018-06-21
6150,서울,마포구,2,0,1,3,2,0,2018-07-21
6151,서울,마포구,8,0,0,8,5,0,2018-08-21
6152,서울,마포구,4,0,0,4,3,0,2018-09-21
6153,서울,마포구,10,1,1,12,8,0,2018-10-21
6154,서울,마포구,5,1,1,7,5,0,2018-11-21
6155,서울,마포구,4,2,1,7,6,0,2018-12-21
6156,서울,서대문구,0,0,1,1,1,0,2018-01-21
6157,서울,서대문구,1,1,2,4,3,0,2018-02-21
6158,서울,서대문구,1,1,0,2,2,0,2018-03-21
6159,서울,서대문구,4,0,0,4,4,0,2018-04-21
6160,서울,서대문구,1,1,0,2,2,0,2018-05-21
6161,서울,서대문구,4,1,1,6,6,0,2018-06-21
6162,서울,서대문구,11,1,2,14,4,0,2018-07-21
6163,서울,서대문구,5,0,1,6,4,0,2018-08-21
6164,서울,서대문구,2,2,1,5,5,0,2018-09-21
6165,서울,서대문구,5,0,1,6,3,0,2018-10-21
6166,서울,서대문구,0,0,0,0,0,0,2018-11-21
6167,서울,서대문구,2,0,0,2,2,0,2018-12-21
6168,서울,서초구,7,0,2,9,3,0,2018-01-21
6169,서울,서초구,6,0,2,8,6,0,2018-02-21
6170,서울,서초구,6,2,2,10,8,0,2018-03-21
6171,서울,서초구,10,3,1,14,8,0,2018-04-21
6172,서울,서초구,5,0,3,8,6,0,2018-05-21
6173,서울,서초구,6,1,2,9,8,0,2018-06-21
6174,서울,서초구,12,2,3,17,11,0,2018-07-21
6175,서울,서초구,5,0,0,5,4,0,2018-08-21
6176,서울,서초구,11,0,6,17,13,1,2018-09-21
6177,서울,서초구,3,0,1,4,4,0,2018-10-21
6178,서울,서초구,5,1,6,12,9,1,2018-11-21
6179,서울,서초구,6,0,4,10,7,0,2018-12-21
6180,서울,성동구,1,0,0,1,1,0,2018-01-21
6181,서울,성동구,2,0,0,2,2,0,2018-02-21
6182,서울,성동구,3,1,1,5,5,0,2018-03-21
6183,서울,성동구,5,0,3,8,7,0,2018-04-21
6184,서울,성동구,3,1,0,4,2,0,2018-05-21
6185,서울,성동구,1,0,1,2,2,0,2018-06-21
6186,서울,성동구,5,1,1,7,3,0,2018-07-21
6187,서울,성동구,4,0,0,4,1,0,2018-08-21
6188,서울,성동구,1,0,0,1,1,0,2018-09-21
6189,서울,성동구,1,1,2,4,4,0,2018-10-21
6190,서울,성동구,6,0,0,6,3,0,2018-11-21
6191,서울,성동구,3,0,3,6,4,0,2018-12-21
6192,서울,성북구,0,1,1,2,2,0,2018-01-21
6193,서울,성북구,4,0,0,4,4,0,2018-02-21
6194,서울,성북구,3,0,0,3,3,0,2018-03-21
6195,서울,성북구,9,0,1,10,4,0,2018-04-21
6196,서울,성북구,0,0,2,2,2,0,2018-05-21
6197,서울,성북구,8,0,1,9,5,0,2018-06-21
6198,서울,성북구,4,0,0,4,3,0,2018-07-21
6199,서울,성북구,2,0,1,3,3,0,2018-08-21
6200,서울,성북구,5,0,0,5,4,0,2018-09-21
6201,서울,성북구,6,0,0,6,4,0,2018-10-21
6202,서울,성북구,4,0,4,8,7,0,2018-11-21
6203,서울,성북구,4,0,1,5,3,0,2018-12-21
6204,서울,송파구,3,1,1,5,4,0,2018-01-21
6205,서울,송파구,4,1,2,7,4,1,2018-02-21
6206,서울,송파구,7,3,3,13,9,0,2018-03-21
6207,서울,송파구,12,2,6,20,16,0,2018-04-21
6208,서울,송파구,9,1,3,13,10,0,2018-05-21
6209,서울,송파구,19,1,1,21,10,0,2018-06-21
6210,서울,송파구,15,0,0,15,10,1,2018-07-21
6211,서울,송파구,4,5,2,11,9,0,2018-08-21
6212,서울,송파구,5,1,4,10,9,0,2018-09-21
6213,서울,송파구,6,1,2,9,7,0,2018-10-21
6214,서울,송파구,7,4,3,14,9,0,2018-11-21
6215,서울,송파구,25,3,2,30,19,0,2018-12-21
6216,서울,양천구,3,2,1,6,5,0,2018-01-21
6217,서울,양천구,1,0,1,2,2,0,2018-02-21
6218,서울,양천구,3,1,2,6,4,0,2018-03-21
6219,서울,양천구,3,1,1,5,5,0,2018-04-21
6220,서울,양천구,5,0,1,6,4,0,2018-05-21
6221,서울,양천구,0,0,1,1,1,0,2018-06-21
6222,서울,양천구,3,0,0,3,2,0,2018-07-21
6223,서울,양천구,3,0,0,3,3,0,2018-08-21
6224,서울,양천구,1,0,1,2,2,0,2018-09-21
6225,서울,양천구,1,0,0,1,1,0,2018-10-21
6226,서울,양천구,2,0,2,4,5,1,2018-11-21
6227,서울,양천구,7,0,0,7,5,0,2018-12-21
6228,서울,영등포구,6,1,2,9,7,0,2018-01-21
6229,서울,영등포구,4,1,0,5,5,0,2018-02-21
6230,서울,영등포구,6,0,1,7,5,0,2018-03-21
6231,서울,영등포구,15,0,2,17,12,0,2018-04-21
6232,서울,영등포구,12,2,2,16,13,0,2018-05-21
6233,서울,영등포구,7,1,3,11,6,0,2018-06-21
6234,서울,영등포구,7,0,1,8,4,0,2018-07-21
6235,서울,영등포구,1,2,2,5,5,0,2018-08-21
6236,서울,영등포구,12,1,3,16,12,0,2018-09-21
6237,서울,영등포구,10,1,0,11,4,0,2018-10-21
6238,서울,영등포구,7,1,0,8,7,0,2018-11-21
6239,서울,영등포구,9,0,2,11,8,0,2018-12-21
6240,서울,용산구,7,0,1,8,2,0,2018-01-21
6241,서울,용산구,2,1,3,6,4,0,2018-02-21
6242,서울,용산구,2,0,1,3,2,0,2018-03-21
6243,서울,용산구,7,1,3,11,8,0,2018-04-21
6244,서울,용산구,1,0,0,1,1,0,2018-05-21
6245,서울,용산구,8,1,1,10,6,0,2018-06-21
6246,서울,용산구,4,0,1,5,3,0,2018-07-21
6247,서울,용산구,3,1,1,5,5,0,2018-08-21
6248,서울,용산구,2,0,2,4,3,0,2018-09-21
6249,서울,용산구,4,0,0,4,3,0,2018-10-21
6250,서울,용산구,2,0,1,3,2,0,2018-11-21
6251,서울,용산구,4,0,2,6,4,0,2018-12-21
6252,서울,은평구,0,0,0,0,0,0,2018-01-21
6253,서울,은평구,3,0,2,5,3,0,2018-02-21
6254,서울,은평구,3,0,0,3,2,0,2018-03-21
6255,서울,은평구,6,0,0,6,4,0,2018-04-21
6256,서울,은평구,5,0,0,5,4,0,2018-05-21
6257,서울,은평구,7,1,3,11,8,0,2018-06-21
6258,서울,은평구,2,0,3,5,4,0,2018-07-21
6259,서울,은평구,4,1,0,5,2,0,2018-08-21
6260,서울,은평구,2,1,1,4,3,0,2018-09-21
6261,서울,은평구,2,0,1,3,3,0,2018-10-21
6262,서울,은평구,4,0,1,5,4,0,2018-11-21
6263,서울,은평구,4,0,1,5,5,0,2018-12-21
6264,서울,종로구,3,0,1,4,3,0,2018-01-21
6265,서울,종로구,0,0,0,0,0,0,2018-02-21
6266,서울,종로구,3,0,0,3,2,0,2018-03-21
6267,서울,종로구,0,0,1,1,1,0,2018-04-21
6268,서울,종로구,2,0,1,3,3,0,2018-05-21
6269,서울,종로구,0,1,0,1,1,0,2018-06-21
6270,서울,종로구,4,0,0,4,4,0,2018-07-21
6271,서울,종로구,3,1,1,5,4,0,2018-08-21
6272,서울,종로구,1,0,1,2,2,0,2018-09-21
6273,서울,종로구,4,1,1,6,4,0,2018-10-21
6274,서울,종로구,0,0,1,1,1,0,2018-11-21
6275,서울,종로구,1,0,1,2,2,0,2018-12-21
6276,서울,중구,3,2,0,5,3,0,2018-01-21
6277,서울,중구,5,0,1,6,3,0,2018-02-21
6278,서울,중구,2,0,1,3,3,0,2018-03-21
6279,서울,중구,0,0,1,1,2,1,2018-04-21
6280,서울,중구,2,0,0,2,2,0,2018-05-21
6281,서울,중구,2,0,3,5,3,0,2018-06-21
6282,서울,중구,0,0,0,0,0,0,2018-07-21
6283,서울,중구,2,1,0,3,3,1,2018-08-21
6284,서울,중구,3,0,4,7,7,0,2018-09-21
6285,서울,중구,4,0,1,5,3,0,2018-10-21
6286,서울,중구,0,0,1,1,1,0,2018-11-21
6287,서울,중구,4,0,0,4,1,0,2018-12-21
6288,서울,중랑구,5,1,1,7,3,0,2018-01-21
6289,서울,중랑구,2,0,0,2,2,0,2018-02-21
6290,서울,중랑구,0,2,3,5,3,0,2018-03-21
6291,서울,중랑구,7,2,0,9,4,0,2018-04-21
6292,서울,중랑구,5,0,1,6,4,0,2018-05-21
6293,서울,중랑구,2,0,1,3,3,0,2018-06-21
6294,서울,중랑구,5,3,3,11,8,0,2018-07-21
6295,서울,중랑구,7,0,1,8,3,0,2018-08-21
6296,서울,중랑구,5,0,2,7,5,0,2018-09-21
6297,서울,중랑구,8,2,2,12,7,0,2018-10-21
6298,서울,중랑구,9,0,2,11,5,0,2018-11-21
6299,서울,중랑구,2,0,1,3,3,0,2018-12-21
6300,서울,강남구,4,3,0,7,6,0,2018-01-22
6301,서울,강남구,9,1,1,11,8,0,2018-02-22
6302,서울,강남구,13,2,4,19,13,0,2018-03-22
6303,서울,강남구,10,0,3,13,7,0,2018-04-22
6304,서울,강남구,4,1,2,7,6,0,2018-05-22
6305,서울,강남구,8,3,5,16,14,0,2018-06-22
6306,서울,강남구,8,0,2,10,7,0,2018-07-22
6307,서울,강남구,11,2,5,18,15,0,2018-08-22
6308,서울,강남구,11,1,0,12,7,0,2018-09-22
6309,서울,강남구,6,0,2,8,6,0,2018-10-22
6310,서울,강남구,4,0,1,5,4,0,2018-11-22
6311,서울,강남구,16,1,1,18,13,0,2018-12-22
6312,서울,강동구,2,0,2,4,5,1,2018-01-22
6313,서울,강동구,3,0,0,3,2,0,2018-02-22
6314,서울,강동구,1,0,1,2,2,1,2018-03-22
6315,서울,강동구,9,0,2,11,9,1,2018-04-22
6316,서울,강동구,0,3,0,3,2,0,2018-05-22
6317,서울,강동구,2,2,2,6,5,0,2018-06-22
6318,서울,강동구,3,0,0,3,1,0,2018-07-22
6319,서울,강동구,5,0,1,6,4,0,2018-08-22
6320,서울,강동구,2,0,3,5,5,0,2018-09-22
6321,서울,강동구,2,0,1,3,3,0,2018-10-22
6322,서울,강동구,6,3,1,10,6,0,2018-11-22
6323,서울,강동구,1,1,2,4,3,0,2018-12-22
6324,서울,강북구,6,1,1,8,6,0,2018-01-22
6325,서울,강북구,1,0,3,4,4,0,2018-02-22
6326,서울,강북구,3,1,0,4,4,0,2018-03-22
6327,서울,강북구,3,0,1,4,2,0,2018-04-22
6328,서울,강북구,5,0,4,9,7,0,2018-05-22
6329,서울,강북구,2,0,3,5,3,0,2018-06-22
6330,서울,강북구,3,0,2,5,4,1,2018-07-22
6331,서울,강북구,2,0,0,2,2,0,2018-08-22
6332,서울,강북구,1,0,2,3,3,0,2018-09-22
6333,서울,강북구,2,0,3,5,5,0,2018-10-22
6334,서울,강북구,5,0,1,6,3,0,2018-11-22
6335,서울,강북구,9,0,0,9,6,0,2018-12-22
6336,서울,강서구,3,2,2,7,6,0,2018-01-22
6337,서울,강서구,3,0,1,4,4,0,2018-02-22
6338,서울,강서구,5,0,1,6,3,0,2018-03-22
6339,서울,강서구,3,0,2,5,3,0,2018-04-22
6340,서울,강서구,4,0,0,4,2,0,2018-05-22
6341,서울,강서구,6,0,4,10,8,0,2018-06-22
6342,서울,강서구,9,0,0,9,3,0,2018-07-22
6343,서울,강서구,2,1,2,5,5,0,2018-08-22
6344,서울,강서구,4,1,1,6,5,0,2018-09-22
6345,서울,강서구,4,0,1,5,4,0,2018-10-22
6346,서울,강서구,6,0,2,8,7,0,2018-11-22
6347,서울,강서구,1,1,0,2,2,0,2018-12-22
6348,서울,관악구,2,0,1,3,3,0,2018-01-22
6349,서울,관악구,1,0,2,3,3,0,2018-02-22
6350,서울,관악구,1,0,0,1,1,0,2018-03-22
6351,서울,관악구,6,0,0,6,5,0,2018-04-22
6352,서울,관악구,1,0,1,2,2,0,2018-05-22
6353,서울,관악구,5,1,2,8,8,0,2018-06-22
6354,서울,관악구,3,0,1,4,4,0,2018-07-22
6355,서울,관악구,1,0,0,1,1,0,2018-08-22
6356,서울,관악구,3,1,2,6,5,0,2018-09-22
6357,서울,관악구,3,0,2,5,5,0,2018-10-22
6358,서울,관악구,5,0,0,5,4,0,2018-11-22
6359,서울,관악구,3,0,2,5,4,0,2018-12-22
6360,서울,광진구,1,0,1,2,2,0,2018-01-22
6361,서울,광진구,2,1,1,4,4,0,2018-02-22
6362,서울,광진구,3,0,1,4,3,0,2018-03-22
6363,서울,광진구,1,0,1,2,1,0,2018-04-22
6364,서울,광진구,6,0,0,6,5,0,2018-05-22
6365,서울,광진구,2,0,1,3,3,0,2018-06-22
6366,서울,광진구,3,2,1,6,3,0,2018-07-22
6367,서울,광진구,3,0,1,4,3,0,2018-08-22
6368,서울,광진구,4,0,2,6,2,0,2018-09-22
6369,서울,광진구,0,0,0,0,0,0,2018-10-22
6370,서울,광진구,2,0,0,2,2,0,2018-11-22
6371,서울,광진구,0,0,0,0,0,0,2018-12-22
6372,서울,구로구,6,0,0,6,4,0,2018-01-22
6373,서울,구로구,1,0,0,1,1,0,2018-02-22
6374,서울,구로구,5,1,2,8,5,0,2018-03-22
6375,서울,구로구,2,0,2,4,3,0,2018-04-22
6376,서울,구로구,8,1,1,10,8,0,2018-05-22
6377,서울,구로구,6,0,1,7,7,0,2018-06-22
6378,서울,구로구,5,0,2,7,4,0,2018-07-22
6379,서울,구로구,1,1,1,3,2,0,2018-08-22
6380,서울,구로구,3,0,1,4,3,0,2018-09-22
6381,서울,구로구,4,0,2,6,6,0,2018-10-22
6382,서울,구로구,4,0,0,4,4,1,2018-11-22
6383,서울,구로구,1,0,0,1,1,0,2018-12-22
6384,서울,금천구,0,1,0,1,1,0,2018-01-22
6385,서울,금천구,3,0,0,3,2,0,2018-02-22
6386,서울,금천구,2,0,2,4,3,0,2018-03-22
6387,서울,금천구,1,0,0,1,1,0,2018-04-22
6388,서울,금천구,0,0,1,1,1,0,2018-05-22
6389,서울,금천구,4,1,1,6,4,0,2018-06-22
6390,서울,금천구,6,2,0,8,5,0,2018-07-22
6391,서울,금천구,2,0,3,5,4,0,2018-08-22
6392,서울,금천구,5,0,1,6,2,0,2018-09-22
6393,서울,금천구,2,0,1,3,3,0,2018-10-22
6394,서울,금천구,3,0,1,4,4,0,2018-11-22
6395,서울,금천구,1,0,0,1,1,0,2018-12-22
6396,서울,노원구,1,0,1,2,2,1,2018-01-22
6397,서울,노원구,3,0,0,3,2,0,2018-02-22
6398,서울,노원구,11,2,5,18,7,0,2018-03-22
6399,서울,노원구,4,1,4,9,8,0,2018-04-22
6400,서울,노원구,1,1,0,2,2,0,2018-05-22
6401,서울,노원구,4,1,2,7,7,0,2018-06-22
6402,서울,노원구,2,0,0,2,2,0,2018-07-22
6403,서울,노원구,6,0,1,7,4,0,2018-08-22
6404,서울,노원구,9,1,4,14,11,0,2018-09-22
6405,서울,노원구,6,0,0,6,5,0,2018-10-22
6406,서울,노원구,2,0,1,3,3,0,2018-11-22
6407,서울,노원구,5,0,1,6,2,0,2018-12-22
6408,서울,도봉구,3,0,2,5,4,0,2018-01-22
6409,서울,도봉구,1,1,1,3,3,0,2018-02-22
6410,서울,도봉구,4,1,2,7,5,0,2018-03-22
6411,서울,도봉구,3,1,2,6,3,0,2018-04-22
6412,서울,도봉구,4,0,1,5,3,0,2018-05-22
6413,서울,도봉구,4,1,1,6,3,0,2018-06-22
6414,서울,도봉구,2,0,1,3,3,0,2018-07-22
6415,서울,도봉구,7,0,3,10,6,0,2018-08-22
6416,서울,도봉구,0,0,1,1,1,0,2018-09-22
6417,서울,도봉구,0,0,3,3,3,0,2018-10-22
6418,서울,도봉구,6,0,0,6,2,0,2018-11-22
6419,서울,도봉구,0,0,1,1,1,0,2018-12-22
6420,서울,동대문구,2,0,0,2,2,0,2018-01-22
6421,서울,동대문구,5,0,0,5,3,0,2018-02-22
6422,서울,동대문구,6,1,1,8,7,0,2018-03-22
6423,서울,동대문구,5,2,2,9,7,0,2018-04-22
6424,서울,동대문구,0,0,1,1,1,0,2018-05-22
6425,서울,동대문구,4,1,1,6,7,1,2018-06-22
6426,서울,동대문구,2,1,3,6,6,0,2018-07-22
6427,서울,동대문구,7,2,1,10,9,0,2018-08-22
6428,서울,동대문구,2,0,3,5,5,0,2018-09-22
6429,서울,동대문구,0,0,1,1,1,0,2018-10-22
6430,서울,동대문구,3,0,1,4,3,0,2018-11-22
6431,서울,동대문구,9,0,1,10,7,0,2018-12-22
6432,서울,동작구,1,0,1,2,2,0,2018-01-22
6433,서울,동작구,1,2,1,4,4,0,2018-02-22
6434,서울,동작구,0,0,0,0,0,0,2018-03-22
6435,서울,동작구,2,1,0,3,3,0,2018-04-22
6436,서울,동작구,3,0,0,3,3,0,2018-05-22
6437,서울,동작구,5,0,2,7,5,0,2018-06-22
6438,서울,동작구,3,1,1,5,3,0,2018-07-22
6439,서울,동작구,5,1,3,9,8,0,2018-08-22
6440,서울,동작구,2,1,2,5,3,0,2018-09-22
6441,서울,동작구,4,1,2,7,6,0,2018-10-22
6442,서울,동작구,5,2,2,9,7,0,2018-11-22
6443,서울,동작구,9,0,2,11,6,0,2018-12-22
6444,서울,마포구,7,0,0,7,5,0,2018-01-22
6445,서울,마포구,5,0,0,5,3,0,2018-02-22
6446,서울,마포구,3,0,1,4,4,0,2018-03-22
6447,서울,마포구,8,0,1,9,5,0,2018-04-22
6448,서울,마포구,13,0,1,14,9,0,2018-05-22
6449,서울,마포구,4,0,3,7,4,0,2018-06-22
6450,서울,마포구,10,0,1,11,4,0,2018-07-22
6451,서울,마포구,4,0,2,6,4,0,2018-08-22
6452,서울,마포구,6,0,3,9,6,0,2018-09-22
6453,서울,마포구,3,0,1,4,3,0,2018-10-22
6454,서울,마포구,3,0,1,4,4,0,2018-11-22
6455,서울,마포구,5,1,1,7,6,0,2018-12-22
6456,서울,서대문구,1,1,0,2,1,0,2018-01-22
6457,서울,서대문구,2,0,2,4,3,0,2018-02-22
6458,서울,서대문구,3,1,1,5,5,0,2018-03-22
6459,서울,서대문구,2,0,0,2,1,0,2018-04-22
6460,서울,서대문구,0,0,0,0,0,0,2018-05-22
6461,서울,서대문구,1,0,0,1,1,0,2018-06-22
6462,서울,서대문구,1,0,0,1,1,0,2018-07-22
6463,서울,서대문구,3,0,1,4,3,0,2018-08-22
6464,서울,서대문구,6,3,0,9,6,0,2018-09-22
6465,서울,서대문구,4,1,1,6,6,0,2018-10-22
6466,서울,서대문구,5,0,0,5,3,0,2018-11-22
6467,서울,서대문구,1,0,1,2,2,0,2018-12-22
6468,서울,서초구,13,2,4,19,16,0,2018-01-22
6469,서울,서초구,5,1,1,7,6,0,2018-02-22
6470,서울,서초구,10,0,4,14,8,0,2018-03-22
6471,서울,서초구,2,1,1,4,4,0,2018-04-22
6472,서울,서초구,11,2,4,17,11,0,2018-05-22
6473,서울,서초구,18,0,5,23,14,0,2018-06-22
6474,서울,서초구,7,2,3,12,8,0,2018-07-22
6475,서울,서초구,4,1,1,6,5,0,2018-08-22
6476,서울,서초구,8,0,3,11,8,0,2018-09-22
6477,서울,서초구,13,0,5,18,11,0,2018-10-22
6478,서울,서초구,8,0,4,12,10,0,2018-11-22
6479,서울,서초구,9,0,0,9,6,0,2018-12-22
6480,서울,성동구,3,0,0,3,2,0,2018-01-22
6481,서울,성동구,3,0,1,4,4,0,2018-02-22
6482,서울,성동구,0,0,0,0,0,0,2018-03-22
6483,서울,성동구,6,4,3,13,5,0,2018-04-22
6484,서울,성동구,5,1,0,6,4,0,2018-05-22
6485,서울,성동구,3,0,1,4,4,0,2018-06-22
6486,서울,성동구,0,1,1,2,2,0,2018-07-22
6487,서울,성동구,4,0,1,5,4,0,2018-08-22
6488,서울,성동구,4,0,1,5,5,0,2018-09-22
6489,서울,성동구,3,0,0,3,3,0,2018-10-22
6490,서울,성동구,1,0,1,2,1,0,2018-11-22
6491,서울,성동구,4,0,0,4,3,0,2018-12-22
6492,서울,성북구,2,0,1,3,3,0,2018-01-22
6493,서울,성북구,4,0,1,5,4,0,2018-02-22
6494,서울,성북구,2,0,1,3,3,0,2018-03-22
6495,서울,성북구,3,0,0,3,2,0,2018-04-22
6496,서울,성북구,4,0,2,6,6,0,2018-05-22
6497,서울,성북구,11,1,0,12,7,0,2018-06-22
6498,서울,성북구,6,1,0,7,3,0,2018-07-22
6499,서울,성북구,4,0,0,4,3,0,2018-08-22
6500,서울,성북구,2,0,2,4,4,0,2018-09-22
6501,서울,성북구,1,0,0,1,1,0,2018-10-22
6502,서울,성북구,2,3,3,8,6,0,2018-11-22
6503,서울,성북구,3,1,2,6,4,0,2018-12-22
6504,서울,송파구,6,0,5,11,4,1,2018-01-22
6505,서울,송파구,2,1,1,4,4,0,2018-02-22
6506,서울,송파구,3,1,1,5,5,0,2018-03-22
6507,서울,송파구,4,1,0,5,4,0,2018-04-22
6508,서울,송파구,4,1,4,9,8,0,2018-05-22
6509,서울,송파구,14,2,3,19,12,0,2018-06-22
6510,서울,송파구,5,2,1,8,7,0,2018-07-22
6511,서울,송파구,4,1,2,7,7,1,2018-08-22
6512,서울,송파구,11,1,1,13,8,0,2018-09-22
6513,서울,송파구,5,1,3,9,8,0,2018-10-22
6514,서울,송파구,11,1,1,13,10,0,2018-11-22
6515,서울,송파구,4,1,4,9,6,0,2018-12-22
6516,서울,양천구,1,0,0,1,1,0,2018-01-22
6517,서울,양천구,1,0,0,1,1,0,2018-02-22
6518,서울,양천구,6,0,3,9,5,0,2018-03-22
6519,서울,양천구,6,0,0,6,3,0,2018-04-22
6520,서울,양천구,10,2,2,14,7,0,2018-05-22
6521,서울,양천구,1,0,0,1,1,0,2018-06-22
6522,서울,양천구,3,0,1,4,4,0,2018-07-22
6523,서울,양천구,8,1,4,13,7,0,2018-08-22
6524,서울,양천구,0,2,1,3,2,0,2018-09-22
6525,서울,양천구,2,0,1,3,3,0,2018-10-22
6526,서울,양천구,3,2,3,8,7,0,2018-11-22
6527,서울,양천구,5,4,0,9,4,0,2018-12-22
6528,서울,영등포구,4,0,1,5,5,0,2018-01-22
6529,서울,영등포구,13,1,1,15,7,0,2018-02-22
6530,서울,영등포구,8,0,0,8,5,0,2018-03-22
6531,서울,영등포구,2,2,1,5,4,0,2018-04-22
6532,서울,영등포구,10,3,1,14,7,0,2018-05-22
6533,서울,영등포구,9,1,3,13,12,0,2018-06-22
6534,서울,영등포구,11,3,2,16,8,0,2018-07-22
6535,서울,영등포구,10,1,1,12,9,0,2018-08-22
6536,서울,영등포구,11,1,2,14,9,0,2018-09-22
6537,서울,영등포구,7,1,1,9,8,0,2018-10-22
6538,서울,영등포구,7,2,1,10,6,0,2018-11-22
6539,서울,영등포구,6,1,2,9,5,0,2018-12-22
6540,서울,용산구,3,0,0,3,3,0,2018-01-22
6541,서울,용산구,5,0,1,6,5,0,2018-02-22
6542,서울,용산구,3,1,1,5,4,0,2018-03-22
6543,서울,용산구,3,0,0,3,3,0,2018-04-22
6544,서울,용산구,2,1,0,3,3,0,2018-05-22
6545,서울,용산구,9,1,3,13,7,0,2018-06-22
6546,서울,용산구,1,0,1,2,2,0,2018-07-22
6547,서울,용산구,6,0,3,9,5,0,2018-08-22
6548,서울,용산구,11,2,1,14,8,0,2018-09-22
6549,서울,용산구,2,0,0,2,1,0,2018-10-22
6550,서울,용산구,2,0,0,2,2,0,2018-11-22
6551,서울,용산구,8,1,0,9,7,0,2018-12-22
6552,서울,은평구,8,1,0,9,5,0,2018-01-22
6553,서울,은평구,3,1,0,4,2,0,2018-02-22
6554,서울,은평구,1,0,1,2,2,0,2018-03-22
6555,서울,은평구,4,1,1,6,4,0,2018-04-22
6556,서울,은평구,4,1,2,7,5,0,2018-05-22
6557,서울,은평구,4,0,3,7,5,0,2018-06-22
6558,서울,은평구,1,0,1,2,2,0,2018-07-22
6559,서울,은평구,7,2,1,10,7,1,2018-08-22
6560,서울,은평구,8,0,0,8,5,0,2018-09-22
6561,서울,은평구,0,2,0,2,2,0,2018-10-22
6562,서울,은평구,1,1,0,2,2,0,2018-11-22
6563,서울,은평구,3,0,1,4,4,0,2018-12-22
6564,서울,종로구,1,1,0,2,2,0,2018-01-22
6565,서울,종로구,2,0,1,3,2,0,2018-02-22
6566,서울,종로구,2,0,2,4,3,0,2018-03-22
6567,서울,종로구,2,0,1,3,3,0,2018-04-22
6568,서울,종로구,3,1,0,4,3,0,2018-05-22
6569,서울,종로구,0,1,0,1,1,0,2018-06-22
6570,서울,종로구,1,0,0,1,1,0,2018-07-22
6571,서울,종로구,2,2,1,5,3,0,2018-08-22
6572,서울,종로구,0,1,0,1,1,0,2018-09-22
6573,서울,종로구,1,0,1,2,2,0,2018-10-22
6574,서울,종로구,1,0,0,1,1,0,2018-11-22
6575,서울,종로구,3,1,1,5,4,0,2018-12-22
6576,서울,중구,3,0,3,6,6,0,2018-01-22
6577,서울,중구,3,0,4,7,4,0,2018-02-22
6578,서울,중구,4,0,0,4,4,0,2018-03-22
6579,서울,중구,1,2,0,3,2,0,2018-04-22
6580,서울,중구,2,0,0,2,2,0,2018-05-22
6581,서울,중구,5,0,2,7,6,0,2018-06-22
6582,서울,중구,3,0,0,3,2,0,2018-07-22
6583,서울,중구,1,0,3,4,4,0,2018-08-22
6584,서울,중구,2,0,1,3,2,0,2018-09-22
6585,서울,중구,2,0,0,2,2,0,2018-10-22
6586,서울,중구,2,1,1,4,3,0,2018-11-22
6587,서울,중구,1,1,0,2,2,0,2018-12-22
6588,서울,중랑구,1,0,0,1,1,0,2018-01-22
6589,서울,중랑구,5,0,0,5,4,0,2018-02-22
6590,서울,중랑구,2,0,1,3,4,1,2018-03-22
6591,서울,중랑구,5,1,0,6,4,0,2018-04-22
6592,서울,중랑구,3,2,3,8,6,0,2018-05-22
6593,서울,중랑구,9,0,3,12,9,0,2018-06-22
6594,서울,중랑구,0,0,1,1,1,0,2018-07-22
6595,서울,중랑구,1,0,3,4,4,0,2018-08-22
6596,서울,중랑구,3,0,1,4,3,0,2018-09-22
6597,서울,중랑구,6,0,2,8,3,0,2018-10-22
6598,서울,중랑구,1,0,0,1,1,0,2018-11-22
6599,서울,중랑구,3,2,2,7,7,0,2018-12-22
6600,서울,강남구,8,0,4,12,9,0,2018-01-23
6601,서울,강남구,14,0,5,19,11,0,2018-02-23
6602,서울,강남구,9,1,5,15,10,0,2018-03-23
6603,서울,강남구,16,2,3,21,14,0,2018-04-23
6604,서울,강남구,5,2,2,9,9,0,2018-05-23
6605,서울,강남구,8,0,4,12,9,0,2018-06-23
6606,서울,강남구,14,1,2,17,14,0,2018-07-23
6607,서울,강남구,7,0,5,12,9,0,2018-08-23
6608,서울,강남구,1,0,2,3,3,0,2018-09-23
6609,서울,강남구,9,1,3,13,11,0,2018-10-23
6610,서울,강남구,22,2,4,28,21,0,2018-11-23
6611,서울,강남구,2,1,0,3,4,1,2018-12-23
6612,서울,강동구,6,0,0,6,4,0,2018-01-23
6613,서울,강동구,2,0,1,3,3,0,2018-02-23
6614,서울,강동구,1,1,2,4,4,0,2018-03-23
6615,서울,강동구,2,1,1,4,4,0,2018-04-23
6616,서울,강동구,9,1,5,15,10,0,2018-05-23
6617,서울,강동구,2,0,3,5,5,0,2018-06-23
6618,서울,강동구,0,1,1,2,3,1,2018-07-23
6619,서울,강동구,0,0,0,0,0,0,2018-08-23
6620,서울,강동구,2,0,0,2,2,0,2018-09-23
6621,서울,강동구,5,2,1,8,6,0,2018-10-23
6622,서울,강동구,4,1,1,6,6,0,2018-11-23
6623,서울,강동구,7,0,4,11,6,0,2018-12-23
6624,서울,강북구,1,0,0,1,1,0,2018-01-23
6625,서울,강북구,8,0,1,9,3,1,2018-02-23
6626,서울,강북구,4,0,3,7,4,0,2018-03-23
6627,서울,강북구,2,0,2,4,3,0,2018-04-23
6628,서울,강북구,5,0,2,7,4,0,2018-05-23
6629,서울,강북구,5,0,0,5,4,0,2018-06-23
6630,서울,강북구,1,0,2,3,2,0,2018-07-23
6631,서울,강북구,6,1,2,9,9,1,2018-08-23
6632,서울,강북구,0,0,0,0,0,0,2018-09-23
6633,서울,강북구,2,0,2,4,4,0,2018-10-23
6634,서울,강북구,4,0,1,5,4,0,2018-11-23
6635,서울,강북구,3,0,2,5,2,0,2018-12-23
6636,서울,강서구,1,0,1,2,2,0,2018-01-23
6637,서울,강서구,2,0,1,3,3,0,2018-02-23
6638,서울,강서구,3,0,1,4,4,0,2018-03-23
6639,서울,강서구,6,0,1,7,6,0,2018-04-23
6640,서울,강서구,2,0,0,2,2,0,2018-05-23
6641,서울,강서구,8,0,3,11,6,0,2018-06-23
6642,서울,강서구,1,0,2,3,3,0,2018-07-23
6643,서울,강서구,5,1,0,6,4,0,2018-08-23
6644,서울,강서구,1,0,0,1,1,0,2018-09-23
6645,서울,강서구,7,0,0,7,5,0,2018-10-23
6646,서울,강서구,1,0,0,1,1,0,2018-11-23
6647,서울,강서구,4,1,0,5,3,0,2018-12-23
6648,서울,관악구,1,0,1,2,2,0,2018-01-23
6649,서울,관악구,2,2,2,6,6,0,2018-02-23
6650,서울,관악구,4,2,0,6,6,0,2018-03-23
6651,서울,관악구,2,0,1,3,3,0,2018-04-23
6652,서울,관악구,4,1,2,7,6,0,2018-05-23
6653,서울,관악구,11,0,3,14,8,0,2018-06-23
6654,서울,관악구,1,1,1,3,2,0,2018-07-23
6655,서울,관악구,2,0,1,3,2,0,2018-08-23
6656,서울,관악구,1,0,0,1,1,0,2018-09-23
6657,서울,관악구,4,0,1,5,5,0,2018-10-23
6658,서울,관악구,2,0,0,2,2,0,2018-11-23
6659,서울,관악구,4,1,2,7,3,0,2018-12-23
6660,서울,광진구,3,0,0,3,3,0,2018-01-23
6661,서울,광진구,1,2,1,4,4,0,2018-02-23
6662,서울,광진구,5,2,0,7,4,0,2018-03-23
6663,서울,광진구,6,1,0,7,4,0,2018-04-23
6664,서울,광진구,2,0,0,2,2,0,2018-05-23
6665,서울,광진구,2,0,1,3,3,0,2018-06-23
6666,서울,광진구,7,0,1,8,5,0,2018-07-23
6667,서울,광진구,0,0,1,1,1,0,2018-08-23
6668,서울,광진구,1,0,0,1,1,0,2018-09-23
6669,서울,광진구,4,0,0,4,3,0,2018-10-23
6670,서울,광진구,3,0,1,4,3,0,2018-11-23
6671,서울,광진구,0,0,1,1,1,0,2018-12-23
6672,서울,구로구,2,0,1,3,3,0,2018-01-23
6673,서울,구로구,10,0,1,11,7,0,2018-02-23
6674,서울,구로구,2,0,2,4,4,0,2018-03-23
6675,서울,구로구,5,0,0,5,3,0,2018-04-23
6676,서울,구로구,11,1,3,15,11,0,2018-05-23
6677,서울,구로구,1,1,3,5,5,0,2018-06-23
6678,서울,구로구,7,0,0,7,7,0,2018-07-23
6679,서울,구로구,11,0,0,11,6,0,2018-08-23
6680,서울,구로구,1,0,0,1,1,0,2018-09-23
6681,서울,구로구,9,0,4,13,8,0,2018-10-23
6682,서울,구로구,7,2,2,11,5,0,2018-11-23
6683,서울,구로구,6,0,0,6,4,0,2018-12-23
6684,서울,금천구,1,2,1,4,4,0,2018-01-23
6685,서울,금천구,6,0,1,7,2,0,2018-02-23
6686,서울,금천구,2,0,2,4,4,0,2018-03-23
6687,서울,금천구,4,2,0,6,3,0,2018-04-23
6688,서울,금천구,9,1,0,10,3,0,2018-05-23
6689,서울,금천구,1,1,0,2,1,0,2018-06-23
6690,서울,금천구,7,0,0,7,5,0,2018-07-23
6691,서울,금천구,1,0,0,1,1,0,2018-08-23
6692,서울,금천구,2,0,0,2,2,0,2018-09-23
6693,서울,금천구,0,0,0,0,0,0,2018-10-23
6694,서울,금천구,0,0,0,0,0,0,2018-11-23
6695,서울,금천구,0,0,0,0,0,0,2018-12-23
6696,서울,노원구,2,0,0,2,1,0,2018-01-23
6697,서울,노원구,4,0,1,5,5,0,2018-02-23
6698,서울,노원구,1,0,2,3,2,0,2018-03-23
6699,서울,노원구,7,0,2,9,7,0,2018-04-23
6700,서울,노원구,7,0,2,9,9,0,2018-05-23
6701,서울,노원구,5,0,1,6,3,0,2018-06-23
6702,서울,노원구,2,0,0,2,2,0,2018-07-23
6703,서울,노원구,9,0,1,10,5,0,2018-08-23
6704,서울,노원구,10,0,1,11,5,0,2018-09-23
6705,서울,노원구,3,0,0,3,3,0,2018-10-23
6706,서울,노원구,2,0,1,3,2,0,2018-11-23
6707,서울,노원구,3,0,1,4,2,0,2018-12-23
6708,서울,도봉구,1,0,1,2,2,0,2018-01-23
6709,서울,도봉구,6,0,0,6,3,0,2018-02-23
6710,서울,도봉구,0,0,2,2,2,0,2018-03-23
6711,서울,도봉구,0,0,0,0,0,0,2018-04-23
6712,서울,도봉구,3,0,2,5,5,0,2018-05-23
6713,서울,도봉구,1,1,0,2,2,0,2018-06-23
6714,서울,도봉구,3,0,1,4,3,0,2018-07-23
6715,서울,도봉구,2,0,1,3,3,0,2018-08-23
6716,서울,도봉구,0,1,0,1,1,0,2018-09-23
6717,서울,도봉구,0,0,0,0,0,0,2018-10-23
6718,서울,도봉구,1,0,0,1,1,0,2018-11-23
6719,서울,도봉구,0,0,0,0,0,0,2018-12-23
6720,서울,동대문구,9,0,4,13,8,0,2018-01-23
6721,서울,동대문구,5,0,1,6,5,0,2018-02-23
6722,서울,동대문구,3,2,0,5,4,0,2018-03-23
6723,서울,동대문구,5,1,0,6,4,0,2018-04-23
6724,서울,동대문구,5,0,1,6,4,0,2018-05-23
6725,서울,동대문구,4,0,5,9,9,0,2018-06-23
6726,서울,동대문구,4,0,3,7,7,0,2018-07-23
6727,서울,동대문구,2,0,1,3,3,0,2018-08-23
6728,서울,동대문구,3,0,0,3,3,0,2018-09-23
6729,서울,동대문구,3,0,0,3,3,0,2018-10-23
6730,서울,동대문구,5,1,3,9,6,0,2018-11-23
6731,서울,동대문구,0,0,3,3,3,0,2018-12-23
6732,서울,동작구,2,0,2,4,4,0,2018-01-23
6733,서울,동작구,1,0,0,1,1,0,2018-02-23
6734,서울,동작구,4,0,0,4,3,0,2018-03-23
6735,서울,동작구,3,0,0,3,3,0,2018-04-23
6736,서울,동작구,5,2,0,7,6,0,2018-05-23
6737,서울,동작구,6,0,1,7,5,0,2018-06-23
6738,서울,동작구,1,2,0,3,3,0,2018-07-23
6739,서울,동작구,7,1,1,9,7,0,2018-08-23
6740,서울,동작구,4,3,0,7,3,0,2018-09-23
6741,서울,동작구,4,0,0,4,3,0,2018-10-23
6742,서울,동작구,0,0,0,0,0,0,2018-11-23
6743,서울,동작구,2,0,1,3,2,0,2018-12-23
6744,서울,마포구,5,0,0,5,4,0,2018-01-23
6745,서울,마포구,5,0,2,7,7,0,2018-02-23
6746,서울,마포구,3,0,4,7,6,0,2018-03-23
6747,서울,마포구,0,1,1,2,2,0,2018-04-23
6748,서울,마포구,9,0,2,11,6,0,2018-05-23
6749,서울,마포구,10,0,1,11,6,0,2018-06-23
6750,서울,마포구,0,0,0,0,0,0,2018-07-23
6751,서울,마포구,3,0,0,3,2,0,2018-08-23
6752,서울,마포구,10,0,0,10,3,0,2018-09-23
6753,서울,마포구,1,0,1,2,2,0,2018-10-23
6754,서울,마포구,0,0,4,4,3,0,2018-11-23
6755,서울,마포구,10,0,1,11,6,0,2018-12-23
6756,서울,서대문구,0,0,1,1,1,0,2018-01-23
6757,서울,서대문구,5,0,1,6,5,0,2018-02-23
6758,서울,서대문구,1,1,0,2,2,0,2018-03-23
6759,서울,서대문구,1,0,1,2,2,0,2018-04-23
6760,서울,서대문구,5,0,0,5,3,0,2018-05-23
6761,서울,서대문구,3,0,0,3,3,0,2018-06-23
6762,서울,서대문구,3,0,0,3,3,0,2018-07-23
6763,서울,서대문구,4,0,1,5,3,0,2018-08-23
6764,서울,서대문구,0,1,1,2,2,0,2018-09-23
6765,서울,서대문구,1,0,0,1,1,0,2018-10-23
6766,서울,서대문구,2,2,0,4,3,0,2018-11-23
6767,서울,서대문구,0,0,0,0,0,0,2018-12-23
6768,서울,서초구,12,1,4,17,11,0,2018-01-23
6769,서울,서초구,6,3,2,11,7,0,2018-02-23
6770,서울,서초구,9,0,3,12,8,0,2018-03-23
6771,서울,서초구,3,0,1,4,4,0,2018-04-23
6772,서울,서초구,8,0,1,9,7,0,2018-05-23
6773,서울,서초구,9,0,3,12,7,0,2018-06-23
6774,서울,서초구,12,0,1,13,7,0,2018-07-23
6775,서울,서초구,8,1,1,10,8,0,2018-08-23
6776,서울,서초구,1,0,0,1,1,0,2018-09-23
6777,서울,서초구,2,0,0,2,2,0,2018-10-23
6778,서울,서초구,3,0,2,5,3,0,2018-11-23
6779,서울,서초구,8,1,2,11,6,0,2018-12-23
6780,서울,성동구,4,1,0,5,5,0,2018-01-23
6781,서울,성동구,1,1,1,3,3,0,2018-02-23
6782,서울,성동구,3,0,0,3,3,0,2018-03-23
6783,서울,성동구,2,0,0,2,2,0,2018-04-23
6784,서울,성동구,5,1,1,7,4,0,2018-05-23
6785,서울,성동구,1,1,0,2,2,0,2018-06-23
6786,서울,성동구,0,1,0,1,1,0,2018-07-23
6787,서울,성동구,4,0,1,5,3,0,2018-08-23
6788,서울,성동구,1,0,0,1,1,0,2018-09-23
6789,서울,성동구,2,0,2,4,4,0,2018-10-23
6790,서울,성동구,3,1,1,5,3,0,2018-11-23
6791,서울,성동구,3,0,1,4,2,0,2018-12-23
6792,서울,성북구,5,0,0,5,3,0,2018-01-23
6793,서울,성북구,1,0,1,2,2,0,2018-02-23
6794,서울,성북구,2,0,2,4,4,0,2018-03-23
6795,서울,성북구,3,0,0,3,2,0,2018-04-23
6796,서울,성북구,5,0,0,5,5,0,2018-05-23
6797,서울,성북구,2,0,0,2,2,0,2018-06-23
6798,서울,성북구,4,0,2,6,5,0,2018-07-23
6799,서울,성북구,12,1,1,14,8,0,2018-08-23
6800,서울,성북구,3,0,0,3,3,0,2018-09-23
6801,서울,성북구,0,0,2,2,2,0,2018-10-23
6802,서울,성북구,5,0,0,5,4,0,2018-11-23
6803,서울,성북구,5,0,2,7,6,0,2018-12-23
6804,서울,송파구,18,3,3,24,14,0,2018-01-23
6805,서울,송파구,11,1,3,15,8,0,2018-02-23
6806,서울,송파구,7,2,2,11,9,0,2018-03-23
6807,서울,송파구,3,1,5,9,8,0,2018-04-23
6808,서울,송파구,8,4,0,12,11,0,2018-05-23
6809,서울,송파구,7,3,2,12,10,0,2018-06-23
6810,서울,송파구,5,0,1,6,5,0,2018-07-23
6811,서울,송파구,2,0,0,2,2,0,2018-08-23
6812,서울,송파구,1,0,0,1,1,0,2018-09-23
6813,서울,송파구,5,0,2,7,6,0,2018-10-23
6814,서울,송파구,13,1,3,17,10,0,2018-11-23
6815,서울,송파구,10,2,0,12,5,0,2018-12-23
6816,서울,양천구,2,1,0,3,3,0,2018-01-23
6817,서울,양천구,4,1,0,5,4,1,2018-02-23
6818,서울,양천구,1,1,1,3,3,0,2018-03-23
6819,서울,양천구,6,0,1,7,4,0,2018-04-23
6820,서울,양천구,1,0,0,1,1,0,2018-05-23
6821,서울,양천구,5,1,2,8,8,0,2018-06-23
6822,서울,양천구,4,0,3,7,5,0,2018-07-23
6823,서울,양천구,5,1,1,7,5,0,2018-08-23
6824,서울,양천구,3,0,0,3,3,0,2018-09-23
6825,서울,양천구,4,2,0,6,6,0,2018-10-23
6826,서울,양천구,4,2,2,8,5,0,2018-11-23
6827,서울,양천구,0,0,0,0,0,0,2018-12-23
6828,서울,영등포구,4,2,3,9,7,0,2018-01-23
6829,서울,영등포구,5,1,1,7,5,0,2018-02-23
6830,서울,영등포구,6,1,3,10,8,0,2018-03-23
6831,서울,영등포구,12,1,2,15,9,0,2018-04-23
6832,서울,영등포구,6,1,0,7,5,0,2018-05-23
6833,서울,영등포구,2,1,2,5,4,0,2018-06-23
6834,서울,영등포구,3,1,3,7,7,0,2018-07-23
6835,서울,영등포구,10,1,4,15,10,0,2018-08-23
6836,서울,영등포구,1,0,2,3,3,0,2018-09-23
6837,서울,영등포구,11,0,2,13,10,0,2018-10-23
6838,서울,영등포구,11,1,0,12,10,0,2018-11-23
6839,서울,영등포구,3,2,1,6,4,0,2018-12-23
6840,서울,용산구,3,0,1,4,4,0,2018-01-23
6841,서울,용산구,12,0,1,13,8,0,2018-02-23
6842,서울,용산구,1,1,1,3,3,0,2018-03-23
6843,서울,용산구,2,0,0,2,2,0,2018-04-23
6844,서울,용산구,3,0,0,3,3,0,2018-05-23
6845,서울,용산구,4,0,0,4,3,0,2018-06-23
6846,서울,용산구,6,1,2,9,7,0,2018-07-23
6847,서울,용산구,5,0,0,5,4,0,2018-08-23
6848,서울,용산구,1,0,0,1,1,0,2018-09-23
6849,서울,용산구,8,0,0,8,5,0,2018-10-23
6850,서울,용산구,4,0,1,5,4,0,2018-11-23
6851,서울,용산구,3,0,0,3,2,0,2018-12-23
6852,서울,은평구,1,1,1,3,3,0,2018-01-23
6853,서울,은평구,3,0,1,4,3,0,2018-02-23
6854,서울,은평구,0,0,1,1,1,0,2018-03-23
6855,서울,은평구,2,0,0,2,2,0,2018-04-23
6856,서울,은평구,1,1,1,3,3,0,2018-05-23
6857,서울,은평구,5,0,0,5,4,0,2018-06-23
6858,서울,은평구,4,1,1,6,3,0,2018-07-23
6859,서울,은평구,4,0,1,5,1,0,2018-08-23
6860,서울,은평구,4,1,2,7,5,0,2018-09-23
6861,서울,은평구,2,0,0,2,2,0,2018-10-23
6862,서울,은평구,4,0,3,7,7,0,2018-11-23
6863,서울,은평구,1,0,0,1,1,0,2018-12-23
6864,서울,종로구,4,0,1,5,4,0,2018-01-23
6865,서울,종로구,2,0,2,4,4,0,2018-02-23
6866,서울,종로구,9,1,3,13,9,0,2018-03-23
6867,서울,종로구,0,0,0,0,0,0,2018-04-23
6868,서울,종로구,3,0,1,4,4,0,2018-05-23
6869,서울,종로구,8,0,2,10,5,0,2018-06-23
6870,서울,종로구,2,0,4,6,6,0,2018-07-23
6871,서울,종로구,6,0,3,9,7,0,2018-08-23
6872,서울,종로구,1,0,0,1,1,0,2018-09-23
6873,서울,종로구,3,5,0,8,3,0,2018-10-23
6874,서울,종로구,0,0,0,0,0,0,2018-11-23
6875,서울,종로구,0,0,0,0,0,0,2018-12-23
6876,서울,중구,1,1,0,2,2,0,2018-01-23
6877,서울,중구,4,2,3,9,6,0,2018-02-23
6878,서울,중구,2,0,3,5,6,1,2018-03-23
6879,서울,중구,6,0,2,8,4,0,2018-04-23
6880,서울,중구,1,0,1,2,2,0,2018-05-23
6881,서울,중구,0,0,1,1,1,0,2018-06-23
6882,서울,중구,1,0,0,1,1,0,2018-07-23
6883,서울,중구,1,1,1,3,2,0,2018-08-23
6884,서울,중구,4,0,0,4,2,0,2018-09-23
6885,서울,중구,8,0,1,9,6,0,2018-10-23
6886,서울,중구,3,0,1,4,2,0,2018-11-23
6887,서울,중구,2,2,0,4,4,0,2018-12-23
6888,서울,중랑구,4,1,2,7,5,0,2018-01-23
6889,서울,중랑구,4,1,2,7,7,0,2018-02-23
6890,서울,중랑구,1,0,1,2,2,0,2018-03-23
6891,서울,중랑구,2,0,0,2,2,0,2018-04-23
6892,서울,중랑구,6,1,3,10,4,0,2018-05-23
6893,서울,중랑구,3,1,2,6,3,0,2018-06-23
6894,서울,중랑구,4,1,1,6,6,0,2018-07-23
6895,서울,중랑구,1,2,0,3,3,0,2018-08-23
6896,서울,중랑구,8,0,2,10,4,0,2018-09-23
6897,서울,중랑구,2,0,1,3,2,0,2018-10-23
6898,서울,중랑구,6,2,1,9,7,1,2018-11-23
6899,서울,중랑구,3,0,0,3,3,0,2018-12-23
6900,서울,강남구,7,0,1,8,7,0,2018-01-24
6901,서울,강남구,8,0,2,10,8,0,2018-02-24
6902,서울,강남구,13,1,2,16,9,0,2018-03-24
6903,서울,강남구,6,2,0,8,7,0,2018-04-24
6904,서울,강남구,5,0,3,8,7,0,2018-05-24
6905,서울,강남구,4,0,0,4,2,0,2018-06-24
6906,서울,강남구,8,0,1,9,6,0,2018-07-24
6907,서울,강남구,5,3,6,14,10,0,2018-08-24
6908,서울,강남구,4,0,1,5,4,0,2018-09-24
6909,서울,강남구,15,1,3,19,11,0,2018-10-24
6910,서울,강남구,6,0,5,11,7,0,2018-11-24
6911,서울,강남구,10,0,1,11,7,0,2018-12-24
6912,서울,강동구,0,0,1,1,1,0,2018-01-24
6913,서울,강동구,1,0,0,1,1,0,2018-02-24
6914,서울,강동구,3,0,1,4,2,0,2018-03-24
6915,서울,강동구,3,0,3,6,5,0,2018-04-24
6916,서울,강동구,2,0,3,5,5,0,2018-05-24
6917,서울,강동구,10,0,1,11,4,0,2018-06-24
6918,서울,강동구,10,1,0,11,6,0,2018-07-24
6919,서울,강동구,7,0,1,8,5,0,2018-08-24
6920,서울,강동구,8,1,1,10,7,0,2018-09-24
6921,서울,강동구,2,0,0,2,2,0,2018-10-24
6922,서울,강동구,3,3,2,8,7,1,2018-11-24
6923,서울,강동구,4,1,3,8,7,0,2018-12-24
6924,서울,강북구,7,0,3,10,6,0,2018-01-24
6925,서울,강북구,3,0,0,3,3,0,2018-02-24
6926,서울,강북구,4,0,1,5,5,0,2018-03-24
6927,서울,강북구,6,0,1,7,6,0,2018-04-24
6928,서울,강북구,3,0,0,3,2,0,2018-05-24
6929,서울,강북구,0,0,1,1,1,0,2018-06-24
6930,서울,강북구,17,0,2,19,4,0,2018-07-24
6931,서울,강북구,0,0,1,1,1,0,2018-08-24
6932,서울,강북구,3,0,1,4,4,0,2018-09-24
6933,서울,강북구,4,0,0,4,2,0,2018-10-24
6934,서울,강북구,5,0,1,6,5,0,2018-11-24
6935,서울,강북구,2,0,1,3,3,0,2018-12-24
6936,서울,강서구,4,1,2,7,7,0,2018-01-24
6937,서울,강서구,4,0,2,6,4,0,2018-02-24
6938,서울,강서구,2,0,2,4,4,0,2018-03-24
6939,서울,강서구,16,2,2,20,5,0,2018-04-24
6940,서울,강서구,1,0,1,2,2,0,2018-05-24
6941,서울,강서구,12,0,1,13,5,0,2018-06-24
6942,서울,강서구,9,0,0,9,5,0,2018-07-24
6943,서울,강서구,8,0,2,10,7,0,2018-08-24
6944,서울,강서구,3,0,0,3,1,0,2018-09-24
6945,서울,강서구,2,0,1,3,3,0,2018-10-24
6946,서울,강서구,4,1,0,5,4,0,2018-11-24
6947,서울,강서구,1,0,0,1,1,0,2018-12-24
6948,서울,관악구,6,1,5,12,9,0,2018-01-24
6949,서울,관악구,3,1,1,5,4,0,2018-02-24
6950,서울,관악구,3,2,0,5,3,0,2018-03-24
6951,서울,관악구,4,0,2,6,3,0,2018-04-24
6952,서울,관악구,3,0,1,4,3,0,2018-05-24
6953,서울,관악구,2,0,0,2,2,0,2018-06-24
6954,서울,관악구,4,0,0,4,2,0,2018-07-24
6955,서울,관악구,2,0,2,4,4,0,2018-08-24
6956,서울,관악구,7,0,4,11,4,0,2018-09-24
6957,서울,관악구,3,0,1,4,4,0,2018-10-24
6958,서울,관악구,3,0,0,3,3,0,2018-11-24
6959,서울,관악구,4,1,0,5,1,0,2018-12-24
6960,서울,광진구,2,0,0,2,1,0,2018-01-24
6961,서울,광진구,3,0,0,3,3,0,2018-02-24
6962,서울,광진구,0,0,0,0,0,0,2018-03-24
6963,서울,광진구,5,0,0,5,4,0,2018-04-24
6964,서울,광진구,2,0,0,2,1,0,2018-05-24
6965,서울,광진구,3,0,4,7,4,0,2018-06-24
6966,서울,광진구,3,0,1,4,4,0,2018-07-24
6967,서울,광진구,1,0,0,1,1,0,2018-08-24
6968,서울,광진구,0,0,0,0,0,0,2018-09-24
6969,서울,광진구,2,0,0,2,2,0,2018-10-24
6970,서울,광진구,2,0,0,2,1,0,2018-11-24
6971,서울,광진구,2,0,0,2,2,0,2018-12-24
6972,서울,구로구,3,0,0,3,2,0,2018-01-24
6973,서울,구로구,3,1,1,5,5,0,2018-02-24
6974,서울,구로구,1,0,1,2,2,0,2018-03-24
6975,서울,구로구,4,0,1,5,4,0,2018-04-24
6976,서울,구로구,5,0,1,6,5,0,2018-05-24
6977,서울,구로구,2,1,2,5,3,0,2018-06-24
6978,서울,구로구,1,0,0,1,1,0,2018-07-24
6979,서울,구로구,0,0,1,1,1,0,2018-08-24
6980,서울,구로구,7,0,0,7,3,0,2018-09-24
6981,서울,구로구,5,0,0,5,4,0,2018-10-24
6982,서울,구로구,6,2,2,10,6,0,2018-11-24
6983,서울,구로구,2,2,0,4,3,0,2018-12-24
6984,서울,금천구,2,0,1,3,3,0,2018-01-24
6985,서울,금천구,0,0,0,0,0,0,2018-02-24
6986,서울,금천구,2,0,1,3,1,0,2018-03-24
6987,서울,금천구,1,0,1,2,2,0,2018-04-24
6988,서울,금천구,2,0,1,3,3,0,2018-05-24
6989,서울,금천구,0,1,0,1,1,0,2018-06-24
6990,서울,금천구,3,0,2,5,5,0,2018-07-24
6991,서울,금천구,4,0,0,4,3,0,2018-08-24
6992,서울,금천구,0,0,0,0,0,0,2018-09-24
6993,서울,금천구,2,0,2,4,3,0,2018-10-24
6994,서울,금천구,3,0,1,4,4,0,2018-11-24
6995,서울,금천구,0,0,0,0,0,0,2018-12-24
6996,서울,노원구,1,0,0,1,1,0,2018-01-24
6997,서울,노원구,2,1,0,3,2,0,2018-02-24
6998,서울,노원구,9,1,1,11,6,0,2018-03-24
6999,서울,노원구,6,0,1,7,2,0,2018-04-24
7000,서울,노원구,11,0,1,12,7,0,2018-05-24
7001,서울,노원구,2,0,1,3,2,0,2018-06-24
7002,서울,노원구,9,0,1,10,5,0,2018-07-24
7003,서울,노원구,1,0,1,2,2,0,2018-08-24
7004,서울,노원구,6,0,0,6,3,0,2018-09-24
7005,서울,노원구,7,3,0,10,7,0,2018-10-24
7006,서울,노원구,6,0,2,8,5,0,2018-11-24
7007,서울,노원구,4,0,1,5,4,0,2018-12-24
7008,서울,도봉구,1,0,3,4,3,0,2018-01-24
7009,서울,도봉구,0,0,0,0,0,0,2018-02-24
7010,서울,도봉구,0,0,0,0,0,0,2018-03-24
7011,서울,도봉구,0,0,1,1,1,0,2018-04-24
7012,서울,도봉구,4,0,0,4,4,0,2018-05-24
7013,서울,도봉구,0,2,0,2,1,0,2018-06-24
7014,서울,도봉구,4,0,2,6,4,0,2018-07-24
7015,서울,도봉구,1,0,5,6,5,0,2018-08-24
7016,서울,도봉구,0,0,2,2,2,0,2018-09-24
7017,서울,도봉구,4,1,1,6,6,0,2018-10-24
7018,서울,도봉구,2,0,1,3,3,0,2018-11-24
7019,서울,도봉구,1,1,0,2,2,0,2018-12-24
7020,서울,동대문구,2,0,1,3,3,0,2018-01-24
7021,서울,동대문구,1,2,2,5,6,1,2018-02-24
7022,서울,동대문구,0,0,1,1,1,0,2018-03-24
7023,서울,동대문구,8,0,0,8,5,0,2018-04-24
7024,서울,동대문구,1,0,1,2,2,0,2018-05-24
7025,서울,동대문구,5,0,0,5,2,0,2018-06-24
7026,서울,동대문구,3,1,1,5,4,0,2018-07-24
7027,서울,동대문구,2,0,3,5,3,0,2018-08-24
7028,서울,동대문구,0,0,1,1,1,0,2018-09-24
7029,서울,동대문구,5,1,2,8,7,0,2018-10-24
7030,서울,동대문구,4,0,1,5,4,0,2018-11-24
7031,서울,동대문구,2,0,1,3,3,0,2018-12-24
7032,서울,동작구,3,0,1,4,4,0,2018-01-24
7033,서울,동작구,4,0,2,6,2,0,2018-02-24
7034,서울,동작구,4,0,0,4,2,0,2018-03-24
7035,서울,동작구,4,1,1,6,5,0,2018-04-24
7036,서울,동작구,2,0,1,3,3,0,2018-05-24
7037,서울,동작구,8,1,2,11,4,0,2018-06-24
7038,서울,동작구,3,1,0,4,4,0,2018-07-24
7039,서울,동작구,3,1,0,4,4,0,2018-08-24
7040,서울,동작구,1,2,0,3,2,0,2018-09-24
7041,서울,동작구,7,2,1,10,7,0,2018-10-24
7042,서울,동작구,7,0,1,8,8,0,2018-11-24
7043,서울,동작구,3,0,0,3,3,0,2018-12-24
7044,서울,마포구,7,0,3,10,3,0,2018-01-24
7045,서울,마포구,7,0,2,9,4,0,2018-02-24
7046,서울,마포구,6,0,0,6,3,0,2018-03-24
7047,서울,마포구,3,0,1,4,4,0,2018-04-24
7048,서울,마포구,7,0,2,9,4,0,2018-05-24
7049,서울,마포구,7,0,2,9,5,0,2018-06-24
7050,서울,마포구,3,1,0,4,2,0,2018-07-24
7051,서울,마포구,4,0,2,6,2,0,2018-08-24
7052,서울,마포구,1,0,1,2,1,0,2018-09-24
7053,서울,마포구,8,1,2,11,7,0,2018-10-24
7054,서울,마포구,4,0,1,5,4,0,2018-11-24
7055,서울,마포구,3,0,1,4,4,0,2018-12-24
7056,서울,서대문구,10,2,2,14,8,0,2018-01-24
7057,서울,서대문구,2,0,0,2,2,0,2018-02-24
7058,서울,서대문구,1,0,2,3,2,0,2018-03-24
7059,서울,서대문구,1,0,0,1,1,0,2018-04-24
7060,서울,서대문구,1,3,1,5,4,0,2018-05-24
7061,서울,서대문구,1,1,1,3,2,0,2018-06-24
7062,서울,서대문구,4,1,0,5,3,0,2018-07-24
7063,서울,서대문구,2,0,0,2,2,0,2018-08-24
7064,서울,서대문구,2,0,0,2,1,0,2018-09-24
7065,서울,서대문구,0,0,2,2,2,0,2018-10-24
7066,서울,서대문구,8,1,1,10,3,0,2018-11-24
7067,서울,서대문구,0,0,0,0,0,0,2018-12-24
7068,서울,서초구,13,2,7,22,17,0,2018-01-24
7069,서울,서초구,8,3,0,11,7,0,2018-02-24
7070,서울,서초구,5,1,3,9,8,1,2018-03-24
7071,서울,서초구,7,0,0,7,6,0,2018-04-24
7072,서울,서초구,7,0,1,8,6,1,2018-05-24
7073,서울,서초구,1,1,1,3,2,0,2018-06-24
7074,서울,서초구,5,0,0,5,5,0,2018-07-24
7075,서울,서초구,8,1,2,11,7,0,2018-08-24
7076,서울,서초구,7,0,1,8,5,1,2018-09-24
7077,서울,서초구,12,1,2,15,9,0,2018-10-24
7078,서울,서초구,16,0,2,18,10,0,2018-11-24
7079,서울,서초구,11,0,0,11,8,1,2018-12-24
7080,서울,성동구,1,0,0,1,1,0,2018-01-24
7081,서울,성동구,3,0,0,3,3,0,2018-02-24
7082,서울,성동구,2,0,1,3,2,0,2018-03-24
7083,서울,성동구,4,1,1,6,6,0,2018-04-24
7084,서울,성동구,3,1,1,5,4,0,2018-05-24
7085,서울,성동구,2,0,0,2,2,0,2018-06-24
7086,서울,성동구,5,0,2,7,5,0,2018-07-24
7087,서울,성동구,4,0,3,7,2,0,2018-08-24
7088,서울,성동구,4,0,1,5,4,0,2018-09-24
7089,서울,성동구,7,0,1,8,5,0,2018-10-24
7090,서울,성동구,5,0,0,5,3,0,2018-11-24
7091,서울,성동구,2,0,1,3,1,0,2018-12-24
7092,서울,성북구,6,0,1,7,5,0,2018-01-24
7093,서울,성북구,5,1,0,6,3,0,2018-02-24
7094,서울,성북구,2,0,1,3,2,0,2018-03-24
7095,서울,성북구,3,0,1,4,4,0,2018-04-24
7096,서울,성북구,5,0,1,6,5,0,2018-05-24
7097,서울,성북구,0,0,2,2,1,0,2018-06-24
7098,서울,성북구,4,0,0,4,1,0,2018-07-24
7099,서울,성북구,1,1,0,2,2,0,2018-08-24
7100,서울,성북구,4,0,2,6,5,0,2018-09-24
7101,서울,성북구,4,0,1,5,4,0,2018-10-24
7102,서울,성북구,1,0,0,1,1,0,2018-11-24
7103,서울,성북구,2,0,1,3,3,0,2018-12-24
7104,서울,송파구,4,0,2,6,6,0,2018-01-24
7105,서울,송파구,0,1,2,3,3,0,2018-02-24
7106,서울,송파구,8,1,1,10,7,0,2018-03-24
7107,서울,송파구,7,0,0,7,3,0,2018-04-24
7108,서울,송파구,14,4,1,19,10,0,2018-05-24
7109,서울,송파구,4,0,0,4,4,0,2018-06-24
7110,서울,송파구,9,3,1,13,10,0,2018-07-24
7111,서울,송파구,10,0,4,14,8,0,2018-08-24
7112,서울,송파구,2,0,0,2,2,0,2018-09-24
7113,서울,송파구,5,2,2,9,5,0,2018-10-24
7114,서울,송파구,20,1,2,23,13,0,2018-11-24
7115,서울,송파구,7,0,8,15,12,0,2018-12-24
7116,서울,양천구,6,1,2,9,5,0,2018-01-24
7117,서울,양천구,2,0,1,3,3,0,2018-02-24
7118,서울,양천구,3,0,0,3,2,0,2018-03-24
7119,서울,양천구,0,1,0,1,1,0,2018-04-24
7120,서울,양천구,2,0,1,3,3,0,2018-05-24
7121,서울,양천구,1,0,1,2,2,0,2018-06-24
7122,서울,양천구,5,0,1,6,6,0,2018-07-24
7123,서울,양천구,3,1,1,5,5,0,2018-08-24
7124,서울,양천구,3,0,0,3,1,0,2018-09-24
7125,서울,양천구,5,0,1,6,5,0,2018-10-24
7126,서울,양천구,1,0,2,3,2,0,2018-11-24
7127,서울,양천구,12,0,1,13,4,0,2018-12-24
7128,서울,영등포구,5,1,4,10,6,0,2018-01-24
7129,서울,영등포구,7,1,2,10,9,0,2018-02-24
7130,서울,영등포구,10,1,0,11,7,0,2018-03-24
7131,서울,영등포구,3,1,2,6,7,1,2018-04-24
7132,서울,영등포구,4,0,0,4,4,0,2018-05-24
7133,서울,영등포구,6,0,1,7,5,0,2018-06-24
7134,서울,영등포구,9,0,5,14,10,0,2018-07-24
7135,서울,영등포구,6,0,4,10,8,0,2018-08-24
7136,서울,영등포구,8,0,1,9,5,0,2018-09-24
7137,서울,영등포구,7,1,2,10,9,0,2018-10-24
7138,서울,영등포구,17,2,0,19,8,0,2018-11-24
7139,서울,영등포구,16,1,4,21,10,0,2018-12-24
7140,서울,용산구,0,1,1,2,2,0,2018-01-24
7141,서울,용산구,2,0,0,2,2,0,2018-02-24
7142,서울,용산구,4,2,2,8,5,0,2018-03-24
7143,서울,용산구,0,0,1,1,1,0,2018-04-24
7144,서울,용산구,6,0,2,8,5,0,2018-05-24
7145,서울,용산구,6,0,0,6,2,0,2018-06-24
7146,서울,용산구,3,0,2,5,5,0,2018-07-24
7147,서울,용산구,3,1,2,6,6,0,2018-08-24
7148,서울,용산구,0,0,0,0,0,0,2018-09-24
7149,서울,용산구,4,0,1,5,3,1,2018-10-24
7150,서울,용산구,0,0,3,3,3,0,2018-11-24
7151,서울,용산구,5,1,1,7,6,0,2018-12-24
7152,서울,은평구,1,0,0,1,1,0,2018-01-24
7153,서울,은평구,3,0,1,4,3,0,2018-02-24
7154,서울,은평구,4,1,2,7,6,0,2018-03-24
7155,서울,은평구,3,0,0,3,3,0,2018-04-24
7156,서울,은평구,3,0,0,3,3,0,2018-05-24
7157,서울,은평구,0,0,1,1,1,0,2018-06-24
7158,서울,은평구,8,1,4,13,7,0,2018-07-24
7159,서울,은평구,0,1,0,1,1,0,2018-08-24
7160,서울,은평구,6,0,1,7,3,0,2018-09-24
7161,서울,은평구,2,1,2,5,3,0,2018-10-24
7162,서울,은평구,1,0,0,1,1,0,2018-11-24
7163,서울,은평구,6,0,3,9,6,0,2018-12-24
7164,서울,종로구,1,0,0,1,1,0,2018-01-24
7165,서울,종로구,0,0,0,0,0,0,2018-02-24
7166,서울,종로구,4,2,3,9,5,0,2018-03-24
7167,서울,종로구,9,0,0,9,6,0,2018-04-24
7168,서울,종로구,3,0,2,5,5,0,2018-05-24
7169,서울,종로구,3,0,1,4,3,0,2018-06-24
7170,서울,종로구,1,1,0,2,2,0,2018-07-24
7171,서울,종로구,3,0,1,4,2,0,2018-08-24
7172,서울,종로구,2,0,0,2,1,0,2018-09-24
7173,서울,종로구,1,2,0,3,2,0,2018-10-24
7174,서울,종로구,9,0,4,13,4,0,2018-11-24
7175,서울,종로구,4,1,1,6,7,1,2018-12-24
7176,서울,중구,1,1,1,3,3,0,2018-01-24
7177,서울,중구,5,0,0,5,4,0,2018-02-24
7178,서울,중구,4,1,2,7,6,0,2018-03-24
7179,서울,중구,5,1,2,8,5,0,2018-04-24
7180,서울,중구,4,0,1,5,5,0,2018-05-24
7181,서울,중구,1,1,2,4,4,0,2018-06-24
7182,서울,중구,6,1,2,9,4,0,2018-07-24
7183,서울,중구,2,0,1,3,3,0,2018-08-24
7184,서울,중구,0,0,0,0,0,0,2018-09-24
7185,서울,중구,4,1,2,7,7,0,2018-10-24
7186,서울,중구,4,0,0,4,1,0,2018-11-24
7187,서울,중구,8,0,0,8,7,0,2018-12-24
7188,서울,중랑구,3,0,1,4,2,0,2018-01-24
7189,서울,중랑구,4,0,2,6,5,0,2018-02-24
7190,서울,중랑구,3,0,2,5,4,0,2018-03-24
7191,서울,중랑구,3,0,0,3,1,0,2018-04-24
7192,서울,중랑구,3,1,0,4,3,0,2018-05-24
7193,서울,중랑구,5,0,4,9,4,0,2018-06-24
7194,서울,중랑구,4,0,1,5,3,0,2018-07-24
7195,서울,중랑구,1,0,0,1,1,0,2018-08-24
7196,서울,중랑구,5,0,1,6,4,0,2018-09-24
7197,서울,중랑구,3,0,3,6,4,0,2018-10-24
7198,서울,중랑구,1,1,0,2,2,0,2018-11-24
7199,서울,중랑구,2,0,1,3,3,0,2018-12-24
7200,서울,강남구,10,0,3,13,10,0,2018-01-25
7201,서울,강남구,3,0,2,5,2,0,2018-02-25
7202,서울,강남구,15,4,2,21,14,0,2018-03-25
7203,서울,강남구,19,0,2,21,11,0,2018-04-25
7204,서울,강남구,11,2,6,19,11,0,2018-05-25
7205,서울,강남구,8,1,2,11,7,0,2018-06-25
7206,서울,강남구,23,1,2,26,16,0,2018-07-25
7207,서울,강남구,14,1,1,16,11,0,2018-08-25
7208,서울,강남구,0,0,0,0,0,0,2018-09-25
7209,서울,강남구,12,1,4,17,16,0,2018-10-25
7210,서울,강남구,10,1,2,13,9,0,2018-11-25
7211,서울,강남구,9,0,2,11,7,0,2018-12-25
7212,서울,강동구,2,0,1,3,3,0,2018-01-25
7213,서울,강동구,4,1,1,6,3,0,2018-02-25
7214,서울,강동구,0,0,0,0,0,0,2018-03-25
7215,서울,강동구,4,0,2,6,5,0,2018-04-25
7216,서울,강동구,5,1,0,6,4,0,2018-05-25
7217,서울,강동구,5,0,1,6,5,0,2018-06-25
7218,서울,강동구,3,3,2,8,5,0,2018-07-25
7219,서울,강동구,5,2,1,8,5,0,2018-08-25
7220,서울,강동구,0,0,1,1,1,0,2018-09-25
7221,서울,강동구,6,1,0,7,6,0,2018-10-25
7222,서울,강동구,0,0,0,0,0,0,2018-11-25
7223,서울,강동구,0,0,0,0,0,0,2018-12-25
7224,서울,강북구,32,0,7,39,6,0,2018-01-25
7225,서울,강북구,3,0,3,6,3,1,2018-02-25
7226,서울,강북구,0,0,0,0,0,0,2018-03-25
7227,서울,강북구,10,0,2,12,4,0,2018-04-25
7228,서울,강북구,0,0,1,1,1,0,2018-05-25
7229,서울,강북구,1,0,1,2,2,0,2018-06-25
7230,서울,강북구,2,0,0,2,1,0,2018-07-25
7231,서울,강북구,7,1,4,12,8,0,2018-08-25
7232,서울,강북구,1,1,1,3,3,0,2018-09-25
7233,서울,강북구,5,1,0,6,5,0,2018-10-25
7234,서울,강북구,0,0,0,0,0,0,2018-11-25
7235,서울,강북구,1,0,1,2,2,0,2018-12-25
7236,서울,강서구,5,1,2,8,6,0,2018-01-25
7237,서울,강서구,5,0,0,5,3,0,2018-02-25
7238,서울,강서구,1,0,0,1,1,0,2018-03-25
7239,서울,강서구,0,2,0,2,2,0,2018-04-25
7240,서울,강서구,2,2,0,4,2,0,2018-05-25
7241,서울,강서구,0,2,3,5,4,0,2018-06-25
7242,서울,강서구,4,0,1,5,3,0,2018-07-25
7243,서울,강서구,21,4,9,34,6,0,2018-08-25
7244,서울,강서구,2,2,2,6,6,0,2018-09-25
7245,서울,강서구,2,0,2,4,3,0,2018-10-25
7246,서울,강서구,4,1,3,8,4,0,2018-11-25
7247,서울,강서구,1,0,1,2,2,0,2018-12-25
7248,서울,관악구,3,1,1,5,5,0,2018-01-25
7249,서울,관악구,4,0,2,6,3,0,2018-02-25
7250,서울,관악구,1,0,1,2,2,0,2018-03-25
7251,서울,관악구,1,0,0,1,1,0,2018-04-25
7252,서울,관악구,2,0,1,3,3,0,2018-05-25
7253,서울,관악구,7,0,0,7,5,0,2018-06-25
7254,서울,관악구,4,1,2,7,5,0,2018-07-25
7255,서울,관악구,2,0,1,3,2,0,2018-08-25
7256,서울,관악구,0,0,0,0,0,0,2018-09-25
7257,서울,관악구,6,0,2,8,5,0,2018-10-25
7258,서울,관악구,3,0,1,4,4,0,2018-11-25
7259,서울,관악구,5,0,0,5,5,0,2018-12-25
7260,서울,광진구,0,0,3,3,3,0,2018-01-25
7261,서울,광진구,0,0,0,0,0,0,2018-02-25
7262,서울,광진구,4,0,1,5,4,0,2018-03-25
7263,서울,광진구,7,0,2,9,7,0,2018-04-25
7264,서울,광진구,4,0,4,8,5,0,2018-05-25
7265,서울,광진구,8,0,1,9,5,0,2018-06-25
7266,서울,광진구,3,0,0,3,3,0,2018-07-25
7267,서울,광진구,2,2,0,4,4,0,2018-08-25
7268,서울,광진구,1,0,0,1,1,0,2018-09-25
7269,서울,광진구,1,0,0,1,1,0,2018-10-25
7270,서울,광진구,4,0,0,4,4,0,2018-11-25
7271,서울,광진구,1,0,1,2,2,0,2018-12-25
7272,서울,구로구,1,0,0,1,1,0,2018-01-25
7273,서울,구로구,9,1,0,10,2,0,2018-02-25
7274,서울,구로구,4,0,3,7,4,0,2018-03-25
7275,서울,구로구,1,0,0,1,1,0,2018-04-25
7276,서울,구로구,7,0,0,7,6,0,2018-05-25
7277,서울,구로구,5,0,1,6,3,0,2018-06-25
7278,서울,구로구,2,0,0,2,2,0,2018-07-25
7279,서울,구로구,5,0,0,5,3,0,2018-08-25
7280,서울,구로구,11,0,1,12,6,0,2018-09-25
7281,서울,구로구,3,0,2,5,5,0,2018-10-25
7282,서울,구로구,4,0,0,4,4,0,2018-11-25
7283,서울,구로구,3,1,1,5,5,0,2018-12-25
7284,서울,금천구,0,0,1,1,1,0,2018-01-25
7285,서울,금천구,2,1,0,3,2,0,2018-02-25
7286,서울,금천구,20,1,1,22,7,0,2018-03-25
7287,서울,금천구,0,1,0,1,1,0,2018-04-25
7288,서울,금천구,1,0,4,5,3,0,2018-05-25
7289,서울,금천구,1,0,1,2,2,0,2018-06-25
7290,서울,금천구,0,1,0,1,1,0,2018-07-25
7291,서울,금천구,4,1,1,6,6,0,2018-08-25
7292,서울,금천구,4,0,0,4,2,0,2018-09-25
7293,서울,금천구,1,0,1,2,2,0,2018-10-25
7294,서울,금천구,6,1,0,7,2,0,2018-11-25
7295,서울,금천구,3,0,2,5,4,0,2018-12-25
7296,서울,노원구,2,0,0,2,2,0,2018-01-25
7297,서울,노원구,3,0,1,4,3,0,2018-02-25
7298,서울,노원구,15,1,3,19,7,0,2018-03-25
7299,서울,노원구,7,0,2,9,8,1,2018-04-25
7300,서울,노원구,3,0,1,4,4,0,2018-05-25
7301,서울,노원구,0,1,0,1,2,1,2018-06-25
7302,서울,노원구,2,1,0,3,3,0,2018-07-25
7303,서울,노원구,2,0,0,2,2,0,2018-08-25
7304,서울,노원구,9,0,0,9,5,0,2018-09-25
7305,서울,노원구,9,0,2,11,4,0,2018-10-25
7306,서울,노원구,4,0,1,5,3,0,2018-11-25
7307,서울,노원구,8,0,0,8,3,0,2018-12-25
7308,서울,도봉구,2,1,0,3,3,0,2018-01-25
7309,서울,도봉구,2,0,0,2,2,0,2018-02-25
7310,서울,도봉구,1,0,0,1,1,0,2018-03-25
7311,서울,도봉구,2,1,2,5,5,0,2018-04-25
7312,서울,도봉구,5,0,1,6,6,0,2018-05-25
7313,서울,도봉구,2,0,2,4,3,0,2018-06-25
7314,서울,도봉구,2,1,0,3,2,0,2018-07-25
7315,서울,도봉구,3,3,0,6,3,0,2018-08-25
7316,서울,도봉구,1,2,0,3,2,0,2018-09-25
7317,서울,도봉구,0,0,0,0,0,0,2018-10-25
7318,서울,도봉구,7,0,0,7,3,0,2018-11-25
7319,서울,도봉구,8,0,0,8,3,0,2018-12-25
7320,서울,동대문구,3,0,0,3,3,0,2018-01-25
7321,서울,동대문구,5,0,2,7,5,0,2018-02-25
7322,서울,동대문구,2,0,1,3,3,0,2018-03-25
7323,서울,동대문구,2,1,1,4,4,0,2018-04-25
7324,서울,동대문구,2,1,0,3,3,0,2018-05-25
7325,서울,동대문구,3,0,0,3,3,0,2018-06-25
7326,서울,동대문구,2,1,3,6,5,0,2018-07-25
7327,서울,동대문구,1,1,2,4,3,0,2018-08-25
7328,서울,동대문구,1,0,0,1,1,0,2018-09-25
7329,서울,동대문구,5,1,2,8,8,0,2018-10-25
7330,서울,동대문구,0,0,0,0,0,0,2018-11-25
7331,서울,동대문구,3,0,1,4,2,0,2018-12-25
7332,서울,동작구,1,0,2,3,2,0,2018-01-25
7333,서울,동작구,4,2,2,8,5,0,2018-02-25
7334,서울,동작구,3,1,0,4,4,0,2018-03-25
7335,서울,동작구,2,1,4,7,7,0,2018-04-25
7336,서울,동작구,4,1,2,7,5,0,2018-05-25
7337,서울,동작구,4,1,2,7,5,0,2018-06-25
7338,서울,동작구,5,1,0,6,5,0,2018-07-25
7339,서울,동작구,4,0,0,4,4,0,2018-08-25
7340,서울,동작구,3,0,2,5,2,0,2018-09-25
7341,서울,동작구,4,0,0,4,4,0,2018-10-25
7342,서울,동작구,0,1,0,1,1,0,2018-11-25
7343,서울,동작구,5,0,1,6,3,0,2018-12-25
7344,서울,마포구,1,0,2,3,3,0,2018-01-25
7345,서울,마포구,3,0,3,6,5,0,2018-02-25
7346,서울,마포구,11,0,1,12,5,0,2018-03-25
7347,서울,마포구,3,0,0,3,2,0,2018-04-25
7348,서울,마포구,2,0,1,3,3,0,2018-05-25
7349,서울,마포구,5,1,0,6,4,0,2018-06-25
7350,서울,마포구,8,0,1,9,5,0,2018-07-25
7351,서울,마포구,9,0,2,11,6,0,2018-08-25
7352,서울,마포구,7,2,1,10,2,0,2018-09-25
7353,서울,마포구,3,0,0,3,2,0,2018-10-25
7354,서울,마포구,8,1,3,12,7,0,2018-11-25
7355,서울,마포구,4,0,0,4,2,0,2018-12-25
7356,서울,서대문구,1,0,0,1,1,0,2018-01-25
7357,서울,서대문구,1,0,1,2,2,0,2018-02-25
7358,서울,서대문구,1,0,0,1,1,0,2018-03-25
7359,서울,서대문구,5,0,1,6,5,0,2018-04-25
7360,서울,서대문구,3,0,0,3,3,0,2018-05-25
7361,서울,서대문구,2,1,2,5,4,0,2018-06-25
7362,서울,서대문구,5,1,0,6,3,0,2018-07-25
7363,서울,서대문구,2,0,4,6,2,0,2018-08-25
7364,서울,서대문구,1,2,0,3,2,0,2018-09-25
7365,서울,서대문구,5,1,0,6,5,0,2018-10-25
7366,서울,서대문구,0,0,1,1,1,0,2018-11-25
7367,서울,서대문구,1,1,0,2,2,0,2018-12-25
7368,서울,서초구,13,0,1,14,10,0,2018-01-25
7369,서울,서초구,5,0,0,5,3,0,2018-02-25
7370,서울,서초구,6,1,3,10,7,0,2018-03-25
7371,서울,서초구,8,0,2,10,9,0,2018-04-25
7372,서울,서초구,2,1,3,6,5,0,2018-05-25
7373,서울,서초구,5,0,4,9,7,0,2018-06-25
7374,서울,서초구,5,1,2,8,6,0,2018-07-25
7375,서울,서초구,10,4,1,15,7,0,2018-08-25
7376,서울,서초구,2,0,0,2,1,0,2018-09-25
7377,서울,서초구,6,0,1,7,5,0,2018-10-25
7378,서울,서초구,2,0,1,3,1,0,2018-11-25
7379,서울,서초구,3,1,0,4,3,0,2018-12-25
7380,서울,성동구,1,0,0,1,1,0,2018-01-25
7381,서울,성동구,0,0,1,1,1,0,2018-02-25
7382,서울,성동구,4,0,2,6,3,0,2018-03-25
7383,서울,성동구,1,0,1,2,2,0,2018-04-25
7384,서울,성동구,3,0,0,3,3,0,2018-05-25
7385,서울,성동구,5,0,2,7,6,0,2018-06-25
7386,서울,성동구,5,0,0,5,5,0,2018-07-25
7387,서울,성동구,3,0,0,3,3,0,2018-08-25
7388,서울,성동구,2,0,0,2,2,0,2018-09-25
7389,서울,성동구,3,1,1,5,3,0,2018-10-25
7390,서울,성동구,1,1,1,3,3,0,2018-11-25
7391,서울,성동구,1,0,0,1,1,0,2018-12-25
7392,서울,성북구,5,0,2,7,5,0,2018-01-25
7393,서울,성북구,2,0,0,2,2,0,2018-02-25
7394,서울,성북구,4,0,1,5,4,0,2018-03-25
7395,서울,성북구,6,1,2,9,7,0,2018-04-25
7396,서울,성북구,3,0,3,6,6,0,2018-05-25
7397,서울,성북구,4,0,1,5,2,0,2018-06-25
7398,서울,성북구,1,0,2,3,2,0,2018-07-25
7399,서울,성북구,1,0,1,2,1,0,2018-08-25
7400,서울,성북구,5,0,0,5,2,0,2018-09-25
7401,서울,성북구,3,1,1,5,4,0,2018-10-25
7402,서울,성북구,6,0,0,6,2,0,2018-11-25
7403,서울,성북구,2,2,0,4,3,0,2018-12-25
7404,서울,송파구,5,0,2,7,6,0,2018-01-25
7405,서울,송파구,3,0,0,3,3,0,2018-02-25
7406,서울,송파구,4,1,1,6,4,0,2018-03-25
7407,서울,송파구,13,2,6,21,13,0,2018-04-25
7408,서울,송파구,7,0,2,9,9,0,2018-05-25
7409,서울,송파구,11,1,3,15,10,1,2018-06-25
7410,서울,송파구,8,0,4,12,10,0,2018-07-25
7411,서울,송파구,10,2,2,14,10,0,2018-08-25
7412,서울,송파구,6,0,0,6,4,0,2018-09-25
7413,서울,송파구,3,0,2,5,5,0,2018-10-25
7414,서울,송파구,5,2,1,8,6,0,2018-11-25
7415,서울,송파구,6,1,2,9,7,0,2018-12-25
7416,서울,양천구,7,2,1,10,7,0,2018-01-25
7417,서울,양천구,1,0,0,1,1,0,2018-02-25
7418,서울,양천구,1,0,1,2,2,0,2018-03-25
7419,서울,양천구,6,0,2,8,7,0,2018-04-25
7420,서울,양천구,2,0,0,2,2,0,2018-05-25
7421,서울,양천구,3,0,2,5,5,0,2018-06-25
7422,서울,양천구,1,0,2,3,3,0,2018-07-25
7423,서울,양천구,4,2,0,6,3,0,2018-08-25
7424,서울,양천구,5,0,1,6,4,0,2018-09-25
7425,서울,양천구,7,0,1,8,6,0,2018-10-25
7426,서울,양천구,2,0,0,2,2,0,2018-11-25
7427,서울,양천구,1,0,3,4,3,1,2018-12-25
7428,서울,영등포구,4,1,1,6,5,0,2018-01-25
7429,서울,영등포구,16,0,0,16,5,0,2018-02-25
7430,서울,영등포구,7,1,1,9,6,0,2018-03-25
7431,서울,영등포구,5,0,0,5,4,0,2018-04-25
7432,서울,영등포구,7,0,2,9,5,0,2018-05-25
7433,서울,영등포구,11,2,0,13,10,0,2018-06-25
7434,서울,영등포구,10,1,2,13,7,0,2018-07-25
7435,서울,영등포구,9,2,3,14,9,0,2018-08-25
7436,서울,영등포구,8,0,2,10,4,0,2018-09-25
7437,서울,영등포구,5,3,6,14,11,0,2018-10-25
7438,서울,영등포구,3,0,2,5,4,0,2018-11-25
7439,서울,영등포구,2,0,0,2,2,0,2018-12-25
7440,서울,용산구,0,0,0,0,0,0,2018-01-25
7441,서울,용산구,2,0,1,3,2,0,2018-02-25
7442,서울,용산구,1,0,1,2,2,0,2018-03-25
7443,서울,용산구,7,0,0,7,4,0,2018-04-25
7444,서울,용산구,4,2,0,6,4,0,2018-05-25
7445,서울,용산구,3,1,1,5,3,0,2018-06-25
7446,서울,용산구,7,0,2,9,6,0,2018-07-25
7447,서울,용산구,3,0,2,5,3,0,2018-08-25
7448,서울,용산구,0,0,0,0,0,0,2018-09-25
7449,서울,용산구,4,0,0,4,3,0,2018-10-25
7450,서울,용산구,3,0,0,3,3,0,2018-11-25
7451,서울,용산구,2,0,1,3,3,0,2018-12-25
7452,서울,은평구,2,0,1,3,3,0,2018-01-25
7453,서울,은평구,0,0,0,0,0,0,2018-02-25
7454,서울,은평구,6,2,1,9,3,0,2018-03-25
7455,서울,은평구,0,0,1,1,1,0,2018-04-25
7456,서울,은평구,1,0,0,1,1,0,2018-05-25
7457,서울,은평구,3,0,3,6,4,0,2018-06-25
7458,서울,은평구,1,0,0,1,1,0,2018-07-25
7459,서울,은평구,4,1,1,6,4,0,2018-08-25
7460,서울,은평구,2,0,0,2,2,0,2018-09-25
7461,서울,은평구,0,0,1,1,1,0,2018-10-25
7462,서울,은평구,7,0,2,9,5,0,2018-11-25
7463,서울,은평구,2,0,0,2,2,0,2018-12-25
7464,서울,종로구,0,0,1,1,1,0,2018-01-25
7465,서울,종로구,2,0,1,3,3,0,2018-02-25
7466,서울,종로구,2,1,1,4,4,0,2018-03-25
7467,서울,종로구,2,1,3,6,4,0,2018-04-25
7468,서울,종로구,6,0,3,9,7,0,2018-05-25
7469,서울,종로구,2,1,1,4,4,0,2018-06-25
7470,서울,종로구,0,0,0,0,0,0,2018-07-25
7471,서울,종로구,4,0,3,7,5,0,2018-08-25
7472,서울,종로구,1,0,1,2,2,0,2018-09-25
7473,서울,종로구,5,0,1,6,6,0,2018-10-25
7474,서울,종로구,1,0,1,2,2,0,2018-11-25
7475,서울,종로구,4,0,0,4,2,0,2018-12-25
7476,서울,중구,4,0,2,6,5,0,2018-01-25
7477,서울,중구,0,0,0,0,0,0,2018-02-25
7478,서울,중구,1,0,1,2,2,0,2018-03-25
7479,서울,중구,0,0,2,2,2,0,2018-04-25
7480,서울,중구,1,0,0,1,1,0,2018-05-25
7481,서울,중구,1,1,1,3,2,0,2018-06-25
7482,서울,중구,7,0,0,7,5,0,2018-07-25
7483,서울,중구,2,0,0,2,2,0,2018-08-25
7484,서울,중구,0,0,0,0,0,0,2018-09-25
7485,서울,중구,4,0,2,6,6,0,2018-10-25
7486,서울,중구,5,2,1,8,3,0,2018-11-25
7487,서울,중구,3,0,0,3,2,0,2018-12-25
7488,서울,중랑구,5,0,0,5,5,0,2018-01-25
7489,서울,중랑구,3,0,1,4,3,1,2018-02-25
7490,서울,중랑구,0,0,0,0,0,0,2018-03-25
7491,서울,중랑구,11,0,0,11,6,0,2018-04-25
7492,서울,중랑구,12,1,4,17,11,0,2018-05-25
7493,서울,중랑구,4,0,2,6,4,0,2018-06-25
7494,서울,중랑구,6,2,3,11,8,0,2018-07-25
7495,서울,중랑구,5,0,0,5,3,0,2018-08-25
7496,서울,중랑구,5,1,0,6,4,0,2018-09-25
7497,서울,중랑구,11,0,1,12,5,0,2018-10-25
7498,서울,중랑구,8,4,5,17,7,0,2018-11-25
7499,서울,중랑구,3,0,2,5,4,0,2018-12-25
7500,서울,강남구,6,1,4,11,9,0,2018-01-26
7501,서울,강남구,5,1,3,9,8,0,2018-02-26
7502,서울,강남구,7,3,2,12,9,0,2018-03-26
7503,서울,강남구,2,0,1,3,3,0,2018-04-26
7504,서울,강남구,16,2,0,18,16,0,2018-05-26
7505,서울,강남구,10,5,4,19,11,0,2018-06-26
7506,서울,강남구,13,0,7,20,14,0,2018-07-26
7507,서울,강남구,7,3,1,11,4,0,2018-08-26
7508,서울,강남구,7,0,4,11,7,0,2018-09-26
7509,서울,강남구,13,4,4,21,14,0,2018-10-26
7510,서울,강남구,3,1,1,5,5,0,2018-11-26
7511,서울,강남구,17,3,3,23,15,0,2018-12-26
7512,서울,강동구,5,0,3,8,6,0,2018-01-26
7513,서울,강동구,3,1,1,5,5,0,2018-02-26
7514,서울,강동구,2,1,1,4,4,0,2018-03-26
7515,서울,강동구,6,2,3,11,8,0,2018-04-26
7516,서울,강동구,2,0,0,2,2,0,2018-05-26
7517,서울,강동구,0,1,4,5,3,0,2018-06-26
7518,서울,강동구,1,1,1,3,3,0,2018-07-26
7519,서울,강동구,2,0,1,3,3,0,2018-08-26
7520,서울,강동구,2,0,2,4,4,0,2018-09-26
7521,서울,강동구,3,1,0,4,3,0,2018-10-26
7522,서울,강동구,1,1,0,2,2,0,2018-11-26
7523,서울,강동구,4,0,1,5,4,0,2018-12-26
7524,서울,강북구,1,0,1,2,2,0,2018-01-26
7525,서울,강북구,3,0,1,4,4,0,2018-02-26
7526,서울,강북구,0,0,1,1,1,0,2018-03-26
7527,서울,강북구,3,0,2,5,4,0,2018-04-26
7528,서울,강북구,5,0,0,5,4,0,2018-05-26
7529,서울,강북구,7,0,0,7,3,0,2018-06-26
7530,서울,강북구,2,0,0,2,2,0,2018-07-26
7531,서울,강북구,1,0,0,1,1,0,2018-08-26
7532,서울,강북구,5,1,0,6,4,0,2018-09-26
7533,서울,강북구,5,0,1,6,5,0,2018-10-26
7534,서울,강북구,2,0,0,2,2,0,2018-11-26
7535,서울,강북구,3,1,1,5,3,0,2018-12-26
7536,서울,강서구,3,0,2,5,4,0,2018-01-26
7537,서울,강서구,0,0,0,0,0,0,2018-02-26
7538,서울,강서구,2,0,2,4,4,0,2018-03-26
7539,서울,강서구,6,1,3,10,8,0,2018-04-26
7540,서울,강서구,3,1,2,6,4,0,2018-05-26
7541,서울,강서구,1,0,0,1,1,0,2018-06-26
7542,서울,강서구,4,0,1,5,4,0,2018-07-26
7543,서울,강서구,9,0,2,11,6,0,2018-08-26
7544,서울,강서구,1,0,2,3,3,0,2018-09-26
7545,서울,강서구,3,0,2,5,5,0,2018-10-26
7546,서울,강서구,4,0,2,6,4,0,2018-11-26
7547,서울,강서구,5,0,0,5,5,0,2018-12-26
7548,서울,관악구,2,0,0,2,2,0,2018-01-26
7549,서울,관악구,7,1,1,9,6,0,2018-02-26
7550,서울,관악구,1,1,1,3,2,0,2018-03-26
7551,서울,관악구,1,0,0,1,1,0,2018-04-26
7552,서울,관악구,6,0,2,8,4,0,2018-05-26
7553,서울,관악구,3,0,1,4,3,0,2018-06-26
7554,서울,관악구,3,0,2,5,4,0,2018-07-26
7555,서울,관악구,1,0,0,1,2,1,2018-08-26
7556,서울,관악구,3,0,0,3,2,0,2018-09-26
7557,서울,관악구,4,0,1,5,4,0,2018-10-26
7558,서울,관악구,0,0,0,0,0,0,2018-11-26
7559,서울,관악구,0,0,0,0,0,0,2018-12-26
7560,서울,광진구,6,0,0,6,5,0,2018-01-26
7561,서울,광진구,1,0,1,2,2,0,2018-02-26
7562,서울,광진구,1,0,2,3,3,0,2018-03-26
7563,서울,광진구,1,1,0,2,2,0,2018-04-26
7564,서울,광진구,7,0,2,9,6,0,2018-05-26
7565,서울,광진구,6,1,1,8,8,0,2018-06-26
7566,서울,광진구,2,0,0,2,2,0,2018-07-26
7567,서울,광진구,16,0,2,18,7,0,2018-08-26
7568,서울,광진구,1,0,0,1,1,0,2018-09-26
7569,서울,광진구,0,0,2,2,2,0,2018-10-26
7570,서울,광진구,4,0,1,5,3,0,2018-11-26
7571,서울,광진구,2,0,1,3,3,0,2018-12-26
7572,서울,구로구,4,2,1,7,3,2,2018-01-26
7573,서울,구로구,8,0,0,8,7,0,2018-02-26
7574,서울,구로구,2,1,0,3,3,0,2018-03-26
7575,서울,구로구,0,0,3,3,3,0,2018-04-26
7576,서울,구로구,1,2,1,4,4,0,2018-05-26
7577,서울,구로구,7,2,1,10,8,0,2018-06-26
7578,서울,구로구,7,0,0,7,7,0,2018-07-26
7579,서울,구로구,1,0,0,1,1,0,2018-08-26
7580,서울,구로구,4,0,2,6,5,0,2018-09-26
7581,서울,구로구,0,0,1,1,1,0,2018-10-26
7582,서울,구로구,3,0,0,3,2,0,2018-11-26
7583,서울,구로구,8,0,2,10,7,0,2018-12-26
7584,서울,금천구,1,0,0,1,1,0,2018-01-26
7585,서울,금천구,4,0,0,4,3,0,2018-02-26
7586,서울,금천구,4,0,5,9,5,0,2018-03-26
7587,서울,금천구,5,1,2,8,7,0,2018-04-26
7588,서울,금천구,1,0,0,1,1,0,2018-05-26
7589,서울,금천구,1,0,0,1,1,0,2018-06-26
7590,서울,금천구,2,0,0,2,2,0,2018-07-26
7591,서울,금천구,0,0,0,0,0,0,2018-08-26
7592,서울,금천구,1,0,0,1,1,0,2018-09-26
7593,서울,금천구,2,0,2,4,3,0,2018-10-26
7594,서울,금천구,2,0,3,5,5,0,2018-11-26
7595,서울,금천구,2,0,0,2,2,0,2018-12-26
7596,서울,노원구,1,0,3,4,4,1,2018-01-26
7597,서울,노원구,1,0,0,1,1,0,2018-02-26
7598,서울,노원구,9,0,1,10,5,0,2018-03-26
7599,서울,노원구,3,1,0,4,4,0,2018-04-26
7600,서울,노원구,4,0,0,4,4,0,2018-05-26
7601,서울,노원구,3,1,0,4,3,0,2018-06-26
7602,서울,노원구,0,0,1,1,1,0,2018-07-26
7603,서울,노원구,0,0,2,2,2,0,2018-08-26
7604,서울,노원구,1,0,2,3,1,0,2018-09-26
7605,서울,노원구,2,0,1,3,3,0,2018-10-26
7606,서울,노원구,8,0,1,9,7,0,2018-11-26
7607,서울,노원구,6,0,2,8,6,0,2018-12-26
7608,서울,도봉구,4,1,0,5,4,0,2018-01-26
7609,서울,도봉구,0,0,0,0,0,0,2018-02-26
7610,서울,도봉구,0,0,0,0,0,0,2018-03-26
7611,서울,도봉구,1,1,2,4,4,0,2018-04-26
7612,서울,도봉구,1,0,1,2,2,0,2018-05-26
7613,서울,도봉구,5,0,0,5,5,0,2018-06-26
7614,서울,도봉구,1,0,0,1,1,0,2018-07-26
7615,서울,도봉구,0,0,1,1,1,0,2018-08-26
7616,서울,도봉구,0,0,1,1,1,0,2018-09-26
7617,서울,도봉구,1,1,2,4,3,0,2018-10-26
7618,서울,도봉구,1,1,0,2,2,0,2018-11-26
7619,서울,도봉구,2,0,0,2,1,0,2018-12-26
7620,서울,동대문구,4,0,0,4,3,0,2018-01-26
7621,서울,동대문구,3,0,1,4,4,0,2018-02-26
7622,서울,동대문구,2,2,3,7,7,1,2018-03-26
7623,서울,동대문구,3,1,1,5,5,0,2018-04-26
7624,서울,동대문구,10,0,1,11,6,0,2018-05-26
7625,서울,동대문구,4,0,2,6,5,0,2018-06-26
7626,서울,동대문구,3,0,1,4,3,0,2018-07-26
7627,서울,동대문구,0,0,0,0,0,0,2018-08-26
7628,서울,동대문구,3,0,1,4,3,0,2018-09-26
7629,서울,동대문구,1,0,0,1,1,0,2018-10-26
7630,서울,동대문구,4,0,3,7,5,0,2018-11-26
7631,서울,동대문구,2,0,2,4,4,0,2018-12-26
7632,서울,동작구,5,0,0,5,4,0,2018-01-26
7633,서울,동작구,6,0,0,6,6,1,2018-02-26
7634,서울,동작구,2,0,0,2,2,0,2018-03-26
7635,서울,동작구,10,1,1,12,9,0,2018-04-26
7636,서울,동작구,4,0,0,4,4,0,2018-05-26
7637,서울,동작구,4,2,0,6,4,0,2018-06-26
7638,서울,동작구,3,1,1,5,4,0,2018-07-26
7639,서울,동작구,5,1,2,8,3,0,2018-08-26
7640,서울,동작구,0,1,0,1,1,0,2018-09-26
7641,서울,동작구,1,0,3,4,4,0,2018-10-26
7642,서울,동작구,2,2,3,7,6,0,2018-11-26
7643,서울,동작구,0,0,0,0,0,0,2018-12-26
7644,서울,마포구,14,0,3,17,9,0,2018-01-26
7645,서울,마포구,9,1,5,15,7,0,2018-02-26
7646,서울,마포구,5,0,0,5,5,0,2018-03-26
7647,서울,마포구,7,0,0,7,5,0,2018-04-26
7648,서울,마포구,9,1,2,12,9,0,2018-05-26
7649,서울,마포구,1,0,1,2,1,0,2018-06-26
7650,서울,마포구,8,0,0,8,6,0,2018-07-26
7651,서울,마포구,4,1,2,7,6,0,2018-08-26
7652,서울,마포구,1,0,3,4,4,0,2018-09-26
7653,서울,마포구,3,0,1,4,5,1,2018-10-26
7654,서울,마포구,7,0,3,10,8,0,2018-11-26
7655,서울,마포구,1,0,0,1,1,0,2018-12-26
7656,서울,서대문구,4,0,1,5,3,0,2018-01-26
7657,서울,서대문구,1,0,2,3,2,0,2018-02-26
7658,서울,서대문구,1,0,1,2,2,0,2018-03-26
7659,서울,서대문구,1,0,0,1,1,0,2018-04-26
7660,서울,서대문구,5,0,2,7,5,0,2018-05-26
7661,서울,서대문구,0,0,1,1,1,0,2018-06-26
7662,서울,서대문구,5,2,0,7,5,0,2018-07-26
7663,서울,서대문구,0,0,0,0,0,0,2018-08-26
7664,서울,서대문구,3,0,2,5,2,0,2018-09-26
7665,서울,서대문구,1,0,1,2,2,0,2018-10-26
7666,서울,서대문구,4,1,0,5,4,0,2018-11-26
7667,서울,서대문구,3,0,1,4,3,0,2018-12-26
7668,서울,서초구,16,1,3,20,16,0,2018-01-26
7669,서울,서초구,8,1,2,11,7,0,2018-02-26
7670,서울,서초구,10,0,2,12,12,0,2018-03-26
7671,서울,서초구,5,0,0,5,5,0,2018-04-26
7672,서울,서초구,6,0,3,9,6,0,2018-05-26
7673,서울,서초구,5,0,3,8,7,0,2018-06-26
7674,서울,서초구,10,0,0,10,8,0,2018-07-26
7675,서울,서초구,0,1,1,2,2,0,2018-08-26
7676,서울,서초구,1,0,0,1,1,0,2018-09-26
7677,서울,서초구,15,3,1,19,12,0,2018-10-26
7678,서울,서초구,1,0,0,1,1,0,2018-11-26
7679,서울,서초구,4,2,0,6,5,0,2018-12-26
7680,서울,성동구,1,0,1,2,2,0,2018-01-26
7681,서울,성동구,4,0,1,5,4,0,2018-02-26
7682,서울,성동구,6,0,1,7,4,0,2018-03-26
7683,서울,성동구,2,0,3,5,4,0,2018-04-26
7684,서울,성동구,3,0,2,5,4,0,2018-05-26
7685,서울,성동구,3,0,2,5,5,0,2018-06-26
7686,서울,성동구,0,0,2,2,3,1,2018-07-26
7687,서울,성동구,4,0,1,5,3,0,2018-08-26
7688,서울,성동구,0,0,1,1,1,0,2018-09-26
7689,서울,성동구,3,0,1,4,4,0,2018-10-26
7690,서울,성동구,0,0,0,0,0,0,2018-11-26
7691,서울,성동구,1,0,1,2,2,0,2018-12-26
7692,서울,성북구,3,0,1,4,3,0,2018-01-26
7693,서울,성북구,0,0,0,0,0,0,2018-02-26
7694,서울,성북구,4,2,0,6,5,0,2018-03-26
7695,서울,성북구,4,0,1,5,4,0,2018-04-26
7696,서울,성북구,2,0,3,5,5,0,2018-05-26
7697,서울,성북구,9,0,1,10,8,0,2018-06-26
7698,서울,성북구,7,1,2,10,8,0,2018-07-26
7699,서울,성북구,4,0,0,4,3,0,2018-08-26
7700,서울,성북구,0,0,0,0,0,0,2018-09-26
7701,서울,성북구,1,0,0,1,1,0,2018-10-26
7702,서울,성북구,3,0,0,3,3,0,2018-11-26
7703,서울,성북구,1,2,1,4,4,0,2018-12-26
7704,서울,송파구,6,0,2,8,7,0,2018-01-26
7705,서울,송파구,8,1,1,10,7,0,2018-02-26
7706,서울,송파구,7,1,4,12,8,0,2018-03-26
7707,서울,송파구,7,1,2,10,9,0,2018-04-26
7708,서울,송파구,14,2,0,16,9,0,2018-05-26
7709,서울,송파구,12,0,3,15,10,0,2018-06-26
7710,서울,송파구,9,3,5,17,12,0,2018-07-26
7711,서울,송파구,10,1,1,12,6,0,2018-08-26
7712,서울,송파구,4,0,0,4,4,0,2018-09-26
7713,서울,송파구,13,0,2,15,10,0,2018-10-26
7714,서울,송파구,6,2,1,9,7,0,2018-11-26
7715,서울,송파구,5,2,1,8,8,0,2018-12-26
7716,서울,양천구,0,0,2,2,2,0,2018-01-26
7717,서울,양천구,4,0,2,6,5,0,2018-02-26
7718,서울,양천구,3,1,0,4,4,1,2018-03-26
7719,서울,양천구,4,0,0,4,4,0,2018-04-26
7720,서울,양천구,4,1,0,5,4,0,2018-05-26
7721,서울,양천구,10,1,5,16,12,0,2018-06-26
7722,서울,양천구,3,3,0,6,4,1,2018-07-26
7723,서울,양천구,1,2,0,3,3,0,2018-08-26
7724,서울,양천구,5,0,1,6,5,0,2018-09-26
7725,서울,양천구,5,0,3,8,4,0,2018-10-26
7726,서울,양천구,1,1,1,3,2,1,2018-11-26
7727,서울,양천구,5,0,1,6,5,0,2018-12-26
7728,서울,영등포구,12,1,4,17,13,0,2018-01-26
7729,서울,영등포구,7,1,2,10,7,0,2018-02-26
7730,서울,영등포구,3,0,0,3,2,0,2018-03-26
7731,서울,영등포구,7,2,3,12,9,0,2018-04-26
7732,서울,영등포구,5,0,1,6,5,0,2018-05-26
7733,서울,영등포구,8,1,1,10,8,0,2018-06-26
7734,서울,영등포구,8,1,1,10,3,0,2018-07-26
7735,서울,영등포구,3,1,1,5,4,0,2018-08-26
7736,서울,영등포구,1,0,1,2,2,0,2018-09-26
7737,서울,영등포구,10,3,2,15,12,0,2018-10-26
7738,서울,영등포구,9,1,3,13,9,0,2018-11-26
7739,서울,영등포구,2,0,4,6,5,0,2018-12-26
7740,서울,용산구,2,0,1,3,2,0,2018-01-26
7741,서울,용산구,3,0,1,4,4,0,2018-02-26
7742,서울,용산구,2,0,2,4,4,0,2018-03-26
7743,서울,용산구,1,1,1,3,3,0,2018-04-26
7744,서울,용산구,10,0,2,12,6,0,2018-05-26
7745,서울,용산구,6,0,0,6,4,0,2018-06-26
7746,서울,용산구,2,0,0,2,2,0,2018-07-26
7747,서울,용산구,6,0,2,8,2,0,2018-08-26
7748,서울,용산구,2,0,0,2,1,0,2018-09-26
7749,서울,용산구,4,1,1,6,5,0,2018-10-26
7750,서울,용산구,5,0,1,6,5,0,2018-11-26
7751,서울,용산구,5,0,1,6,3,0,2018-12-26
7752,서울,은평구,2,2,1,5,5,0,2018-01-26
7753,서울,은평구,4,0,3,7,3,0,2018-02-26
7754,서울,은평구,2,1,1,4,3,0,2018-03-26
7755,서울,은평구,0,1,1,2,2,0,2018-04-26
7756,서울,은평구,2,1,2,5,5,0,2018-05-26
7757,서울,은평구,3,1,1,5,4,0,2018-06-26
7758,서울,은평구,0,0,1,1,1,0,2018-07-26
7759,서울,은평구,1,0,0,1,1,0,2018-08-26
7760,서울,은평구,0,0,1,1,1,0,2018-09-26
7761,서울,은평구,4,0,4,8,6,0,2018-10-26
7762,서울,은평구,2,1,0,3,3,0,2018-11-26
7763,서울,은평구,1,1,0,2,1,0,2018-12-26
7764,서울,종로구,2,2,0,4,2,0,2018-01-26
7765,서울,종로구,3,0,0,3,3,0,2018-02-26
7766,서울,종로구,1,1,1,3,3,0,2018-03-26
7767,서울,종로구,3,0,1,4,4,0,2018-04-26
7768,서울,종로구,3,1,0,4,3,0,2018-05-26
7769,서울,종로구,4,1,0,5,5,0,2018-06-26
7770,서울,종로구,3,0,0,3,3,0,2018-07-26
7771,서울,종로구,0,0,0,0,0,0,2018-08-26
7772,서울,종로구,3,1,1,5,4,0,2018-09-26
7773,서울,종로구,3,0,1,4,3,0,2018-10-26
7774,서울,종로구,2,0,1,3,3,0,2018-11-26
7775,서울,종로구,1,0,2,3,3,0,2018-12-26
7776,서울,중구,1,0,2,3,3,0,2018-01-26
7777,서울,중구,2,0,2,4,4,0,2018-02-26
7778,서울,중구,5,0,1,6,5,0,2018-03-26
7779,서울,중구,2,1,0,3,3,0,2018-04-26
7780,서울,중구,7,0,1,8,4,0,2018-05-26
7781,서울,중구,4,0,1,5,4,0,2018-06-26
7782,서울,중구,0,0,2,2,2,0,2018-07-26
7783,서울,중구,1,0,0,1,1,0,2018-08-26
7784,서울,중구,0,0,0,0,0,0,2018-09-26
7785,서울,중구,6,1,3,10,7,0,2018-10-26
7786,서울,중구,2,0,1,3,3,0,2018-11-26
7787,서울,중구,1,0,0,1,1,0,2018-12-26
7788,서울,중랑구,2,2,1,5,4,0,2018-01-26
7789,서울,중랑구,3,0,0,3,3,0,2018-02-26
7790,서울,중랑구,3,0,2,5,4,0,2018-03-26
7791,서울,중랑구,2,3,2,7,5,0,2018-04-26
7792,서울,중랑구,4,0,5,9,7,0,2018-05-26
7793,서울,중랑구,4,0,0,4,2,0,2018-06-26
7794,서울,중랑구,4,1,1,6,5,0,2018-07-26
7795,서울,중랑구,0,0,2,2,2,0,2018-08-26
7796,서울,중랑구,8,0,0,8,5,0,2018-09-26
7797,서울,중랑구,1,0,0,1,1,0,2018-10-26
7798,서울,중랑구,1,0,3,4,4,0,2018-11-26
7799,서울,중랑구,4,0,0,4,3,0,2018-12-26
7800,서울,강남구,9,0,2,11,8,0,2018-01-27
7801,서울,강남구,9,0,0,9,7,1,2018-02-27
7802,서울,강남구,6,2,2,10,6,0,2018-03-27
7803,서울,강남구,8,4,5,17,11,0,2018-04-27
7804,서울,강남구,12,0,3,15,8,0,2018-05-27
7805,서울,강남구,2,1,5,8,6,0,2018-06-27
7806,서울,강남구,14,2,5,21,14,0,2018-07-27
7807,서울,강남구,20,3,1,24,15,0,2018-08-27
7808,서울,강남구,5,0,2,7,7,0,2018-09-27
7809,서울,강남구,8,0,2,10,8,0,2018-10-27
7810,서울,강남구,10,0,0,10,5,0,2018-11-27
7811,서울,강남구,6,0,4,10,9,0,2018-12-27
7812,서울,강동구,1,0,0,1,1,0,2018-01-27
7813,서울,강동구,2,1,0,3,3,0,2018-02-27
7814,서울,강동구,3,0,1,4,4,0,2018-03-27
7815,서울,강동구,3,0,0,3,3,0,2018-04-27
7816,서울,강동구,8,0,1,9,2,0,2018-05-27
7817,서울,강동구,0,0,3,3,3,0,2018-06-27
7818,서울,강동구,3,1,0,4,2,0,2018-07-27
7819,서울,강동구,2,0,0,2,2,0,2018-08-27
7820,서울,강동구,2,0,1,3,2,0,2018-09-27
7821,서울,강동구,8,0,2,10,5,0,2018-10-27
7822,서울,강동구,2,2,0,4,3,0,2018-11-27
7823,서울,강동구,5,3,1,9,5,0,2018-12-27
7824,서울,강북구,3,0,0,3,3,0,2018-01-27
7825,서울,강북구,0,0,1,1,1,0,2018-02-27
7826,서울,강북구,5,0,1,6,5,0,2018-03-27
7827,서울,강북구,3,0,1,4,3,0,2018-04-27
7828,서울,강북구,2,2,1,5,4,0,2018-05-27
7829,서울,강북구,2,0,0,2,2,0,2018-06-27
7830,서울,강북구,2,1,1,4,4,0,2018-07-27
7831,서울,강북구,2,0,0,2,2,0,2018-08-27
7832,서울,강북구,6,0,1,7,7,0,2018-09-27
7833,서울,강북구,1,1,1,3,2,0,2018-10-27
7834,서울,강북구,3,0,1,4,2,0,2018-11-27
7835,서울,강북구,2,0,0,2,2,0,2018-12-27
7836,서울,강서구,3,0,0,3,2,0,2018-01-27
7837,서울,강서구,6,0,1,7,4,0,2018-02-27
7838,서울,강서구,2,0,0,2,1,0,2018-03-27
7839,서울,강서구,5,1,1,7,7,0,2018-04-27
7840,서울,강서구,0,1,1,2,2,0,2018-05-27
7841,서울,강서구,2,2,0,4,4,0,2018-06-27
7842,서울,강서구,7,1,1,9,5,0,2018-07-27
7843,서울,강서구,1,1,0,2,2,0,2018-08-27
7844,서울,강서구,4,0,4,8,5,0,2018-09-27
7845,서울,강서구,7,0,1,8,5,0,2018-10-27
7846,서울,강서구,2,0,1,3,2,0,2018-11-27
7847,서울,강서구,2,1,1,4,4,0,2018-12-27
7848,서울,관악구,2,0,1,3,3,0,2018-01-27
7849,서울,관악구,3,0,0,3,2,0,2018-02-27
7850,서울,관악구,2,0,3,5,4,0,2018-03-27
7851,서울,관악구,3,1,0,4,2,0,2018-04-27
7852,서울,관악구,2,0,3,5,3,0,2018-05-27
7853,서울,관악구,1,0,0,1,1,0,2018-06-27
7854,서울,관악구,10,0,2,12,6,0,2018-07-27
7855,서울,관악구,2,0,0,2,3,1,2018-08-27
7856,서울,관악구,3,0,0,3,2,0,2018-09-27
7857,서울,관악구,4,0,0,4,2,0,2018-10-27
7858,서울,관악구,0,0,1,1,1,0,2018-11-27
7859,서울,관악구,3,0,0,3,2,0,2018-12-27
7860,서울,광진구,2,0,2,4,4,0,2018-01-27
7861,서울,광진구,3,0,1,4,3,0,2018-02-27
7862,서울,광진구,1,0,2,3,2,0,2018-03-27
7863,서울,광진구,1,0,2,3,1,0,2018-04-27
7864,서울,광진구,2,0,0,2,1,0,2018-05-27
7865,서울,광진구,1,2,0,3,3,0,2018-06-27
7866,서울,광진구,4,1,1,6,5,0,2018-07-27
7867,서울,광진구,7,0,2,9,7,0,2018-08-27
7868,서울,광진구,4,0,2,6,4,0,2018-09-27
7869,서울,광진구,5,0,4,9,5,0,2018-10-27
7870,서울,광진구,4,0,0,4,3,0,2018-11-27
7871,서울,광진구,0,0,0,0,0,0,2018-12-27
7872,서울,구로구,14,0,1,15,6,0,2018-01-27
7873,서울,구로구,2,0,1,3,3,0,2018-02-27
7874,서울,구로구,6,0,0,6,3,0,2018-03-27
7875,서울,구로구,6,1,0,7,6,0,2018-04-27
7876,서울,구로구,4,0,0,4,2,0,2018-05-27
7877,서울,구로구,8,0,2,10,6,0,2018-06-27
7878,서울,구로구,8,2,6,16,12,0,2018-07-27
7879,서울,구로구,7,0,1,8,6,0,2018-08-27
7880,서울,구로구,7,2,1,10,6,0,2018-09-27
7881,서울,구로구,5,1,0,6,4,0,2018-10-27
7882,서울,구로구,3,2,1,6,5,0,2018-11-27
7883,서울,구로구,8,0,1,9,5,0,2018-12-27
7884,서울,금천구,0,0,0,0,0,0,2018-01-27
7885,서울,금천구,2,0,3,5,5,0,2018-02-27
7886,서울,금천구,3,0,1,4,2,0,2018-03-27
7887,서울,금천구,1,0,1,2,2,0,2018-04-27
7888,서울,금천구,1,0,0,1,1,0,2018-05-27
7889,서울,금천구,4,0,0,4,3,0,2018-06-27
7890,서울,금천구,4,0,1,5,4,0,2018-07-27
7891,서울,금천구,8,1,1,10,4,0,2018-08-27
7892,서울,금천구,3,0,0,3,3,0,2018-09-27
7893,서울,금천구,3,2,0,5,4,0,2018-10-27
7894,서울,금천구,6,0,0,6,3,0,2018-11-27
7895,서울,금천구,1,0,2,3,3,0,2018-12-27
7896,서울,노원구,1,1,2,4,4,0,2018-01-27
7897,서울,노원구,6,1,1,8,8,1,2018-02-27
7898,서울,노원구,0,0,1,1,1,0,2018-03-27
7899,서울,노원구,3,1,3,7,7,0,2018-04-27
7900,서울,노원구,0,2,0,2,2,0,2018-05-27
7901,서울,노원구,2,2,0,4,3,0,2018-06-27
7902,서울,노원구,0,0,3,3,3,0,2018-07-27
7903,서울,노원구,5,0,2,7,5,0,2018-08-27
7904,서울,노원구,5,1,1,7,6,0,2018-09-27
7905,서울,노원구,7,0,1,8,4,0,2018-10-27
7906,서울,노원구,4,0,0,4,4,0,2018-11-27
7907,서울,노원구,9,0,2,11,9,0,2018-12-27
7908,서울,도봉구,2,0,0,2,1,0,2018-01-27
7909,서울,도봉구,4,0,0,4,3,0,2018-02-27
7910,서울,도봉구,0,1,0,1,1,0,2018-03-27
7911,서울,도봉구,1,0,0,1,1,0,2018-04-27
7912,서울,도봉구,1,0,0,1,1,0,2018-05-27
7913,서울,도봉구,2,1,1,4,4,0,2018-06-27
7914,서울,도봉구,0,0,1,1,1,0,2018-07-27
7915,서울,도봉구,0,0,1,1,1,0,2018-08-27
7916,서울,도봉구,3,0,0,3,3,0,2018-09-27
7917,서울,도봉구,2,0,3,5,2,0,2018-10-27
7918,서울,도봉구,1,0,1,2,2,0,2018-11-27
7919,서울,도봉구,0,0,1,1,1,0,2018-12-27
7920,서울,동대문구,10,0,1,11,4,0,2018-01-27
7921,서울,동대문구,2,2,1,5,5,0,2018-02-27
7922,서울,동대문구,3,0,1,4,3,0,2018-03-27
7923,서울,동대문구,10,0,3,13,10,0,2018-04-27
7924,서울,동대문구,3,1,1,5,5,0,2018-05-27
7925,서울,동대문구,2,0,0,2,2,0,2018-06-27
7926,서울,동대문구,6,0,3,9,5,0,2018-07-27
7927,서울,동대문구,2,1,2,5,5,0,2018-08-27
7928,서울,동대문구,3,0,2,5,5,0,2018-09-27
7929,서울,동대문구,5,1,1,7,6,0,2018-10-27
7930,서울,동대문구,0,3,3,6,3,0,2018-11-27
7931,서울,동대문구,8,0,0,8,6,0,2018-12-27
7932,서울,동작구,1,1,1,3,3,0,2018-01-27
7933,서울,동작구,1,0,1,2,2,0,2018-02-27
7934,서울,동작구,4,2,1,7,5,0,2018-03-27
7935,서울,동작구,2,1,4,7,2,0,2018-04-27
7936,서울,동작구,3,0,2,5,5,0,2018-05-27
7937,서울,동작구,4,4,2,10,7,0,2018-06-27
7938,서울,동작구,4,2,2,8,3,0,2018-07-27
7939,서울,동작구,2,0,2,4,4,0,2018-08-27
7940,서울,동작구,2,1,1,4,3,0,2018-09-27
7941,서울,동작구,2,0,2,4,3,0,2018-10-27
7942,서울,동작구,3,0,1,4,4,0,2018-11-27
7943,서울,동작구,4,0,0,4,4,0,2018-12-27
7944,서울,마포구,3,0,5,8,6,0,2018-01-27
7945,서울,마포구,4,0,0,4,1,0,2018-02-27
7946,서울,마포구,1,4,1,6,3,0,2018-03-27
7947,서울,마포구,6,1,0,7,6,0,2018-04-27
7948,서울,마포구,7,0,3,10,7,0,2018-05-27
7949,서울,마포구,4,1,1,6,5,0,2018-06-27
7950,서울,마포구,11,0,0,11,7,0,2018-07-27
7951,서울,마포구,1,0,0,1,2,1,2018-08-27
7952,서울,마포구,7,0,0,7,6,0,2018-09-27
7953,서울,마포구,11,0,0,11,9,0,2018-10-27
7954,서울,마포구,5,0,0,5,1,0,2018-11-27
7955,서울,마포구,1,1,0,2,2,0,2018-12-27
7956,서울,서대문구,0,0,0,0,0,0,2018-01-27
7957,서울,서대문구,2,0,2,4,3,0,2018-02-27
7958,서울,서대문구,4,0,1,5,5,0,2018-03-27
7959,서울,서대문구,4,3,1,8,6,0,2018-04-27
7960,서울,서대문구,3,0,0,3,1,0,2018-05-27
7961,서울,서대문구,0,0,0,0,0,0,2018-06-27
7962,서울,서대문구,2,0,0,2,2,0,2018-07-27
7963,서울,서대문구,3,0,0,3,1,0,2018-08-27
7964,서울,서대문구,2,0,0,2,2,0,2018-09-27
7965,서울,서대문구,7,0,1,8,4,0,2018-10-27
7966,서울,서대문구,1,0,1,2,2,0,2018-11-27
7967,서울,서대문구,3,0,2,5,4,0,2018-12-27
7968,서울,서초구,3,2,0,5,5,0,2018-01-27
7969,서울,서초구,3,1,1,5,5,1,2018-02-27
7970,서울,서초구,8,2,1,11,5,0,2018-03-27
7971,서울,서초구,6,0,1,7,4,0,2018-04-27
7972,서울,서초구,8,2,0,10,5,0,2018-05-27
7973,서울,서초구,1,0,1,2,2,0,2018-06-27
7974,서울,서초구,11,1,7,19,13,0,2018-07-27
7975,서울,서초구,7,1,3,11,9,0,2018-08-27
7976,서울,서초구,5,0,1,6,6,0,2018-09-27
7977,서울,서초구,10,1,2,13,11,0,2018-10-27
7978,서울,서초구,16,1,2,19,11,0,2018-11-27
7979,서울,서초구,9,2,2,13,10,0,2018-12-27
7980,서울,성동구,4,0,0,4,3,0,2018-01-27
7981,서울,성동구,2,0,1,3,3,0,2018-02-27
7982,서울,성동구,7,1,1,9,7,0,2018-03-27
7983,서울,성동구,0,0,0,0,0,0,2018-04-27
7984,서울,성동구,1,0,0,1,1,0,2018-05-27
7985,서울,성동구,4,0,0,4,3,0,2018-06-27
7986,서울,성동구,7,1,2,10,7,0,2018-07-27
7987,서울,성동구,3,0,1,4,4,0,2018-08-27
7988,서울,성동구,1,0,1,2,2,0,2018-09-27
7989,서울,성동구,8,0,1,9,7,0,2018-10-27
7990,서울,성동구,3,0,1,4,3,0,2018-11-27
7991,서울,성동구,1,1,0,2,1,0,2018-12-27
7992,서울,성북구,5,1,2,8,7,0,2018-01-27
7993,서울,성북구,1,0,2,3,2,0,2018-02-27
7994,서울,성북구,5,0,1,6,5,0,2018-03-27
7995,서울,성북구,6,0,1,7,4,0,2018-04-27
7996,서울,성북구,3,0,2,5,3,0,2018-05-27
7997,서울,성북구,2,0,0,2,2,0,2018-06-27
7998,서울,성북구,7,1,2,10,7,0,2018-07-27
7999,서울,성북구,0,0,0,0,0,0,2018-08-27
8000,서울,성북구,3,0,1,4,3,0,2018-09-27
8001,서울,성북구,11,1,0,12,9,0,2018-10-27
8002,서울,성북구,3,0,0,3,3,0,2018-11-27
8003,서울,성북구,2,0,1,3,3,0,2018-12-27
8004,서울,송파구,12,0,3,15,10,1,2018-01-27
8005,서울,송파구,9,1,4,14,9,0,2018-02-27
8006,서울,송파구,6,2,3,11,6,0,2018-03-27
8007,서울,송파구,5,1,3,9,8,1,2018-04-27
8008,서울,송파구,2,1,0,3,3,0,2018-05-27
8009,서울,송파구,7,2,1,10,10,0,2018-06-27
8010,서울,송파구,11,1,4,16,14,0,2018-07-27
8011,서울,송파구,6,0,2,8,8,0,2018-08-27
8012,서울,송파구,8,0,2,10,8,0,2018-09-27
8013,서울,송파구,6,4,2,12,9,0,2018-10-27
8014,서울,송파구,1,0,1,2,2,0,2018-11-27
8015,서울,송파구,9,0,1,10,7,0,2018-12-27
8016,서울,양천구,3,0,0,3,2,0,2018-01-27
8017,서울,양천구,5,0,0,5,5,0,2018-02-27
8018,서울,양천구,4,0,1,5,5,0,2018-03-27
8019,서울,양천구,4,0,2,6,5,0,2018-04-27
8020,서울,양천구,2,0,0,2,1,0,2018-05-27
8021,서울,양천구,0,0,2,2,1,0,2018-06-27
8022,서울,양천구,6,0,1,7,5,0,2018-07-27
8023,서울,양천구,9,0,1,10,8,0,2018-08-27
8024,서울,양천구,2,0,1,3,2,0,2018-09-27
8025,서울,양천구,5,0,0,5,4,0,2018-10-27
8026,서울,양천구,6,0,2,8,7,0,2018-11-27
8027,서울,양천구,5,0,1,6,5,0,2018-12-27
8028,서울,영등포구,8,2,1,11,9,0,2018-01-27
8029,서울,영등포구,3,0,1,4,3,0,2018-02-27
8030,서울,영등포구,3,1,0,4,4,0,2018-03-27
8031,서울,영등포구,9,0,2,11,8,0,2018-04-27
8032,서울,영등포구,1,1,1,3,2,0,2018-05-27
8033,서울,영등포구,5,0,2,7,6,0,2018-06-27
8034,서울,영등포구,9,0,0,9,7,0,2018-07-27
8035,서울,영등포구,5,4,0,9,6,0,2018-08-27
8036,서울,영등포구,8,0,2,10,9,0,2018-09-27
8037,서울,영등포구,5,1,3,9,6,0,2018-10-27
8038,서울,영등포구,2,1,0,3,3,0,2018-11-27
8039,서울,영등포구,7,1,2,10,9,0,2018-12-27
8040,서울,용산구,0,0,0,0,0,0,2018-01-27
8041,서울,용산구,2,0,1,3,3,0,2018-02-27
8042,서울,용산구,8,0,2,10,6,0,2018-03-27
8043,서울,용산구,8,1,3,12,7,0,2018-04-27
8044,서울,용산구,5,0,3,8,5,0,2018-05-27
8045,서울,용산구,2,0,1,3,3,0,2018-06-27
8046,서울,용산구,7,0,2,9,6,0,2018-07-27
8047,서울,용산구,3,0,0,3,1,0,2018-08-27
8048,서울,용산구,2,0,0,2,2,0,2018-09-27
8049,서울,용산구,0,0,0,0,0,0,2018-10-27
8050,서울,용산구,0,0,0,0,0,0,2018-11-27
8051,서울,용산구,3,0,0,3,2,0,2018-12-27
8052,서울,은평구,0,0,1,1,1,0,2018-01-27
8053,서울,은평구,2,0,1,3,3,0,2018-02-27
8054,서울,은평구,4,0,1,5,3,0,2018-03-27
8055,서울,은평구,2,0,1,3,3,0,2018-04-27
8056,서울,은평구,8,1,2,11,5,0,2018-05-27
8057,서울,은평구,5,0,2,7,5,0,2018-06-27
8058,서울,은평구,5,2,0,7,4,0,2018-07-27
8059,서울,은평구,7,0,1,8,7,0,2018-08-27
8060,서울,은평구,0,0,2,2,2,0,2018-09-27
8061,서울,은평구,1,0,0,1,1,0,2018-10-27
8062,서울,은평구,2,1,0,3,3,0,2018-11-27
8063,서울,은평구,13,4,2,19,9,0,2018-12-27
8064,서울,종로구,1,0,0,1,1,0,2018-01-27
8065,서울,종로구,3,0,0,3,2,0,2018-02-27
8066,서울,종로구,2,0,0,2,2,0,2018-03-27
8067,서울,종로구,1,0,0,1,1,0,2018-04-27
8068,서울,종로구,2,0,0,2,1,0,2018-05-27
8069,서울,종로구,2,0,2,4,4,0,2018-06-27
8070,서울,종로구,3,0,3,6,5,0,2018-07-27
8071,서울,종로구,5,0,3,8,6,0,2018-08-27
8072,서울,종로구,2,0,0,2,1,0,2018-09-27
8073,서울,종로구,7,1,3,11,8,0,2018-10-27
8074,서울,종로구,1,0,1,2,3,1,2018-11-27
8075,서울,종로구,7,1,1,9,6,0,2018-12-27
8076,서울,중구,0,0,1,1,1,0,2018-01-27
8077,서울,중구,3,1,2,6,5,0,2018-02-27
8078,서울,중구,1,1,2,4,2,0,2018-03-27
8079,서울,중구,1,0,0,1,1,0,2018-04-27
8080,서울,중구,3,0,2,5,4,0,2018-05-27
8081,서울,중구,1,0,2,3,3,0,2018-06-27
8082,서울,중구,1,0,1,2,2,0,2018-07-27
8083,서울,중구,3,1,1,5,5,0,2018-08-27
8084,서울,중구,0,0,0,0,0,0,2018-09-27
8085,서울,중구,4,0,3,7,6,0,2018-10-27
8086,서울,중구,1,2,1,4,3,0,2018-11-27
8087,서울,중구,3,0,0,3,3,0,2018-12-27
8088,서울,중랑구,3,0,2,5,4,0,2018-01-27
8089,서울,중랑구,2,0,5,7,5,0,2018-02-27
8090,서울,중랑구,3,1,2,6,3,0,2018-03-27
8091,서울,중랑구,7,0,2,9,5,0,2018-04-27
8092,서울,중랑구,6,0,2,8,5,0,2018-05-27
8093,서울,중랑구,6,0,2,8,6,0,2018-06-27
8094,서울,중랑구,3,1,5,9,7,0,2018-07-27
8095,서울,중랑구,4,1,2,7,7,0,2018-08-27
8096,서울,중랑구,4,2,0,6,6,0,2018-09-27
8097,서울,중랑구,15,0,4,19,13,0,2018-10-27
8098,서울,중랑구,6,0,2,8,7,0,2018-11-27
8099,서울,중랑구,5,1,0,6,4,0,2018-12-27
8100,서울,강남구,6,0,1,7,4,0,2018-01-28
8101,서울,강남구,10,0,3,13,9,0,2018-02-28
8102,서울,강남구,8,1,0,9,7,0,2018-03-28
8103,서울,강남구,10,1,2,13,8,0,2018-04-28
8104,서울,강남구,8,0,1,9,7,0,2018-05-28
8105,서울,강남구,9,2,2,13,12,0,2018-06-28
8106,서울,강남구,10,0,2,12,9,0,2018-07-28
8107,서울,강남구,12,0,4,16,13,0,2018-08-28
8108,서울,강남구,9,5,3,17,11,0,2018-09-28
8109,서울,강남구,13,0,0,13,7,0,2018-10-28
8110,서울,강남구,11,0,3,14,11,0,2018-11-28
8111,서울,강남구,10,0,1,11,11,0,2018-12-28
8112,서울,강동구,2,1,1,4,3,0,2018-01-28
8113,서울,강동구,7,1,1,9,7,0,2018-02-28
8114,서울,강동구,2,0,2,4,3,0,2018-03-28
8115,서울,강동구,3,1,2,6,6,0,2018-04-28
8116,서울,강동구,7,1,2,10,8,0,2018-05-28
8117,서울,강동구,4,0,0,4,3,0,2018-06-28
8118,서울,강동구,8,0,2,10,5,0,2018-07-28
8119,서울,강동구,3,0,0,3,3,0,2018-08-28
8120,서울,강동구,7,2,0,9,7,0,2018-09-28
8121,서울,강동구,3,0,1,4,2,0,2018-10-28
8122,서울,강동구,7,0,1,8,6,0,2018-11-28
8123,서울,강동구,10,2,0,12,4,0,2018-12-28
8124,서울,강북구,0,0,1,1,1,0,2018-01-28
8125,서울,강북구,2,0,0,2,2,0,2018-02-28
8126,서울,강북구,6,0,2,8,5,0,2018-03-28
8127,서울,강북구,1,1,0,2,2,0,2018-04-28
8128,서울,강북구,4,0,0,4,3,0,2018-05-28
8129,서울,강북구,3,0,0,3,3,0,2018-06-28
8130,서울,강북구,2,0,1,3,3,0,2018-07-28
8131,서울,강북구,2,1,1,4,4,0,2018-08-28
8132,서울,강북구,3,0,2,5,4,0,2018-09-28
8133,서울,강북구,2,0,1,3,3,0,2018-10-28
8134,서울,강북구,2,0,2,4,4,0,2018-11-28
8135,서울,강북구,1,0,0,1,1,0,2018-12-28
8136,서울,강서구,1,1,2,4,4,0,2018-01-28
8137,서울,강서구,2,0,3,5,5,0,2018-02-28
8138,서울,강서구,3,0,2,5,4,0,2018-03-28
8139,서울,강서구,8,2,1,11,4,0,2018-04-28
8140,서울,강서구,4,0,1,5,3,0,2018-05-28
8141,서울,강서구,6,1,4,11,7,1,2018-06-28
8142,서울,강서구,6,3,3,12,6,0,2018-07-28
8143,서울,강서구,7,1,3,11,7,0,2018-08-28
8144,서울,강서구,3,0,2,5,3,0,2018-09-28
8145,서울,강서구,0,0,1,1,1,0,2018-10-28
8146,서울,강서구,4,0,5,9,8,0,2018-11-28
8147,서울,강서구,4,0,1,5,4,0,2018-12-28
8148,서울,관악구,6,1,1,8,4,0,2018-01-28
8149,서울,관악구,10,0,0,10,7,0,2018-02-28
8150,서울,관악구,1,0,1,2,2,0,2018-03-28
8151,서울,관악구,3,0,1,4,3,0,2018-04-28
8152,서울,관악구,1,0,2,3,3,0,2018-05-28
8153,서울,관악구,2,0,1,3,3,0,2018-06-28
8154,서울,관악구,2,0,2,4,2,0,2018-07-28
8155,서울,관악구,5,2,5,12,4,0,2018-08-28
8156,서울,관악구,4,1,1,6,5,0,2018-09-28
8157,서울,관악구,4,0,1,5,4,0,2018-10-28
8158,서울,관악구,3,1,1,5,5,0,2018-11-28
8159,서울,관악구,1,0,0,1,1,0,2018-12-28
8160,서울,광진구,0,0,0,0,0,0,2018-01-28
8161,서울,광진구,1,0,1,2,2,0,2018-02-28
8162,서울,광진구,5,0,2,7,3,0,2018-03-28
8163,서울,광진구,3,1,3,7,5,0,2018-04-28
8164,서울,광진구,1,0,0,1,1,0,2018-05-28
8165,서울,광진구,3,1,0,4,3,0,2018-06-28
8166,서울,광진구,0,0,0,0,0,0,2018-07-28
8167,서울,광진구,5,0,1,6,5,0,2018-08-28
8168,서울,광진구,4,0,0,4,4,0,2018-09-28
8169,서울,광진구,2,0,0,2,2,0,2018-10-28
8170,서울,광진구,4,0,4,8,6,0,2018-11-28
8171,서울,광진구,0,0,0,0,0,0,2018-12-28
8172,서울,구로구,7,1,0,8,3,0,2018-01-28
8173,서울,구로구,14,0,3,17,6,0,2018-02-28
8174,서울,구로구,0,0,3,3,3,0,2018-03-28
8175,서울,구로구,0,0,0,0,1,1,2018-04-28
8176,서울,구로구,2,1,0,3,3,0,2018-05-28
8177,서울,구로구,4,0,2,6,5,0,2018-06-28
8178,서울,구로구,11,1,0,12,7,0,2018-07-28
8179,서울,구로구,2,0,1,3,3,0,2018-08-28
8180,서울,구로구,2,1,1,4,4,0,2018-09-28
8181,서울,구로구,3,0,2,5,5,0,2018-10-28
8182,서울,구로구,2,0,2,4,4,0,2018-11-28
8183,서울,구로구,7,0,1,8,5,0,2018-12-28
8184,서울,금천구,3,0,0,3,2,0,2018-01-28
8185,서울,금천구,1,0,0,1,1,0,2018-02-28
8186,서울,금천구,2,0,1,3,3,0,2018-03-28
8187,서울,금천구,1,1,0,2,2,0,2018-04-28
8188,서울,금천구,1,0,0,1,1,0,2018-05-28
8189,서울,금천구,6,0,2,8,3,0,2018-06-28
8190,서울,금천구,1,0,1,2,2,0,2018-07-28
8191,서울,금천구,1,0,0,1,1,0,2018-08-28
8192,서울,금천구,0,0,0,0,0,0,2018-09-28
8193,서울,금천구,0,0,0,0,0,0,2018-10-28
8194,서울,금천구,0,0,0,0,1,1,2018-11-28
8195,서울,금천구,5,0,1,6,4,0,2018-12-28
8196,서울,노원구,7,2,4,13,5,0,2018-01-28
8197,서울,노원구,2,0,0,2,2,0,2018-02-28
8198,서울,노원구,10,0,0,10,7,0,2018-03-28
8199,서울,노원구,3,1,1,5,3,0,2018-04-28
8200,서울,노원구,1,0,0,1,1,0,2018-05-28
8201,서울,노원구,3,0,1,4,3,0,2018-06-28
8202,서울,노원구,2,0,0,2,2,0,2018-07-28
8203,서울,노원구,16,0,2,18,7,0,2018-08-28
8204,서울,노원구,2,0,1,3,3,0,2018-09-28
8205,서울,노원구,1,0,0,1,1,0,2018-10-28
8206,서울,노원구,2,0,0,2,2,0,2018-11-28
8207,서울,노원구,7,0,1,8,7,0,2018-12-28
8208,서울,도봉구,0,0,0,0,0,0,2018-01-28
8209,서울,도봉구,2,0,0,2,2,0,2018-02-28
8210,서울,도봉구,1,1,0,2,2,0,2018-03-28
8211,서울,도봉구,0,1,2,3,3,0,2018-04-28
8212,서울,도봉구,1,0,1,2,2,0,2018-05-28
8213,서울,도봉구,3,0,1,4,4,0,2018-06-28
8214,서울,도봉구,2,0,1,3,3,0,2018-07-28
8215,서울,도봉구,3,1,1,5,3,0,2018-08-28
8216,서울,도봉구,2,0,1,3,3,0,2018-09-28
8217,서울,도봉구,0,0,1,1,1,0,2018-10-28
8218,서울,도봉구,0,0,0,0,0,0,2018-11-28
8219,서울,도봉구,1,0,0,1,1,0,2018-12-28
8220,서울,동대문구,1,1,0,2,2,0,2018-01-28
8221,서울,동대문구,1,1,1,3,3,0,2018-02-28
8222,서울,동대문구,0,0,1,1,1,0,2018-03-28
8223,서울,동대문구,0,0,1,1,1,0,2018-04-28
8224,서울,동대문구,11,1,6,18,4,0,2018-05-28
8225,서울,동대문구,6,0,4,10,8,0,2018-06-28
8226,서울,동대문구,8,0,1,9,8,0,2018-07-28
8227,서울,동대문구,2,0,0,2,2,0,2018-08-28
8228,서울,동대문구,5,1,1,7,5,0,2018-09-28
8229,서울,동대문구,1,2,3,6,7,1,2018-10-28
8230,서울,동대문구,1,0,2,3,3,0,2018-11-28
8231,서울,동대문구,6,0,1,7,5,0,2018-12-28
8232,서울,동작구,3,1,0,4,3,0,2018-01-28
8233,서울,동작구,0,0,0,0,0,0,2018-02-28
8234,서울,동작구,4,0,3,7,5,0,2018-03-28
8235,서울,동작구,4,2,0,6,3,0,2018-04-28
8236,서울,동작구,0,0,0,0,0,0,2018-05-28
8237,서울,동작구,10,0,2,12,9,0,2018-06-28
8238,서울,동작구,2,1,0,3,3,0,2018-07-28
8239,서울,동작구,1,0,1,2,2,0,2018-08-28
8240,서울,동작구,4,0,1,5,4,0,2018-09-28
8241,서울,동작구,3,2,0,5,5,0,2018-10-28
8242,서울,동작구,2,0,2,4,3,0,2018-11-28
8243,서울,동작구,4,1,0,5,5,0,2018-12-28
8244,서울,마포구,9,0,0,9,7,0,2018-01-28
8245,서울,마포구,4,1,0,5,4,0,2018-02-28
8246,서울,마포구,3,0,0,3,2,0,2018-03-28
8247,서울,마포구,6,0,3,9,3,0,2018-04-28
8248,서울,마포구,3,0,1,4,2,0,2018-05-28
8249,서울,마포구,3,1,3,7,7,0,2018-06-28
8250,서울,마포구,7,4,2,13,6,0,2018-07-28
8251,서울,마포구,6,0,1,7,6,0,2018-08-28
8252,서울,마포구,7,1,0,8,7,0,2018-09-28
8253,서울,마포구,4,0,0,4,4,0,2018-10-28
8254,서울,마포구,5,1,3,9,6,0,2018-11-28
8255,서울,마포구,5,0,0,5,5,0,2018-12-28
8256,서울,서대문구,1,0,1,2,1,0,2018-01-28
8257,서울,서대문구,1,0,1,2,2,0,2018-02-28
8258,서울,서대문구,0,0,3,3,2,0,2018-03-28
8259,서울,서대문구,0,2,0,2,2,0,2018-04-28
8260,서울,서대문구,2,0,0,2,2,0,2018-05-28
8261,서울,서대문구,2,0,0,2,1,0,2018-06-28
8262,서울,서대문구,1,0,0,1,1,0,2018-07-28
8263,서울,서대문구,4,0,0,4,2,0,2018-08-28
8264,서울,서대문구,2,0,1,3,3,0,2018-09-28
8265,서울,서대문구,5,0,7,12,6,0,2018-10-28
8266,서울,서대문구,3,1,1,5,3,0,2018-11-28
8267,서울,서대문구,3,0,2,5,5,0,2018-12-28
8268,서울,서초구,4,0,2,6,6,0,2018-01-28
8269,서울,서초구,5,3,2,10,6,0,2018-02-28
8270,서울,서초구,15,0,2,17,10,0,2018-03-28
8271,서울,서초구,7,0,2,9,8,0,2018-04-28
8272,서울,서초구,3,0,2,5,4,0,2018-05-28
8273,서울,서초구,8,3,1,12,9,0,2018-06-28
8274,서울,서초구,3,0,1,4,4,0,2018-07-28
8275,서울,서초구,3,0,0,3,3,0,2018-08-28
8276,서울,서초구,3,0,1,4,4,1,2018-09-28
8277,서울,서초구,6,0,4,10,8,0,2018-10-28
8278,서울,서초구,7,1,3,11,9,0,2018-11-28
8279,서울,서초구,14,0,2,16,10,0,2018-12-28
8280,서울,성동구,1,0,1,2,2,0,2018-01-28
8281,서울,성동구,4,0,0,4,3,0,2018-02-28
8282,서울,성동구,6,0,3,9,5,0,2018-03-28
8283,서울,성동구,1,0,1,2,2,0,2018-04-28
8284,서울,성동구,7,0,3,10,8,0,2018-05-28
8285,서울,성동구,5,0,1,6,4,0,2018-06-28
8286,서울,성동구,5,1,0,6,3,0,2018-07-28
8287,서울,성동구,9,0,1,10,6,0,2018-08-28
8288,서울,성동구,4,0,0,4,4,0,2018-09-28
8289,서울,성동구,2,0,0,2,1,0,2018-10-28
8290,서울,성동구,3,0,1,4,4,0,2018-11-28
8291,서울,성동구,5,0,0,5,2,0,2018-12-28
8292,서울,성북구,4,0,1,5,4,0,2018-01-28
8293,서울,성북구,8,0,4,12,9,0,2018-02-28
8294,서울,성북구,0,0,4,4,4,0,2018-03-28
8295,서울,성북구,6,0,0,6,7,1,2018-04-28
8296,서울,성북구,6,0,2,8,5,0,2018-05-28
8297,서울,성북구,6,0,0,6,4,0,2018-06-28
8298,서울,성북구,0,0,4,4,4,0,2018-07-28
8299,서울,성북구,0,0,0,0,0,0,2018-08-28
8300,서울,성북구,7,0,1,8,7,0,2018-09-28
8301,서울,성북구,3,0,1,4,3,0,2018-10-28
8302,서울,성북구,2,0,1,3,3,0,2018-11-28
8303,서울,성북구,3,0,2,5,5,0,2018-12-28
8304,서울,송파구,4,0,3,7,5,0,2018-01-28
8305,서울,송파구,13,7,6,26,21,0,2018-02-28
8306,서울,송파구,6,1,1,8,7,0,2018-03-28
8307,서울,송파구,5,2,3,10,7,0,2018-04-28
8308,서울,송파구,4,1,2,7,5,0,2018-05-28
8309,서울,송파구,5,3,6,14,5,0,2018-06-28
8310,서울,송파구,17,2,8,27,14,0,2018-07-28
8311,서울,송파구,17,3,5,25,10,0,2018-08-28
8312,서울,송파구,3,0,3,6,3,0,2018-09-28
8313,서울,송파구,5,6,0,11,5,0,2018-10-28
8314,서울,송파구,6,3,4,13,11,0,2018-11-28
8315,서울,송파구,8,0,1,9,8,0,2018-12-28
8316,서울,양천구,1,0,0,1,1,0,2018-01-28
8317,서울,양천구,1,0,0,1,1,0,2018-02-28
8318,서울,양천구,10,0,2,12,9,0,2018-03-28
8319,서울,양천구,5,1,1,7,5,0,2018-04-28
8320,서울,양천구,3,1,1,5,5,0,2018-05-28
8321,서울,양천구,3,0,2,5,4,0,2018-06-28
8322,서울,양천구,1,0,0,1,1,0,2018-07-28
8323,서울,양천구,11,1,1,13,10,0,2018-08-28
8324,서울,양천구,6,1,0,7,5,0,2018-09-28
8325,서울,양천구,9,0,3,12,7,0,2018-10-28
8326,서울,양천구,7,0,1,8,6,0,2018-11-28
8327,서울,양천구,4,0,0,4,3,0,2018-12-28
8328,서울,영등포구,12,0,0,12,6,0,2018-01-28
8329,서울,영등포구,6,1,2,9,7,0,2018-02-28
8330,서울,영등포구,4,1,0,5,5,0,2018-03-28
8331,서울,영등포구,2,1,2,5,4,0,2018-04-28
8332,서울,영등포구,7,1,0,8,5,0,2018-05-28
8333,서울,영등포구,6,2,1,9,7,0,2018-06-28
8334,서울,영등포구,2,1,3,6,5,0,2018-07-28
8335,서울,영등포구,10,1,1,12,8,0,2018-08-28
8336,서울,영등포구,4,0,0,4,4,0,2018-09-28
8337,서울,영등포구,2,0,0,2,2,0,2018-10-28
8338,서울,영등포구,7,1,0,8,7,0,2018-11-28
8339,서울,영등포구,11,1,0,12,6,0,2018-12-28
8340,서울,용산구,3,0,0,3,2,0,2018-01-28
8341,서울,용산구,4,0,4,8,7,0,2018-02-28
8342,서울,용산구,3,1,1,5,3,0,2018-03-28
8343,서울,용산구,10,0,3,13,8,0,2018-04-28
8344,서울,용산구,2,0,0,2,3,1,2018-05-28
8345,서울,용산구,0,0,3,3,3,0,2018-06-28
8346,서울,용산구,4,1,0,5,5,0,2018-07-28
8347,서울,용산구,3,0,0,3,2,0,2018-08-28
8348,서울,용산구,4,0,0,4,3,0,2018-09-28
8349,서울,용산구,7,0,0,7,3,0,2018-10-28
8350,서울,용산구,4,0,3,7,5,0,2018-11-28
8351,서울,용산구,3,0,0,3,1,0,2018-12-28
8352,서울,은평구,0,0,1,1,1,0,2018-01-28
8353,서울,은평구,1,1,2,4,3,0,2018-02-28
8354,서울,은평구,0,0,3,3,3,0,2018-03-28
8355,서울,은평구,4,1,0,5,5,1,2018-04-28
8356,서울,은평구,0,2,1,3,3,0,2018-05-28
8357,서울,은평구,6,1,1,8,4,0,2018-06-28
8358,서울,은평구,2,0,1,3,3,0,2018-07-28
8359,서울,은평구,3,0,1,4,4,0,2018-08-28
8360,서울,은평구,5,1,0,6,6,1,2018-09-28
8361,서울,은평구,4,0,4,8,4,0,2018-10-28
8362,서울,은평구,5,0,1,6,5,0,2018-11-28
8363,서울,은평구,5,2,2,9,3,0,2018-12-28
8364,서울,종로구,2,0,0,2,2,0,2018-01-28
8365,서울,종로구,4,1,1,6,6,0,2018-02-28
8366,서울,종로구,3,0,1,4,4,0,2018-03-28
8367,서울,종로구,2,0,0,2,1,0,2018-04-28
8368,서울,종로구,3,1,0,4,3,0,2018-05-28
8369,서울,종로구,5,0,0,5,4,0,2018-06-28
8370,서울,종로구,2,0,0,2,1,0,2018-07-28
8371,서울,종로구,5,0,2,7,4,0,2018-08-28
8372,서울,종로구,7,1,2,10,4,0,2018-09-28
8373,서울,종로구,7,0,0,7,4,0,2018-10-28
8374,서울,종로구,5,0,0,5,4,0,2018-11-28
8375,서울,종로구,6,0,1,7,7,0,2018-12-28
8376,서울,중구,2,0,1,3,3,0,2018-01-28
8377,서울,중구,6,0,2,8,7,0,2018-02-28
8378,서울,중구,2,2,1,5,4,0,2018-03-28
8379,서울,중구,0,1,0,1,1,0,2018-04-28
8380,서울,중구,1,0,1,2,2,0,2018-05-28
8381,서울,중구,1,0,3,4,4,0,2018-06-28
8382,서울,중구,2,1,1,4,3,0,2018-07-28
8383,서울,중구,3,0,0,3,3,0,2018-08-28
8384,서울,중구,2,0,1,3,3,0,2018-09-28
8385,서울,중구,3,0,0,3,3,0,2018-10-28
8386,서울,중구,0,0,0,0,0,0,2018-11-28
8387,서울,중구,4,0,3,7,5,0,2018-12-28
8388,서울,중랑구,4,0,0,4,3,0,2018-01-28
8389,서울,중랑구,3,3,1,7,7,0,2018-02-28
8390,서울,중랑구,5,0,2,7,6,0,2018-03-28
8391,서울,중랑구,1,1,3,5,5,0,2018-04-28
8392,서울,중랑구,5,0,3,8,7,0,2018-05-28
8393,서울,중랑구,7,0,1,8,6,0,2018-06-28
8394,서울,중랑구,1,0,1,2,2,0,2018-07-28
8395,서울,중랑구,6,1,0,7,7,0,2018-08-28
8396,서울,중랑구,11,1,3,15,5,0,2018-09-28
8397,서울,중랑구,5,3,0,8,7,0,2018-10-28
8398,서울,중랑구,5,0,0,5,4,0,2018-11-28
8399,서울,중랑구,5,1,1,7,5,0,2018-12-28
8400,서울,강남구,19,1,1,21,12,0,2018-01-29
8402,서울,강남구,8,1,3,12,10,0,2018-03-29
8403,서울,강남구,5,1,5,11,9,0,2018-04-29
8404,서울,강남구,9,1,6,16,12,0,2018-05-29
8405,서울,강남구,14,3,1,18,11,0,2018-06-29
8406,서울,강남구,7,2,3,12,8,0,2018-07-29
8407,서울,강남구,8,0,2,10,6,0,2018-08-29
8408,서울,강남구,16,1,6,23,15,0,2018-09-29
8409,서울,강남구,10,3,2,15,10,2,2018-10-29
8410,서울,강남구,9,1,1,11,10,0,2018-11-29
8411,서울,강남구,10,0,4,14,9,0,2018-12-29
8412,서울,강동구,5,0,0,5,5,0,2018-01-29
8414,서울,강동구,7,0,2,9,5,0,2018-03-29
8415,서울,강동구,2,0,1,3,3,0,2018-04-29
8416,서울,강동구,7,1,3,11,4,0,2018-05-29
8417,서울,강동구,2,3,1,6,4,0,2018-06-29
8418,서울,강동구,3,0,1,4,2,0,2018-07-29
8419,서울,강동구,3,1,0,4,4,0,2018-08-29
8420,서울,강동구,5,0,1,6,1,0,2018-09-29
8421,서울,강동구,5,1,2,8,6,0,2018-10-29
8422,서울,강동구,2,2,1,5,4,0,2018-11-29
8423,서울,강동구,1,0,1,2,2,0,2018-12-29
8424,서울,강북구,0,1,1,2,2,0,2018-01-29
8426,서울,강북구,0,0,2,2,2,0,2018-03-29
8427,서울,강북구,2,0,0,2,2,0,2018-04-29
8428,서울,강북구,9,0,1,10,9,0,2018-05-29
8429,서울,강북구,4,0,0,4,3,0,2018-06-29
8430,서울,강북구,1,0,0,1,1,0,2018-07-29
8431,서울,강북구,0,0,2,2,2,0,2018-08-29
8432,서울,강북구,0,0,1,1,1,0,2018-09-29
8433,서울,강북구,2,0,0,2,1,0,2018-10-29
8434,서울,강북구,1,0,0,1,1,0,2018-11-29
8435,서울,강북구,1,0,0,1,1,0,2018-12-29
8436,서울,강서구,6,2,0,8,7,0,2018-01-29
8438,서울,강서구,5,0,0,5,4,0,2018-03-29
8439,서울,강서구,3,0,1,4,3,0,2018-04-29
8440,서울,강서구,1,0,4,5,3,0,2018-05-29
8441,서울,강서구,2,0,2,4,4,0,2018-06-29
8442,서울,강서구,0,1,2,3,3,0,2018-07-29
8443,서울,강서구,6,0,0,6,6,0,2018-08-29
8444,서울,강서구,13,0,1,14,5,0,2018-09-29
8445,서울,강서구,2,0,0,2,2,0,2018-10-29
8446,서울,강서구,6,0,2,8,7,0,2018-11-29
8447,서울,강서구,4,0,1,5,2,0,2018-12-29
8448,서울,관악구,1,0,1,2,2,0,2018-01-29
8450,서울,관악구,6,0,3,9,8,0,2018-03-29
8451,서울,관악구,8,0,0,8,5,0,2018-04-29
8452,서울,관악구,2,0,1,3,2,0,2018-05-29
8453,서울,관악구,2,1,0,3,3,0,2018-06-29
8454,서울,관악구,0,0,1,1,1,0,2018-07-29
8455,서울,관악구,1,1,0,2,2,0,2018-08-29
8456,서울,관악구,3,0,0,3,3,1,2018-09-29
8457,서울,관악구,6,1,0,7,5,0,2018-10-29
8458,서울,관악구,5,0,1,6,5,0,2018-11-29
8459,서울,관악구,2,0,0,2,2,0,2018-12-29
8460,서울,광진구,3,0,0,3,3,1,2018-01-29
8462,서울,광진구,2,0,0,2,1,0,2018-03-29
8463,서울,광진구,1,0,1,2,2,0,2018-04-29
8464,서울,광진구,3,0,1,4,4,0,2018-05-29
8465,서울,광진구,1,0,0,1,1,0,2018-06-29
8466,서울,광진구,9,0,0,9,6,0,2018-07-29
8467,서울,광진구,0,0,2,2,2,0,2018-08-29
8468,서울,광진구,6,0,0,6,4,0,2018-09-29
8469,서울,광진구,0,0,2,2,2,0,2018-10-29
8470,서울,광진구,1,0,2,3,3,0,2018-11-29
8471,서울,광진구,3,0,0,3,2,0,2018-12-29
8472,서울,구로구,2,0,2,4,3,0,2018-01-29
8474,서울,구로구,3,0,3,6,5,0,2018-03-29
8475,서울,구로구,2,0,0,2,1,0,2018-04-29
8476,서울,구로구,6,0,2,8,6,0,2018-05-29
8477,서울,구로구,4,0,0,4,4,0,2018-06-29
8478,서울,구로구,2,0,0,2,2,0,2018-07-29
8479,서울,구로구,6,0,2,8,6,0,2018-08-29
8480,서울,구로구,10,1,2,13,7,0,2018-09-29
8481,서울,구로구,3,0,0,3,3,0,2018-10-29
8482,서울,구로구,0,1,0,1,1,0,2018-11-29
8483,서울,구로구,3,0,0,3,3,0,2018-12-29
8484,서울,금천구,2,0,1,3,3,0,2018-01-29
8486,서울,금천구,6,0,1,7,4,0,2018-03-29
8487,서울,금천구,1,0,1,2,2,0,2018-04-29
8488,서울,금천구,3,0,0,3,2,0,2018-05-29
8489,서울,금천구,2,0,1,3,3,0,2018-06-29
8490,서울,금천구,3,0,0,3,1,0,2018-07-29
8491,서울,금천구,3,0,0,3,2,0,2018-08-29
8492,서울,금천구,4,0,3,7,5,0,2018-09-29
8493,서울,금천구,7,0,0,7,5,0,2018-10-29
8494,서울,금천구,3,0,0,3,3,0,2018-11-29
8495,서울,금천구,1,0,1,2,2,0,2018-12-29
8496,서울,노원구,2,1,1,4,4,0,2018-01-29
8498,서울,노원구,5,0,0,5,3,0,2018-03-29
8499,서울,노원구,2,1,0,3,2,0,2018-04-29
8500,서울,노원구,10,0,5,15,12,0,2018-05-29
8501,서울,노원구,6,0,2,8,7,0,2018-06-29
8502,서울,노원구,1,0,2,3,2,0,2018-07-29
8503,서울,노원구,4,0,6,10,5,0,2018-08-29
8504,서울,노원구,6,0,3,9,4,0,2018-09-29
8505,서울,노원구,5,0,2,7,4,0,2018-10-29
8506,서울,노원구,5,0,0,5,4,0,2018-11-29
8507,서울,노원구,1,1,1,3,3,0,2018-12-29
8508,서울,도봉구,1,0,1,2,2,0,2018-01-29
8510,서울,도봉구,2,1,3,6,5,0,2018-03-29
8511,서울,도봉구,0,0,1,1,1,0,2018-04-29
8512,서울,도봉구,2,0,0,2,2,0,2018-05-29
8513,서울,도봉구,0,0,0,0,0,0,2018-06-29
8514,서울,도봉구,1,1,1,3,3,0,2018-07-29
8515,서울,도봉구,4,0,1,5,3,0,2018-08-29
8516,서울,도봉구,5,0,1,6,5,0,2018-09-29
8517,서울,도봉구,1,0,1,2,2,0,2018-10-29
8518,서울,도봉구,1,0,1,2,2,0,2018-11-29
8519,서울,도봉구,5,1,0,6,3,0,2018-12-29
8520,서울,동대문구,6,0,1,7,5,0,2018-01-29
8522,서울,동대문구,11,0,5,16,10,0,2018-03-29
8523,서울,동대문구,4,0,2,6,4,0,2018-04-29
8524,서울,동대문구,5,0,0,5,5,0,2018-05-29
8525,서울,동대문구,1,0,0,1,1,0,2018-06-29
8526,서울,동대문구,5,0,0,5,4,0,2018-07-29
8527,서울,동대문구,1,1,3,5,3,0,2018-08-29
8528,서울,동대문구,6,0,4,10,6,0,2018-09-29
8529,서울,동대문구,4,0,3,7,7,0,2018-10-29
8530,서울,동대문구,5,0,2,7,6,0,2018-11-29
8531,서울,동대문구,2,1,1,4,3,0,2018-12-29
8532,서울,동작구,4,1,0,5,3,0,2018-01-29
8534,서울,동작구,0,1,0,1,1,0,2018-03-29
8535,서울,동작구,0,0,1,1,1,0,2018-04-29
8536,서울,동작구,6,0,1,7,6,0,2018-05-29
8537,서울,동작구,6,1,0,7,5,0,2018-06-29
8538,서울,동작구,1,0,1,2,2,0,2018-07-29
8539,서울,동작구,2,0,1,3,3,0,2018-08-29
8540,서울,동작구,3,2,4,9,5,0,2018-09-29
8541,서울,동작구,4,0,1,5,4,0,2018-10-29
8542,서울,동작구,4,0,2,6,6,0,2018-11-29
8543,서울,동작구,2,0,1,3,2,0,2018-12-29
8544,서울,마포구,3,0,1,4,3,0,2018-01-29
8546,서울,마포구,2,0,1,3,2,0,2018-03-29
8547,서울,마포구,2,0,1,3,2,0,2018-04-29
8548,서울,마포구,4,3,1,8,4,0,2018-05-29
8549,서울,마포구,7,0,4,11,8,0,2018-06-29
8550,서울,마포구,9,7,4,20,6,0,2018-07-29
8551,서울,마포구,2,0,1,3,3,0,2018-08-29
8552,서울,마포구,14,1,3,18,9,0,2018-09-29
8553,서울,마포구,1,0,1,2,2,0,2018-10-29
8554,서울,마포구,5,0,0,5,5,0,2018-11-29
8555,서울,마포구,4,0,1,5,2,0,2018-12-29
8556,서울,서대문구,1,1,1,3,3,0,2018-01-29
8558,서울,서대문구,3,1,0,4,3,0,2018-03-29
8559,서울,서대문구,0,2,0,2,1,0,2018-04-29
8560,서울,서대문구,2,0,0,2,1,0,2018-05-29
8561,서울,서대문구,2,2,1,5,5,0,2018-06-29
8562,서울,서대문구,1,0,0,1,1,0,2018-07-29
8563,서울,서대문구,0,2,1,3,2,0,2018-08-29
8564,서울,서대문구,0,0,0,0,0,0,2018-09-29
8565,서울,서대문구,4,0,1,5,5,0,2018-10-29
8566,서울,서대문구,8,1,0,9,4,0,2018-11-29
8567,서울,서대문구,3,0,0,3,2,0,2018-12-29
8568,서울,서초구,10,0,0,10,10,0,2018-01-29
8570,서울,서초구,8,0,1,9,8,0,2018-03-29
8571,서울,서초구,5,1,3,9,7,0,2018-04-29
8572,서울,서초구,6,1,3,10,8,0,2018-05-29
8573,서울,서초구,6,0,2,8,7,0,2018-06-29
8574,서울,서초구,3,1,0,4,1,0,2018-07-29
8575,서울,서초구,6,1,3,10,9,0,2018-08-29
8576,서울,서초구,4,0,1,5,5,0,2018-09-29
8577,서울,서초구,2,0,2,4,4,0,2018-10-29
8578,서울,서초구,19,7,7,33,16,1,2018-11-29
8579,서울,서초구,10,0,2,12,9,0,2018-12-29
8580,서울,성동구,5,0,1,6,2,0,2018-01-29
8582,서울,성동구,2,0,2,4,4,0,2018-03-29
8583,서울,성동구,0,1,0,1,1,0,2018-04-29
8584,서울,성동구,0,1,0,1,1,0,2018-05-29
8585,서울,성동구,2,1,2,5,4,0,2018-06-29
8586,서울,성동구,1,0,0,1,1,0,2018-07-29
8587,서울,성동구,2,0,0,2,1,0,2018-08-29
8588,서울,성동구,4,0,3,7,5,0,2018-09-29
8589,서울,성동구,8,0,5,13,9,0,2018-10-29
8590,서울,성동구,4,0,0,4,5,1,2018-11-29
8591,서울,성동구,3,0,0,3,3,0,2018-12-29
8592,서울,성북구,1,0,2,3,3,0,2018-01-29
8594,서울,성북구,10,0,2,12,7,0,2018-03-29
8595,서울,성북구,0,1,1,2,2,0,2018-04-29
8596,서울,성북구,1,0,0,1,1,0,2018-05-29
8597,서울,성북구,4,0,0,4,3,0,2018-06-29
8598,서울,성북구,3,0,0,3,3,0,2018-07-29
8599,서울,성북구,5,0,0,5,3,0,2018-08-29
8600,서울,성북구,0,0,0,0,0,0,2018-09-29
8601,서울,성북구,0,0,0,0,1,1,2018-10-29
8602,서울,성북구,4,0,0,4,3,0,2018-11-29
8603,서울,성북구,3,0,0,3,2,0,2018-12-29
8604,서울,송파구,14,0,0,14,10,0,2018-01-29
8606,서울,송파구,17,1,2,20,12,0,2018-03-29
8607,서울,송파구,8,1,1,10,6,0,2018-04-29
8608,서울,송파구,8,2,3,13,11,0,2018-05-29
8609,서울,송파구,6,1,2,9,7,0,2018-06-29
8610,서울,송파구,7,6,5,18,11,0,2018-07-29
8611,서울,송파구,7,1,0,8,5,0,2018-08-29
8612,서울,송파구,7,0,0,7,6,0,2018-09-29
8613,서울,송파구,4,2,4,10,10,0,2018-10-29
8614,서울,송파구,8,1,2,11,8,0,2018-11-29
8615,서울,송파구,7,1,1,9,6,0,2018-12-29
8616,서울,양천구,1,0,1,2,2,0,2018-01-29
8618,서울,양천구,0,0,0,0,0,0,2018-03-29
8619,서울,양천구,2,0,1,3,3,0,2018-04-29
8620,서울,양천구,3,0,0,3,3,0,2018-05-29
8621,서울,양천구,3,0,3,6,6,0,2018-06-29
8622,서울,양천구,1,1,3,5,4,0,2018-07-29
8623,서울,양천구,13,1,4,18,8,0,2018-08-29
8624,서울,양천구,3,1,2,6,4,0,2018-09-29
8625,서울,양천구,6,0,0,6,5,0,2018-10-29
8626,서울,양천구,2,0,0,2,2,0,2018-11-29
8627,서울,양천구,0,0,0,0,0,0,2018-12-29
8628,서울,영등포구,8,1,5,14,5,0,2018-01-29
8630,서울,영등포구,8,0,4,12,11,0,2018-03-29
8631,서울,영등포구,3,1,2,6,4,0,2018-04-29
8632,서울,영등포구,10,1,5,16,11,0,2018-05-29
8633,서울,영등포구,9,2,0,11,9,0,2018-06-29
8634,서울,영등포구,8,0,0,8,3,0,2018-07-29
8635,서울,영등포구,5,2,0,7,8,1,2018-08-29
8636,서울,영등포구,7,0,2,9,6,0,2018-09-29
8637,서울,영등포구,6,0,2,8,6,1,2018-10-29
8638,서울,영등포구,4,1,3,8,6,0,2018-11-29
8639,서울,영등포구,12,0,7,19,9,0,2018-12-29
8640,서울,용산구,3,1,2,6,3,0,2018-01-29
8642,서울,용산구,3,1,2,6,4,0,2018-03-29
8643,서울,용산구,3,0,2,5,5,0,2018-04-29
8644,서울,용산구,6,1,1,8,4,0,2018-05-29
8645,서울,용산구,4,0,0,4,4,0,2018-06-29
8646,서울,용산구,2,0,4,6,3,0,2018-07-29
8647,서울,용산구,7,0,1,8,5,0,2018-08-29
8648,서울,용산구,2,0,2,4,4,0,2018-09-29
8649,서울,용산구,3,0,4,7,4,0,2018-10-29
8650,서울,용산구,3,0,0,3,3,0,2018-11-29
8651,서울,용산구,1,0,0,1,1,0,2018-12-29
8652,서울,은평구,2,0,2,4,4,0,2018-01-29
8654,서울,은평구,1,0,1,2,2,0,2018-03-29
8655,서울,은평구,1,0,0,1,1,0,2018-04-29
8656,서울,은평구,3,0,0,3,3,0,2018-05-29
8657,서울,은평구,5,0,0,5,4,0,2018-06-29
8658,서울,은평구,1,0,1,2,2,0,2018-07-29
8659,서울,은평구,3,1,1,5,5,0,2018-08-29
8660,서울,은평구,5,0,0,5,3,0,2018-09-29
8661,서울,은평구,1,1,1,3,3,0,2018-10-29
8662,서울,은평구,1,0,2,3,3,0,2018-11-29
8663,서울,은평구,4,0,1,5,4,0,2018-12-29
8664,서울,종로구,3,0,0,3,3,0,2018-01-29
8666,서울,종로구,3,0,2,5,4,0,2018-03-29
8667,서울,종로구,3,0,0,3,3,0,2018-04-29
8668,서울,종로구,3,1,3,7,7,0,2018-05-29
8669,서울,종로구,3,0,2,5,3,0,2018-06-29
8670,서울,종로구,7,0,2,9,1,0,2018-07-29
8671,서울,종로구,2,2,0,4,4,0,2018-08-29
8672,서울,종로구,10,1,3,14,8,0,2018-09-29
8673,서울,종로구,0,0,0,0,0,0,2018-10-29
8674,서울,종로구,0,0,0,0,0,0,2018-11-29
8675,서울,종로구,2,0,1,3,2,0,2018-12-29
8676,서울,중구,0,1,1,2,2,0,2018-01-29
8678,서울,중구,2,1,0,3,2,0,2018-03-29
8679,서울,중구,0,0,0,0,0,0,2018-04-29
8680,서울,중구,0,0,5,5,3,0,2018-05-29
8681,서울,중구,3,0,0,3,2,0,2018-06-29
8682,서울,중구,3,1,1,5,3,0,2018-07-29
8683,서울,중구,2,0,0,2,1,0,2018-08-29
8684,서울,중구,1,1,2,4,3,0,2018-09-29
8685,서울,중구,3,0,1,4,3,0,2018-10-29
8686,서울,중구,6,0,0,6,4,0,2018-11-29
8687,서울,중구,2,2,4,8,5,1,2018-12-29
8688,서울,중랑구,3,0,1,4,3,0,2018-01-29
8690,서울,중랑구,3,1,1,5,5,0,2018-03-29
8691,서울,중랑구,3,0,1,4,3,0,2018-04-29
8692,서울,중랑구,2,0,0,2,2,0,2018-05-29
8693,서울,중랑구,1,1,1,3,3,0,2018-06-29
8694,서울,중랑구,2,0,1,3,3,0,2018-07-29
8695,서울,중랑구,6,0,2,8,5,0,2018-08-29
8696,서울,중랑구,2,0,1,3,3,0,2018-09-29
8697,서울,중랑구,8,0,0,8,4,0,2018-10-29
8698,서울,중랑구,5,1,2,8,5,1,2018-11-29
8699,서울,중랑구,7,0,2,9,7,0,2018-12-29
8700,서울,강남구,14,0,3,17,14,0,2018-01-30
8702,서울,강남구,3,4,3,10,7,0,2018-03-30
8703,서울,강남구,6,1,0,7,7,0,2018-04-30
8704,서울,강남구,9,3,7,19,16,0,2018-05-30
8705,서울,강남구,11,0,4,15,7,0,2018-06-30
8706,서울,강남구,15,0,5,20,16,0,2018-07-30
8707,서울,강남구,10,2,0,12,8,1,2018-08-30
8708,서울,강남구,9,2,2,13,8,1,2018-09-30
8709,서울,강남구,10,1,5,16,14,0,2018-10-30
8710,서울,강남구,11,1,2,14,11,0,2018-11-30
8711,서울,강남구,19,6,0,25,8,0,2018-12-30
8712,서울,강동구,4,0,1,5,4,0,2018-01-30
8714,서울,강동구,1,1,3,5,5,0,2018-03-30
8715,서울,강동구,1,1,2,4,2,0,2018-04-30
8716,서울,강동구,2,0,0,2,1,0,2018-05-30
8717,서울,강동구,2,0,1,3,2,0,2018-06-30
8718,서울,강동구,3,1,0,4,2,0,2018-07-30
8719,서울,강동구,3,0,0,3,3,0,2018-08-30
8720,서울,강동구,2,1,0,3,3,0,2018-09-30
8721,서울,강동구,8,0,2,10,8,0,2018-10-30
8722,서울,강동구,0,0,1,1,1,0,2018-11-30
8723,서울,강동구,2,0,0,2,2,0,2018-12-30
8724,서울,강북구,4,0,0,4,4,0,2018-01-30
8726,서울,강북구,5,0,2,7,5,0,2018-03-30
8727,서울,강북구,1,0,1,2,2,0,2018-04-30
8728,서울,강북구,3,0,1,4,4,0,2018-05-30
8729,서울,강북구,2,0,0,2,2,0,2018-06-30
8730,서울,강북구,1,0,0,1,1,0,2018-07-30
8731,서울,강북구,0,1,2,3,2,0,2018-08-30
8732,서울,강북구,2,1,0,3,3,0,2018-09-30
8733,서울,강북구,6,0,1,7,7,1,2018-10-30
8734,서울,강북구,2,1,0,3,3,0,2018-11-30
8735,서울,강북구,7,1,7,15,8,1,2018-12-30
8736,서울,강서구,24,0,3,27,4,0,2018-01-30
8738,서울,강서구,7,0,5,12,6,0,2018-03-30
8739,서울,강서구,5,1,1,7,6,0,2018-04-30
8740,서울,강서구,3,0,1,4,4,1,2018-05-30
8741,서울,강서구,9,0,2,11,7,1,2018-06-30
8742,서울,강서구,4,0,3,7,6,0,2018-07-30
8743,서울,강서구,2,0,1,3,3,0,2018-08-30
8744,서울,강서구,8,0,1,9,4,0,2018-09-30
8745,서울,강서구,3,0,1,4,4,0,2018-10-30
8746,서울,강서구,5,0,1,6,4,0,2018-11-30
8747,서울,강서구,8,2,0,10,6,0,2018-12-30
8748,서울,관악구,3,1,2,6,5,0,2018-01-30
8750,서울,관악구,2,1,1,4,3,0,2018-03-30
8751,서울,관악구,2,1,0,3,3,0,2018-04-30
8752,서울,관악구,3,0,0,3,3,0,2018-05-30
8753,서울,관악구,2,0,1,3,2,0,2018-06-30
8754,서울,관악구,7,0,1,8,5,0,2018-07-30
8755,서울,관악구,3,0,0,3,2,0,2018-08-30
8756,서울,관악구,1,0,1,2,2,0,2018-09-30
8757,서울,관악구,5,1,1,7,6,0,2018-10-30
8758,서울,관악구,1,0,0,1,1,0,2018-11-30
8759,서울,관악구,2,0,3,5,4,0,2018-12-30
8760,서울,광진구,5,0,1,6,4,0,2018-01-30
8762,서울,광진구,3,0,0,3,3,0,2018-03-30
8763,서울,광진구,0,0,2,2,2,0,2018-04-30
8764,서울,광진구,0,0,0,0,0,0,2018-05-30
8765,서울,광진구,3,0,0,3,2,0,2018-06-30
8766,서울,광진구,2,0,0,2,2,0,2018-07-30
8767,서울,광진구,3,0,1,4,4,0,2018-08-30
8768,서울,광진구,0,1,1,2,2,0,2018-09-30
8769,서울,광진구,1,0,1,2,1,0,2018-10-30
8770,서울,광진구,10,0,1,11,5,0,2018-11-30
8771,서울,광진구,0,0,0,0,0,0,2018-12-30
8772,서울,구로구,1,0,1,2,2,0,2018-01-30
8774,서울,구로구,5,1,1,7,7,0,2018-03-30
8775,서울,구로구,5,3,0,8,4,0,2018-04-30
8776,서울,구로구,6,0,3,9,6,0,2018-05-30
8777,서울,구로구,4,0,0,4,3,0,2018-06-30
8778,서울,구로구,6,0,0,6,5,0,2018-07-30
8779,서울,구로구,1,0,1,2,2,0,2018-08-30
8780,서울,구로구,15,1,2,18,6,0,2018-09-30
8781,서울,구로구,2,1,0,3,2,0,2018-10-30
8782,서울,구로구,8,0,1,9,8,0,2018-11-30
8783,서울,구로구,2,0,0,2,1,0,2018-12-30
8784,서울,금천구,0,1,0,1,1,0,2018-01-30
8786,서울,금천구,1,0,0,1,1,0,2018-03-30
8787,서울,금천구,7,0,0,7,7,0,2018-04-30
8788,서울,금천구,0,0,0,0,0,0,2018-05-30
8789,서울,금천구,1,0,0,1,1,0,2018-06-30
8790,서울,금천구,0,0,0,0,0,0,2018-07-30
8791,서울,금천구,3,0,0,3,3,0,2018-08-30
8792,서울,금천구,7,0,0,7,2,0,2018-09-30
8793,서울,금천구,7,0,2,9,5,0,2018-10-30
8794,서울,금천구,2,0,1,3,3,0,2018-11-30
8795,서울,금천구,5,0,1,6,4,0,2018-12-30
8796,서울,노원구,8,0,1,9,7,0,2018-01-30
8798,서울,노원구,7,0,0,7,3,0,2018-03-30
8799,서울,노원구,3,0,3,6,6,0,2018-04-30
8800,서울,노원구,1,2,1,4,4,0,2018-05-30
8801,서울,노원구,5,0,0,5,4,0,2018-06-30
8802,서울,노원구,3,1,1,5,5,0,2018-07-30
8803,서울,노원구,5,0,0,5,4,0,2018-08-30
8804,서울,노원구,6,0,2,8,5,0,2018-09-30
8805,서울,노원구,2,0,2,4,4,0,2018-10-30
8806,서울,노원구,3,0,1,4,3,0,2018-11-30
8807,서울,노원구,5,0,1,6,3,0,2018-12-30
8808,서울,도봉구,0,0,0,0,0,0,2018-01-30
8810,서울,도봉구,1,0,2,3,3,0,2018-03-30
8811,서울,도봉구,3,1,1,5,4,0,2018-04-30
8812,서울,도봉구,0,0,0,0,0,0,2018-05-30
8813,서울,도봉구,1,1,0,2,1,0,2018-06-30
8814,서울,도봉구,1,1,2,4,4,0,2018-07-30
8815,서울,도봉구,1,1,0,2,1,0,2018-08-30
8816,서울,도봉구,0,0,1,1,1,0,2018-09-30
8817,서울,도봉구,6,1,0,7,2,0,2018-10-30
8818,서울,도봉구,3,0,1,4,2,0,2018-11-30
8819,서울,도봉구,0,0,2,2,2,0,2018-12-30
8820,서울,동대문구,3,0,0,3,3,0,2018-01-30
8822,서울,동대문구,4,0,0,4,2,0,2018-03-30
8823,서울,동대문구,1,0,0,1,1,0,2018-04-30
8824,서울,동대문구,3,0,3,6,6,0,2018-05-30
8825,서울,동대문구,2,1,1,4,4,0,2018-06-30
8826,서울,동대문구,3,0,1,4,3,0,2018-07-30
8827,서울,동대문구,1,0,1,2,1,0,2018-08-30
8828,서울,동대문구,2,1,0,3,4,1,2018-09-30
8829,서울,동대문구,2,0,2,4,3,0,2018-10-30
8830,서울,동대문구,5,1,0,6,5,0,2018-11-30
8831,서울,동대문구,1,0,1,2,1,0,2018-12-30
8832,서울,동작구,7,0,0,7,4,0,2018-01-30
8834,서울,동작구,0,0,2,2,1,0,2018-03-30
8835,서울,동작구,0,0,2,2,2,0,2018-04-30
8836,서울,동작구,4,3,0,7,3,0,2018-05-30
8837,서울,동작구,3,1,1,5,5,0,2018-06-30
8838,서울,동작구,1,1,0,2,2,0,2018-07-30
8839,서울,동작구,5,0,2,7,5,0,2018-08-30
8840,서울,동작구,3,1,0,4,3,0,2018-09-30
8841,서울,동작구,1,1,2,4,4,0,2018-10-30
8842,서울,동작구,7,2,4,13,9,0,2018-11-30
8843,서울,동작구,1,0,0,1,1,0,2018-12-30
8844,서울,마포구,8,0,2,10,6,0,2018-01-30
8846,서울,마포구,0,0,0,0,0,0,2018-03-30
8847,서울,마포구,1,0,1,2,2,0,2018-04-30
8848,서울,마포구,5,0,1,6,4,0,2018-05-30
8849,서울,마포구,3,1,1,5,4,0,2018-06-30
8850,서울,마포구,3,3,1,7,5,0,2018-07-30
8851,서울,마포구,7,0,1,8,4,0,2018-08-30
8852,서울,마포구,7,2,0,9,7,0,2018-09-30
8853,서울,마포구,6,1,0,7,4,0,2018-10-30
8854,서울,마포구,8,1,4,13,7,0,2018-11-30
8855,서울,마포구,6,2,1,9,5,0,2018-12-30
8856,서울,서대문구,1,1,1,3,2,0,2018-01-30
8858,서울,서대문구,1,0,0,1,1,0,2018-03-30
8859,서울,서대문구,3,2,3,8,8,0,2018-04-30
8860,서울,서대문구,3,0,0,3,3,0,2018-05-30
8861,서울,서대문구,0,0,0,0,0,0,2018-06-30
8862,서울,서대문구,0,0,2,2,2,0,2018-07-30
8863,서울,서대문구,4,0,0,4,3,0,2018-08-30
8864,서울,서대문구,0,0,1,1,1,0,2018-09-30
8865,서울,서대문구,1,1,1,3,2,0,2018-10-30
8866,서울,서대문구,2,0,2,4,3,0,2018-11-30
8867,서울,서대문구,0,1,1,2,2,0,2018-12-30
8868,서울,서초구,5,1,2,8,6,0,2018-01-30
8870,서울,서초구,11,1,4,16,10,0,2018-03-30
8871,서울,서초구,5,0,0,5,5,0,2018-04-30
8872,서울,서초구,6,1,2,9,7,0,2018-05-30
8873,서울,서초구,1,0,1,2,2,0,2018-06-30
8874,서울,서초구,12,1,8,21,13,0,2018-07-30
8875,서울,서초구,6,2,0,8,6,0,2018-08-30
8876,서울,서초구,6,1,2,9,6,0,2018-09-30
8877,서울,서초구,11,3,2,16,13,0,2018-10-30
8878,서울,서초구,1,1,3,5,4,0,2018-11-30
8879,서울,서초구,1,0,0,1,2,1,2018-12-30
8880,서울,성동구,3,0,1,4,3,0,2018-01-30
8882,서울,성동구,2,0,4,6,6,0,2018-03-30
8883,서울,성동구,4,0,0,4,3,0,2018-04-30
8884,서울,성동구,3,0,0,3,3,0,2018-05-30
8885,서울,성동구,2,0,0,2,2,0,2018-06-30
8886,서울,성동구,2,0,2,4,2,0,2018-07-30
8887,서울,성동구,0,0,1,1,1,0,2018-08-30
8888,서울,성동구,0,0,0,0,0,0,2018-09-30
8889,서울,성동구,2,1,2,5,4,0,2018-10-30
8890,서울,성동구,9,0,2,11,7,0,2018-11-30
8891,서울,성동구,0,0,0,0,0,0,2018-12-30
8892,서울,성북구,7,2,1,10,8,0,2018-01-30
8894,서울,성북구,5,0,1,6,4,0,2018-03-30
8895,서울,성북구,3,0,3,6,2,0,2018-04-30
8896,서울,성북구,4,0,0,4,4,0,2018-05-30
8897,서울,성북구,6,0,0,6,4,0,2018-06-30
8898,서울,성북구,3,0,2,5,3,0,2018-07-30
8899,서울,성북구,4,0,0,4,1,0,2018-08-30
8900,서울,성북구,2,0,4,6,5,0,2018-09-30
8901,서울,성북구,4,0,2,6,6,0,2018-10-30
8902,서울,성북구,1,0,1,2,2,0,2018-11-30
8903,서울,성북구,1,0,0,1,1,0,2018-12-30
8904,서울,송파구,4,1,4,9,9,0,2018-01-30
8906,서울,송파구,6,1,3,10,8,0,2018-03-30
8907,서울,송파구,7,2,0,9,8,0,2018-04-30
8908,서울,송파구,13,2,8,23,13,1,2018-05-30
8909,서울,송파구,8,1,4,13,9,0,2018-06-30
8910,서울,송파구,10,2,6,18,13,1,2018-07-30
8911,서울,송파구,3,0,1,4,4,0,2018-08-30
8912,서울,송파구,4,0,2,6,4,0,2018-09-30
8913,서울,송파구,14,1,1,16,13,0,2018-10-30
8914,서울,송파구,23,1,1,25,19,0,2018-11-30
8915,서울,송파구,2,0,0,2,2,0,2018-12-30
8916,서울,양천구,27,6,5,38,5,0,2018-01-30
8918,서울,양천구,5,1,3,9,7,0,2018-03-30
8919,서울,양천구,5,0,3,8,6,0,2018-04-30
8920,서울,양천구,9,0,0,9,5,0,2018-05-30
8921,서울,양천구,3,5,0,8,4,0,2018-06-30
8922,서울,양천구,2,0,1,3,2,0,2018-07-30
8923,서울,양천구,1,1,0,2,2,0,2018-08-30
8924,서울,양천구,2,0,0,2,2,0,2018-09-30
8925,서울,양천구,4,0,2,6,4,0,2018-10-30
8926,서울,양천구,4,0,0,4,4,0,2018-11-30
8927,서울,양천구,2,0,0,2,2,0,2018-12-30
8928,서울,영등포구,5,0,5,10,4,0,2018-01-30
8930,서울,영등포구,8,1,4,13,7,0,2018-03-30
8931,서울,영등포구,3,0,3,6,6,0,2018-04-30
8932,서울,영등포구,4,0,2,6,6,0,2018-05-30
8933,서울,영등포구,8,0,1,9,5,0,2018-06-30
8934,서울,영등포구,7,2,1,10,7,0,2018-07-30
8935,서울,영등포구,9,1,0,10,8,0,2018-08-30
8936,서울,영등포구,2,1,1,4,4,0,2018-09-30
8937,서울,영등포구,7,0,2,9,7,0,2018-10-30
8938,서울,영등포구,11,3,0,14,9,0,2018-11-30
8939,서울,영등포구,1,2,1,4,4,0,2018-12-30
8940,서울,용산구,0,0,2,2,2,0,2018-01-30
8942,서울,용산구,2,0,3,5,4,0,2018-03-30
8943,서울,용산구,4,0,1,5,4,0,2018-04-30
8944,서울,용산구,4,0,1,5,4,0,2018-05-30
8945,서울,용산구,1,0,2,3,4,1,2018-06-30
8946,서울,용산구,5,0,1,6,3,0,2018-07-30
8947,서울,용산구,2,0,1,3,3,0,2018-08-30
8948,서울,용산구,3,0,0,3,3,0,2018-09-30
8949,서울,용산구,6,0,3,9,7,0,2018-10-30
8950,서울,용산구,5,2,3,10,9,0,2018-11-30
8951,서울,용산구,5,0,3,8,3,0,2018-12-30
8952,서울,은평구,3,1,1,5,3,0,2018-01-30
8954,서울,은평구,1,0,0,1,1,0,2018-03-30
8955,서울,은평구,2,0,2,4,4,0,2018-04-30
8956,서울,은평구,0,0,0,0,0,0,2018-05-30
8957,서울,은평구,3,0,0,3,3,0,2018-06-30
8958,서울,은평구,2,1,2,5,4,0,2018-07-30
8959,서울,은평구,2,0,1,3,3,0,2018-08-30
8960,서울,은평구,3,1,0,4,4,0,2018-09-30
8961,서울,은평구,7,0,0,7,4,0,2018-10-30
8962,서울,은평구,1,0,3,4,3,0,2018-11-30
8963,서울,은평구,5,0,6,11,4,0,2018-12-30
8964,서울,종로구,1,1,0,2,2,0,2018-01-30
8966,서울,종로구,5,10,1,16,4,0,2018-03-30
8967,서울,종로구,3,0,0,3,1,0,2018-04-30
8968,서울,종로구,3,1,0,4,4,0,2018-05-30
8969,서울,종로구,4,0,0,4,3,0,2018-06-30
8970,서울,종로구,5,0,2,7,4,0,2018-07-30
8971,서울,종로구,3,0,1,4,3,0,2018-08-30
8972,서울,종로구,1,0,2,3,2,0,2018-09-30
8973,서울,종로구,4,0,1,5,3,0,2018-10-30
8974,서울,종로구,0,1,1,2,2,0,2018-11-30
8975,서울,종로구,1,0,0,1,1,0,2018-12-30
8976,서울,중구,7,2,0,9,5,0,2018-01-30
8978,서울,중구,4,1,0,5,3,0,2018-03-30
8979,서울,중구,5,5,3,13,5,0,2018-04-30
8980,서울,중구,3,0,2,5,4,0,2018-05-30
8981,서울,중구,0,0,1,1,1,0,2018-06-30
8982,서울,중구,0,0,1,1,1,0,2018-07-30
8983,서울,중구,3,0,2,5,5,0,2018-08-30
8984,서울,중구,0,0,0,0,0,0,2018-09-30
8985,서울,중구,2,0,0,2,2,0,2018-10-30
8986,서울,중구,4,1,1,6,5,0,2018-11-30
8987,서울,중구,0,0,0,0,0,0,2018-12-30
8988,서울,중랑구,14,0,2,16,8,0,2018-01-30
8990,서울,중랑구,2,0,0,2,2,0,2018-03-30
8991,서울,중랑구,1,1,0,2,2,0,2018-04-30
8992,서울,중랑구,5,3,1,9,9,0,2018-05-30
8993,서울,중랑구,7,2,1,10,7,0,2018-06-30
8994,서울,중랑구,10,2,6,18,7,0,2018-07-30
8995,서울,중랑구,3,1,1,5,4,0,2018-08-30
8996,서울,중랑구,1,1,3,5,3,0,2018-09-30
8997,서울,중랑구,10,1,0,11,6,0,2018-10-30
8998,서울,중랑구,4,2,2,8,6,0,2018-11-30
8999,서울,중랑구,1,1,1,3,3,0,2018-12-30
9000,서울,강남구,7,1,1,9,9,0,2018-01-31
9002,서울,강남구,4,2,3,9,8,0,2018-03-31
9004,서울,강남구,10,2,3,15,10,0,2018-05-31
9006,서울,강남구,4,0,1,5,5,0,2018-07-31
9007,서울,강남구,14,0,2,16,12,0,2018-08-31
9009,서울,강남구,3,2,0,5,4,0,2018-10-31
9011,서울,강남구,8,0,2,10,8,0,2018-12-31
9012,서울,강동구,1,0,0,1,1,0,2018-01-31
9014,서울,강동구,1,0,1,2,2,0,2018-03-31
9016,서울,강동구,4,1,2,7,4,0,2018-05-31
9018,서울,강동구,3,0,0,3,3,0,2018-07-31
9019,서울,강동구,2,0,1,3,3,0,2018-08-31
9021,서울,강동구,5,2,1,8,5,0,2018-10-31
9023,서울,강동구,7,1,3,11,5,0,2018-12-31
9024,서울,강북구,6,0,5,11,7,0,2018-01-31
9026,서울,강북구,2,0,1,3,3,0,2018-03-31
9028,서울,강북구,0,0,0,0,0,0,2018-05-31
9030,서울,강북구,3,0,1,4,2,0,2018-07-31
9031,서울,강북구,4,0,1,5,4,0,2018-08-31
9033,서울,강북구,3,1,1,5,3,0,2018-10-31
9035,서울,강북구,2,0,0,2,1,0,2018-12-31
9036,서울,강서구,2,0,2,4,4,0,2018-01-31
9038,서울,강서구,0,1,0,1,1,0,2018-03-31
9040,서울,강서구,10,0,5,15,8,0,2018-05-31
9042,서울,강서구,2,1,0,3,3,0,2018-07-31
9043,서울,강서구,5,1,0,6,5,0,2018-08-31
9045,서울,강서구,1,0,2,3,3,0,2018-10-31
9047,서울,강서구,1,1,3,5,4,0,2018-12-31
9048,서울,관악구,3,0,1,4,4,0,2018-01-31
9050,서울,관악구,2,0,0,2,2,0,2018-03-31
9052,서울,관악구,5,1,0,6,6,0,2018-05-31
9054,서울,관악구,5,0,3,8,8,0,2018-07-31
9055,서울,관악구,11,2,2,15,8,0,2018-08-31
9057,서울,관악구,5,1,1,7,5,0,2018-10-31
9059,서울,관악구,3,0,2,5,5,0,2018-12-31
9060,서울,광진구,13,0,2,15,6,0,2018-01-31
9062,서울,광진구,5,0,1,6,3,0,2018-03-31
9064,서울,광진구,1,1,3,5,4,0,2018-05-31
9066,서울,광진구,3,0,2,5,2,0,2018-07-31
9067,서울,광진구,5,0,0,5,3,0,2018-08-31
9069,서울,광진구,3,2,1,6,4,0,2018-10-31
9071,서울,광진구,0,0,0,0,0,0,2018-12-31
9072,서울,구로구,5,0,0,5,5,0,2018-01-31
9074,서울,구로구,6,0,4,10,6,0,2018-03-31
9076,서울,구로구,2,1,3,6,5,0,2018-05-31
9078,서울,구로구,16,2,4,22,13,0,2018-07-31
9079,서울,구로구,3,0,0,3,3,0,2018-08-31
9081,서울,구로구,8,0,7,15,10,0,2018-10-31
9083,서울,구로구,6,0,0,6,5,0,2018-12-31
9084,서울,금천구,2,1,1,4,3,0,2018-01-31
9086,서울,금천구,2,0,1,3,3,0,2018-03-31
9088,서울,금천구,3,0,1,4,3,0,2018-05-31
9090,서울,금천구,4,1,0,5,4,0,2018-07-31
9091,서울,금천구,6,0,0,6,2,0,2018-08-31
9093,서울,금천구,0,0,0,0,0,0,2018-10-31
9095,서울,금천구,0,0,0,0,0,0,2018-12-31
9096,서울,노원구,1,1,1,3,2,0,2018-01-31
9098,서울,노원구,5,1,2,8,7,0,2018-03-31
9100,서울,노원구,2,2,0,4,4,0,2018-05-31
9102,서울,노원구,1,0,1,2,2,0,2018-07-31
9103,서울,노원구,6,4,1,11,5,0,2018-08-31
9105,서울,노원구,2,0,1,3,3,0,2018-10-31
9107,서울,노원구,5,1,1,7,5,0,2018-12-31
9108,서울,도봉구,3,0,1,4,4,0,2018-01-31
9110,서울,도봉구,1,0,1,2,2,0,2018-03-31
9112,서울,도봉구,2,0,3,5,2,0,2018-05-31
9114,서울,도봉구,2,2,1,5,4,0,2018-07-31
9115,서울,도봉구,0,0,1,1,1,0,2018-08-31
9117,서울,도봉구,2,0,2,4,3,0,2018-10-31
9119,서울,도봉구,0,2,0,2,2,0,2018-12-31
9120,서울,동대문구,8,1,3,12,10,0,2018-01-31
9122,서울,동대문구,3,0,3,6,6,0,2018-03-31
9124,서울,동대문구,4,0,3,7,7,0,2018-05-31
9126,서울,동대문구,4,0,4,8,8,0,2018-07-31
9127,서울,동대문구,4,2,0,6,4,0,2018-08-31
9129,서울,동대문구,0,1,0,1,1,0,2018-10-31
9131,서울,동대문구,4,0,1,5,4,0,2018-12-31
9132,서울,동작구,0,0,2,2,1,0,2018-01-31
9134,서울,동작구,4,1,3,8,3,0,2018-03-31
9136,서울,동작구,8,1,2,11,8,0,2018-05-31
9138,서울,동작구,0,1,1,2,2,0,2018-07-31
9139,서울,동작구,8,1,2,11,7,0,2018-08-31
9141,서울,동작구,9,0,2,11,7,0,2018-10-31
9143,서울,동작구,6,0,2,8,5,0,2018-12-31
9144,서울,마포구,4,0,1,5,5,0,2018-01-31
9146,서울,마포구,14,0,1,15,7,0,2018-03-31
9148,서울,마포구,3,0,2,5,5,0,2018-05-31
9150,서울,마포구,4,0,5,9,7,0,2018-07-31
9151,서울,마포구,3,1,1,5,5,0,2018-08-31
9153,서울,마포구,1,2,2,5,5,0,2018-10-31
9155,서울,마포구,6,2,1,9,7,0,2018-12-31
9156,서울,서대문구,3,0,0,3,1,0,2018-01-31
9158,서울,서대문구,2,1,2,5,4,0,2018-03-31
9160,서울,서대문구,1,0,2,3,2,0,2018-05-31
9162,서울,서대문구,0,1,0,1,1,0,2018-07-31
9163,서울,서대문구,1,0,0,1,1,0,2018-08-31
9165,서울,서대문구,2,0,1,3,3,0,2018-10-31
9167,서울,서대문구,1,3,0,4,3,0,2018-12-31
9168,서울,서초구,12,0,1,13,6,0,2018-01-31
9170,서울,서초구,16,2,2,20,8,0,2018-03-31
9172,서울,서초구,10,0,6,16,9,0,2018-05-31
9174,서울,서초구,14,0,4,18,11,0,2018-07-31
9175,서울,서초구,5,1,2,8,7,0,2018-08-31
9177,서울,서초구,8,0,0,8,5,0,2018-10-31
9179,서울,서초구,9,1,3,13,8,0,2018-12-31
9180,서울,성동구,11,1,1,13,6,0,2018-01-31
9182,서울,성동구,2,0,1,3,2,0,2018-03-31
9184,서울,성동구,5,1,1,7,3,0,2018-05-31
9186,서울,성동구,1,0,2,3,2,0,2018-07-31
9187,서울,성동구,9,0,1,10,6,0,2018-08-31
9189,서울,성동구,4,0,0,4,4,0,2018-10-31
9191,서울,성동구,6,0,1,7,4,0,2018-12-31
9192,서울,성북구,5,0,3,8,6,0,2018-01-31
9194,서울,성북구,3,1,0,4,2,0,2018-03-31
9196,서울,성북구,6,0,2,8,7,0,2018-05-31
9198,서울,성북구,0,0,1,1,1,0,2018-07-31
9199,서울,성북구,7,1,0,8,7,0,2018-08-31
9201,서울,성북구,4,0,0,4,4,0,2018-10-31
9203,서울,성북구,5,0,1,6,5,0,2018-12-31
9204,서울,송파구,8,2,1,11,7,0,2018-01-31
9206,서울,송파구,3,1,1,5,5,0,2018-03-31
9208,서울,송파구,9,1,1,11,10,0,2018-05-31
9210,서울,송파구,5,0,4,9,7,0,2018-07-31
9211,서울,송파구,3,2,1,6,4,0,2018-08-31
9213,서울,송파구,19,2,8,29,14,0,2018-10-31
9215,서울,송파구,7,1,2,10,9,0,2018-12-31
9216,서울,양천구,4,0,1,5,4,0,2018-01-31
9218,서울,양천구,2,0,1,3,3,0,2018-03-31
9220,서울,양천구,2,2,0,4,4,0,2018-05-31
9222,서울,양천구,3,0,0,3,2,0,2018-07-31
9223,서울,양천구,2,0,0,2,2,0,2018-08-31
9225,서울,양천구,4,0,3,7,7,0,2018-10-31
9227,서울,양천구,5,1,1,7,6,0,2018-12-31
9228,서울,영등포구,6,1,3,10,7,0,2018-01-31
9230,서울,영등포구,11,1,3,15,12,0,2018-03-31
9232,서울,영등포구,7,2,1,10,7,0,2018-05-31
9234,서울,영등포구,6,0,0,6,3,0,2018-07-31
9235,서울,영등포구,12,0,1,13,6,0,2018-08-31
9237,서울,영등포구,9,0,1,10,9,0,2018-10-31
9239,서울,영등포구,3,2,2,7,6,0,2018-12-31
9240,서울,용산구,1,0,0,1,1,0,2018-01-31
9242,서울,용산구,17,0,1,18,6,0,2018-03-31
9244,서울,용산구,6,0,6,12,9,1,2018-05-31
9246,서울,용산구,6,0,0,6,6,0,2018-07-31
9247,서울,용산구,3,1,2,6,6,0,2018-08-31
9249,서울,용산구,0,0,1,1,1,0,2018-10-31
9251,서울,용산구,2,1,3,6,5,1,2018-12-31
9252,서울,은평구,1,0,1,2,2,0,2018-01-31
9254,서울,은평구,1,0,1,2,2,0,2018-03-31
9256,서울,은평구,0,0,0,0,0,0,2018-05-31
9258,서울,은평구,3,0,2,5,4,0,2018-07-31
9259,서울,은평구,9,2,1,12,8,0,2018-08-31
9261,서울,은평구,5,0,2,7,4,0,2018-10-31
9263,서울,은평구,3,2,0,5,3,0,2018-12-31
9264,서울,종로구,9,2,1,12,8,0,2018-01-31
9266,서울,종로구,4,1,1,6,5,0,2018-03-31
9268,서울,종로구,3,2,1,6,4,0,2018-05-31
9270,서울,종로구,1,0,2,3,2,0,2018-07-31
9271,서울,종로구,0,0,1,1,1,0,2018-08-31
9273,서울,종로구,7,0,4,11,6,0,2018-10-31
9275,서울,종로구,0,0,1,1,1,0,2018-12-31
9276,서울,중구,4,0,0,4,4,0,2018-01-31
9278,서울,중구,7,2,2,11,5,0,2018-03-31
9280,서울,중구,6,0,4,10,8,0,2018-05-31
9282,서울,중구,2,0,1,3,3,0,2018-07-31
9283,서울,중구,0,0,1,1,1,0,2018-08-31
9285,서울,중구,0,1,0,1,1,0,2018-10-31
9287,서울,중구,3,0,3,6,4,0,2018-12-31
9288,서울,중랑구,7,0,0,7,5,0,2018-01-31
9290,서울,중랑구,0,1,0,1,1,0,2018-03-31
9292,서울,중랑구,9,1,3,13,10,0,2018-05-31
9294,서울,중랑구,3,0,1,4,3,0,2018-07-31
9295,서울,중랑구,5,0,1,6,5,0,2018-08-31
9297,서울,중랑구,8,0,0,8,6,0,2018-10-31
9299,서울,중랑구,2,0,0,2,2,0,2018-12-31
0,서울,강남구,7,0,2,9,6,0,2019-01-01
1,서울,강남구,5,0,1,6,4,0,2019-02-01
2,서울,강남구,8,0,3,11,7,0,2019-03-01
3,서울,강남구,17,1,2,20,14,0,2019-04-01
4,서울,강남구,8,0,0,8,8,0,2019-05-01
5,서울,강남구,9,1,1,11,9,1,2019-06-01
6,서울,강남구,10,0,1,11,9,0,2019-07-01
7,서울,강남구,14,1,0,15,10,0,2019-08-01
8,서울,강남구,8,1,1,10,6,0,2019-09-01
9,서울,강남구,12,2,2,16,13,0,2019-10-01
10,서울,강남구,6,0,7,13,11,1,2019-11-01
11,서울,강남구,6,3,2,11,9,0,2019-12-01
12,서울,강동구,0,0,2,2,2,0,2019-01-01
13,서울,강동구,4,1,3,8,5,0,2019-02-01
14,서울,강동구,0,2,1,3,2,0,2019-03-01
15,서울,강동구,1,0,2,3,2,0,2019-04-01
16,서울,강동구,1,1,2,4,4,0,2019-05-01
17,서울,강동구,4,1,5,10,9,0,2019-06-01
18,서울,강동구,2,0,2,4,4,0,2019-07-01
19,서울,강동구,5,0,0,5,4,0,2019-08-01
20,서울,강동구,3,0,0,3,2,0,2019-09-01
21,서울,강동구,1,1,1,3,3,0,2019-10-01
22,서울,강동구,2,0,0,2,1,0,2019-11-01
23,서울,강동구,8,2,1,11,7,1,2019-12-01
24,서울,강북구,0,0,0,0,0,0,2019-01-01
25,서울,강북구,0,0,1,1,1,0,2019-02-01
26,서울,강북구,6,0,2,8,7,0,2019-03-01
27,서울,강북구,8,0,2,10,5,0,2019-04-01
28,서울,강북구,6,0,0,6,3,0,2019-05-01
29,서울,강북구,3,0,1,4,2,0,2019-06-01
30,서울,강북구,4,0,1,5,4,0,2019-07-01
31,서울,강북구,5,0,2,7,4,0,2019-08-01
32,서울,강북구,2,0,0,2,2,0,2019-09-01
33,서울,강북구,3,0,1,4,4,0,2019-10-01
34,서울,강북구,2,0,1,3,3,0,2019-11-01
35,서울,강북구,6,0,1,7,4,0,2019-12-01
36,서울,강서구,5,0,1,6,3,0,2019-01-01
37,서울,강서구,2,0,2,4,4,0,2019-02-01
38,서울,강서구,1,0,2,3,3,0,2019-03-01
39,서울,강서구,17,1,3,21,10,0,2019-04-01
40,서울,강서구,2,0,0,2,1,0,2019-05-01
41,서울,강서구,4,0,1,5,3,0,2019-06-01
42,서울,강서구,2,0,0,2,2,0,2019-07-01
43,서울,강서구,7,1,1,9,6,0,2019-08-01
44,서울,강서구,2,1,0,3,3,0,2019-09-01
45,서울,강서구,4,0,1,5,4,1,2019-10-01
46,서울,강서구,2,0,2,4,4,0,2019-11-01
47,서울,강서구,3,0,1,4,4,0,2019-12-01
48,서울,관악구,2,1,0,3,1,0,2019-01-01
49,서울,관악구,2,0,1,3,3,0,2019-02-01
50,서울,관악구,7,0,0,7,5,0,2019-03-01
51,서울,관악구,5,0,1,6,5,0,2019-04-01
52,서울,관악구,2,0,1,3,3,0,2019-05-01
53,서울,관악구,8,2,0,10,9,0,2019-06-01
54,서울,관악구,2,0,2,4,4,0,2019-07-01
55,서울,관악구,4,0,1,5,5,0,2019-08-01
56,서울,관악구,7,1,0,8,6,0,2019-09-01
57,서울,관악구,3,0,1,4,3,0,2019-10-01
58,서울,관악구,6,0,0,6,4,0,2019-11-01
59,서울,관악구,5,1,0,6,3,0,2019-12-01
60,서울,광진구,2,0,0,2,1,0,2019-01-01
61,서울,광진구,0,0,1,1,1,0,2019-02-01
62,서울,광진구,1,0,0,1,1,0,2019-03-01
63,서울,광진구,0,0,0,0,0,0,2019-04-01
64,서울,광진구,4,0,1,5,5,0,2019-05-01
65,서울,광진구,0,0,0,0,0,0,2019-06-01
66,서울,광진구,3,0,2,5,5,0,2019-07-01
67,서울,광진구,2,0,1,3,3,0,2019-08-01
68,서울,광진구,4,0,0,4,2,0,2019-09-01
69,서울,광진구,3,0,2,5,4,0,2019-10-01
70,서울,광진구,1,0,0,1,1,0,2019-11-01
71,서울,광진구,3,0,0,3,2,0,2019-12-01
72,서울,구로구,2,1,0,3,3,0,2019-01-01
73,서울,구로구,10,0,5,15,12,0,2019-02-01
74,서울,구로구,3,0,3,6,4,0,2019-03-01
75,서울,구로구,8,0,4,12,8,0,2019-04-01
76,서울,구로구,3,0,1,4,3,0,2019-05-01
77,서울,구로구,4,0,3,7,5,0,2019-06-01
78,서울,구로구,0,0,0,0,0,0,2019-07-01
79,서울,구로구,4,1,0,5,2,0,2019-08-01
80,서울,구로구,5,0,1,6,4,0,2019-09-01
81,서울,구로구,2,0,0,2,2,0,2019-10-01
82,서울,구로구,13,0,1,14,12,0,2019-11-01
83,서울,구로구,1,0,0,1,1,0,2019-12-01
84,서울,금천구,0,0,1,1,1,0,2019-01-01
85,서울,금천구,1,0,1,2,2,0,2019-02-01
86,서울,금천구,3,0,0,3,3,0,2019-03-01
87,서울,금천구,2,0,2,4,3,0,2019-04-01
88,서울,금천구,2,0,2,4,3,0,2019-05-01
89,서울,금천구,2,0,1,3,3,0,2019-06-01
90,서울,금천구,3,0,1,4,3,0,2019-07-01
91,서울,금천구,4,0,3,7,5,1,2019-08-01
92,서울,금천구,1,0,0,1,1,0,2019-09-01
93,서울,금천구,0,0,2,2,3,1,2019-10-01
94,서울,금천구,8,0,1,9,7,0,2019-11-01
95,서울,금천구,3,0,0,3,2,0,2019-12-01
96,서울,노원구,14,1,1,16,8,0,2019-01-01
97,서울,노원구,6,2,1,9,6,0,2019-02-01
98,서울,노원구,0,1,1,2,2,0,2019-03-01
99,서울,노원구,4,0,2,6,5,0,2019-04-01
100,서울,노원구,9,0,3,12,7,0,2019-05-01
101,서울,노원구,1,3,1,5,3,0,2019-06-01
102,서울,노원구,5,0,1,6,5,0,2019-07-01
103,서울,노원구,3,1,0,4,2,0,2019-08-01
104,서울,노원구,0,0,2,2,2,0,2019-09-01
105,서울,노원구,3,0,0,3,3,0,2019-10-01
106,서울,노원구,5,0,2,7,5,0,2019-11-01
107,서울,노원구,3,0,1,4,3,0,2019-12-01
108,서울,도봉구,0,0,0,0,0,0,2019-01-01
109,서울,도봉구,2,0,1,3,3,0,2019-02-01
110,서울,도봉구,2,0,0,2,1,0,2019-03-01
111,서울,도봉구,3,0,0,3,3,0,2019-04-01
112,서울,도봉구,0,0,0,0,0,0,2019-05-01
113,서울,도봉구,3,0,1,4,3,0,2019-06-01
114,서울,도봉구,3,0,3,6,5,0,2019-07-01
115,서울,도봉구,1,1,1,3,3,0,2019-08-01
116,서울,도봉구,9,0,0,9,4,0,2019-09-01
117,서울,도봉구,0,0,1,1,1,0,2019-10-01
118,서울,도봉구,0,0,1,1,1,0,2019-11-01
119,서울,도봉구,3,0,1,4,4,0,2019-12-01
120,서울,동대문구,2,0,0,2,2,0,2019-01-01
121,서울,동대문구,5,0,2,7,7,0,2019-02-01
122,서울,동대문구,1,0,0,1,1,0,2019-03-01
123,서울,동대문구,7,1,0,8,6,0,2019-04-01
124,서울,동대문구,1,0,2,3,2,0,2019-05-01
125,서울,동대문구,2,0,4,6,4,0,2019-06-01
126,서울,동대문구,9,1,0,10,6,0,2019-07-01
127,서울,동대문구,1,0,1,2,2,0,2019-08-01
128,서울,동대문구,6,0,2,8,5,0,2019-09-01
129,서울,동대문구,3,0,1,4,4,0,2019-10-01
130,서울,동대문구,2,0,2,4,4,0,2019-11-01
131,서울,동대문구,4,2,2,8,6,0,2019-12-01
132,서울,동작구,0,1,0,1,1,0,2019-01-01
133,서울,동작구,9,1,0,10,3,0,2019-02-01
134,서울,동작구,2,1,3,6,5,0,2019-03-01
135,서울,동작구,2,0,3,5,4,0,2019-04-01
136,서울,동작구,1,0,0,1,1,0,2019-05-01
137,서울,동작구,8,2,0,10,4,0,2019-06-01
138,서울,동작구,7,1,1,9,6,0,2019-07-01
139,서울,동작구,4,0,0,4,3,0,2019-08-01
140,서울,동작구,3,3,1,7,6,0,2019-09-01
141,서울,동작구,4,0,3,7,7,0,2019-10-01
142,서울,동작구,3,1,3,7,5,0,2019-11-01
143,서울,동작구,3,2,0,5,2,0,2019-12-01
144,서울,마포구,2,0,0,2,2,0,2019-01-01
145,서울,마포구,4,1,1,6,4,0,2019-02-01
146,서울,마포구,3,0,1,4,3,0,2019-03-01
147,서울,마포구,5,1,1,7,4,0,2019-04-01
148,서울,마포구,0,0,0,0,0,0,2019-05-01
149,서울,마포구,7,4,0,11,6,0,2019-06-01
150,서울,마포구,6,0,3,9,8,0,2019-07-01
151,서울,마포구,4,3,1,8,7,0,2019-08-01
152,서울,마포구,2,0,0,2,2,0,2019-09-01
153,서울,마포구,1,0,0,1,1,0,2019-10-01
154,서울,마포구,9,1,5,15,8,0,2019-11-01
155,서울,마포구,5,1,2,8,5,1,2019-12-01
156,서울,서대문구,1,0,0,1,1,0,2019-01-01
157,서울,서대문구,6,0,1,7,3,0,2019-02-01
158,서울,서대문구,1,0,0,1,1,0,2019-03-01
159,서울,서대문구,0,0,1,1,1,0,2019-04-01
160,서울,서대문구,4,2,0,6,6,0,2019-05-01
161,서울,서대문구,4,0,1,5,3,0,2019-06-01
162,서울,서대문구,1,3,2,6,4,0,2019-07-01
163,서울,서대문구,5,0,1,6,4,0,2019-08-01
164,서울,서대문구,5,1,3,9,3,0,2019-09-01
165,서울,서대문구,4,0,1,5,3,0,2019-10-01
166,서울,서대문구,4,0,2,6,5,0,2019-11-01
167,서울,서대문구,0,0,0,0,0,0,2019-12-01
168,서울,서초구,9,1,3,13,8,0,2019-01-01
169,서울,서초구,17,2,4,23,10,0,2019-02-01
170,서울,서초구,7,1,0,8,4,0,2019-03-01
171,서울,서초구,4,1,1,6,4,0,2019-04-01
172,서울,서초구,4,1,0,5,3,0,2019-05-01
173,서울,서초구,11,1,3,15,9,0,2019-06-01
174,서울,서초구,3,0,0,3,2,0,2019-07-01
175,서울,서초구,9,0,4,13,8,0,2019-08-01
176,서울,서초구,5,0,1,6,4,0,2019-09-01
177,서울,서초구,3,2,0,5,3,0,2019-10-01
178,서울,서초구,4,1,2,7,7,0,2019-11-01
179,서울,서초구,7,0,1,8,6,0,2019-12-01
180,서울,성동구,1,0,0,1,1,0,2019-01-01
181,서울,성동구,4,2,1,7,6,0,2019-02-01
182,서울,성동구,0,0,1,1,1,0,2019-03-01
183,서울,성동구,2,0,1,3,3,0,2019-04-01
184,서울,성동구,4,0,2,6,7,1,2019-05-01
185,서울,성동구,6,0,0,6,5,0,2019-06-01
186,서울,성동구,3,0,0,3,3,0,2019-07-01
187,서울,성동구,1,0,1,2,2,0,2019-08-01
188,서울,성동구,2,1,0,3,3,0,2019-09-01
189,서울,성동구,1,0,1,2,2,0,2019-10-01
190,서울,성동구,1,0,0,1,1,0,2019-11-01
191,서울,성동구,2,0,0,2,2,0,2019-12-01
192,서울,성북구,1,0,1,2,2,0,2019-01-01
193,서울,성북구,5,0,0,5,4,0,2019-02-01
194,서울,성북구,5,0,0,5,3,0,2019-03-01
195,서울,성북구,3,0,1,4,4,0,2019-04-01
196,서울,성북구,0,0,0,0,0,0,2019-05-01
197,서울,성북구,4,2,1,7,7,0,2019-06-01
198,서울,성북구,4,0,2,6,5,0,2019-07-01
199,서울,성북구,3,1,1,5,4,0,2019-08-01
200,서울,성북구,2,0,3,5,3,0,2019-09-01
201,서울,성북구,9,1,0,10,6,0,2019-10-01
202,서울,성북구,3,1,0,4,5,1,2019-11-01
203,서울,성북구,8,1,0,9,6,0,2019-12-01
204,서울,송파구,7,0,1,8,4,0,2019-01-01
205,서울,송파구,9,2,0,11,9,0,2019-02-01
206,서울,송파구,9,2,0,11,3,0,2019-03-01
207,서울,송파구,9,0,2,11,9,0,2019-04-01
208,서울,송파구,10,2,1,13,9,0,2019-05-01
209,서울,송파구,4,1,2,7,5,0,2019-06-01
210,서울,송파구,4,1,1,6,5,0,2019-07-01
211,서울,송파구,7,1,1,9,4,0,2019-08-01
212,서울,송파구,9,1,1,11,7,0,2019-09-01
213,서울,송파구,12,1,0,13,10,0,2019-10-01
214,서울,송파구,12,2,5,19,15,0,2019-11-01
215,서울,송파구,5,1,2,8,7,0,2019-12-01
216,서울,양천구,3,0,0,3,2,0,2019-01-01
217,서울,양천구,0,2,0,2,2,0,2019-02-01
218,서울,양천구,2,0,1,3,3,0,2019-03-01
219,서울,양천구,5,1,0,6,6,1,2019-04-01
220,서울,양천구,13,0,4,17,11,0,2019-05-01
221,서울,양천구,4,0,0,4,4,0,2019-06-01
222,서울,양천구,4,0,2,6,6,0,2019-07-01
223,서울,양천구,3,0,1,4,4,0,2019-08-01
224,서울,양천구,1,1,1,3,3,0,2019-09-01
225,서울,양천구,5,0,0,5,4,0,2019-10-01
226,서울,양천구,3,0,0,3,3,0,2019-11-01
227,서울,양천구,5,0,2,7,4,0,2019-12-01
228,서울,영등포구,6,2,0,8,3,0,2019-01-01
229,서울,영등포구,4,0,3,7,6,0,2019-02-01
230,서울,영등포구,8,3,2,13,8,1,2019-03-01
231,서울,영등포구,8,0,4,12,9,0,2019-04-01
232,서울,영등포구,6,1,2,9,7,0,2019-05-01
233,서울,영등포구,7,1,1,9,8,0,2019-06-01
234,서울,영등포구,9,0,0,9,6,0,2019-07-01
235,서울,영등포구,17,1,1,19,6,0,2019-08-01
236,서울,영등포구,8,0,1,9,5,0,2019-09-01
237,서울,영등포구,17,2,3,22,12,1,2019-10-01
238,서울,영등포구,8,1,2,11,7,0,2019-11-01
239,서울,영등포구,10,0,0,10,6,0,2019-12-01
240,서울,용산구,1,0,1,2,2,0,2019-01-01
241,서울,용산구,4,0,1,5,5,0,2019-02-01
242,서울,용산구,5,1,0,6,3,0,2019-03-01
243,서울,용산구,0,0,0,0,0,0,2019-04-01
244,서울,용산구,1,0,0,1,1,0,2019-05-01
245,서울,용산구,1,0,2,3,2,0,2019-06-01
246,서울,용산구,2,0,0,2,2,0,2019-07-01
247,서울,용산구,3,0,3,6,5,0,2019-08-01
248,서울,용산구,7,0,0,7,2,0,2019-09-01
249,서울,용산구,0,0,0,0,0,0,2019-10-01
250,서울,용산구,2,1,1,4,3,0,2019-11-01
251,서울,용산구,8,0,1,9,4,0,2019-12-01
252,서울,은평구,0,1,1,2,2,0,2019-01-01
253,서울,은평구,0,0,1,1,1,0,2019-02-01
254,서울,은평구,3,2,1,6,6,0,2019-03-01
255,서울,은평구,0,0,1,1,1,0,2019-04-01
256,서울,은평구,4,0,0,4,2,0,2019-05-01
257,서울,은평구,2,0,1,3,1,0,2019-06-01
258,서울,은평구,4,3,1,8,6,0,2019-07-01
259,서울,은평구,1,0,1,2,2,0,2019-08-01
260,서울,은평구,0,0,1,1,1,0,2019-09-01
261,서울,은평구,1,0,4,5,6,1,2019-10-01
262,서울,은평구,0,0,0,0,0,0,2019-11-01
263,서울,은평구,2,1,2,5,5,0,2019-12-01
264,서울,종로구,0,0,1,1,1,0,2019-01-01
265,서울,종로구,3,0,0,3,3,0,2019-02-01
266,서울,종로구,2,0,0,2,2,0,2019-03-01
267,서울,종로구,0,0,1,1,1,0,2019-04-01
268,서울,종로구,3,0,0,3,2,0,2019-05-01
269,서울,종로구,0,0,1,1,1,0,2019-06-01
270,서울,종로구,4,2,1,7,5,0,2019-07-01
271,서울,종로구,2,0,1,3,3,0,2019-08-01
272,서울,종로구,6,1,2,9,4,0,2019-09-01
273,서울,종로구,1,1,0,2,1,0,2019-10-01
274,서울,종로구,6,1,2,9,7,0,2019-11-01
275,서울,종로구,6,0,0,6,4,0,2019-12-01
276,서울,중구,1,0,0,1,1,0,2019-01-01
277,서울,중구,1,0,0,1,1,0,2019-02-01
278,서울,중구,1,0,0,1,1,0,2019-03-01
279,서울,중구,7,0,2,9,5,1,2019-04-01
280,서울,중구,4,0,1,5,4,0,2019-05-01
281,서울,중구,4,2,2,8,4,0,2019-06-01
282,서울,중구,5,0,2,7,5,0,2019-07-01
283,서울,중구,6,0,1,7,5,0,2019-08-01
284,서울,중구,0,1,0,1,1,0,2019-09-01
285,서울,중구,7,5,1,13,7,0,2019-10-01
286,서울,중구,10,0,4,14,11,0,2019-11-01
287,서울,중구,5,0,0,5,5,0,2019-12-01
288,서울,중랑구,3,0,2,5,5,0,2019-01-01
289,서울,중랑구,4,1,1,6,6,0,2019-02-01
290,서울,중랑구,3,0,0,3,2,0,2019-03-01
291,서울,중랑구,5,2,1,8,6,0,2019-04-01
292,서울,중랑구,3,0,0,3,2,0,2019-05-01
293,서울,중랑구,4,0,1,5,3,0,2019-06-01
294,서울,중랑구,7,0,1,8,2,0,2019-07-01
295,서울,중랑구,5,1,1,7,6,0,2019-08-01
296,서울,중랑구,3,0,1,4,4,0,2019-09-01
297,서울,중랑구,4,0,2,6,5,0,2019-10-01
298,서울,중랑구,7,2,0,9,6,0,2019-11-01
299,서울,중랑구,7,0,1,8,4,0,2019-12-01
300,서울,강남구,6,0,3,9,7,0,2019-01-02
301,서울,강남구,4,1,1,6,5,0,2019-02-02
302,서울,강남구,4,2,1,7,6,0,2019-03-02
303,서울,강남구,14,2,2,18,15,0,2019-04-02
304,서울,강남구,13,0,7,20,11,0,2019-05-02
305,서울,강남구,6,1,0,7,4,0,2019-06-02
306,서울,강남구,15,1,1,17,12,0,2019-07-02
307,서울,강남구,12,1,3,16,12,0,2019-08-02
308,서울,강남구,17,1,2,20,16,0,2019-09-02
309,서울,강남구,8,1,3,12,11,0,2019-10-02
310,서울,강남구,10,1,3,14,9,0,2019-11-02
311,서울,강남구,17,2,1,20,15,0,2019-12-02
312,서울,강동구,1,0,2,3,2,0,2019-01-02
313,서울,강동구,2,0,0,2,2,0,2019-02-02
314,서울,강동구,4,0,1,5,3,0,2019-03-02
315,서울,강동구,4,1,3,8,5,0,2019-04-02
316,서울,강동구,3,1,3,7,4,0,2019-05-02
317,서울,강동구,4,1,1,6,5,0,2019-06-02
318,서울,강동구,4,0,2,6,5,0,2019-07-02
319,서울,강동구,2,1,0,3,3,0,2019-08-02
320,서울,강동구,1,0,2,3,4,1,2019-09-02
321,서울,강동구,3,1,0,4,3,0,2019-10-02
322,서울,강동구,12,0,2,14,5,0,2019-11-02
323,서울,강동구,0,0,1,1,1,0,2019-12-02
324,서울,강북구,4,0,0,4,4,0,2019-01-02
325,서울,강북구,3,1,0,4,4,0,2019-02-02
326,서울,강북구,6,0,0,6,3,0,2019-03-02
327,서울,강북구,3,0,1,4,4,0,2019-04-02
328,서울,강북구,9,0,5,14,6,0,2019-05-02
329,서울,강북구,1,0,0,1,1,0,2019-06-02
330,서울,강북구,1,0,0,1,1,0,2019-07-02
331,서울,강북구,10,1,1,12,7,0,2019-08-02
332,서울,강북구,7,0,2,9,7,0,2019-09-02
333,서울,강북구,7,1,1,9,6,0,2019-10-02
334,서울,강북구,2,0,0,2,2,0,2019-11-02
335,서울,강북구,6,0,0,6,5,0,2019-12-02
336,서울,강서구,5,0,1,6,5,0,2019-01-02
337,서울,강서구,2,0,0,2,2,0,2019-02-02
338,서울,강서구,6,0,0,6,5,0,2019-03-02
339,서울,강서구,4,0,0,4,4,0,2019-04-02
340,서울,강서구,4,0,1,5,5,0,2019-05-02
341,서울,강서구,5,1,1,7,5,0,2019-06-02
342,서울,강서구,1,0,0,1,1,0,2019-07-02
343,서울,강서구,10,1,4,15,9,0,2019-08-02
344,서울,강서구,2,0,0,2,1,0,2019-09-02
345,서울,강서구,3,0,1,4,4,0,2019-10-02
346,서울,강서구,14,0,2,16,7,0,2019-11-02
347,서울,강서구,12,2,2,16,6,0,2019-12-02
348,서울,관악구,4,0,2,6,4,0,2019-01-02
349,서울,관악구,0,0,2,2,2,0,2019-02-02
350,서울,관악구,5,0,0,5,2,0,2019-03-02
351,서울,관악구,2,0,1,3,3,0,2019-04-02
352,서울,관악구,4,0,1,5,4,0,2019-05-02
353,서울,관악구,2,0,0,2,1,0,2019-06-02
354,서울,관악구,3,0,0,3,3,0,2019-07-02
355,서울,관악구,6,0,2,8,5,0,2019-08-02
356,서울,관악구,9,0,0,9,6,0,2019-09-02
357,서울,관악구,1,2,0,3,2,0,2019-10-02
358,서울,관악구,3,1,1,5,4,0,2019-11-02
359,서울,관악구,10,0,0,10,4,0,2019-12-02
360,서울,광진구,0,0,1,1,1,0,2019-01-02
361,서울,광진구,5,0,1,6,4,0,2019-02-02
362,서울,광진구,2,0,0,2,1,0,2019-03-02
363,서울,광진구,3,0,1,4,4,0,2019-04-02
364,서울,광진구,5,0,0,5,4,0,2019-05-02
365,서울,광진구,3,0,1,4,3,0,2019-06-02
366,서울,광진구,5,0,1,6,1,0,2019-07-02
367,서울,광진구,4,0,0,4,2,0,2019-08-02
368,서울,광진구,6,0,2,8,5,0,2019-09-02
369,서울,광진구,0,0,0,0,0,0,2019-10-02
370,서울,광진구,0,2,1,3,1,0,2019-11-02
371,서울,광진구,0,1,1,2,2,0,2019-12-02
372,서울,구로구,4,0,0,4,3,0,2019-01-02
373,서울,구로구,2,0,2,4,3,0,2019-02-02
374,서울,구로구,1,0,1,2,2,0,2019-03-02
375,서울,구로구,6,0,0,6,4,0,2019-04-02
376,서울,구로구,7,0,3,10,9,0,2019-05-02
377,서울,구로구,3,0,1,4,1,0,2019-06-02
378,서울,구로구,5,0,1,6,4,0,2019-07-02
379,서울,구로구,2,0,2,4,3,0,2019-08-02
380,서울,구로구,5,0,1,6,4,0,2019-09-02
381,서울,구로구,5,1,5,11,7,0,2019-10-02
382,서울,구로구,8,0,2,10,7,0,2019-11-02
383,서울,구로구,8,0,2,10,6,0,2019-12-02
384,서울,금천구,0,0,0,0,0,0,2019-01-02
385,서울,금천구,1,0,0,1,1,0,2019-02-02
386,서울,금천구,3,0,0,3,2,0,2019-03-02
387,서울,금천구,1,2,3,6,5,0,2019-04-02
388,서울,금천구,3,0,0,3,3,0,2019-05-02
389,서울,금천구,1,0,0,1,1,0,2019-06-02
390,서울,금천구,3,1,1,5,4,0,2019-07-02
391,서울,금천구,6,1,1,8,7,0,2019-08-02
392,서울,금천구,2,0,3,5,4,0,2019-09-02
393,서울,금천구,0,0,1,1,1,0,2019-10-02
394,서울,금천구,6,0,0,6,4,0,2019-11-02
395,서울,금천구,4,0,2,6,3,0,2019-12-02
396,서울,노원구,5,0,0,5,4,0,2019-01-02
397,서울,노원구,2,1,0,3,3,0,2019-02-02
398,서울,노원구,5,0,1,6,3,0,2019-03-02
399,서울,노원구,7,2,2,11,9,0,2019-04-02
400,서울,노원구,6,0,2,8,7,0,2019-05-02
401,서울,노원구,6,0,2,8,4,0,2019-06-02
402,서울,노원구,6,1,2,9,5,0,2019-07-02
403,서울,노원구,8,0,0,8,5,0,2019-08-02
404,서울,노원구,19,1,3,23,6,0,2019-09-02
405,서울,노원구,4,0,3,7,7,0,2019-10-02
406,서울,노원구,7,0,1,8,6,0,2019-11-02
407,서울,노원구,4,0,1,5,4,0,2019-12-02
408,서울,도봉구,1,0,0,1,1,0,2019-01-02
409,서울,도봉구,4,0,1,5,5,0,2019-02-02
410,서울,도봉구,1,2,2,5,1,0,2019-03-02
411,서울,도봉구,2,0,1,3,2,0,2019-04-02
412,서울,도봉구,1,1,2,4,4,0,2019-05-02
413,서울,도봉구,6,1,1,8,5,0,2019-06-02
414,서울,도봉구,0,0,0,0,0,0,2019-07-02
415,서울,도봉구,3,0,0,3,3,0,2019-08-02
416,서울,도봉구,1,0,0,1,1,0,2019-09-02
417,서울,도봉구,1,0,2,3,3,0,2019-10-02
418,서울,도봉구,2,1,0,3,3,0,2019-11-02
419,서울,도봉구,4,0,0,4,2,0,2019-12-02
420,서울,동대문구,1,0,0,1,1,0,2019-01-02
421,서울,동대문구,1,1,1,3,2,0,2019-02-02
422,서울,동대문구,6,0,1,7,3,0,2019-03-02
423,서울,동대문구,3,1,2,6,6,0,2019-04-02
424,서울,동대문구,2,1,1,4,3,0,2019-05-02
425,서울,동대문구,6,2,0,8,6,0,2019-06-02
426,서울,동대문구,7,0,1,8,7,0,2019-07-02
427,서울,동대문구,4,0,0,4,4,0,2019-08-02
428,서울,동대문구,2,0,3,5,5,1,2019-09-02
429,서울,동대문구,4,1,1,6,6,0,2019-10-02
430,서울,동대문구,5,0,0,5,3,0,2019-11-02
431,서울,동대문구,6,0,1,7,7,0,2019-12-02
432,서울,동작구,6,0,0,6,3,0,2019-01-02
433,서울,동작구,2,0,0,2,2,0,2019-02-02
434,서울,동작구,4,0,1,5,5,0,2019-03-02
435,서울,동작구,2,0,2,4,4,0,2019-04-02
436,서울,동작구,4,0,1,5,4,0,2019-05-02
437,서울,동작구,7,2,0,9,6,0,2019-06-02
438,서울,동작구,0,0,1,1,1,0,2019-07-02
439,서울,동작구,6,1,1,8,4,0,2019-08-02
440,서울,동작구,4,0,0,4,3,0,2019-09-02
441,서울,동작구,5,1,2,8,5,0,2019-10-02
442,서울,동작구,7,0,2,9,7,0,2019-11-02
443,서울,동작구,4,0,1,5,5,0,2019-12-02
444,서울,마포구,4,1,1,6,6,0,2019-01-02
445,서울,마포구,0,0,0,0,0,0,2019-02-02
446,서울,마포구,1,0,0,1,1,0,2019-03-02
447,서울,마포구,0,0,0,0,0,0,2019-04-02
448,서울,마포구,7,0,0,7,5,0,2019-05-02
449,서울,마포구,1,0,0,1,1,0,2019-06-02
450,서울,마포구,2,0,4,6,4,0,2019-07-02
451,서울,마포구,5,1,2,8,8,0,2019-08-02
452,서울,마포구,8,0,2,10,6,0,2019-09-02
453,서울,마포구,1,0,0,1,1,0,2019-10-02
454,서울,마포구,3,0,0,3,3,0,2019-11-02
455,서울,마포구,2,0,1,3,3,0,2019-12-02
456,서울,서대문구,2,3,1,6,4,0,2019-01-02
457,서울,서대문구,0,0,0,0,0,0,2019-02-02
458,서울,서대문구,2,1,0,3,3,0,2019-03-02
459,서울,서대문구,1,0,0,1,1,0,2019-04-02
460,서울,서대문구,1,1,1,3,4,1,2019-05-02
461,서울,서대문구,12,11,1,24,2,0,2019-06-02
462,서울,서대문구,4,0,1,5,5,0,2019-07-02
463,서울,서대문구,3,0,0,3,3,0,2019-08-02
464,서울,서대문구,2,0,1,3,3,0,2019-09-02
465,서울,서대문구,3,0,2,5,4,0,2019-10-02
466,서울,서대문구,4,2,2,8,5,1,2019-11-02
467,서울,서대문구,3,0,1,4,4,0,2019-12-02
468,서울,서초구,4,1,1,6,6,0,2019-01-02
469,서울,서초구,4,0,1,5,3,0,2019-02-02
470,서울,서초구,6,0,2,8,6,0,2019-03-02
471,서울,서초구,9,0,1,10,6,0,2019-04-02
472,서울,서초구,4,0,2,6,6,0,2019-05-02
473,서울,서초구,4,1,0,5,3,0,2019-06-02
474,서울,서초구,3,0,4,7,7,0,2019-07-02
475,서울,서초구,6,1,2,9,7,0,2019-08-02
476,서울,서초구,3,0,2,5,4,0,2019-09-02
477,서울,서초구,8,1,1,10,8,1,2019-10-02
478,서울,서초구,26,1,2,29,14,0,2019-11-02
479,서울,서초구,4,1,1,6,5,0,2019-12-02
480,서울,성동구,1,0,1,2,2,0,2019-01-02
481,서울,성동구,1,0,0,1,1,0,2019-02-02
482,서울,성동구,4,1,0,5,4,0,2019-03-02
483,서울,성동구,3,0,0,3,3,0,2019-04-02
484,서울,성동구,2,2,3,7,6,0,2019-05-02
485,서울,성동구,4,0,1,5,4,0,2019-06-02
486,서울,성동구,4,0,1,5,4,0,2019-07-02
487,서울,성동구,8,0,2,10,4,0,2019-08-02
488,서울,성동구,2,0,1,3,3,0,2019-09-02
489,서울,성동구,2,0,1,3,2,0,2019-10-02
490,서울,성동구,8,2,2,12,8,0,2019-11-02
491,서울,성동구,3,1,0,4,2,0,2019-12-02
492,서울,성북구,7,0,5,12,7,0,2019-01-02
493,서울,성북구,1,0,0,1,1,0,2019-02-02
494,서울,성북구,2,0,1,3,3,0,2019-03-02
495,서울,성북구,6,0,0,6,5,0,2019-04-02
496,서울,성북구,5,1,1,7,6,0,2019-05-02
497,서울,성북구,0,0,0,0,0,0,2019-06-02
498,서울,성북구,3,0,1,4,3,0,2019-07-02
499,서울,성북구,0,0,0,0,0,0,2019-08-02
500,서울,성북구,6,2,0,8,7,0,2019-09-02
501,서울,성북구,13,1,2,16,11,0,2019-10-02
502,서울,성북구,9,1,5,15,7,0,2019-11-02
503,서울,성북구,2,1,0,3,3,0,2019-12-02
504,서울,송파구,8,0,2,10,8,0,2019-01-02
505,서울,송파구,5,2,2,9,8,0,2019-02-02
506,서울,송파구,3,0,4,7,6,0,2019-03-02
507,서울,송파구,7,1,4,12,11,0,2019-04-02
508,서울,송파구,7,2,2,11,8,0,2019-05-02
509,서울,송파구,4,1,0,5,5,0,2019-06-02
510,서울,송파구,8,1,5,14,8,0,2019-07-02
511,서울,송파구,9,1,0,10,8,0,2019-08-02
512,서울,송파구,3,0,4,7,7,0,2019-09-02
513,서울,송파구,15,4,2,21,17,0,2019-10-02
514,서울,송파구,8,0,2,10,7,0,2019-11-02
515,서울,송파구,21,0,2,23,16,0,2019-12-02
516,서울,양천구,10,1,2,13,4,0,2019-01-02
517,서울,양천구,2,0,0,2,2,0,2019-02-02
518,서울,양천구,3,0,0,3,2,0,2019-03-02
519,서울,양천구,7,1,0,8,6,0,2019-04-02
520,서울,양천구,7,1,0,8,5,0,2019-05-02
521,서울,양천구,1,2,0,3,3,0,2019-06-02
522,서울,양천구,2,1,1,4,4,0,2019-07-02
523,서울,양천구,2,0,2,4,3,0,2019-08-02
524,서울,양천구,1,3,1,5,5,0,2019-09-02
525,서울,양천구,5,1,2,8,8,0,2019-10-02
526,서울,양천구,1,0,3,4,2,0,2019-11-02
527,서울,양천구,3,0,0,3,2,0,2019-12-02
528,서울,영등포구,10,0,4,14,9,0,2019-01-02
529,서울,영등포구,8,0,1,9,6,0,2019-02-02
530,서울,영등포구,6,1,0,7,7,0,2019-03-02
531,서울,영등포구,6,0,1,7,6,0,2019-04-02
532,서울,영등포구,3,3,0,6,6,0,2019-05-02
533,서울,영등포구,6,2,2,10,7,0,2019-06-02
534,서울,영등포구,2,0,1,3,3,0,2019-07-02
535,서울,영등포구,7,2,4,13,9,0,2019-08-02
536,서울,영등포구,11,1,1,13,10,0,2019-09-02
537,서울,영등포구,18,2,2,22,9,0,2019-10-02
538,서울,영등포구,10,1,6,17,9,0,2019-11-02
539,서울,영등포구,11,0,5,16,10,0,2019-12-02
540,서울,용산구,0,0,0,0,0,0,2019-01-02
541,서울,용산구,1,0,0,1,1,0,2019-02-02
542,서울,용산구,3,0,3,6,5,0,2019-03-02
543,서울,용산구,1,0,1,2,2,0,2019-04-02
544,서울,용산구,3,1,3,7,6,0,2019-05-02
545,서울,용산구,6,0,3,9,7,0,2019-06-02
546,서울,용산구,1,0,0,1,1,0,2019-07-02
547,서울,용산구,2,0,1,3,3,0,2019-08-02
548,서울,용산구,0,0,1,1,1,0,2019-09-02
549,서울,용산구,3,0,0,3,3,0,2019-10-02
550,서울,용산구,3,0,3,6,4,0,2019-11-02
551,서울,용산구,1,0,1,2,2,0,2019-12-02
552,서울,은평구,2,1,2,5,3,0,2019-01-02
553,서울,은평구,3,0,6,9,6,0,2019-02-02
554,서울,은평구,5,0,1,6,3,0,2019-03-02
555,서울,은평구,1,0,2,3,3,0,2019-04-02
556,서울,은평구,1,0,0,1,1,0,2019-05-02
557,서울,은평구,3,0,1,4,3,0,2019-06-02
558,서울,은평구,1,1,1,3,3,0,2019-07-02
559,서울,은평구,2,1,0,3,2,0,2019-08-02
560,서울,은평구,2,1,0,3,2,0,2019-09-02
561,서울,은평구,4,0,1,5,5,0,2019-10-02
562,서울,은평구,3,0,0,3,3,0,2019-11-02
563,서울,은평구,3,1,1,5,4,0,2019-12-02
564,서울,종로구,4,0,0,4,2,0,2019-01-02
565,서울,종로구,0,1,0,1,1,0,2019-02-02
566,서울,종로구,5,2,1,8,2,0,2019-03-02
567,서울,종로구,8,0,4,12,7,0,2019-04-02
568,서울,종로구,1,0,2,3,3,0,2019-05-02
569,서울,종로구,1,0,1,2,2,0,2019-06-02
570,서울,종로구,0,0,1,1,1,0,2019-07-02
571,서울,종로구,1,0,1,2,1,0,2019-08-02
572,서울,종로구,3,1,0,4,3,0,2019-09-02
573,서울,종로구,3,0,1,4,4,0,2019-10-02
574,서울,종로구,4,0,2,6,2,0,2019-11-02
575,서울,종로구,2,0,3,5,4,0,2019-12-02
576,서울,중구,1,2,3,6,6,1,2019-01-02
577,서울,중구,0,0,1,1,1,0,2019-02-02
578,서울,중구,0,1,0,1,1,0,2019-03-02
579,서울,중구,4,0,1,5,4,0,2019-04-02
580,서울,중구,5,1,2,8,6,0,2019-05-02
581,서울,중구,4,0,0,4,2,0,2019-06-02
582,서울,중구,5,0,0,5,4,0,2019-07-02
583,서울,중구,3,0,2,5,4,0,2019-08-02
584,서울,중구,8,1,1,10,7,0,2019-09-02
585,서울,중구,4,1,4,9,3,0,2019-10-02
586,서울,중구,1,0,1,2,2,0,2019-11-02
587,서울,중구,4,0,2,6,5,0,2019-12-02
588,서울,중랑구,2,0,2,4,4,0,2019-01-02
589,서울,중랑구,8,3,1,12,4,0,2019-02-02
590,서울,중랑구,1,0,0,1,1,0,2019-03-02
591,서울,중랑구,3,1,2,6,6,0,2019-04-02
592,서울,중랑구,2,2,1,5,5,0,2019-05-02
593,서울,중랑구,2,0,0,2,2,0,2019-06-02
594,서울,중랑구,7,1,3,11,7,0,2019-07-02
595,서울,중랑구,0,0,2,2,2,0,2019-08-02
596,서울,중랑구,11,1,4,16,7,0,2019-09-02
597,서울,중랑구,15,0,2,17,12,0,2019-10-02
598,서울,중랑구,2,1,2,5,5,0,2019-11-02
599,서울,중랑구,4,0,0,4,3,0,2019-12-02
600,서울,강남구,16,1,3,20,11,0,2019-01-03
601,서울,강남구,13,1,0,14,4,0,2019-02-03
602,서울,강남구,5,0,2,7,3,0,2019-03-03
603,서울,강남구,9,2,2,13,11,0,2019-04-03
604,서울,강남구,11,2,3,16,15,0,2019-05-03
605,서울,강남구,14,0,3,17,12,0,2019-06-03
606,서울,강남구,12,2,2,16,13,0,2019-07-03
607,서울,강남구,11,1,3,15,12,0,2019-08-03
608,서울,강남구,4,0,5,9,7,0,2019-09-03
609,서울,강남구,13,1,2,16,13,1,2019-10-03
610,서울,강남구,8,0,2,10,6,0,2019-11-03
611,서울,강남구,15,4,5,24,19,0,2019-12-03
612,서울,강동구,1,0,0,1,1,0,2019-01-03
613,서울,강동구,12,0,3,15,4,0,2019-02-03
614,서울,강동구,9,0,3,12,6,0,2019-03-03
615,서울,강동구,2,1,3,6,4,0,2019-04-03
616,서울,강동구,4,0,2,6,5,0,2019-05-03
617,서울,강동구,1,0,4,5,3,0,2019-06-03
618,서울,강동구,6,0,1,7,4,0,2019-07-03
619,서울,강동구,6,0,1,7,3,0,2019-08-03
620,서울,강동구,0,0,0,0,0,0,2019-09-03
621,서울,강동구,5,1,2,8,4,0,2019-10-03
622,서울,강동구,1,1,2,4,4,0,2019-11-03
623,서울,강동구,2,2,0,4,3,0,2019-12-03
624,서울,강북구,4,0,1,5,3,0,2019-01-03
625,서울,강북구,2,0,1,3,2,0,2019-02-03
626,서울,강북구,2,0,0,2,2,0,2019-03-03
627,서울,강북구,8,0,1,9,7,0,2019-04-03
628,서울,강북구,2,0,1,3,3,0,2019-05-03
629,서울,강북구,2,0,0,2,2,0,2019-06-03
630,서울,강북구,1,0,2,3,2,0,2019-07-03
631,서울,강북구,0,0,4,4,3,0,2019-08-03
632,서울,강북구,1,0,1,2,2,0,2019-09-03
633,서울,강북구,3,0,3,6,5,0,2019-10-03
634,서울,강북구,1,0,0,1,1,0,2019-11-03
635,서울,강북구,5,0,0,5,4,0,2019-12-03
636,서울,강서구,0,0,3,3,3,0,2019-01-03
637,서울,강서구,2,1,1,4,4,0,2019-02-03
638,서울,강서구,1,0,0,1,1,0,2019-03-03
639,서울,강서구,2,0,0,2,2,0,2019-04-03
640,서울,강서구,5,1,0,6,4,0,2019-05-03
641,서울,강서구,3,0,1,4,4,0,2019-06-03
642,서울,강서구,14,2,3,19,12,0,2019-07-03
643,서울,강서구,4,1,1,6,6,0,2019-08-03
644,서울,강서구,7,0,1,8,7,0,2019-09-03
645,서울,강서구,8,1,3,12,8,0,2019-10-03
646,서울,강서구,5,1,6,12,7,0,2019-11-03
647,서울,강서구,5,0,1,6,3,0,2019-12-03
648,서울,관악구,2,0,1,3,3,0,2019-01-03
649,서울,관악구,1,1,2,4,4,0,2019-02-03
650,서울,관악구,3,0,0,3,2,0,2019-03-03
651,서울,관악구,3,0,0,3,3,0,2019-04-03
652,서울,관악구,1,0,1,2,2,0,2019-05-03
653,서울,관악구,1,1,1,3,2,0,2019-06-03
654,서울,관악구,2,0,0,2,2,0,2019-07-03
655,서울,관악구,2,0,0,2,2,0,2019-08-03
656,서울,관악구,2,1,5,8,6,0,2019-09-03
657,서울,관악구,6,0,2,8,7,0,2019-10-03
658,서울,관악구,3,0,1,4,4,0,2019-11-03
659,서울,관악구,3,0,0,3,4,1,2019-12-03
660,서울,광진구,0,0,1,1,1,0,2019-01-03
661,서울,광진구,2,0,0,2,2,0,2019-02-03
662,서울,광진구,1,0,0,1,1,0,2019-03-03
663,서울,광진구,2,0,2,4,3,0,2019-04-03
664,서울,광진구,4,0,1,5,5,1,2019-05-03
665,서울,광진구,1,0,1,2,2,0,2019-06-03
666,서울,광진구,1,0,3,4,3,0,2019-07-03
667,서울,광진구,6,0,1,7,3,0,2019-08-03
668,서울,광진구,4,0,2,6,3,0,2019-09-03
669,서울,광진구,7,0,0,7,4,0,2019-10-03
670,서울,광진구,1,0,0,1,1,0,2019-11-03
671,서울,광진구,3,0,0,3,3,0,2019-12-03
672,서울,구로구,12,0,2,14,9,0,2019-01-03
673,서울,구로구,5,1,2,8,4,0,2019-02-03
674,서울,구로구,2,0,1,3,3,0,2019-03-03
675,서울,구로구,5,0,2,7,6,0,2019-04-03
676,서울,구로구,1,0,1,2,2,0,2019-05-03
677,서울,구로구,4,0,1,5,5,1,2019-06-03
678,서울,구로구,6,0,0,6,5,0,2019-07-03
679,서울,구로구,1,2,2,5,4,0,2019-08-03
680,서울,구로구,4,0,3,7,5,0,2019-09-03
681,서울,구로구,2,0,2,4,3,0,2019-10-03
682,서울,구로구,3,0,0,3,3,0,2019-11-03
683,서울,구로구,4,1,1,6,4,0,2019-12-03
684,서울,금천구,0,0,0,0,0,0,2019-01-03
685,서울,금천구,2,0,0,2,1,0,2019-02-03
686,서울,금천구,6,0,4,10,5,0,2019-03-03
687,서울,금천구,6,0,3,9,4,0,2019-04-03
688,서울,금천구,6,0,1,7,4,0,2019-05-03
689,서울,금천구,1,0,0,1,1,0,2019-06-03
690,서울,금천구,2,1,0,3,2,0,2019-07-03
691,서울,금천구,4,0,1,5,3,0,2019-08-03
692,서울,금천구,3,0,1,4,4,0,2019-09-03
693,서울,금천구,0,1,1,2,2,0,2019-10-03
694,서울,금천구,6,1,5,12,2,0,2019-11-03
695,서울,금천구,2,0,0,2,2,0,2019-12-03
696,서울,노원구,3,0,0,3,2,1,2019-01-03
697,서울,노원구,9,0,1,10,6,0,2019-02-03
698,서울,노원구,6,0,1,7,3,0,2019-03-03
699,서울,노원구,1,0,1,2,2,0,2019-04-03
700,서울,노원구,4,0,0,4,4,0,2019-05-03
701,서울,노원구,8,1,1,10,7,0,2019-06-03
702,서울,노원구,4,0,4,8,8,0,2019-07-03
703,서울,노원구,1,0,0,1,1,0,2019-08-03
704,서울,노원구,8,0,0,8,6,1,2019-09-03
705,서울,노원구,3,0,0,3,3,0,2019-10-03
706,서울,노원구,2,0,1,3,3,0,2019-11-03
707,서울,노원구,1,0,1,2,1,0,2019-12-03
708,서울,도봉구,1,0,2,3,3,0,2019-01-03
709,서울,도봉구,2,1,0,3,2,0,2019-02-03
710,서울,도봉구,0,0,0,0,0,0,2019-03-03
711,서울,도봉구,3,0,0,3,1,0,2019-04-03
712,서울,도봉구,3,1,0,4,4,0,2019-05-03
713,서울,도봉구,8,0,0,8,5,0,2019-06-03
714,서울,도봉구,1,3,0,4,2,0,2019-07-03
715,서울,도봉구,1,0,0,1,1,0,2019-08-03
716,서울,도봉구,2,0,0,2,2,0,2019-09-03
717,서울,도봉구,4,0,1,5,3,0,2019-10-03
718,서울,도봉구,5,0,2,7,5,0,2019-11-03
719,서울,도봉구,7,0,2,9,6,0,2019-12-03
720,서울,동대문구,1,0,6,7,4,0,2019-01-03
721,서울,동대문구,2,0,0,2,2,0,2019-02-03
722,서울,동대문구,0,0,0,0,0,0,2019-03-03
723,서울,동대문구,5,0,2,7,4,0,2019-04-03
724,서울,동대문구,0,0,2,2,2,0,2019-05-03
725,서울,동대문구,6,0,0,6,2,0,2019-06-03
726,서울,동대문구,4,0,1,5,5,0,2019-07-03
727,서울,동대문구,1,0,2,3,3,0,2019-08-03
728,서울,동대문구,8,0,4,12,11,0,2019-09-03
729,서울,동대문구,3,0,0,3,3,0,2019-10-03
730,서울,동대문구,4,2,0,6,4,0,2019-11-03
731,서울,동대문구,4,2,3,9,9,1,2019-12-03
732,서울,동작구,3,0,0,3,3,0,2019-01-03
733,서울,동작구,2,0,2,4,4,0,2019-02-03
734,서울,동작구,5,0,3,8,7,0,2019-03-03
735,서울,동작구,2,1,1,4,3,0,2019-04-03
736,서울,동작구,3,0,1,4,4,0,2019-05-03
737,서울,동작구,3,1,1,5,5,0,2019-06-03
738,서울,동작구,0,2,1,3,1,0,2019-07-03
739,서울,동작구,1,0,2,3,3,0,2019-08-03
740,서울,동작구,5,0,2,7,6,0,2019-09-03
741,서울,동작구,5,0,3,8,5,0,2019-10-03
742,서울,동작구,2,0,0,2,2,0,2019-11-03
743,서울,동작구,5,1,0,6,2,0,2019-12-03
744,서울,마포구,5,0,1,6,5,0,2019-01-03
745,서울,마포구,7,1,2,10,3,0,2019-02-03
746,서울,마포구,2,0,0,2,2,0,2019-03-03
747,서울,마포구,3,0,1,4,4,0,2019-04-03
748,서울,마포구,5,3,5,13,9,0,2019-05-03
749,서울,마포구,1,0,2,3,3,0,2019-06-03
750,서울,마포구,4,2,0,6,5,0,2019-07-03
751,서울,마포구,2,0,1,3,3,0,2019-08-03
752,서울,마포구,5,0,3,8,5,0,2019-09-03
753,서울,마포구,0,1,1,2,2,0,2019-10-03
754,서울,마포구,1,0,0,1,1,0,2019-11-03
755,서울,마포구,1,0,0,1,1,0,2019-12-03
756,서울,서대문구,3,0,0,3,3,0,2019-01-03
757,서울,서대문구,0,0,4,4,3,0,2019-02-03
758,서울,서대문구,0,0,0,0,0,0,2019-03-03
759,서울,서대문구,1,1,0,2,1,0,2019-04-03
760,서울,서대문구,2,0,0,2,1,0,2019-05-03
761,서울,서대문구,4,2,2,8,7,0,2019-06-03
762,서울,서대문구,4,0,2,6,6,0,2019-07-03
763,서울,서대문구,0,0,1,1,1,0,2019-08-03
764,서울,서대문구,3,0,2,5,5,0,2019-09-03
765,서울,서대문구,2,1,1,4,3,0,2019-10-03
766,서울,서대문구,2,1,1,4,3,0,2019-11-03
767,서울,서대문구,3,0,0,3,2,0,2019-12-03
768,서울,서초구,2,1,3,6,5,0,2019-01-03
769,서울,서초구,3,0,3,6,3,0,2019-02-03
770,서울,서초구,4,1,1,6,5,0,2019-03-03
771,서울,서초구,3,1,0,4,3,0,2019-04-03
772,서울,서초구,5,1,2,8,7,0,2019-05-03
773,서울,서초구,4,1,2,7,6,0,2019-06-03
774,서울,서초구,5,0,1,6,6,0,2019-07-03
775,서울,서초구,6,1,1,8,5,0,2019-08-03
776,서울,서초구,7,1,5,13,8,0,2019-09-03
777,서울,서초구,7,0,0,7,4,0,2019-10-03
778,서울,서초구,8,1,1,10,6,0,2019-11-03
779,서울,서초구,3,0,0,3,3,0,2019-12-03
780,서울,성동구,13,0,2,15,8,0,2019-01-03
781,서울,성동구,0,0,0,0,0,0,2019-02-03
782,서울,성동구,0,0,0,0,0,0,2019-03-03
783,서울,성동구,2,0,0,2,2,0,2019-04-03
784,서울,성동구,1,0,0,1,1,0,2019-05-03
785,서울,성동구,4,0,0,4,3,0,2019-06-03
786,서울,성동구,0,0,1,1,1,0,2019-07-03
787,서울,성동구,2,0,0,2,2,0,2019-08-03
788,서울,성동구,3,0,2,5,4,0,2019-09-03
789,서울,성동구,1,0,1,2,2,0,2019-10-03
790,서울,성동구,2,1,1,4,3,0,2019-11-03
791,서울,성동구,3,0,2,5,4,1,2019-12-03
792,서울,성북구,1,0,0,1,1,0,2019-01-03
793,서울,성북구,3,0,0,3,2,0,2019-02-03
794,서울,성북구,6,0,1,7,4,0,2019-03-03
795,서울,성북구,2,0,1,3,3,0,2019-04-03
796,서울,성북구,1,0,2,3,2,0,2019-05-03
797,서울,성북구,3,1,1,5,3,0,2019-06-03
798,서울,성북구,2,0,0,2,2,0,2019-07-03
799,서울,성북구,6,0,2,8,4,0,2019-08-03
800,서울,성북구,6,3,1,10,8,0,2019-09-03
801,서울,성북구,3,0,4,7,4,0,2019-10-03
802,서울,성북구,3,0,1,4,3,0,2019-11-03
803,서울,성북구,3,0,4,7,5,0,2019-12-03
804,서울,송파구,3,2,2,7,6,0,2019-01-03
805,서울,송파구,8,1,1,10,5,0,2019-02-03
806,서울,송파구,2,2,0,4,4,0,2019-03-03
807,서울,송파구,8,0,1,9,9,0,2019-04-03
808,서울,송파구,8,1,5,14,9,0,2019-05-03
809,서울,송파구,3,0,0,3,2,0,2019-06-03
810,서울,송파구,5,2,4,11,9,0,2019-07-03
811,서울,송파구,4,0,2,6,5,0,2019-08-03
812,서울,송파구,7,1,2,10,9,0,2019-09-03
813,서울,송파구,7,1,3,11,9,0,2019-10-03
814,서울,송파구,5,1,1,7,6,0,2019-11-03
815,서울,송파구,12,3,1,16,10,0,2019-12-03
816,서울,양천구,3,0,1,4,4,0,2019-01-03
817,서울,양천구,6,1,1,8,4,0,2019-02-03
818,서울,양천구,1,0,0,1,1,0,2019-03-03
819,서울,양천구,4,2,1,7,6,0,2019-04-03
820,서울,양천구,6,0,0,6,6,0,2019-05-03
821,서울,양천구,4,0,0,4,2,0,2019-06-03
822,서울,양천구,0,0,0,0,0,0,2019-07-03
823,서울,양천구,2,0,1,3,3,0,2019-08-03
824,서울,양천구,4,0,0,4,4,0,2019-09-03
825,서울,양천구,3,1,1,5,4,0,2019-10-03
826,서울,양천구,2,0,0,2,1,0,2019-11-03
827,서울,양천구,3,1,1,5,4,0,2019-12-03
828,서울,영등포구,7,1,2,10,9,0,2019-01-03
829,서울,영등포구,1,0,3,4,3,1,2019-02-03
830,서울,영등포구,0,0,2,2,2,0,2019-03-03
831,서울,영등포구,6,0,1,7,6,0,2019-04-03
832,서울,영등포구,7,3,2,12,8,0,2019-05-03
833,서울,영등포구,3,1,2,6,6,0,2019-06-03
834,서울,영등포구,6,0,0,6,4,0,2019-07-03
835,서울,영등포구,13,3,1,17,9,0,2019-08-03
836,서울,영등포구,5,0,0,5,4,0,2019-09-03
837,서울,영등포구,6,0,4,10,8,0,2019-10-03
838,서울,영등포구,4,1,4,9,7,0,2019-11-03
839,서울,영등포구,5,0,2,7,6,0,2019-12-03
840,서울,용산구,0,1,1,2,2,0,2019-01-03
841,서울,용산구,5,0,0,5,3,0,2019-02-03
842,서울,용산구,5,0,3,8,4,0,2019-03-03
843,서울,용산구,6,3,1,10,6,0,2019-04-03
844,서울,용산구,4,0,2,6,5,0,2019-05-03
845,서울,용산구,4,0,2,6,3,0,2019-06-03
846,서울,용산구,2,0,0,2,2,0,2019-07-03
847,서울,용산구,4,0,1,5,4,1,2019-08-03
848,서울,용산구,0,0,0,0,0,0,2019-09-03
849,서울,용산구,1,0,0,1,1,0,2019-10-03
850,서울,용산구,2,0,1,3,2,0,2019-11-03
851,서울,용산구,8,0,0,8,5,0,2019-12-03
852,서울,은평구,3,0,3,6,5,0,2019-01-03
853,서울,은평구,2,0,0,2,1,0,2019-02-03
854,서울,은평구,3,0,2,5,4,0,2019-03-03
855,서울,은평구,2,0,0,2,2,0,2019-04-03
856,서울,은평구,1,1,2,4,4,0,2019-05-03
857,서울,은평구,3,0,2,5,5,0,2019-06-03
858,서울,은평구,2,1,2,5,3,0,2019-07-03
859,서울,은평구,2,0,0,2,1,0,2019-08-03
860,서울,은평구,5,1,2,8,6,0,2019-09-03
861,서울,은평구,4,0,0,4,4,0,2019-10-03
862,서울,은평구,4,0,0,4,4,0,2019-11-03
863,서울,은평구,5,1,1,7,6,0,2019-12-03
864,서울,종로구,2,1,1,4,4,0,2019-01-03
865,서울,종로구,0,0,0,0,0,0,2019-02-03
866,서울,종로구,7,0,1,8,4,1,2019-03-03
867,서울,종로구,6,2,1,9,6,0,2019-04-03
868,서울,종로구,7,2,1,10,7,0,2019-05-03
869,서울,종로구,3,0,1,4,3,0,2019-06-03
870,서울,종로구,1,0,3,4,2,0,2019-07-03
871,서울,종로구,2,0,0,2,1,0,2019-08-03
872,서울,종로구,2,0,2,4,4,0,2019-09-03
873,서울,종로구,3,0,0,3,2,0,2019-10-03
874,서울,종로구,2,1,0,3,3,0,2019-11-03
875,서울,종로구,3,0,0,3,3,0,2019-12-03
876,서울,중구,1,0,1,2,3,1,2019-01-03
877,서울,중구,1,0,0,1,1,0,2019-02-03
878,서울,중구,0,0,0,0,0,0,2019-03-03
879,서울,중구,4,1,2,7,7,0,2019-04-03
880,서울,중구,3,1,2,6,6,0,2019-05-03
881,서울,중구,1,0,2,3,3,0,2019-06-03
882,서울,중구,6,1,1,8,6,0,2019-07-03
883,서울,중구,0,0,0,0,0,0,2019-08-03
884,서울,중구,6,0,0,6,4,0,2019-09-03
885,서울,중구,4,0,0,4,3,0,2019-10-03
886,서울,중구,6,0,2,8,5,0,2019-11-03
887,서울,중구,1,1,0,2,2,0,2019-12-03
888,서울,중랑구,3,0,2,5,4,0,2019-01-03
889,서울,중랑구,2,0,1,3,3,0,2019-02-03
890,서울,중랑구,1,0,2,3,3,0,2019-03-03
891,서울,중랑구,1,1,1,3,3,0,2019-04-03
892,서울,중랑구,6,0,0,6,6,0,2019-05-03
893,서울,중랑구,7,1,0,8,6,0,2019-06-03
894,서울,중랑구,6,0,1,7,5,0,2019-07-03
895,서울,중랑구,9,1,0,10,8,0,2019-08-03
896,서울,중랑구,2,0,2,4,4,0,2019-09-03
897,서울,중랑구,8,0,1,9,5,0,2019-10-03
898,서울,중랑구,2,0,1,3,2,0,2019-11-03
899,서울,중랑구,7,0,3,10,7,0,2019-12-03
900,서울,강남구,12,0,2,14,8,0,2019-01-04
901,서울,강남구,3,0,0,3,2,0,2019-02-04
902,서울,강남구,6,0,5,11,9,0,2019-03-04
903,서울,강남구,6,1,0,7,6,0,2019-04-04
904,서울,강남구,4,0,0,4,4,0,2019-05-04
905,서울,강남구,13,1,2,16,13,0,2019-06-04
906,서울,강남구,16,3,0,19,15,0,2019-07-04
907,서울,강남구,12,3,0,15,9,0,2019-08-04
908,서울,강남구,10,0,1,11,11,0,2019-09-04
909,서울,강남구,11,1,3,15,11,0,2019-10-04
910,서울,강남구,12,2,2,16,14,0,2019-11-04
911,서울,강남구,13,0,5,18,13,0,2019-12-04
912,서울,강동구,0,1,1,2,1,0,2019-01-04
913,서울,강동구,0,0,0,0,0,0,2019-02-04
914,서울,강동구,2,0,0,2,1,0,2019-03-04
915,서울,강동구,2,0,5,7,6,0,2019-04-04
916,서울,강동구,3,0,2,5,4,0,2019-05-04
917,서울,강동구,1,0,2,3,3,0,2019-06-04
918,서울,강동구,1,1,0,2,2,0,2019-07-04
919,서울,강동구,2,0,0,2,2,0,2019-08-04
920,서울,강동구,11,0,3,14,3,0,2019-09-04
921,서울,강동구,0,0,0,0,0,0,2019-10-04
922,서울,강동구,3,0,1,4,3,0,2019-11-04
923,서울,강동구,4,0,0,4,4,0,2019-12-04
924,서울,강북구,8,1,0,9,4,0,2019-01-04
925,서울,강북구,0,1,0,1,1,0,2019-02-04
926,서울,강북구,5,0,2,7,6,0,2019-03-04
927,서울,강북구,9,0,1,10,8,0,2019-04-04
928,서울,강북구,0,0,1,1,1,0,2019-05-04
929,서울,강북구,2,0,3,5,4,0,2019-06-04
930,서울,강북구,4,0,2,6,5,0,2019-07-04
931,서울,강북구,6,0,0,6,6,0,2019-08-04
932,서울,강북구,7,1,0,8,6,0,2019-09-04
933,서울,강북구,5,0,1,6,6,0,2019-10-04
934,서울,강북구,2,0,1,3,3,0,2019-11-04
935,서울,강북구,7,0,1,8,4,0,2019-12-04
936,서울,강서구,9,0,1,10,7,0,2019-01-04
937,서울,강서구,8,0,0,8,6,0,2019-02-04
938,서울,강서구,1,0,0,1,1,0,2019-03-04
939,서울,강서구,4,0,1,5,5,0,2019-04-04
940,서울,강서구,5,1,0,6,5,0,2019-05-04
941,서울,강서구,5,0,1,6,5,0,2019-06-04
942,서울,강서구,4,2,1,7,4,0,2019-07-04
943,서울,강서구,8,1,1,10,6,0,2019-08-04
944,서울,강서구,3,1,2,6,6,0,2019-09-04
945,서울,강서구,3,0,0,3,2,0,2019-10-04
946,서울,강서구,8,1,1,10,8,0,2019-11-04
947,서울,강서구,5,0,0,5,5,1,2019-12-04
948,서울,관악구,3,0,3,6,6,0,2019-01-04
949,서울,관악구,6,0,0,6,5,0,2019-02-04
950,서울,관악구,0,0,0,0,0,0,2019-03-04
951,서울,관악구,4,0,1,5,4,0,2019-04-04
952,서울,관악구,2,0,2,4,4,0,2019-05-04
953,서울,관악구,3,0,0,3,2,0,2019-06-04
954,서울,관악구,8,0,1,9,6,0,2019-07-04
955,서울,관악구,3,0,0,3,2,0,2019-08-04
956,서울,관악구,1,0,0,1,1,0,2019-09-04
957,서울,관악구,3,1,0,4,3,0,2019-10-04
958,서울,관악구,3,1,2,6,5,0,2019-11-04
959,서울,관악구,4,0,1,5,5,0,2019-12-04
960,서울,광진구,0,0,0,0,0,0,2019-01-04
961,서울,광진구,1,0,2,3,2,0,2019-02-04
962,서울,광진구,3,0,0,3,2,1,2019-03-04
963,서울,광진구,6,0,1,7,6,0,2019-04-04
964,서울,광진구,5,1,0,6,6,0,2019-05-04
965,서울,광진구,2,0,0,2,2,0,2019-06-04
966,서울,광진구,2,1,0,3,3,0,2019-07-04
967,서울,광진구,0,1,0,1,1,0,2019-08-04
968,서울,광진구,5,0,3,8,5,0,2019-09-04
969,서울,광진구,3,0,2,5,5,0,2019-10-04
970,서울,광진구,2,0,1,3,3,0,2019-11-04
971,서울,광진구,3,0,0,3,2,0,2019-12-04
972,서울,구로구,3,0,1,4,3,0,2019-01-04
973,서울,구로구,1,0,1,2,1,0,2019-02-04
974,서울,구로구,2,0,0,2,2,0,2019-03-04
975,서울,구로구,0,0,2,2,2,0,2019-04-04
976,서울,구로구,6,0,3,9,6,0,2019-05-04
977,서울,구로구,3,0,3,6,6,0,2019-06-04
978,서울,구로구,4,1,4,9,6,0,2019-07-04
979,서울,구로구,5,0,0,5,5,0,2019-08-04
980,서울,구로구,8,0,1,9,9,0,2019-09-04
981,서울,구로구,2,1,0,3,3,0,2019-10-04
982,서울,구로구,6,2,2,10,8,0,2019-11-04
983,서울,구로구,3,1,0,4,4,0,2019-12-04
984,서울,금천구,0,0,4,4,4,0,2019-01-04
985,서울,금천구,2,0,0,2,2,0,2019-02-04
986,서울,금천구,4,0,1,5,4,0,2019-03-04
987,서울,금천구,0,0,0,0,0,0,2019-04-04
988,서울,금천구,0,1,1,2,1,0,2019-05-04
989,서울,금천구,7,1,0,8,6,0,2019-06-04
990,서울,금천구,2,0,0,2,2,0,2019-07-04
991,서울,금천구,1,0,1,2,1,0,2019-08-04
992,서울,금천구,2,0,0,2,2,0,2019-09-04
993,서울,금천구,5,0,0,5,4,0,2019-10-04
994,서울,금천구,3,0,1,4,3,0,2019-11-04
995,서울,금천구,3,0,0,3,3,0,2019-12-04
996,서울,노원구,4,0,0,4,2,0,2019-01-04
997,서울,노원구,6,0,0,6,2,0,2019-02-04
998,서울,노원구,3,0,2,5,4,0,2019-03-04
999,서울,노원구,2,0,0,2,2,0,2019-04-04
1000,서울,노원구,2,0,0,2,2,0,2019-05-04
1001,서울,노원구,6,0,3,9,7,0,2019-06-04
1002,서울,노원구,3,2,0,5,4,0,2019-07-04
1003,서울,노원구,4,1,1,6,4,0,2019-08-04
1004,서울,노원구,7,0,0,7,7,0,2019-09-04
1005,서울,노원구,8,0,2,10,6,0,2019-10-04
1006,서울,노원구,8,0,4,12,9,0,2019-11-04
1007,서울,노원구,7,0,2,9,6,0,2019-12-04
1008,서울,도봉구,1,0,2,3,3,0,2019-01-04
1009,서울,도봉구,1,0,2,3,1,0,2019-02-04
1010,서울,도봉구,3,0,0,3,3,0,2019-03-04
1011,서울,도봉구,1,0,1,2,2,0,2019-04-04
1012,서울,도봉구,3,2,3,8,5,0,2019-05-04
1013,서울,도봉구,3,1,2,6,6,0,2019-06-04
1014,서울,도봉구,0,1,0,1,1,0,2019-07-04
1015,서울,도봉구,0,0,0,0,0,0,2019-08-04
1016,서울,도봉구,4,2,0,6,1,0,2019-09-04
1017,서울,도봉구,1,1,0,2,2,0,2019-10-04
1018,서울,도봉구,1,0,0,1,1,0,2019-11-04
1019,서울,도봉구,1,0,0,1,1,0,2019-12-04
1020,서울,동대문구,5,0,1,6,6,0,2019-01-04
1021,서울,동대문구,4,0,1,5,1,0,2019-02-04
1022,서울,동대문구,2,0,1,3,3,0,2019-03-04
1023,서울,동대문구,3,1,5,9,7,0,2019-04-04
1024,서울,동대문구,4,0,1,5,5,0,2019-05-04
1025,서울,동대문구,3,0,0,3,3,0,2019-06-04
1026,서울,동대문구,4,0,0,4,4,0,2019-07-04
1027,서울,동대문구,11,1,2,14,7,0,2019-08-04
1028,서울,동대문구,7,0,1,8,8,0,2019-09-04
1029,서울,동대문구,1,1,2,4,4,1,2019-10-04
1030,서울,동대문구,15,1,1,17,11,0,2019-11-04
1031,서울,동대문구,3,0,3,6,5,0,2019-12-04
1032,서울,동작구,2,0,2,4,4,0,2019-01-04
1033,서울,동작구,0,0,0,0,0,0,2019-02-04
1034,서울,동작구,2,1,0,3,3,0,2019-03-04
1035,서울,동작구,2,0,0,2,2,0,2019-04-04
1036,서울,동작구,4,1,1,6,4,0,2019-05-04
1037,서울,동작구,5,0,2,7,4,0,2019-06-04
1038,서울,동작구,4,0,0,4,4,0,2019-07-04
1039,서울,동작구,2,1,0,3,2,0,2019-08-04
1040,서울,동작구,2,1,0,3,2,0,2019-09-04
1041,서울,동작구,10,1,0,11,6,0,2019-10-04
1042,서울,동작구,0,1,1,2,1,0,2019-11-04
1043,서울,동작구,10,1,2,13,4,0,2019-12-04
1044,서울,마포구,3,0,0,3,2,0,2019-01-04
1045,서울,마포구,1,0,0,1,1,0,2019-02-04
1046,서울,마포구,1,0,0,1,1,0,2019-03-04
1047,서울,마포구,4,1,1,6,5,0,2019-04-04
1048,서울,마포구,2,2,1,5,5,0,2019-05-04
1049,서울,마포구,2,0,0,2,2,0,2019-06-04
1050,서울,마포구,11,0,3,14,10,0,2019-07-04
1051,서울,마포구,15,0,2,17,9,0,2019-08-04
1052,서울,마포구,1,0,0,1,1,0,2019-09-04
1053,서울,마포구,4,0,0,4,4,0,2019-10-04
1054,서울,마포구,8,0,4,12,8,0,2019-11-04
1055,서울,마포구,3,2,1,6,4,0,2019-12-04
1056,서울,서대문구,3,0,2,5,5,0,2019-01-04
1057,서울,서대문구,0,0,0,0,0,0,2019-02-04
1058,서울,서대문구,0,1,0,1,1,0,2019-03-04
1059,서울,서대문구,0,0,2,2,2,0,2019-04-04
1060,서울,서대문구,3,0,2,5,4,0,2019-05-04
1061,서울,서대문구,1,2,0,3,2,0,2019-06-04
1062,서울,서대문구,1,1,0,2,2,0,2019-07-04
1063,서울,서대문구,5,0,1,6,5,0,2019-08-04
1064,서울,서대문구,1,0,3,4,4,0,2019-09-04
1065,서울,서대문구,6,1,1,8,6,0,2019-10-04
1066,서울,서대문구,1,0,0,1,1,0,2019-11-04
1067,서울,서대문구,2,1,0,3,2,0,2019-12-04
1068,서울,서초구,4,0,1,5,5,0,2019-01-04
1069,서울,서초구,4,0,3,7,3,0,2019-02-04
1070,서울,서초구,5,0,1,6,5,0,2019-03-04
1071,서울,서초구,13,0,0,13,8,0,2019-04-04
1072,서울,서초구,3,0,0,3,3,0,2019-05-04
1073,서울,서초구,6,0,2,8,7,0,2019-06-04
1074,서울,서초구,4,2,4,10,7,0,2019-07-04
1075,서울,서초구,6,0,1,7,5,0,2019-08-04
1076,서울,서초구,6,0,0,6,5,0,2019-09-04
1077,서울,서초구,11,2,1,14,13,0,2019-10-04
1078,서울,서초구,10,1,4,15,14,0,2019-11-04
1079,서울,서초구,9,0,2,11,5,0,2019-12-04
1080,서울,성동구,2,0,0,2,2,0,2019-01-04
1081,서울,성동구,0,0,0,0,0,0,2019-02-04
1082,서울,성동구,2,1,0,3,3,0,2019-03-04
1083,서울,성동구,9,1,1,11,4,0,2019-04-04
1084,서울,성동구,2,0,1,3,3,0,2019-05-04
1085,서울,성동구,4,0,2,6,6,0,2019-06-04
1086,서울,성동구,3,0,0,3,3,0,2019-07-04
1087,서울,성동구,0,0,0,0,0,0,2019-08-04
1088,서울,성동구,1,0,0,1,1,0,2019-09-04
1089,서울,성동구,2,0,1,3,2,0,2019-10-04
1090,서울,성동구,2,0,2,4,4,0,2019-11-04
1091,서울,성동구,0,0,0,0,0,0,2019-12-04
1092,서울,성북구,0,0,0,0,0,0,2019-01-04
1093,서울,성북구,1,0,0,1,1,0,2019-02-04
1094,서울,성북구,3,0,0,3,3,0,2019-03-04
1095,서울,성북구,4,0,2,6,6,0,2019-04-04
1096,서울,성북구,6,0,2,8,5,0,2019-05-04
1097,서울,성북구,1,0,1,2,1,0,2019-06-04
1098,서울,성북구,6,1,2,9,7,0,2019-07-04
1099,서울,성북구,1,0,0,1,1,0,2019-08-04
1100,서울,성북구,4,0,0,4,4,0,2019-09-04
1101,서울,성북구,9,0,2,11,8,0,2019-10-04
1102,서울,성북구,0,0,1,1,1,0,2019-11-04
1103,서울,성북구,2,1,2,5,4,0,2019-12-04
1104,서울,송파구,5,6,4,15,5,0,2019-01-04
1105,서울,송파구,5,1,0,6,5,0,2019-02-04
1106,서울,송파구,17,0,2,19,11,0,2019-03-04
1107,서울,송파구,15,0,1,16,10,0,2019-04-04
1108,서울,송파구,11,0,1,12,7,0,2019-05-04
1109,서울,송파구,11,1,0,12,8,0,2019-06-04
1110,서울,송파구,9,1,1,11,8,0,2019-07-04
1111,서울,송파구,8,1,3,12,7,0,2019-08-04
1112,서울,송파구,4,0,3,7,6,0,2019-09-04
1113,서울,송파구,14,2,1,17,12,0,2019-10-04
1114,서울,송파구,5,1,1,7,7,0,2019-11-04
1115,서울,송파구,17,6,2,25,14,0,2019-12-04
1116,서울,양천구,8,0,4,12,10,0,2019-01-04
1117,서울,양천구,3,0,1,4,3,0,2019-02-04
1118,서울,양천구,1,1,0,2,1,0,2019-03-04
1119,서울,양천구,3,0,0,3,3,0,2019-04-04
1120,서울,양천구,3,0,1,4,3,1,2019-05-04
1121,서울,양천구,2,0,1,3,2,0,2019-06-04
1122,서울,양천구,5,1,0,6,5,0,2019-07-04
1123,서울,양천구,2,1,0,3,3,0,2019-08-04
1124,서울,양천구,2,1,1,4,4,0,2019-09-04
1125,서울,양천구,4,0,2,6,4,0,2019-10-04
1126,서울,양천구,2,0,0,2,2,0,2019-11-04
1127,서울,양천구,6,0,4,10,7,0,2019-12-04
1128,서울,영등포구,4,0,2,6,5,0,2019-01-04
1129,서울,영등포구,2,0,2,4,1,0,2019-02-04
1130,서울,영등포구,5,2,0,7,5,0,2019-03-04
1131,서울,영등포구,5,1,2,8,8,0,2019-04-04
1132,서울,영등포구,7,1,2,10,6,0,2019-05-04
1133,서울,영등포구,5,0,2,7,7,0,2019-06-04
1134,서울,영등포구,4,1,0,5,5,0,2019-07-04
1135,서울,영등포구,4,1,5,10,9,0,2019-08-04
1136,서울,영등포구,10,0,0,10,5,0,2019-09-04
1137,서울,영등포구,8,1,0,9,6,0,2019-10-04
1138,서울,영등포구,8,0,2,10,9,0,2019-11-04
1139,서울,영등포구,7,1,1,9,7,0,2019-12-04
1140,서울,용산구,2,0,1,3,3,0,2019-01-04
1141,서울,용산구,0,0,3,3,3,0,2019-02-04
1142,서울,용산구,2,0,0,2,2,0,2019-03-04
1143,서울,용산구,5,2,1,8,6,0,2019-04-04
1144,서울,용산구,8,0,0,8,4,0,2019-05-04
1145,서울,용산구,5,0,2,7,4,0,2019-06-04
1146,서울,용산구,2,1,1,4,4,0,2019-07-04
1147,서울,용산구,0,0,0,0,0,0,2019-08-04
1148,서울,용산구,0,0,0,0,0,0,2019-09-04
1149,서울,용산구,6,0,0,6,5,0,2019-10-04
1150,서울,용산구,2,0,0,2,2,0,2019-11-04
1151,서울,용산구,3,0,0,3,3,0,2019-12-04
1152,서울,은평구,3,2,2,7,5,0,2019-01-04
1153,서울,은평구,2,1,1,4,4,0,2019-02-04
1154,서울,은평구,1,0,0,1,1,0,2019-03-04
1155,서울,은평구,1,0,0,1,1,0,2019-04-04
1156,서울,은평구,8,0,3,11,8,0,2019-05-04
1157,서울,은평구,4,0,0,4,3,0,2019-06-04
1158,서울,은평구,1,0,0,1,1,0,2019-07-04
1159,서울,은평구,0,0,1,1,1,0,2019-08-04
1160,서울,은평구,4,0,2,6,3,0,2019-09-04
1161,서울,은평구,2,0,3,5,4,0,2019-10-04
1162,서울,은평구,1,0,1,2,2,0,2019-11-04
1163,서울,은평구,1,1,1,3,2,0,2019-12-04
1164,서울,종로구,2,0,1,3,3,0,2019-01-04
1165,서울,종로구,2,1,1,4,2,0,2019-02-04
1166,서울,종로구,2,1,0,3,2,0,2019-03-04
1167,서울,종로구,4,0,0,4,4,0,2019-04-04
1168,서울,종로구,5,0,2,7,4,0,2019-05-04
1169,서울,종로구,4,1,1,6,5,0,2019-06-04
1170,서울,종로구,5,0,0,5,4,0,2019-07-04
1171,서울,종로구,5,1,0,6,3,0,2019-08-04
1172,서울,종로구,1,1,1,3,3,0,2019-09-04
1173,서울,종로구,4,0,1,5,5,0,2019-10-04
1174,서울,종로구,4,1,0,5,4,0,2019-11-04
1175,서울,종로구,2,1,0,3,3,0,2019-12-04
1176,서울,중구,2,0,1,3,3,0,2019-01-04
1177,서울,중구,0,0,0,0,0,0,2019-02-04
1178,서울,중구,1,0,1,2,2,0,2019-03-04
1179,서울,중구,1,1,1,3,3,0,2019-04-04
1180,서울,중구,4,1,1,6,5,0,2019-05-04
1181,서울,중구,1,0,0,1,1,0,2019-06-04
1182,서울,중구,1,0,1,2,1,0,2019-07-04
1183,서울,중구,2,0,0,2,2,0,2019-08-04
1184,서울,중구,3,0,0,3,3,0,2019-09-04
1185,서울,중구,2,0,0,2,1,0,2019-10-04
1186,서울,중구,4,1,2,7,5,0,2019-11-04
1187,서울,중구,5,0,1,6,4,0,2019-12-04
1188,서울,중랑구,3,1,0,4,4,0,2019-01-04
1189,서울,중랑구,1,0,0,1,1,0,2019-02-04
1190,서울,중랑구,2,0,0,2,2,0,2019-03-04
1191,서울,중랑구,10,1,1,12,9,0,2019-04-04
1192,서울,중랑구,2,0,0,2,2,0,2019-05-04
1193,서울,중랑구,7,3,2,12,9,0,2019-06-04
1194,서울,중랑구,10,0,3,13,9,0,2019-07-04
1195,서울,중랑구,4,1,1,6,3,0,2019-08-04
1196,서울,중랑구,1,5,1,7,6,0,2019-09-04
1197,서울,중랑구,4,1,3,8,7,0,2019-10-04
1198,서울,중랑구,6,1,0,7,5,0,2019-11-04
1199,서울,중랑구,8,0,0,8,6,0,2019-12-04
1200,서울,강남구,13,6,3,22,11,0,2019-01-05
1201,서울,강남구,1,1,2,4,4,0,2019-02-05
1202,서울,강남구,4,0,5,9,6,0,2019-03-05
1203,서울,강남구,9,0,0,9,3,0,2019-04-05
1204,서울,강남구,1,1,1,3,2,0,2019-05-05
1205,서울,강남구,8,2,0,10,6,0,2019-06-05
1206,서울,강남구,19,0,0,19,14,0,2019-07-05
1207,서울,강남구,10,3,1,14,8,0,2019-08-05
1208,서울,강남구,8,1,2,11,10,0,2019-09-05
1209,서울,강남구,8,6,3,17,12,0,2019-10-05
1210,서울,강남구,6,1,4,11,10,0,2019-11-05
1211,서울,강남구,17,1,1,19,15,0,2019-12-05
1212,서울,강동구,3,0,0,3,2,0,2019-01-05
1213,서울,강동구,2,1,0,3,2,0,2019-02-05
1214,서울,강동구,3,0,0,3,3,0,2019-03-05
1215,서울,강동구,2,1,1,4,4,0,2019-04-05
1216,서울,강동구,0,0,3,3,4,1,2019-05-05
1217,서울,강동구,5,0,0,5,4,0,2019-06-05
1218,서울,강동구,4,0,2,6,5,0,2019-07-05
1219,서울,강동구,2,1,3,6,6,0,2019-08-05
1220,서울,강동구,4,0,0,4,4,0,2019-09-05
1221,서울,강동구,2,0,0,2,1,0,2019-10-05
1222,서울,강동구,2,1,1,4,4,0,2019-11-05
1223,서울,강동구,2,0,2,4,4,0,2019-12-05
1224,서울,강북구,2,0,0,2,2,0,2019-01-05
1225,서울,강북구,0,0,1,1,1,0,2019-02-05
1226,서울,강북구,1,0,0,1,1,0,2019-03-05
1227,서울,강북구,7,0,0,7,3,0,2019-04-05
1228,서울,강북구,1,1,0,2,2,0,2019-05-05
1229,서울,강북구,6,2,1,9,5,0,2019-06-05
1230,서울,강북구,0,0,2,2,2,0,2019-07-05
1231,서울,강북구,1,0,0,1,1,0,2019-08-05
1232,서울,강북구,9,0,2,11,7,0,2019-09-05
1233,서울,강북구,1,0,0,1,1,0,2019-10-05
1234,서울,강북구,2,0,1,3,3,0,2019-11-05
1235,서울,강북구,3,0,0,3,3,0,2019-12-05
1236,서울,강서구,7,1,1,9,8,0,2019-01-05
1237,서울,강서구,3,0,0,3,1,0,2019-02-05
1238,서울,강서구,6,0,0,6,5,0,2019-03-05
1239,서울,강서구,7,0,2,9,8,0,2019-04-05
1240,서울,강서구,2,0,1,3,3,0,2019-05-05
1241,서울,강서구,0,2,1,3,3,0,2019-06-05
1242,서울,강서구,12,1,2,15,11,0,2019-07-05
1243,서울,강서구,3,0,0,3,2,0,2019-08-05
1244,서울,강서구,7,0,0,7,6,0,2019-09-05
1245,서울,강서구,4,0,1,5,4,0,2019-10-05
1246,서울,강서구,4,0,0,4,5,1,2019-11-05
1247,서울,강서구,8,0,1,9,8,0,2019-12-05
1248,서울,관악구,0,1,0,1,1,0,2019-01-05
1249,서울,관악구,3,0,0,3,2,0,2019-02-05
1250,서울,관악구,1,0,1,2,2,0,2019-03-05
1251,서울,관악구,3,0,1,4,4,0,2019-04-05
1252,서울,관악구,3,0,0,3,3,0,2019-05-05
1253,서울,관악구,3,0,2,5,5,0,2019-06-05
1254,서울,관악구,4,0,1,5,4,0,2019-07-05
1255,서울,관악구,3,0,2,5,5,0,2019-08-05
1256,서울,관악구,7,0,0,7,5,0,2019-09-05
1257,서울,관악구,2,1,0,3,3,0,2019-10-05
1258,서울,관악구,0,0,2,2,2,0,2019-11-05
1259,서울,관악구,3,0,0,3,3,0,2019-12-05
1260,서울,광진구,3,0,0,3,2,0,2019-01-05
1261,서울,광진구,0,1,1,2,2,0,2019-02-05
1262,서울,광진구,5,0,1,6,5,0,2019-03-05
1263,서울,광진구,1,0,2,3,3,0,2019-04-05
1264,서울,광진구,2,0,2,4,3,0,2019-05-05
1265,서울,광진구,1,1,1,3,3,0,2019-06-05
1266,서울,광진구,3,1,1,5,4,1,2019-07-05
1267,서울,광진구,2,0,0,2,2,0,2019-08-05
1268,서울,광진구,2,0,1,3,2,0,2019-09-05
1269,서울,광진구,0,0,0,0,0,0,2019-10-05
1270,서울,광진구,3,0,1,4,3,0,2019-11-05
1271,서울,광진구,1,0,0,1,1,0,2019-12-05
1272,서울,구로구,8,2,3,13,7,0,2019-01-05
1273,서울,구로구,1,0,0,1,1,0,2019-02-05
1274,서울,구로구,2,0,1,3,2,0,2019-03-05
1275,서울,구로구,7,0,1,8,4,0,2019-04-05
1276,서울,구로구,9,0,4,13,7,0,2019-05-05
1277,서울,구로구,7,1,0,8,6,0,2019-06-05
1278,서울,구로구,5,0,0,5,3,0,2019-07-05
1279,서울,구로구,5,0,2,7,7,0,2019-08-05
1280,서울,구로구,3,1,2,6,3,0,2019-09-05
1281,서울,구로구,9,0,0,9,3,0,2019-10-05
1282,서울,구로구,1,0,2,3,3,0,2019-11-05
1283,서울,구로구,5,0,3,8,7,0,2019-12-05
1284,서울,금천구,5,0,0,5,4,0,2019-01-05
1285,서울,금천구,1,1,0,2,1,0,2019-02-05
1286,서울,금천구,2,0,1,3,3,0,2019-03-05
1287,서울,금천구,6,1,1,8,5,0,2019-04-05
1288,서울,금천구,1,0,2,3,2,0,2019-05-05
1289,서울,금천구,0,1,0,1,1,0,2019-06-05
1290,서울,금천구,3,0,0,3,3,0,2019-07-05
1291,서울,금천구,4,0,0,4,3,0,2019-08-05
1292,서울,금천구,3,0,0,3,2,1,2019-09-05
1293,서울,금천구,1,0,0,1,1,0,2019-10-05
1294,서울,금천구,3,0,3,6,5,0,2019-11-05
1295,서울,금천구,1,0,4,5,3,0,2019-12-05
1296,서울,노원구,6,0,1,7,4,0,2019-01-05
1297,서울,노원구,0,0,0,0,0,0,2019-02-05
1298,서울,노원구,0,0,2,2,2,0,2019-03-05
1299,서울,노원구,8,0,2,10,7,0,2019-04-05
1300,서울,노원구,8,3,0,11,8,0,2019-05-05
1301,서울,노원구,2,0,0,2,1,0,2019-06-05
1302,서울,노원구,0,1,1,2,2,0,2019-07-05
1303,서울,노원구,2,1,2,5,5,0,2019-08-05
1304,서울,노원구,4,0,3,7,7,0,2019-09-05
1305,서울,노원구,3,1,3,7,4,0,2019-10-05
1306,서울,노원구,5,0,5,10,9,0,2019-11-05
1307,서울,노원구,0,1,1,2,2,0,2019-12-05
1308,서울,도봉구,1,1,0,2,2,0,2019-01-05
1309,서울,도봉구,2,1,1,4,2,0,2019-02-05
1310,서울,도봉구,0,0,0,0,0,0,2019-03-05
1311,서울,도봉구,3,1,0,4,3,0,2019-04-05
1312,서울,도봉구,1,1,0,2,2,0,2019-05-05
1313,서울,도봉구,6,0,1,7,6,0,2019-06-05
1314,서울,도봉구,4,0,0,4,3,0,2019-07-05
1315,서울,도봉구,0,1,2,3,3,0,2019-08-05
1316,서울,도봉구,5,0,1,6,5,0,2019-09-05
1317,서울,도봉구,0,1,0,1,1,0,2019-10-05
1318,서울,도봉구,4,0,1,5,5,0,2019-11-05
1319,서울,도봉구,1,0,1,2,2,0,2019-12-05
1320,서울,동대문구,5,0,2,7,6,0,2019-01-05
1321,서울,동대문구,4,0,0,4,2,0,2019-02-05
1322,서울,동대문구,1,0,3,4,3,0,2019-03-05
1323,서울,동대문구,1,1,3,5,5,0,2019-04-05
1324,서울,동대문구,3,0,3,6,2,0,2019-05-05
1325,서울,동대문구,4,1,3,8,5,0,2019-06-05
1326,서울,동대문구,7,0,2,9,5,0,2019-07-05
1327,서울,동대문구,1,0,0,1,1,0,2019-08-05
1328,서울,동대문구,2,0,2,4,4,0,2019-09-05
1329,서울,동대문구,6,0,0,6,5,0,2019-10-05
1330,서울,동대문구,2,1,3,6,5,0,2019-11-05
1331,서울,동대문구,6,0,2,8,6,0,2019-12-05
1332,서울,동작구,1,1,1,3,3,0,2019-01-05
1333,서울,동작구,2,2,1,5,2,0,2019-02-05
1334,서울,동작구,3,1,0,4,4,0,2019-03-05
1335,서울,동작구,2,2,0,4,3,0,2019-04-05
1336,서울,동작구,7,1,6,14,8,0,2019-05-05
1337,서울,동작구,6,0,0,6,4,0,2019-06-05
1338,서울,동작구,5,1,2,8,6,0,2019-07-05
1339,서울,동작구,4,3,1,8,5,0,2019-08-05
1340,서울,동작구,4,0,0,4,3,0,2019-09-05
1341,서울,동작구,2,2,1,5,5,0,2019-10-05
1342,서울,동작구,3,0,2,5,5,0,2019-11-05
1343,서울,동작구,5,0,1,6,3,0,2019-12-05
1344,서울,마포구,1,0,0,1,1,0,2019-01-05
1345,서울,마포구,1,0,1,2,2,0,2019-02-05
1346,서울,마포구,3,0,2,5,5,0,2019-03-05
1347,서울,마포구,4,0,0,4,3,0,2019-04-05
1348,서울,마포구,1,0,0,1,1,0,2019-05-05
1349,서울,마포구,4,0,3,7,6,0,2019-06-05
1350,서울,마포구,8,0,3,11,5,0,2019-07-05
1351,서울,마포구,0,3,2,5,4,0,2019-08-05
1352,서울,마포구,13,0,1,14,7,0,2019-09-05
1353,서울,마포구,8,0,1,9,2,0,2019-10-05
1354,서울,마포구,6,0,0,6,5,0,2019-11-05
1355,서울,마포구,3,0,2,5,5,0,2019-12-05
1356,서울,서대문구,2,0,0,2,2,0,2019-01-05
1357,서울,서대문구,0,0,1,1,1,0,2019-02-05
1358,서울,서대문구,2,0,2,4,4,0,2019-03-05
1359,서울,서대문구,2,0,0,2,2,0,2019-04-05
1360,서울,서대문구,3,1,4,8,6,0,2019-05-05
1361,서울,서대문구,2,0,1,3,3,0,2019-06-05
1362,서울,서대문구,1,1,1,3,3,0,2019-07-05
1363,서울,서대문구,2,0,0,2,1,0,2019-08-05
1364,서울,서대문구,4,0,0,4,3,0,2019-09-05
1365,서울,서대문구,7,0,1,8,3,0,2019-10-05
1366,서울,서대문구,2,0,1,3,3,0,2019-11-05
1367,서울,서대문구,2,0,2,4,3,0,2019-12-05
1368,서울,서초구,10,0,2,12,7,0,2019-01-05
1369,서울,서초구,4,0,0,4,3,0,2019-02-05
1370,서울,서초구,8,0,0,8,6,0,2019-03-05
1371,서울,서초구,6,1,2,9,4,0,2019-04-05
1372,서울,서초구,7,1,2,10,6,0,2019-05-05
1373,서울,서초구,8,1,6,15,11,0,2019-06-05
1374,서울,서초구,10,1,0,11,8,0,2019-07-05
1375,서울,서초구,2,0,0,2,2,0,2019-08-05
1376,서울,서초구,7,0,1,8,7,0,2019-09-05
1377,서울,서초구,22,1,1,24,11,0,2019-10-05
1378,서울,서초구,7,1,2,10,6,0,2019-11-05
1379,서울,서초구,3,1,0,4,4,0,2019-12-05
1380,서울,성동구,0,0,0,0,0,0,2019-01-05
1381,서울,성동구,2,0,0,2,2,0,2019-02-05
1382,서울,성동구,3,0,1,4,2,0,2019-03-05
1383,서울,성동구,6,3,1,10,6,0,2019-04-05
1384,서울,성동구,4,0,2,6,3,0,2019-05-05
1385,서울,성동구,1,0,2,3,3,0,2019-06-05
1386,서울,성동구,5,1,2,8,4,0,2019-07-05
1387,서울,성동구,2,1,0,3,3,0,2019-08-05
1388,서울,성동구,1,2,1,4,2,0,2019-09-05
1389,서울,성동구,4,0,0,4,5,1,2019-10-05
1390,서울,성동구,0,0,0,0,0,0,2019-11-05
1391,서울,성동구,1,0,0,1,1,0,2019-12-05
1392,서울,성북구,3,0,0,3,1,0,2019-01-05
1393,서울,성북구,0,0,0,0,0,0,2019-02-05
1394,서울,성북구,4,0,4,8,7,0,2019-03-05
1395,서울,성북구,4,1,0,5,5,0,2019-04-05
1396,서울,성북구,4,0,2,6,5,0,2019-05-05
1397,서울,성북구,3,0,2,5,5,0,2019-06-05
1398,서울,성북구,3,0,2,5,4,0,2019-07-05
1399,서울,성북구,1,0,1,2,2,0,2019-08-05
1400,서울,성북구,0,0,2,2,2,0,2019-09-05
1401,서울,성북구,11,0,2,13,6,0,2019-10-05
1402,서울,성북구,1,1,4,6,5,0,2019-11-05
1403,서울,성북구,5,1,3,9,9,0,2019-12-05
1404,서울,송파구,0,2,3,5,4,0,2019-01-05
1405,서울,송파구,1,0,1,2,2,0,2019-02-05
1406,서울,송파구,7,0,1,8,3,0,2019-03-05
1407,서울,송파구,5,2,1,8,7,0,2019-04-05
1408,서울,송파구,5,2,2,9,6,0,2019-05-05
1409,서울,송파구,7,2,2,11,10,0,2019-06-05
1410,서울,송파구,7,0,1,8,7,0,2019-07-05
1411,서울,송파구,6,2,2,10,7,0,2019-08-05
1412,서울,송파구,7,3,1,11,8,0,2019-09-05
1413,서울,송파구,18,0,3,21,12,0,2019-10-05
1414,서울,송파구,9,0,2,11,11,0,2019-11-05
1415,서울,송파구,4,1,2,7,7,0,2019-12-05
1416,서울,양천구,9,0,0,9,2,0,2019-01-05
1417,서울,양천구,0,0,0,0,0,0,2019-02-05
1418,서울,양천구,2,0,0,2,1,0,2019-03-05
1419,서울,양천구,7,1,2,10,9,0,2019-04-05
1420,서울,양천구,3,2,0,5,4,0,2019-05-05
1421,서울,양천구,11,0,2,13,10,1,2019-06-05
1422,서울,양천구,2,1,1,4,4,0,2019-07-05
1423,서울,양천구,10,1,1,12,9,0,2019-08-05
1424,서울,양천구,4,1,2,7,7,0,2019-09-05
1425,서울,양천구,13,2,4,19,9,0,2019-10-05
1426,서울,양천구,1,2,1,4,3,0,2019-11-05
1427,서울,양천구,5,1,2,8,5,0,2019-12-05
1428,서울,영등포구,5,0,2,7,5,0,2019-01-05
1429,서울,영등포구,4,0,0,4,3,0,2019-02-05
1430,서울,영등포구,8,1,0,9,7,0,2019-03-05
1431,서울,영등포구,17,2,6,25,13,0,2019-04-05
1432,서울,영등포구,3,0,2,5,3,0,2019-05-05
1433,서울,영등포구,11,1,2,14,10,1,2019-06-05
1434,서울,영등포구,7,0,3,10,10,0,2019-07-05
1435,서울,영등포구,7,0,3,10,7,0,2019-08-05
1436,서울,영등포구,3,0,0,3,3,0,2019-09-05
1437,서울,영등포구,8,1,4,13,9,0,2019-10-05
1438,서울,영등포구,9,0,2,11,8,0,2019-11-05
1439,서울,영등포구,8,2,2,12,11,0,2019-12-05
1440,서울,용산구,5,0,2,7,4,0,2019-01-05
1441,서울,용산구,2,0,1,3,2,0,2019-02-05
1442,서울,용산구,2,0,0,2,2,0,2019-03-05
1443,서울,용산구,2,0,0,2,2,0,2019-04-05
1444,서울,용산구,5,1,0,6,5,0,2019-05-05
1445,서울,용산구,4,0,3,7,7,0,2019-06-05
1446,서울,용산구,4,1,0,5,3,0,2019-07-05
1447,서울,용산구,4,0,0,4,3,0,2019-08-05
1448,서울,용산구,2,0,2,4,3,0,2019-09-05
1449,서울,용산구,2,0,0,2,2,0,2019-10-05
1450,서울,용산구,6,0,1,7,5,0,2019-11-05
1451,서울,용산구,1,0,1,2,2,0,2019-12-05
1452,서울,은평구,8,0,1,9,5,0,2019-01-05
1453,서울,은평구,0,0,0,0,0,0,2019-02-05
1454,서울,은평구,1,0,0,1,1,0,2019-03-05
1455,서울,은평구,6,0,1,7,5,0,2019-04-05
1456,서울,은평구,5,0,1,6,3,0,2019-05-05
1457,서울,은평구,3,3,4,10,7,0,2019-06-05
1458,서울,은평구,2,0,0,2,2,0,2019-07-05
1459,서울,은평구,1,0,3,4,4,0,2019-08-05
1460,서울,은평구,1,0,0,1,1,0,2019-09-05
1461,서울,은평구,1,1,0,2,2,0,2019-10-05
1462,서울,은평구,2,1,0,3,3,0,2019-11-05
1463,서울,은평구,1,0,1,2,2,0,2019-12-05
1464,서울,종로구,9,1,2,12,7,0,2019-01-05
1465,서울,종로구,1,1,0,2,1,0,2019-02-05
1466,서울,종로구,0,0,0,0,0,0,2019-03-05
1467,서울,종로구,2,0,0,2,2,0,2019-04-05
1468,서울,종로구,2,0,0,2,2,0,2019-05-05
1469,서울,종로구,4,1,1,6,6,0,2019-06-05
1470,서울,종로구,0,0,0,0,0,0,2019-07-05
1471,서울,종로구,7,2,1,10,5,0,2019-08-05
1472,서울,종로구,6,0,1,7,6,0,2019-09-05
1473,서울,종로구,6,0,0,6,5,0,2019-10-05
1474,서울,종로구,2,0,0,2,2,0,2019-11-05
1475,서울,종로구,2,2,4,8,6,0,2019-12-05
1476,서울,중구,0,0,0,0,0,0,2019-01-05
1477,서울,중구,0,0,1,1,1,0,2019-02-05
1478,서울,중구,1,0,0,1,1,0,2019-03-05
1479,서울,중구,4,0,1,5,2,0,2019-04-05
1480,서울,중구,0,0,0,0,0,0,2019-05-05
1481,서울,중구,3,0,2,5,4,0,2019-06-05
1482,서울,중구,0,1,0,1,1,0,2019-07-05
1483,서울,중구,3,0,1,4,3,0,2019-08-05
1484,서울,중구,4,1,1,6,4,0,2019-09-05
1485,서울,중구,0,0,0,0,0,0,2019-10-05
1486,서울,중구,6,0,1,7,6,0,2019-11-05
1487,서울,중구,5,0,4,9,8,0,2019-12-05
1488,서울,중랑구,3,2,0,5,5,0,2019-01-05
1489,서울,중랑구,0,0,1,1,1,0,2019-02-05
1490,서울,중랑구,2,0,0,2,1,0,2019-03-05
1491,서울,중랑구,6,0,4,10,9,0,2019-04-05
1492,서울,중랑구,2,1,1,4,4,0,2019-05-05
1493,서울,중랑구,4,0,0,4,3,0,2019-06-05
1494,서울,중랑구,3,0,1,4,3,0,2019-07-05
1495,서울,중랑구,3,1,1,5,4,0,2019-08-05
1496,서울,중랑구,8,0,0,8,5,0,2019-09-05
1497,서울,중랑구,2,2,2,6,5,0,2019-10-05
1498,서울,중랑구,10,2,1,13,8,0,2019-11-05
1499,서울,중랑구,2,2,6,10,10,0,2019-12-05
1500,서울,강남구,4,0,1,5,4,0,2019-01-06
1501,서울,강남구,1,1,0,2,2,0,2019-02-06
1502,서울,강남구,12,2,2,16,12,0,2019-03-06
1503,서울,강남구,20,3,1,24,17,0,2019-04-06
1504,서울,강남구,1,2,0,3,3,0,2019-05-06
1505,서울,강남구,8,0,1,9,8,0,2019-06-06
1506,서울,강남구,11,0,1,12,8,0,2019-07-06
1507,서울,강남구,13,2,1,16,12,0,2019-08-06
1508,서울,강남구,17,2,3,22,17,0,2019-09-06
1509,서울,강남구,4,0,1,5,3,0,2019-10-06
1510,서울,강남구,7,2,2,11,9,0,2019-11-06
1511,서울,강남구,10,1,3,14,12,0,2019-12-06
1512,서울,강동구,2,1,0,3,3,0,2019-01-06
1513,서울,강동구,3,0,1,4,2,0,2019-02-06
1514,서울,강동구,5,0,0,5,4,0,2019-03-06
1515,서울,강동구,3,0,2,5,4,0,2019-04-06
1516,서울,강동구,2,1,1,4,2,0,2019-05-06
1517,서울,강동구,3,0,1,4,4,1,2019-06-06
1518,서울,강동구,3,0,1,4,4,0,2019-07-06
1519,서울,강동구,7,1,1,9,5,0,2019-08-06
1520,서울,강동구,4,2,0,6,5,0,2019-09-06
1521,서울,강동구,6,1,0,7,5,0,2019-10-06
1522,서울,강동구,4,1,2,7,5,0,2019-11-06
1523,서울,강동구,1,0,0,1,1,0,2019-12-06
1524,서울,강북구,3,0,0,3,3,0,2019-01-06
1525,서울,강북구,10,1,2,13,4,0,2019-02-06
1526,서울,강북구,10,0,1,11,8,0,2019-03-06
1527,서울,강북구,1,1,0,2,2,0,2019-04-06
1528,서울,강북구,1,1,2,4,3,0,2019-05-06
1529,서울,강북구,5,0,0,5,4,0,2019-06-06
1530,서울,강북구,4,1,0,5,5,0,2019-07-06
1531,서울,강북구,5,0,1,6,5,0,2019-08-06
1532,서울,강북구,8,1,0,9,3,0,2019-09-06
1533,서울,강북구,3,2,1,6,4,0,2019-10-06
1534,서울,강북구,5,0,0,5,4,0,2019-11-06
1535,서울,강북구,2,0,0,2,1,0,2019-12-06
1536,서울,강서구,4,1,0,5,3,0,2019-01-06
1537,서울,강서구,3,0,0,3,2,0,2019-02-06
1538,서울,강서구,4,0,1,5,4,0,2019-03-06
1539,서울,강서구,4,0,0,4,3,0,2019-04-06
1540,서울,강서구,3,1,3,7,7,2,2019-05-06
1541,서울,강서구,2,1,0,3,3,0,2019-06-06
1542,서울,강서구,3,0,0,3,3,0,2019-07-06
1543,서울,강서구,3,0,1,4,3,0,2019-08-06
1544,서울,강서구,3,0,3,6,5,0,2019-09-06
1545,서울,강서구,13,0,2,15,8,0,2019-10-06
1546,서울,강서구,2,0,2,4,2,0,2019-11-06
1547,서울,강서구,6,0,2,8,8,0,2019-12-06
1548,서울,관악구,5,0,0,5,2,0,2019-01-06
1549,서울,관악구,4,0,1,5,5,0,2019-02-06
1550,서울,관악구,1,1,0,2,3,1,2019-03-06
1551,서울,관악구,10,0,3,13,9,0,2019-04-06
1552,서울,관악구,2,1,1,4,4,0,2019-05-06
1553,서울,관악구,9,0,0,9,8,0,2019-06-06
1554,서울,관악구,2,1,0,3,2,0,2019-07-06
1555,서울,관악구,0,0,0,0,0,0,2019-08-06
1556,서울,관악구,1,1,1,3,3,0,2019-09-06
1557,서울,관악구,1,0,2,3,3,0,2019-10-06
1558,서울,관악구,2,0,0,2,2,0,2019-11-06
1559,서울,관악구,1,0,0,1,1,0,2019-12-06
1560,서울,광진구,1,0,0,1,1,0,2019-01-06
1561,서울,광진구,2,0,0,2,1,0,2019-02-06
1562,서울,광진구,3,0,0,3,3,0,2019-03-06
1563,서울,광진구,1,0,2,3,2,0,2019-04-06
1564,서울,광진구,2,1,3,6,5,0,2019-05-06
1565,서울,광진구,5,0,0,5,3,0,2019-06-06
1566,서울,광진구,5,0,0,5,4,0,2019-07-06
1567,서울,광진구,4,1,2,7,4,0,2019-08-06
1568,서울,광진구,4,0,0,4,4,0,2019-09-06
1569,서울,광진구,1,0,0,1,1,0,2019-10-06
1570,서울,광진구,1,0,0,1,1,0,2019-11-06
1571,서울,광진구,1,0,0,1,1,0,2019-12-06
1572,서울,구로구,7,0,3,10,4,0,2019-01-06
1573,서울,구로구,1,0,2,3,3,0,2019-02-06
1574,서울,구로구,3,0,1,4,3,0,2019-03-06
1575,서울,구로구,1,0,0,1,1,0,2019-04-06
1576,서울,구로구,1,1,0,2,2,0,2019-05-06
1577,서울,구로구,7,0,0,7,3,0,2019-06-06
1578,서울,구로구,2,0,1,3,3,0,2019-07-06
1579,서울,구로구,10,0,2,12,10,0,2019-08-06
1580,서울,구로구,5,2,0,7,4,0,2019-09-06
1581,서울,구로구,1,0,0,1,1,0,2019-10-06
1582,서울,구로구,5,0,2,7,5,0,2019-11-06
1583,서울,구로구,2,1,2,5,5,0,2019-12-06
1584,서울,금천구,0,0,0,0,0,0,2019-01-06
1585,서울,금천구,4,0,0,4,2,0,2019-02-06
1586,서울,금천구,1,0,0,1,1,0,2019-03-06
1587,서울,금천구,4,0,0,4,4,0,2019-04-06
1588,서울,금천구,7,1,0,8,2,0,2019-05-06
1589,서울,금천구,3,0,0,3,2,0,2019-06-06
1590,서울,금천구,4,0,1,5,5,0,2019-07-06
1591,서울,금천구,5,0,2,7,4,0,2019-08-06
1592,서울,금천구,1,1,2,4,4,0,2019-09-06
1593,서울,금천구,3,1,1,5,4,0,2019-10-06
1594,서울,금천구,4,0,0,4,4,0,2019-11-06
1595,서울,금천구,1,0,0,1,1,0,2019-12-06
1596,서울,노원구,1,0,0,1,1,0,2019-01-06
1597,서울,노원구,1,0,0,1,1,0,2019-02-06
1598,서울,노원구,4,0,3,7,5,0,2019-03-06
1599,서울,노원구,1,0,0,1,1,0,2019-04-06
1600,서울,노원구,2,0,3,5,5,0,2019-05-06
1601,서울,노원구,1,0,1,2,2,0,2019-06-06
1602,서울,노원구,14,0,1,15,8,0,2019-07-06
1603,서울,노원구,0,0,1,1,1,0,2019-08-06
1604,서울,노원구,8,1,0,9,8,0,2019-09-06
1605,서울,노원구,3,0,1,4,4,0,2019-10-06
1606,서울,노원구,3,1,1,5,5,0,2019-11-06
1607,서울,노원구,4,0,3,7,6,0,2019-12-06
1608,서울,도봉구,0,0,0,0,0,0,2019-01-06
1609,서울,도봉구,0,0,0,0,0,0,2019-02-06
1610,서울,도봉구,0,0,0,0,0,0,2019-03-06
1611,서울,도봉구,5,0,0,5,1,0,2019-04-06
1612,서울,도봉구,2,1,1,4,3,0,2019-05-06
1613,서울,도봉구,0,0,0,0,0,0,2019-06-06
1614,서울,도봉구,3,0,0,3,3,0,2019-07-06
1615,서울,도봉구,2,1,1,4,4,0,2019-08-06
1616,서울,도봉구,4,0,0,4,3,0,2019-09-06
1617,서울,도봉구,0,0,0,0,0,0,2019-10-06
1618,서울,도봉구,8,0,0,8,4,0,2019-11-06
1619,서울,도봉구,5,0,0,5,4,0,2019-12-06
1620,서울,동대문구,6,0,1,7,6,0,2019-01-06
1621,서울,동대문구,2,0,0,2,2,0,2019-02-06
1622,서울,동대문구,7,1,2,10,5,0,2019-03-06
1623,서울,동대문구,2,1,1,4,4,0,2019-04-06
1624,서울,동대문구,2,0,0,2,2,0,2019-05-06
1625,서울,동대문구,2,1,1,4,4,0,2019-06-06
1626,서울,동대문구,7,0,1,8,8,0,2019-07-06
1627,서울,동대문구,4,0,1,5,4,0,2019-08-06
1628,서울,동대문구,1,0,1,2,2,0,2019-09-06
1629,서울,동대문구,1,0,0,1,1,0,2019-10-06
1630,서울,동대문구,8,0,0,8,5,0,2019-11-06
1631,서울,동대문구,5,1,2,8,7,0,2019-12-06
1632,서울,동작구,4,0,2,6,5,0,2019-01-06
1633,서울,동작구,0,0,0,0,0,0,2019-02-06
1634,서울,동작구,7,0,1,8,6,0,2019-03-06
1635,서울,동작구,3,0,0,3,2,0,2019-04-06
1636,서울,동작구,4,0,0,4,4,0,2019-05-06
1637,서울,동작구,4,1,2,7,5,0,2019-06-06
1638,서울,동작구,2,0,1,3,3,0,2019-07-06
1639,서울,동작구,2,0,1,3,3,0,2019-08-06
1640,서울,동작구,4,0,2,6,6,0,2019-09-06
1641,서울,동작구,1,0,1,2,1,0,2019-10-06
1642,서울,동작구,2,0,0,2,1,0,2019-11-06
1643,서울,동작구,3,1,2,6,5,0,2019-12-06
1644,서울,마포구,2,0,1,3,3,0,2019-01-06
1645,서울,마포구,1,0,0,1,1,0,2019-02-06
1646,서울,마포구,1,1,2,4,1,0,2019-03-06
1647,서울,마포구,5,1,0,6,4,0,2019-04-06
1648,서울,마포구,1,0,0,1,1,0,2019-05-06
1649,서울,마포구,8,0,4,12,9,0,2019-06-06
1650,서울,마포구,7,1,1,9,6,0,2019-07-06
1651,서울,마포구,5,1,1,7,5,0,2019-08-06
1652,서울,마포구,12,0,3,15,9,0,2019-09-06
1653,서울,마포구,4,1,2,7,3,0,2019-10-06
1654,서울,마포구,2,0,0,2,2,0,2019-11-06
1655,서울,마포구,8,0,1,9,8,0,2019-12-06
1656,서울,서대문구,0,0,0,0,0,0,2019-01-06
1657,서울,서대문구,0,0,1,1,1,0,2019-02-06
1658,서울,서대문구,3,1,0,4,4,0,2019-03-06
1659,서울,서대문구,1,1,1,3,3,0,2019-04-06
1660,서울,서대문구,1,1,1,3,3,0,2019-05-06
1661,서울,서대문구,0,0,1,1,1,0,2019-06-06
1662,서울,서대문구,4,1,1,6,4,0,2019-07-06
1663,서울,서대문구,1,2,2,5,3,0,2019-08-06
1664,서울,서대문구,0,1,1,2,2,0,2019-09-06
1665,서울,서대문구,2,0,0,2,1,0,2019-10-06
1666,서울,서대문구,3,0,1,4,2,0,2019-11-06
1667,서울,서대문구,5,2,3,10,5,0,2019-12-06
1668,서울,서초구,0,0,0,0,0,0,2019-01-06
1669,서울,서초구,0,0,0,0,0,0,2019-02-06
1670,서울,서초구,2,0,2,4,4,0,2019-03-06
1671,서울,서초구,17,0,2,19,4,0,2019-04-06
1672,서울,서초구,1,3,1,5,4,0,2019-05-06
1673,서울,서초구,8,0,0,8,5,0,2019-06-06
1674,서울,서초구,11,1,1,13,10,0,2019-07-06
1675,서울,서초구,7,0,0,7,5,0,2019-08-06
1676,서울,서초구,1,0,1,2,2,0,2019-09-06
1677,서울,서초구,2,0,1,3,3,0,2019-10-06
1678,서울,서초구,5,2,0,7,7,0,2019-11-06
1679,서울,서초구,7,1,1,9,8,0,2019-12-06
1680,서울,성동구,3,0,0,3,2,0,2019-01-06
1681,서울,성동구,1,0,0,1,1,0,2019-02-06
1682,서울,성동구,1,0,0,1,1,0,2019-03-06
1683,서울,성동구,1,0,0,1,1,0,2019-04-06
1684,서울,성동구,0,0,0,0,0,0,2019-05-06
1685,서울,성동구,2,2,1,5,3,0,2019-06-06
1686,서울,성동구,2,0,2,4,3,0,2019-07-06
1687,서울,성동구,2,1,0,3,2,0,2019-08-06
1688,서울,성동구,3,0,1,4,3,0,2019-09-06
1689,서울,성동구,1,1,1,3,2,0,2019-10-06
1690,서울,성동구,2,0,0,2,2,0,2019-11-06
1691,서울,성동구,4,0,1,5,2,0,2019-12-06
1692,서울,성북구,2,1,3,6,2,0,2019-01-06
1693,서울,성북구,0,0,0,0,0,0,2019-02-06
1694,서울,성북구,9,0,2,11,6,0,2019-03-06
1695,서울,성북구,5,0,0,5,4,0,2019-04-06
1696,서울,성북구,2,0,3,5,4,0,2019-05-06
1697,서울,성북구,4,0,1,5,4,0,2019-06-06
1698,서울,성북구,2,0,1,3,2,0,2019-07-06
1699,서울,성북구,8,0,0,8,2,0,2019-08-06
1700,서울,성북구,9,0,1,10,10,0,2019-09-06
1701,서울,성북구,0,0,1,1,1,0,2019-10-06
1702,서울,성북구,0,0,0,0,0,0,2019-11-06
1703,서울,성북구,2,0,1,3,3,0,2019-12-06
1704,서울,송파구,1,0,0,1,1,0,2019-01-06
1705,서울,송파구,3,0,1,4,5,1,2019-02-06
1706,서울,송파구,3,0,0,3,3,0,2019-03-06
1707,서울,송파구,12,1,3,16,12,0,2019-04-06
1708,서울,송파구,12,2,2,16,10,0,2019-05-06
1709,서울,송파구,16,2,1,19,10,0,2019-06-06
1710,서울,송파구,5,0,1,6,6,0,2019-07-06
1711,서울,송파구,9,0,1,10,7,0,2019-08-06
1712,서울,송파구,9,1,3,13,8,0,2019-09-06
1713,서울,송파구,6,3,2,11,9,0,2019-10-06
1714,서울,송파구,9,0,1,10,7,0,2019-11-06
1715,서울,송파구,6,0,0,6,6,0,2019-12-06
1716,서울,양천구,4,0,1,5,3,0,2019-01-06
1717,서울,양천구,5,1,1,7,4,0,2019-02-06
1718,서울,양천구,4,1,0,5,4,0,2019-03-06
1719,서울,양천구,7,0,1,8,5,0,2019-04-06
1720,서울,양천구,7,0,1,8,5,0,2019-05-06
1721,서울,양천구,2,1,1,4,4,0,2019-06-06
1722,서울,양천구,7,1,1,9,4,0,2019-07-06
1723,서울,양천구,0,0,1,1,1,0,2019-08-06
1724,서울,양천구,2,2,0,4,4,0,2019-09-06
1725,서울,양천구,5,1,0,6,3,0,2019-10-06
1726,서울,양천구,8,0,1,9,3,0,2019-11-06
1727,서울,양천구,7,0,2,9,5,0,2019-12-06
1728,서울,영등포구,0,0,1,1,1,0,2019-01-06
1729,서울,영등포구,1,1,1,3,3,0,2019-02-06
1730,서울,영등포구,5,0,1,6,5,0,2019-03-06
1731,서울,영등포구,4,0,3,7,7,0,2019-04-06
1732,서울,영등포구,2,1,0,3,3,0,2019-05-06
1733,서울,영등포구,11,1,3,15,11,0,2019-06-06
1734,서울,영등포구,14,4,0,18,12,0,2019-07-06
1735,서울,영등포구,10,1,2,13,6,0,2019-08-06
1736,서울,영등포구,9,0,2,11,8,0,2019-09-06
1737,서울,영등포구,6,2,1,9,7,0,2019-10-06
1738,서울,영등포구,4,0,1,5,4,0,2019-11-06
1739,서울,영등포구,4,0,0,4,3,0,2019-12-06
1740,서울,용산구,4,0,1,5,2,0,2019-01-06
1741,서울,용산구,2,0,0,2,2,0,2019-02-06
1742,서울,용산구,2,0,2,4,3,0,2019-03-06
1743,서울,용산구,8,0,1,9,3,0,2019-04-06
1744,서울,용산구,6,2,1,9,5,0,2019-05-06
1745,서울,용산구,0,0,2,2,2,0,2019-06-06
1746,서울,용산구,1,0,2,3,3,0,2019-07-06
1747,서울,용산구,1,0,1,2,3,1,2019-08-06
1748,서울,용산구,1,0,1,2,2,0,2019-09-06
1749,서울,용산구,8,0,2,10,7,0,2019-10-06
1750,서울,용산구,3,0,0,3,3,0,2019-11-06
1751,서울,용산구,1,0,1,2,2,0,2019-12-06
1752,서울,은평구,1,1,0,2,2,0,2019-01-06
1753,서울,은평구,0,0,0,0,0,0,2019-02-06
1754,서울,은평구,2,0,0,2,2,0,2019-03-06
1755,서울,은평구,1,0,1,2,2,0,2019-04-06
1756,서울,은평구,0,2,0,2,2,0,2019-05-06
1757,서울,은평구,2,0,1,3,2,0,2019-06-06
1758,서울,은평구,0,4,1,5,3,0,2019-07-06
1759,서울,은평구,2,1,2,5,3,0,2019-08-06
1760,서울,은평구,13,0,2,15,4,0,2019-09-06
1761,서울,은평구,4,1,0,5,4,0,2019-10-06
1762,서울,은평구,3,0,0,3,3,0,2019-11-06
1763,서울,은평구,6,1,2,9,7,0,2019-12-06
1764,서울,종로구,2,0,0,2,2,0,2019-01-06
1765,서울,종로구,2,0,1,3,1,0,2019-02-06
1766,서울,종로구,3,1,1,5,3,0,2019-03-06
1767,서울,종로구,4,0,1,5,4,0,2019-04-06
1768,서울,종로구,3,0,0,3,2,0,2019-05-06
1769,서울,종로구,1,1,1,3,2,0,2019-06-06
1770,서울,종로구,3,3,1,7,6,0,2019-07-06
1771,서울,종로구,9,0,0,9,4,0,2019-08-06
1772,서울,종로구,7,0,0,7,5,0,2019-09-06
1773,서울,종로구,3,0,0,3,2,0,2019-10-06
1774,서울,종로구,4,1,0,5,3,0,2019-11-06
1775,서울,종로구,1,0,1,2,2,0,2019-12-06
1776,서울,중구,1,0,0,1,1,0,2019-01-06
1777,서울,중구,1,0,3,4,3,0,2019-02-06
1778,서울,중구,1,1,1,3,2,0,2019-03-06
1779,서울,중구,1,1,2,4,3,0,2019-04-06
1780,서울,중구,2,0,0,2,1,0,2019-05-06
1781,서울,중구,2,1,1,4,3,0,2019-06-06
1782,서울,중구,2,1,1,4,4,0,2019-07-06
1783,서울,중구,3,1,1,5,4,0,2019-08-06
1784,서울,중구,3,0,2,5,4,0,2019-09-06
1785,서울,중구,1,0,0,1,2,1,2019-10-06
1786,서울,중구,3,0,4,7,5,0,2019-11-06
1787,서울,중구,4,1,2,7,7,0,2019-12-06
1788,서울,중랑구,1,0,0,1,1,0,2019-01-06
1789,서울,중랑구,4,0,1,5,3,0,2019-02-06
1790,서울,중랑구,1,0,2,3,3,0,2019-03-06
1791,서울,중랑구,4,0,2,6,5,0,2019-04-06
1792,서울,중랑구,8,0,0,8,5,0,2019-05-06
1793,서울,중랑구,1,0,2,3,3,0,2019-06-06
1794,서울,중랑구,3,0,0,3,3,0,2019-07-06
1795,서울,중랑구,2,0,2,4,4,0,2019-08-06
1796,서울,중랑구,3,1,5,9,9,1,2019-09-06
1797,서울,중랑구,8,3,3,14,9,0,2019-10-06
1798,서울,중랑구,9,0,1,10,7,0,2019-11-06
1799,서울,중랑구,4,0,4,8,8,0,2019-12-06
1800,서울,강남구,11,2,3,16,10,0,2019-01-07
1801,서울,강남구,7,1,2,10,8,0,2019-02-07
1802,서울,강남구,10,1,2,13,9,0,2019-03-07
1803,서울,강남구,6,2,4,12,9,0,2019-04-07
1804,서울,강남구,12,2,4,18,11,0,2019-05-07
1805,서울,강남구,18,2,6,26,18,0,2019-06-07
1806,서울,강남구,7,1,1,9,7,0,2019-07-07
1807,서울,강남구,12,0,1,13,12,1,2019-08-07
1808,서울,강남구,11,2,1,14,8,0,2019-09-07
1809,서울,강남구,21,1,1,23,15,0,2019-10-07
1810,서울,강남구,14,1,4,19,16,0,2019-11-07
1811,서울,강남구,19,1,0,20,13,0,2019-12-07
1812,서울,강동구,4,0,0,4,4,0,2019-01-07
1813,서울,강동구,3,0,0,3,2,0,2019-02-07
1814,서울,강동구,4,0,2,6,5,0,2019-03-07
1815,서울,강동구,3,0,1,4,3,0,2019-04-07
1816,서울,강동구,2,2,0,4,2,0,2019-05-07
1817,서울,강동구,4,0,1,5,4,0,2019-06-07
1818,서울,강동구,1,6,2,9,3,0,2019-07-07
1819,서울,강동구,4,1,2,7,5,0,2019-08-07
1820,서울,강동구,3,2,0,5,4,0,2019-09-07
1821,서울,강동구,5,0,1,6,6,0,2019-10-07
1822,서울,강동구,4,0,2,6,5,0,2019-11-07
1823,서울,강동구,3,0,0,3,3,0,2019-12-07
1824,서울,강북구,1,0,3,4,4,0,2019-01-07
1825,서울,강북구,1,0,0,1,1,0,2019-02-07
1826,서울,강북구,6,0,1,7,5,0,2019-03-07
1827,서울,강북구,6,0,0,6,6,0,2019-04-07
1828,서울,강북구,4,0,0,4,3,0,2019-05-07
1829,서울,강북구,4,0,0,4,3,0,2019-06-07
1830,서울,강북구,1,0,0,1,1,0,2019-07-07
1831,서울,강북구,4,0,0,4,5,1,2019-08-07
1832,서울,강북구,0,0,0,0,0,0,2019-09-07
1833,서울,강북구,2,0,2,4,4,0,2019-10-07
1834,서울,강북구,3,1,1,5,5,0,2019-11-07
1835,서울,강북구,3,0,0,3,3,0,2019-12-07
1836,서울,강서구,3,0,0,3,2,0,2019-01-07
1837,서울,강서구,6,0,0,6,5,0,2019-02-07
1838,서울,강서구,4,0,0,4,3,0,2019-03-07
1839,서울,강서구,2,0,0,2,3,1,2019-04-07
1840,서울,강서구,2,0,0,2,4,2,2019-05-07
1841,서울,강서구,10,7,2,19,5,0,2019-06-07
1842,서울,강서구,0,0,2,2,2,0,2019-07-07
1843,서울,강서구,9,0,2,11,6,0,2019-08-07
1844,서울,강서구,6,0,2,8,8,1,2019-09-07
1845,서울,강서구,0,0,0,0,0,0,2019-10-07
1846,서울,강서구,2,0,1,3,3,0,2019-11-07
1847,서울,강서구,0,0,1,1,1,0,2019-12-07
1848,서울,관악구,3,0,1,4,2,0,2019-01-07
1849,서울,관악구,5,0,0,5,4,0,2019-02-07
1850,서울,관악구,2,0,0,2,2,0,2019-03-07
1851,서울,관악구,4,0,2,6,4,0,2019-04-07
1852,서울,관악구,1,0,0,1,1,0,2019-05-07
1853,서울,관악구,3,0,0,3,3,0,2019-06-07
1854,서울,관악구,1,0,2,3,3,0,2019-07-07
1855,서울,관악구,3,1,0,4,3,0,2019-08-07
1856,서울,관악구,1,0,0,1,1,0,2019-09-07
1857,서울,관악구,4,1,1,6,6,0,2019-10-07
1858,서울,관악구,7,1,0,8,6,0,2019-11-07
1859,서울,관악구,1,0,1,2,2,0,2019-12-07
1860,서울,광진구,1,0,1,2,2,0,2019-01-07
1861,서울,광진구,3,0,3,6,4,0,2019-02-07
1862,서울,광진구,5,0,1,6,5,0,2019-03-07
1863,서울,광진구,3,0,0,3,2,0,2019-04-07
1864,서울,광진구,5,0,1,6,5,0,2019-05-07
1865,서울,광진구,2,1,1,4,3,0,2019-06-07
1866,서울,광진구,1,0,2,3,3,0,2019-07-07
1867,서울,광진구,0,0,0,0,0,0,2019-08-07
1868,서울,광진구,5,0,1,6,5,0,2019-09-07
1869,서울,광진구,4,0,1,5,4,0,2019-10-07
1870,서울,광진구,2,0,1,3,2,0,2019-11-07
1871,서울,광진구,6,0,1,7,4,0,2019-12-07
1872,서울,구로구,2,1,0,3,3,0,2019-01-07
1873,서울,구로구,3,0,0,3,3,1,2019-02-07
1874,서울,구로구,11,1,2,14,9,0,2019-03-07
1875,서울,구로구,1,0,4,5,2,0,2019-04-07
1876,서울,구로구,2,0,0,2,2,0,2019-05-07
1877,서울,구로구,9,0,0,9,4,0,2019-06-07
1878,서울,구로구,1,1,0,2,2,0,2019-07-07
1879,서울,구로구,2,0,0,2,2,0,2019-08-07
1880,서울,구로구,0,0,0,0,0,0,2019-09-07
1881,서울,구로구,7,0,2,9,5,0,2019-10-07
1882,서울,구로구,2,1,1,4,4,0,2019-11-07
1883,서울,구로구,2,0,1,3,2,0,2019-12-07
1884,서울,금천구,0,0,2,2,2,0,2019-01-07
1885,서울,금천구,0,0,1,1,1,0,2019-02-07
1886,서울,금천구,2,0,0,2,2,0,2019-03-07
1887,서울,금천구,6,0,1,7,6,0,2019-04-07
1888,서울,금천구,4,1,0,5,4,0,2019-05-07
1889,서울,금천구,5,0,0,5,2,0,2019-06-07
1890,서울,금천구,1,0,0,1,1,0,2019-07-07
1891,서울,금천구,2,0,2,4,4,0,2019-08-07
1892,서울,금천구,1,2,0,3,1,0,2019-09-07
1893,서울,금천구,1,2,1,4,3,0,2019-10-07
1894,서울,금천구,3,0,1,4,2,0,2019-11-07
1895,서울,금천구,2,1,0,3,3,0,2019-12-07
1896,서울,노원구,2,0,1,3,2,0,2019-01-07
1897,서울,노원구,2,0,3,5,4,0,2019-02-07
1898,서울,노원구,5,0,1,6,4,0,2019-03-07
1899,서울,노원구,8,0,2,10,6,0,2019-04-07
1900,서울,노원구,3,0,1,4,4,0,2019-05-07
1901,서울,노원구,10,0,1,11,9,0,2019-06-07
1902,서울,노원구,7,2,2,11,7,0,2019-07-07
1903,서울,노원구,5,0,2,7,5,0,2019-08-07
1904,서울,노원구,3,0,0,3,3,0,2019-09-07
1905,서울,노원구,6,0,2,8,7,0,2019-10-07
1906,서울,노원구,9,0,4,13,10,0,2019-11-07
1907,서울,노원구,2,3,0,5,5,1,2019-12-07
1908,서울,도봉구,0,0,1,1,1,0,2019-01-07
1909,서울,도봉구,0,0,2,2,2,0,2019-02-07
1910,서울,도봉구,0,0,1,1,1,0,2019-03-07
1911,서울,도봉구,8,0,2,10,5,0,2019-04-07
1912,서울,도봉구,2,0,0,2,2,0,2019-05-07
1913,서울,도봉구,1,1,0,2,2,0,2019-06-07
1914,서울,도봉구,3,0,2,5,4,0,2019-07-07
1915,서울,도봉구,3,0,4,7,4,0,2019-08-07
1916,서울,도봉구,2,1,0,3,2,0,2019-09-07
1917,서울,도봉구,4,0,1,5,3,0,2019-10-07
1918,서울,도봉구,2,0,0,2,1,0,2019-11-07
1919,서울,도봉구,4,0,0,4,3,0,2019-12-07
1920,서울,동대문구,2,0,3,5,5,0,2019-01-07
1921,서울,동대문구,5,0,1,6,6,0,2019-02-07
1922,서울,동대문구,2,0,2,4,4,0,2019-03-07
1923,서울,동대문구,2,0,1,3,2,0,2019-04-07
1924,서울,동대문구,1,0,0,1,1,0,2019-05-07
1925,서울,동대문구,8,1,0,9,6,0,2019-06-07
1926,서울,동대문구,6,0,0,6,3,0,2019-07-07
1927,서울,동대문구,1,0,1,2,2,0,2019-08-07
1928,서울,동대문구,5,2,3,10,8,0,2019-09-07
1929,서울,동대문구,3,1,2,6,6,0,2019-10-07
1930,서울,동대문구,7,2,3,12,10,0,2019-11-07
1931,서울,동대문구,7,1,0,8,5,0,2019-12-07
1932,서울,동작구,0,0,0,0,0,0,2019-01-07
1933,서울,동작구,0,0,0,0,0,0,2019-02-07
1934,서울,동작구,5,2,1,8,4,0,2019-03-07
1935,서울,동작구,5,1,1,7,5,0,2019-04-07
1936,서울,동작구,5,0,0,5,4,0,2019-05-07
1937,서울,동작구,4,1,0,5,5,0,2019-06-07
1938,서울,동작구,2,1,0,3,3,0,2019-07-07
1939,서울,동작구,2,0,0,2,2,0,2019-08-07
1940,서울,동작구,2,0,1,3,3,0,2019-09-07
1941,서울,동작구,2,0,2,4,4,0,2019-10-07
1942,서울,동작구,2,0,0,2,2,0,2019-11-07
1943,서울,동작구,5,1,1,7,5,0,2019-12-07
1944,서울,마포구,7,0,6,13,3,0,2019-01-07
1945,서울,마포구,11,0,0,11,5,0,2019-02-07
1946,서울,마포구,5,0,1,6,5,0,2019-03-07
1947,서울,마포구,1,0,1,2,2,0,2019-04-07
1948,서울,마포구,9,2,1,12,10,2,2019-05-07
1949,서울,마포구,12,0,5,17,9,0,2019-06-07
1950,서울,마포구,8,1,5,14,6,0,2019-07-07
1951,서울,마포구,7,0,0,7,5,0,2019-08-07
1952,서울,마포구,4,0,0,4,4,0,2019-09-07
1953,서울,마포구,5,0,0,5,4,0,2019-10-07
1954,서울,마포구,7,0,5,12,6,0,2019-11-07
1955,서울,마포구,7,0,3,10,10,0,2019-12-07
1956,서울,서대문구,1,0,2,3,2,0,2019-01-07
1957,서울,서대문구,4,1,1,6,5,0,2019-02-07
1958,서울,서대문구,2,1,0,3,3,0,2019-03-07
1959,서울,서대문구,2,0,0,2,1,0,2019-04-07
1960,서울,서대문구,4,0,1,5,5,0,2019-05-07
1961,서울,서대문구,9,3,1,13,2,0,2019-06-07
1962,서울,서대문구,1,0,2,3,2,0,2019-07-07
1963,서울,서대문구,0,1,2,3,3,0,2019-08-07
1964,서울,서대문구,5,1,2,8,5,0,2019-09-07
1965,서울,서대문구,3,0,1,4,3,0,2019-10-07
1966,서울,서대문구,0,0,1,1,1,0,2019-11-07
1967,서울,서대문구,2,1,0,3,3,0,2019-12-07
1968,서울,서초구,2,2,1,5,3,0,2019-01-07
1969,서울,서초구,1,0,2,3,3,0,2019-02-07
1970,서울,서초구,2,0,2,4,3,0,2019-03-07
1971,서울,서초구,10,0,2,12,6,0,2019-04-07
1972,서울,서초구,1,0,3,4,4,0,2019-05-07
1973,서울,서초구,5,1,1,7,5,0,2019-06-07
1974,서울,서초구,5,2,4,11,2,0,2019-07-07
1975,서울,서초구,7,0,1,8,6,0,2019-08-07
1976,서울,서초구,8,0,1,9,6,0,2019-09-07
1977,서울,서초구,5,0,1,6,4,0,2019-10-07
1978,서울,서초구,10,0,1,11,10,0,2019-11-07
1979,서울,서초구,12,1,2,15,7,0,2019-12-07
1980,서울,성동구,3,1,0,4,3,0,2019-01-07
1981,서울,성동구,1,0,0,1,1,0,2019-02-07
1982,서울,성동구,4,0,0,4,3,0,2019-03-07
1983,서울,성동구,1,0,0,1,1,0,2019-04-07
1984,서울,성동구,4,1,4,9,10,2,2019-05-07
1985,서울,성동구,3,0,2,5,5,0,2019-06-07
1986,서울,성동구,1,0,1,2,2,0,2019-07-07
1987,서울,성동구,4,0,1,5,4,0,2019-08-07
1988,서울,성동구,0,0,1,1,1,0,2019-09-07
1989,서울,성동구,2,0,0,2,2,0,2019-10-07
1990,서울,성동구,5,0,2,7,5,0,2019-11-07
1991,서울,성동구,1,0,0,1,1,0,2019-12-07
1992,서울,성북구,8,0,2,10,6,0,2019-01-07
1993,서울,성북구,4,0,1,5,4,0,2019-02-07
1994,서울,성북구,0,1,1,2,2,0,2019-03-07
1995,서울,성북구,3,0,1,4,5,1,2019-04-07
1996,서울,성북구,7,1,1,9,8,0,2019-05-07
1997,서울,성북구,2,0,0,2,3,1,2019-06-07
1998,서울,성북구,0,0,0,0,0,0,2019-07-07
1999,서울,성북구,4,1,0,5,2,0,2019-08-07
2000,서울,성북구,0,0,0,0,0,0,2019-09-07
2001,서울,성북구,1,0,0,1,1,0,2019-10-07
2002,서울,성북구,3,0,2,5,5,0,2019-11-07
2003,서울,성북구,8,0,0,8,5,0,2019-12-07
2004,서울,송파구,7,0,0,7,3,0,2019-01-07
2005,서울,송파구,10,1,2,13,10,0,2019-02-07
2006,서울,송파구,11,1,4,16,13,0,2019-03-07
2007,서울,송파구,9,2,0,11,7,0,2019-04-07
2008,서울,송파구,7,1,3,11,10,0,2019-05-07
2009,서울,송파구,8,2,2,12,7,0,2019-06-07
2010,서울,송파구,7,1,1,9,7,0,2019-07-07
2011,서울,송파구,2,1,1,4,3,0,2019-08-07
2012,서울,송파구,14,0,0,14,10,0,2019-09-07
2013,서울,송파구,8,0,1,9,8,1,2019-10-07
2014,서울,송파구,5,0,0,5,5,0,2019-11-07
2015,서울,송파구,6,0,3,9,7,0,2019-12-07
2016,서울,양천구,8,1,0,9,6,0,2019-01-07
2017,서울,양천구,3,0,0,3,2,0,2019-02-07
2018,서울,양천구,1,0,0,1,1,0,2019-03-07
2019,서울,양천구,3,0,0,3,4,2,2019-04-07
2020,서울,양천구,5,0,4,9,4,0,2019-05-07
2021,서울,양천구,2,1,1,4,4,0,2019-06-07
2022,서울,양천구,3,1,0,4,3,0,2019-07-07
2023,서울,양천구,16,1,1,18,7,0,2019-08-07
2024,서울,양천구,3,0,0,3,1,0,2019-09-07
2025,서울,양천구,7,2,0,9,8,0,2019-10-07
2026,서울,양천구,4,0,0,4,3,0,2019-11-07
2027,서울,양천구,10,1,4,15,6,0,2019-12-07
2028,서울,영등포구,12,1,2,15,9,0,2019-01-07
2029,서울,영등포구,2,1,2,5,5,0,2019-02-07
2030,서울,영등포구,9,0,3,12,9,0,2019-03-07
2031,서울,영등포구,11,3,2,16,13,0,2019-04-07
2032,서울,영등포구,4,0,0,4,4,0,2019-05-07
2033,서울,영등포구,6,0,2,8,7,0,2019-06-07
2034,서울,영등포구,7,0,3,10,7,0,2019-07-07
2035,서울,영등포구,7,0,1,8,7,0,2019-08-07
2036,서울,영등포구,2,1,0,3,2,0,2019-09-07
2037,서울,영등포구,5,0,1,6,5,0,2019-10-07
2038,서울,영등포구,3,1,3,7,6,0,2019-11-07
2039,서울,영등포구,4,0,0,4,4,0,2019-12-07
2040,서울,용산구,2,0,0,2,2,0,2019-01-07
2041,서울,용산구,5,0,0,5,4,0,2019-02-07
2042,서울,용산구,2,1,0,3,3,0,2019-03-07
2043,서울,용산구,5,1,0,6,3,0,2019-04-07
2044,서울,용산구,1,1,0,2,2,0,2019-05-07
2045,서울,용산구,2,0,2,4,4,0,2019-06-07
2046,서울,용산구,1,0,0,1,1,0,2019-07-07
2047,서울,용산구,3,0,1,4,3,0,2019-08-07
2048,서울,용산구,4,0,0,4,3,0,2019-09-07
2049,서울,용산구,2,0,0,2,2,0,2019-10-07
2050,서울,용산구,1,1,2,4,4,0,2019-11-07
2051,서울,용산구,3,0,1,4,4,0,2019-12-07
2052,서울,은평구,3,1,0,4,3,0,2019-01-07
2053,서울,은평구,6,1,0,7,4,0,2019-02-07
2054,서울,은평구,8,1,1,10,7,0,2019-03-07
2055,서울,은평구,1,0,0,1,1,0,2019-04-07
2056,서울,은평구,1,1,1,3,2,0,2019-05-07
2057,서울,은평구,0,0,0,0,0,0,2019-06-07
2058,서울,은평구,1,0,0,1,1,0,2019-07-07
2059,서울,은평구,2,0,1,3,2,0,2019-08-07
2060,서울,은평구,2,2,3,7,5,0,2019-09-07
2061,서울,은평구,2,1,1,4,4,0,2019-10-07
2062,서울,은평구,2,0,2,4,3,0,2019-11-07
2063,서울,은평구,2,0,2,4,4,0,2019-12-07
2064,서울,종로구,0,3,2,5,4,0,2019-01-07
2065,서울,종로구,1,1,1,3,2,0,2019-02-07
2066,서울,종로구,4,0,1,5,4,0,2019-03-07
2067,서울,종로구,2,1,0,3,2,0,2019-04-07
2068,서울,종로구,5,1,0,6,6,1,2019-05-07
2069,서울,종로구,0,0,0,0,0,0,2019-06-07
2070,서울,종로구,2,0,0,2,2,0,2019-07-07
2071,서울,종로구,2,0,0,2,2,0,2019-08-07
2072,서울,종로구,0,0,0,0,0,0,2019-09-07
2073,서울,종로구,6,2,1,9,6,0,2019-10-07
2074,서울,종로구,6,1,2,9,6,0,2019-11-07
2075,서울,종로구,8,1,1,10,7,0,2019-12-07
2076,서울,중구,1,0,0,1,1,0,2019-01-07
2077,서울,중구,0,0,0,0,0,0,2019-02-07
2078,서울,중구,2,0,0,2,2,0,2019-03-07
2079,서울,중구,9,1,0,10,4,0,2019-04-07
2080,서울,중구,5,0,2,7,5,0,2019-05-07
2081,서울,중구,4,0,5,9,6,0,2019-06-07
2082,서울,중구,4,1,1,6,3,0,2019-07-07
2083,서울,중구,4,1,1,6,5,0,2019-08-07
2084,서울,중구,7,1,2,10,5,0,2019-09-07
2085,서울,중구,4,0,1,5,5,0,2019-10-07
2086,서울,중구,2,0,1,3,3,0,2019-11-07
2087,서울,중구,20,16,1,37,5,0,2019-12-07
2088,서울,중랑구,4,2,0,6,6,0,2019-01-07
2089,서울,중랑구,4,0,2,6,5,0,2019-02-07
2090,서울,중랑구,2,0,1,3,3,0,2019-03-07
2091,서울,중랑구,1,0,1,2,2,0,2019-04-07
2092,서울,중랑구,5,1,0,6,6,0,2019-05-07
2093,서울,중랑구,9,2,3,14,10,0,2019-06-07
2094,서울,중랑구,5,1,3,9,5,0,2019-07-07
2095,서울,중랑구,5,0,1,6,5,0,2019-08-07
2096,서울,중랑구,4,1,1,6,5,0,2019-09-07
2097,서울,중랑구,4,1,4,9,9,0,2019-10-07
2098,서울,중랑구,2,0,0,2,2,0,2019-11-07
2099,서울,중랑구,5,1,3,9,6,0,2019-12-07
2100,서울,강남구,14,1,4,19,14,0,2019-01-08
2101,서울,강남구,10,1,2,13,8,0,2019-02-08
2102,서울,강남구,15,0,5,20,13,0,2019-03-08
2103,서울,강남구,12,0,4,16,14,0,2019-04-08
2104,서울,강남구,16,0,0,16,7,0,2019-05-08
2105,서울,강남구,17,1,0,18,11,0,2019-06-08
2106,서울,강남구,19,1,2,22,14,0,2019-07-08
2107,서울,강남구,7,5,1,13,9,0,2019-08-08
2108,서울,강남구,2,2,0,4,4,0,2019-09-08
2109,서울,강남구,24,3,2,29,18,0,2019-10-08
2110,서울,강남구,14,1,2,17,12,0,2019-11-08
2111,서울,강남구,22,1,2,25,13,0,2019-12-08
2112,서울,강동구,1,0,0,1,1,0,2019-01-08
2113,서울,강동구,2,1,1,4,3,0,2019-02-08
2114,서울,강동구,5,2,2,9,7,0,2019-03-08
2115,서울,강동구,0,0,1,1,1,0,2019-04-08
2116,서울,강동구,6,2,0,8,7,0,2019-05-08
2117,서울,강동구,8,1,1,10,7,0,2019-06-08
2118,서울,강동구,5,1,3,9,5,0,2019-07-08
2119,서울,강동구,3,1,1,5,4,0,2019-08-08
2120,서울,강동구,0,0,0,0,0,0,2019-09-08
2121,서울,강동구,3,0,1,4,5,1,2019-10-08
2122,서울,강동구,2,3,2,7,6,0,2019-11-08
2123,서울,강동구,3,0,1,4,3,0,2019-12-08
2124,서울,강북구,3,0,0,3,1,0,2019-01-08
2125,서울,강북구,1,0,1,2,2,0,2019-02-08
2126,서울,강북구,2,0,1,3,3,0,2019-03-08
2127,서울,강북구,4,0,0,4,4,0,2019-04-08
2128,서울,강북구,3,0,2,5,5,0,2019-05-08
2129,서울,강북구,4,0,1,5,5,0,2019-06-08
2130,서울,강북구,1,0,1,2,2,0,2019-07-08
2131,서울,강북구,1,0,1,2,2,0,2019-08-08
2132,서울,강북구,0,0,0,0,0,0,2019-09-08
2133,서울,강북구,7,2,0,9,4,0,2019-10-08
2134,서울,강북구,1,0,0,1,1,0,2019-11-08
2135,서울,강북구,1,0,0,1,1,0,2019-12-08
2136,서울,강서구,4,0,0,4,5,1,2019-01-08
2137,서울,강서구,4,0,0,4,4,0,2019-02-08
2138,서울,강서구,9,1,2,12,8,0,2019-03-08
2139,서울,강서구,2,0,3,5,5,0,2019-04-08
2140,서울,강서구,7,0,2,9,7,0,2019-05-08
2141,서울,강서구,4,0,1,5,5,0,2019-06-08
2142,서울,강서구,3,0,1,4,4,0,2019-07-08
2143,서울,강서구,5,0,5,10,10,0,2019-08-08
2144,서울,강서구,5,1,3,9,6,0,2019-09-08
2145,서울,강서구,8,1,1,10,8,0,2019-10-08
2146,서울,강서구,4,0,0,4,3,0,2019-11-08
2147,서울,강서구,4,1,0,5,5,0,2019-12-08
2148,서울,관악구,4,0,0,4,4,0,2019-01-08
2149,서울,관악구,7,0,0,7,6,0,2019-02-08
2150,서울,관악구,3,0,0,3,2,0,2019-03-08
2151,서울,관악구,3,0,0,3,3,0,2019-04-08
2152,서울,관악구,7,0,1,8,4,0,2019-05-08
2153,서울,관악구,6,0,3,9,5,0,2019-06-08
2154,서울,관악구,12,0,0,12,9,0,2019-07-08
2155,서울,관악구,4,0,2,6,5,0,2019-08-08
2156,서울,관악구,2,1,1,4,3,0,2019-09-08
2157,서울,관악구,5,0,4,9,6,0,2019-10-08
2158,서울,관악구,4,0,0,4,4,0,2019-11-08
2159,서울,관악구,2,0,0,2,1,0,2019-12-08
2160,서울,광진구,0,0,0,0,0,0,2019-01-08
2161,서울,광진구,0,0,0,0,0,0,2019-02-08
2162,서울,광진구,1,1,1,3,3,0,2019-03-08
2163,서울,광진구,2,0,0,2,2,0,2019-04-08
2164,서울,광진구,4,0,1,5,4,0,2019-05-08
2165,서울,광진구,7,0,0,7,3,0,2019-06-08
2166,서울,광진구,4,0,1,5,5,0,2019-07-08
2167,서울,광진구,1,0,0,1,1,0,2019-08-08
2168,서울,광진구,0,0,1,1,1,0,2019-09-08
2169,서울,광진구,1,0,0,1,1,0,2019-10-08
2170,서울,광진구,6,0,1,7,7,0,2019-11-08
2171,서울,광진구,2,0,1,3,3,0,2019-12-08
2172,서울,구로구,6,0,1,7,6,0,2019-01-08
2173,서울,구로구,4,0,2,6,4,0,2019-02-08
2174,서울,구로구,4,1,5,10,8,0,2019-03-08
2175,서울,구로구,2,1,3,6,6,0,2019-04-08
2176,서울,구로구,7,0,2,9,6,0,2019-05-08
2177,서울,구로구,0,1,1,2,2,0,2019-06-08
2178,서울,구로구,2,0,1,3,3,0,2019-07-08
2179,서울,구로구,5,0,2,7,5,0,2019-08-08
2180,서울,구로구,6,0,1,7,4,0,2019-09-08
2181,서울,구로구,9,0,2,11,7,0,2019-10-08
2182,서울,구로구,4,0,1,5,6,1,2019-11-08
2183,서울,구로구,6,0,1,7,3,0,2019-12-08
2184,서울,금천구,0,0,0,0,0,0,2019-01-08
2185,서울,금천구,0,0,0,0,0,0,2019-02-08
2186,서울,금천구,3,0,0,3,2,0,2019-03-08
2187,서울,금천구,5,0,1,6,2,0,2019-04-08
2188,서울,금천구,2,0,0,2,2,0,2019-05-08
2189,서울,금천구,1,1,1,3,3,0,2019-06-08
2190,서울,금천구,2,0,3,5,4,0,2019-07-08
2191,서울,금천구,2,0,1,3,2,0,2019-08-08
2192,서울,금천구,3,0,0,3,1,0,2019-09-08
2193,서울,금천구,4,0,2,6,4,0,2019-10-08
2194,서울,금천구,6,1,0,7,5,0,2019-11-08
2195,서울,금천구,5,0,0,5,5,0,2019-12-08
2196,서울,노원구,8,1,4,13,9,0,2019-01-08
2197,서울,노원구,2,2,1,5,4,0,2019-02-08
2198,서울,노원구,3,0,4,7,5,0,2019-03-08
2199,서울,노원구,2,0,3,5,3,0,2019-04-08
2200,서울,노원구,2,0,0,2,2,0,2019-05-08
2201,서울,노원구,2,0,1,3,3,0,2019-06-08
2202,서울,노원구,5,0,3,8,6,0,2019-07-08
2203,서울,노원구,9,1,0,10,7,0,2019-08-08
2204,서울,노원구,7,1,0,8,5,0,2019-09-08
2205,서울,노원구,6,1,6,13,7,0,2019-10-08
2206,서울,노원구,10,1,2,13,8,0,2019-11-08
2207,서울,노원구,4,0,2,6,5,0,2019-12-08
2208,서울,도봉구,2,1,4,7,6,0,2019-01-08
2209,서울,도봉구,0,0,1,1,1,0,2019-02-08
2210,서울,도봉구,3,1,1,5,3,0,2019-03-08
2211,서울,도봉구,4,0,1,5,3,0,2019-04-08
2212,서울,도봉구,1,0,0,1,1,0,2019-05-08
2213,서울,도봉구,2,0,0,2,2,0,2019-06-08
2214,서울,도봉구,0,1,0,1,1,0,2019-07-08
2215,서울,도봉구,0,1,0,1,1,0,2019-08-08
2216,서울,도봉구,1,0,1,2,2,0,2019-09-08
2217,서울,도봉구,2,0,1,3,2,0,2019-10-08
2218,서울,도봉구,2,0,0,2,2,0,2019-11-08
2219,서울,도봉구,1,1,0,2,2,0,2019-12-08
2220,서울,동대문구,3,2,3,8,6,0,2019-01-08
2221,서울,동대문구,5,0,2,7,3,0,2019-02-08
2222,서울,동대문구,4,1,0,5,5,0,2019-03-08
2223,서울,동대문구,1,1,0,2,2,0,2019-04-08
2224,서울,동대문구,3,0,0,3,3,0,2019-05-08
2225,서울,동대문구,5,1,2,8,6,0,2019-06-08
2226,서울,동대문구,6,0,2,8,6,0,2019-07-08
2227,서울,동대문구,3,1,0,4,3,0,2019-08-08
2228,서울,동대문구,3,0,3,6,6,0,2019-09-08
2229,서울,동대문구,4,0,0,4,3,0,2019-10-08
2230,서울,동대문구,8,0,4,12,6,0,2019-11-08
2231,서울,동대문구,2,0,1,3,3,0,2019-12-08
2232,서울,동작구,1,0,1,2,2,0,2019-01-08
2233,서울,동작구,2,0,4,6,5,0,2019-02-08
2234,서울,동작구,6,3,3,12,5,0,2019-03-08
2235,서울,동작구,0,0,0,0,0,0,2019-04-08
2236,서울,동작구,2,3,1,6,4,0,2019-05-08
2237,서울,동작구,7,4,3,14,10,0,2019-06-08
2238,서울,동작구,6,1,1,8,5,0,2019-07-08
2239,서울,동작구,7,2,0,9,6,0,2019-08-08
2240,서울,동작구,6,1,0,7,5,0,2019-09-08
2241,서울,동작구,2,0,0,2,2,0,2019-10-08
2242,서울,동작구,4,1,1,6,6,0,2019-11-08
2243,서울,동작구,4,0,2,6,3,0,2019-12-08
2244,서울,마포구,10,0,1,11,7,0,2019-01-08
2245,서울,마포구,7,1,0,8,4,1,2019-02-08
2246,서울,마포구,4,1,0,5,4,0,2019-03-08
2247,서울,마포구,5,0,1,6,4,0,2019-04-08
2248,서울,마포구,3,0,2,5,5,0,2019-05-08
2249,서울,마포구,3,2,2,7,3,0,2019-06-08
2250,서울,마포구,1,2,0,3,2,0,2019-07-08
2251,서울,마포구,2,0,3,5,4,0,2019-08-08
2252,서울,마포구,5,0,2,7,4,0,2019-09-08
2253,서울,마포구,1,1,0,2,2,0,2019-10-08
2254,서울,마포구,5,2,0,7,7,0,2019-11-08
2255,서울,마포구,3,0,0,3,2,0,2019-12-08
2256,서울,서대문구,3,0,1,4,3,0,2019-01-08
2257,서울,서대문구,1,0,0,1,1,0,2019-02-08
2258,서울,서대문구,2,1,0,3,3,0,2019-03-08
2259,서울,서대문구,3,0,1,4,2,0,2019-04-08
2260,서울,서대문구,2,0,0,2,2,0,2019-05-08
2261,서울,서대문구,1,1,1,3,3,0,2019-06-08
2262,서울,서대문구,0,0,1,1,1,0,2019-07-08
2263,서울,서대문구,2,1,1,4,4,0,2019-08-08
2264,서울,서대문구,6,0,1,7,3,0,2019-09-08
2265,서울,서대문구,1,0,0,1,1,0,2019-10-08
2266,서울,서대문구,2,1,0,3,3,0,2019-11-08
2267,서울,서대문구,1,1,0,2,3,1,2019-12-08
2268,서울,서초구,5,1,1,7,4,0,2019-01-08
2269,서울,서초구,14,2,2,18,10,0,2019-02-08
2270,서울,서초구,6,0,2,8,6,0,2019-03-08
2271,서울,서초구,4,2,5,11,6,0,2019-04-08
2272,서울,서초구,3,1,1,5,4,0,2019-05-08
2273,서울,서초구,1,0,0,1,1,0,2019-06-08
2274,서울,서초구,15,2,1,18,14,0,2019-07-08
2275,서울,서초구,8,0,1,9,6,0,2019-08-08
2276,서울,서초구,8,1,1,10,8,0,2019-09-08
2277,서울,서초구,5,2,5,12,7,0,2019-10-08
2278,서울,서초구,8,0,0,8,5,0,2019-11-08
2279,서울,서초구,3,0,3,6,4,0,2019-12-08
2280,서울,성동구,3,1,3,7,5,0,2019-01-08
2281,서울,성동구,2,0,1,3,3,0,2019-02-08
2282,서울,성동구,1,0,0,1,1,0,2019-03-08
2283,서울,성동구,2,0,0,2,2,0,2019-04-08
2284,서울,성동구,4,0,1,5,2,0,2019-05-08
2285,서울,성동구,2,0,0,2,2,0,2019-06-08
2286,서울,성동구,1,0,0,1,1,0,2019-07-08
2287,서울,성동구,3,0,1,4,4,0,2019-08-08
2288,서울,성동구,5,0,0,5,3,0,2019-09-08
2289,서울,성동구,4,0,2,6,4,0,2019-10-08
2290,서울,성동구,1,0,4,5,5,0,2019-11-08
2291,서울,성동구,3,0,1,4,4,0,2019-12-08
2292,서울,성북구,4,0,0,4,3,0,2019-01-08
2293,서울,성북구,4,1,0,5,4,0,2019-02-08
2294,서울,성북구,5,1,2,8,7,0,2019-03-08
2295,서울,성북구,6,0,2,8,6,0,2019-04-08
2296,서울,성북구,6,0,2,8,5,0,2019-05-08
2297,서울,성북구,1,0,0,1,1,0,2019-06-08
2298,서울,성북구,5,0,1,6,4,0,2019-07-08
2299,서울,성북구,4,0,1,5,4,0,2019-08-08
2300,서울,성북구,2,0,2,4,4,0,2019-09-08
2301,서울,성북구,6,1,4,11,11,0,2019-10-08
2302,서울,성북구,1,0,3,4,4,0,2019-11-08
2303,서울,성북구,2,0,0,2,2,0,2019-12-08
2304,서울,송파구,18,1,2,21,10,0,2019-01-08
2305,서울,송파구,2,0,4,6,6,0,2019-02-08
2306,서울,송파구,9,2,5,16,13,0,2019-03-08
2307,서울,송파구,9,0,1,10,7,0,2019-04-08
2308,서울,송파구,15,0,9,24,12,0,2019-05-08
2309,서울,송파구,5,0,1,6,5,0,2019-06-08
2310,서울,송파구,5,4,2,11,9,0,2019-07-08
2311,서울,송파구,12,2,3,17,10,0,2019-08-08
2312,서울,송파구,1,0,0,1,1,0,2019-09-08
2313,서울,송파구,11,0,3,14,11,0,2019-10-08
2314,서울,송파구,2,5,0,7,5,0,2019-11-08
2315,서울,송파구,3,0,0,3,2,0,2019-12-08
2316,서울,양천구,3,0,1,4,3,0,2019-01-08
2317,서울,양천구,4,1,2,7,6,0,2019-02-08
2318,서울,양천구,4,0,0,4,4,0,2019-03-08
2319,서울,양천구,7,0,2,9,7,0,2019-04-08
2320,서울,양천구,9,0,1,10,6,0,2019-05-08
2321,서울,양천구,2,0,0,2,1,0,2019-06-08
2322,서울,양천구,1,2,0,3,3,0,2019-07-08
2323,서울,양천구,6,1,0,7,5,1,2019-08-08
2324,서울,양천구,2,1,1,4,4,0,2019-09-08
2325,서울,양천구,5,2,0,7,6,0,2019-10-08
2326,서울,양천구,3,1,1,5,5,0,2019-11-08
2327,서울,양천구,3,0,0,3,3,0,2019-12-08
2328,서울,영등포구,7,0,2,9,7,0,2019-01-08
2329,서울,영등포구,4,0,2,6,3,0,2019-02-08
2330,서울,영등포구,2,1,3,6,5,0,2019-03-08
2331,서울,영등포구,8,0,5,13,10,0,2019-04-08
2332,서울,영등포구,9,0,2,11,8,0,2019-05-08
2333,서울,영등포구,9,2,1,12,9,0,2019-06-08
2334,서울,영등포구,8,1,1,10,8,0,2019-07-08
2335,서울,영등포구,7,1,3,11,7,0,2019-08-08
2336,서울,영등포구,1,0,0,1,1,0,2019-09-08
2337,서울,영등포구,13,4,3,20,9,0,2019-10-08
2338,서울,영등포구,3,1,0,4,4,0,2019-11-08
2339,서울,영등포구,7,0,1,8,5,0,2019-12-08
2340,서울,용산구,7,3,1,11,5,0,2019-01-08
2341,서울,용산구,0,0,2,2,2,0,2019-02-08
2342,서울,용산구,2,0,1,3,2,0,2019-03-08
2343,서울,용산구,3,0,2,5,5,0,2019-04-08
2344,서울,용산구,5,0,2,7,6,0,2019-05-08
2345,서울,용산구,1,0,1,2,2,0,2019-06-08
2346,서울,용산구,6,1,0,7,5,0,2019-07-08
2347,서울,용산구,1,0,0,1,1,0,2019-08-08
2348,서울,용산구,4,0,0,4,3,0,2019-09-08
2349,서울,용산구,4,0,0,4,3,0,2019-10-08
2350,서울,용산구,6,1,0,7,5,0,2019-11-08
2351,서울,용산구,0,0,1,1,1,0,2019-12-08
2352,서울,은평구,1,0,1,2,2,0,2019-01-08
2353,서울,은평구,4,0,2,6,5,0,2019-02-08
2354,서울,은평구,4,1,0,5,2,0,2019-03-08
2355,서울,은평구,0,0,1,1,1,0,2019-04-08
2356,서울,은평구,2,1,0,3,2,0,2019-05-08
2357,서울,은평구,1,0,3,4,4,0,2019-06-08
2358,서울,은평구,3,0,0,3,3,0,2019-07-08
2359,서울,은평구,2,0,2,4,4,0,2019-08-08
2360,서울,은평구,3,1,1,5,5,0,2019-09-08
2361,서울,은평구,3,0,5,8,6,0,2019-10-08
2362,서울,은평구,5,0,0,5,3,0,2019-11-08
2363,서울,은평구,0,0,1,1,1,0,2019-12-08
2364,서울,종로구,1,0,2,3,3,0,2019-01-08
2365,서울,종로구,0,0,1,1,1,0,2019-02-08
2366,서울,종로구,1,0,1,2,2,0,2019-03-08
2367,서울,종로구,1,0,0,1,1,0,2019-04-08
2368,서울,종로구,6,2,1,9,5,0,2019-05-08
2369,서울,종로구,1,0,0,1,1,0,2019-06-08
2370,서울,종로구,2,0,3,5,3,0,2019-07-08
2371,서울,종로구,4,1,1,6,4,0,2019-08-08
2372,서울,종로구,2,0,0,2,2,0,2019-09-08
2373,서울,종로구,0,0,1,1,1,0,2019-10-08
2374,서울,종로구,2,0,2,4,4,0,2019-11-08
2375,서울,종로구,1,0,1,2,2,0,2019-12-08
2376,서울,중구,0,0,2,2,1,0,2019-01-08
2377,서울,중구,2,0,0,2,2,0,2019-02-08
2378,서울,중구,7,1,2,10,5,0,2019-03-08
2379,서울,중구,3,2,2,7,6,0,2019-04-08
2380,서울,중구,0,0,0,0,0,0,2019-05-08
2381,서울,중구,0,1,3,4,3,0,2019-06-08
2382,서울,중구,5,2,1,8,6,0,2019-07-08
2383,서울,중구,0,0,1,1,1,0,2019-08-08
2384,서울,중구,2,1,0,3,2,0,2019-09-08
2385,서울,중구,2,1,0,3,3,0,2019-10-08
2386,서울,중구,1,1,0,2,2,0,2019-11-08
2387,서울,중구,0,0,0,0,0,0,2019-12-08
2388,서울,중랑구,7,1,2,10,4,0,2019-01-08
2389,서울,중랑구,0,0,1,1,1,0,2019-02-08
2390,서울,중랑구,3,2,1,6,5,0,2019-03-08
2391,서울,중랑구,1,0,3,4,3,0,2019-04-08
2392,서울,중랑구,0,0,1,1,1,0,2019-05-08
2393,서울,중랑구,2,1,1,4,4,0,2019-06-08
2394,서울,중랑구,0,0,0,0,0,0,2019-07-08
2395,서울,중랑구,4,0,3,7,6,0,2019-08-08
2396,서울,중랑구,7,0,1,8,6,0,2019-09-08
2397,서울,중랑구,6,1,2,9,7,0,2019-10-08
2398,서울,중랑구,9,0,3,12,8,0,2019-11-08
2399,서울,중랑구,1,1,1,3,3,0,2019-12-08
2400,서울,강남구,6,1,2,9,7,0,2019-01-09
2401,서울,강남구,9,3,1,13,8,0,2019-02-09
2402,서울,강남구,5,0,2,7,6,0,2019-03-09
2403,서울,강남구,5,0,1,6,6,0,2019-04-09
2404,서울,강남구,10,0,1,11,10,0,2019-05-09
2405,서울,강남구,7,1,1,9,8,0,2019-06-09
2406,서울,강남구,5,1,1,7,6,0,2019-07-09
2407,서울,강남구,15,0,3,18,14,0,2019-08-09
2408,서울,강남구,8,0,0,8,7,0,2019-09-09
2409,서울,강남구,11,1,2,14,10,0,2019-10-09
2410,서울,강남구,11,1,0,12,10,0,2019-11-09
2411,서울,강남구,6,1,4,11,9,0,2019-12-09
2412,서울,강동구,5,1,0,6,4,0,2019-01-09
2413,서울,강동구,1,0,1,2,2,0,2019-02-09
2414,서울,강동구,1,1,1,3,3,0,2019-03-09
2415,서울,강동구,1,1,1,3,3,0,2019-04-09
2416,서울,강동구,3,0,0,3,3,0,2019-05-09
2417,서울,강동구,5,0,0,5,2,0,2019-06-09
2418,서울,강동구,10,0,3,13,11,1,2019-07-09
2419,서울,강동구,4,0,0,4,4,0,2019-08-09
2420,서울,강동구,1,0,4,5,5,0,2019-09-09
2421,서울,강동구,3,0,0,3,3,0,2019-10-09
2422,서울,강동구,5,0,2,7,5,0,2019-11-09
2423,서울,강동구,3,0,0,3,2,0,2019-12-09
2424,서울,강북구,3,0,3,6,5,0,2019-01-09
2425,서울,강북구,6,0,0,6,4,0,2019-02-09
2426,서울,강북구,7,0,2,9,7,0,2019-03-09
2427,서울,강북구,3,0,0,3,2,0,2019-04-09
2428,서울,강북구,3,0,2,5,4,0,2019-05-09
2429,서울,강북구,8,0,1,9,6,0,2019-06-09
2430,서울,강북구,2,0,1,3,2,0,2019-07-09
2431,서울,강북구,3,0,2,5,4,0,2019-08-09
2432,서울,강북구,4,0,1,5,3,0,2019-09-09
2433,서울,강북구,0,0,0,0,0,0,2019-10-09
2434,서울,강북구,7,0,0,7,4,0,2019-11-09
2435,서울,강북구,2,1,0,3,3,0,2019-12-09
2436,서울,강서구,7,0,1,8,6,0,2019-01-09
2437,서울,강서구,3,1,2,6,5,0,2019-02-09
2438,서울,강서구,5,0,2,7,6,0,2019-03-09
2439,서울,강서구,7,1,2,10,7,0,2019-04-09
2440,서울,강서구,6,0,0,6,5,0,2019-05-09
2441,서울,강서구,3,0,1,4,5,1,2019-06-09
2442,서울,강서구,7,1,1,9,8,0,2019-07-09
2443,서울,강서구,9,0,1,10,8,0,2019-08-09
2444,서울,강서구,12,0,3,15,6,0,2019-09-09
2445,서울,강서구,9,0,1,10,5,0,2019-10-09
2446,서울,강서구,2,1,4,7,7,0,2019-11-09
2447,서울,강서구,4,0,2,6,6,0,2019-12-09
2448,서울,관악구,6,0,0,6,3,0,2019-01-09
2449,서울,관악구,1,0,1,2,2,0,2019-02-09
2450,서울,관악구,2,1,1,4,3,0,2019-03-09
2451,서울,관악구,10,1,1,12,9,1,2019-04-09
2452,서울,관악구,0,0,0,0,0,0,2019-05-09
2453,서울,관악구,4,0,1,5,4,0,2019-06-09
2454,서울,관악구,3,0,1,4,3,0,2019-07-09
2455,서울,관악구,6,0,0,6,6,0,2019-08-09
2456,서울,관악구,5,0,0,5,4,0,2019-09-09
2457,서울,관악구,2,0,2,4,3,0,2019-10-09
2458,서울,관악구,9,1,0,10,9,1,2019-11-09
2459,서울,관악구,0,0,0,0,0,0,2019-12-09
2460,서울,광진구,1,0,2,3,3,0,2019-01-09
2461,서울,광진구,0,1,0,1,1,0,2019-02-09
2462,서울,광진구,8,0,0,8,2,0,2019-03-09
2463,서울,광진구,3,1,0,4,4,0,2019-04-09
2464,서울,광진구,2,0,0,2,2,0,2019-05-09
2465,서울,광진구,0,0,0,0,0,0,2019-06-09
2466,서울,광진구,0,0,0,0,0,0,2019-07-09
2467,서울,광진구,0,0,1,1,1,0,2019-08-09
2468,서울,광진구,0,0,2,2,2,0,2019-09-09
2469,서울,광진구,0,0,1,1,1,0,2019-10-09
2470,서울,광진구,6,0,1,7,5,0,2019-11-09
2471,서울,광진구,0,0,1,1,1,0,2019-12-09
2472,서울,구로구,5,1,2,8,4,0,2019-01-09
2473,서울,구로구,6,0,2,8,6,0,2019-02-09
2474,서울,구로구,3,0,0,3,2,0,2019-03-09
2475,서울,구로구,5,2,5,12,7,0,2019-04-09
2476,서울,구로구,1,0,0,1,1,0,2019-05-09
2477,서울,구로구,1,0,0,1,1,0,2019-06-09
2478,서울,구로구,2,0,0,2,2,0,2019-07-09
2479,서울,구로구,1,0,0,1,1,0,2019-08-09
2480,서울,구로구,4,3,0,7,4,0,2019-09-09
2481,서울,구로구,7,1,1,9,9,1,2019-10-09
2482,서울,구로구,2,0,0,2,2,0,2019-11-09
2483,서울,구로구,5,0,1,6,3,0,2019-12-09
2484,서울,금천구,0,0,0,0,0,0,2019-01-09
2485,서울,금천구,1,0,0,1,1,0,2019-02-09
2486,서울,금천구,6,0,1,7,4,0,2019-03-09
2487,서울,금천구,7,0,0,7,4,0,2019-04-09
2488,서울,금천구,1,0,0,1,1,0,2019-05-09
2489,서울,금천구,2,0,0,2,1,0,2019-06-09
2490,서울,금천구,2,0,1,3,2,0,2019-07-09
2491,서울,금천구,14,13,6,33,2,0,2019-08-09
2492,서울,금천구,2,0,0,2,2,0,2019-09-09
2493,서울,금천구,2,0,0,2,2,0,2019-10-09
2494,서울,금천구,4,1,0,5,4,0,2019-11-09
2495,서울,금천구,0,0,3,3,2,0,2019-12-09
2496,서울,노원구,2,0,1,3,2,0,2019-01-09
2497,서울,노원구,4,0,1,5,4,0,2019-02-09
2498,서울,노원구,7,1,3,11,7,0,2019-03-09
2499,서울,노원구,10,0,0,10,7,0,2019-04-09
2500,서울,노원구,8,0,2,10,7,0,2019-05-09
2501,서울,노원구,5,0,3,8,6,0,2019-06-09
2502,서울,노원구,1,3,2,6,6,0,2019-07-09
2503,서울,노원구,5,2,1,8,6,0,2019-08-09
2504,서울,노원구,8,0,3,11,8,0,2019-09-09
2505,서울,노원구,6,0,2,8,8,0,2019-10-09
2506,서울,노원구,11,1,5,17,12,0,2019-11-09
2507,서울,노원구,6,0,2,8,5,0,2019-12-09
2508,서울,도봉구,0,1,3,4,3,0,2019-01-09
2509,서울,도봉구,0,0,0,0,0,0,2019-02-09
2510,서울,도봉구,3,0,1,4,3,0,2019-03-09
2511,서울,도봉구,2,0,3,5,4,0,2019-04-09
2512,서울,도봉구,0,1,3,4,4,0,2019-05-09
2513,서울,도봉구,0,0,0,0,0,0,2019-06-09
2514,서울,도봉구,1,1,1,3,3,0,2019-07-09
2515,서울,도봉구,1,0,0,1,1,0,2019-08-09
2516,서울,도봉구,2,0,0,2,2,0,2019-09-09
2517,서울,도봉구,1,0,0,1,1,0,2019-10-09
2518,서울,도봉구,0,0,1,1,1,0,2019-11-09
2519,서울,도봉구,1,4,1,6,5,0,2019-12-09
2520,서울,동대문구,5,1,1,7,5,0,2019-01-09
2521,서울,동대문구,3,0,0,3,2,0,2019-02-09
2522,서울,동대문구,4,0,0,4,3,0,2019-03-09
2523,서울,동대문구,6,0,2,8,5,0,2019-04-09
2524,서울,동대문구,0,0,2,2,2,0,2019-05-09
2525,서울,동대문구,2,0,4,6,3,0,2019-06-09
2526,서울,동대문구,4,1,2,7,6,0,2019-07-09
2527,서울,동대문구,4,0,7,11,7,0,2019-08-09
2528,서울,동대문구,2,0,2,4,3,0,2019-09-09
2529,서울,동대문구,2,0,2,4,3,0,2019-10-09
2530,서울,동대문구,2,3,5,10,8,0,2019-11-09
2531,서울,동대문구,2,0,5,7,7,0,2019-12-09
2532,서울,동작구,3,0,0,3,3,0,2019-01-09
2533,서울,동작구,0,0,0,0,0,0,2019-02-09
2534,서울,동작구,8,1,1,10,3,0,2019-03-09
2535,서울,동작구,4,2,1,7,7,1,2019-04-09
2536,서울,동작구,16,8,4,28,4,0,2019-05-09
2537,서울,동작구,2,0,1,3,2,0,2019-06-09
2538,서울,동작구,5,1,1,7,6,0,2019-07-09
2539,서울,동작구,5,1,2,8,5,0,2019-08-09
2540,서울,동작구,2,2,3,7,7,0,2019-09-09
2541,서울,동작구,2,0,3,5,5,0,2019-10-09
2542,서울,동작구,3,1,0,4,3,0,2019-11-09
2543,서울,동작구,3,0,1,4,4,0,2019-12-09
2544,서울,마포구,5,0,0,5,2,0,2019-01-09
2545,서울,마포구,4,2,1,7,6,0,2019-02-09
2546,서울,마포구,2,0,0,2,2,0,2019-03-09
2547,서울,마포구,9,2,1,12,5,0,2019-04-09
2548,서울,마포구,3,0,0,3,3,0,2019-05-09
2549,서울,마포구,4,0,0,4,3,0,2019-06-09
2550,서울,마포구,10,0,0,10,4,0,2019-07-09
2551,서울,마포구,5,0,2,7,6,0,2019-08-09
2552,서울,마포구,7,0,0,7,5,0,2019-09-09
2553,서울,마포구,9,0,4,13,8,0,2019-10-09
2554,서울,마포구,1,1,2,4,4,0,2019-11-09
2555,서울,마포구,3,0,1,4,3,1,2019-12-09
2556,서울,서대문구,0,0,1,1,1,0,2019-01-09
2557,서울,서대문구,0,0,0,0,0,0,2019-02-09
2558,서울,서대문구,2,0,0,2,2,0,2019-03-09
2559,서울,서대문구,1,0,0,1,1,0,2019-04-09
2560,서울,서대문구,8,1,0,9,6,0,2019-05-09
2561,서울,서대문구,1,0,0,1,1,0,2019-06-09
2562,서울,서대문구,2,0,1,3,3,0,2019-07-09
2563,서울,서대문구,3,1,0,4,4,1,2019-08-09
2564,서울,서대문구,7,1,1,9,8,0,2019-09-09
2565,서울,서대문구,2,2,0,4,3,0,2019-10-09
2566,서울,서대문구,1,0,2,3,3,0,2019-11-09
2567,서울,서대문구,2,1,1,4,4,0,2019-12-09
2568,서울,서초구,6,1,3,10,8,0,2019-01-09
2569,서울,서초구,3,0,0,3,1,0,2019-02-09
2570,서울,서초구,10,3,0,13,9,0,2019-03-09
2571,서울,서초구,9,0,0,9,7,0,2019-04-09
2572,서울,서초구,3,0,1,4,4,0,2019-05-09
2573,서울,서초구,3,1,2,6,4,0,2019-06-09
2574,서울,서초구,9,1,2,12,10,0,2019-07-09
2575,서울,서초구,6,3,1,10,8,0,2019-08-09
2576,서울,서초구,8,1,0,9,7,0,2019-09-09
2577,서울,서초구,6,0,2,8,3,0,2019-10-09
2578,서울,서초구,11,0,1,12,7,0,2019-11-09
2579,서울,서초구,10,0,0,10,8,0,2019-12-09
2580,서울,성동구,3,0,0,3,2,0,2019-01-09
2581,서울,성동구,3,0,0,3,2,0,2019-02-09
2582,서울,성동구,5,0,1,6,4,0,2019-03-09
2583,서울,성동구,2,0,0,2,2,0,2019-04-09
2584,서울,성동구,3,0,1,4,4,0,2019-05-09
2585,서울,성동구,0,0,0,0,0,0,2019-06-09
2586,서울,성동구,3,0,0,3,3,0,2019-07-09
2587,서울,성동구,2,0,0,2,2,0,2019-08-09
2588,서울,성동구,8,0,2,10,5,0,2019-09-09
2589,서울,성동구,2,0,0,2,2,0,2019-10-09
2590,서울,성동구,2,1,0,3,3,0,2019-11-09
2591,서울,성동구,7,0,0,7,6,0,2019-12-09
2592,서울,성북구,2,0,1,3,3,0,2019-01-09
2593,서울,성북구,3,1,0,4,3,0,2019-02-09
2594,서울,성북구,1,0,2,3,3,0,2019-03-09
2595,서울,성북구,5,0,1,6,4,0,2019-04-09
2596,서울,성북구,1,1,0,2,1,0,2019-05-09
2597,서울,성북구,0,1,0,1,1,0,2019-06-09
2598,서울,성북구,4,0,0,4,4,0,2019-07-09
2599,서울,성북구,1,0,0,1,1,0,2019-08-09
2600,서울,성북구,5,1,2,8,6,0,2019-09-09
2601,서울,성북구,6,0,1,7,4,0,2019-10-09
2602,서울,성북구,0,0,3,3,3,0,2019-11-09
2603,서울,성북구,6,0,1,7,6,0,2019-12-09
2604,서울,송파구,2,2,2,6,5,0,2019-01-09
2605,서울,송파구,3,2,2,7,4,0,2019-02-09
2606,서울,송파구,11,2,4,17,11,0,2019-03-09
2607,서울,송파구,6,2,0,8,5,0,2019-04-09
2608,서울,송파구,3,1,4,8,7,0,2019-05-09
2609,서울,송파구,6,0,1,7,4,0,2019-06-09
2610,서울,송파구,10,1,2,13,10,0,2019-07-09
2611,서울,송파구,11,3,1,15,10,0,2019-08-09
2612,서울,송파구,14,0,2,16,14,0,2019-09-09
2613,서울,송파구,4,1,6,11,6,0,2019-10-09
2614,서울,송파구,5,2,0,7,5,0,2019-11-09
2615,서울,송파구,4,0,0,4,3,0,2019-12-09
2616,서울,양천구,6,1,3,10,4,0,2019-01-09
2617,서울,양천구,4,0,0,4,2,0,2019-02-09
2618,서울,양천구,7,1,2,10,7,0,2019-03-09
2619,서울,양천구,2,0,2,4,4,0,2019-04-09
2620,서울,양천구,4,1,0,5,4,0,2019-05-09
2621,서울,양천구,1,0,2,3,2,0,2019-06-09
2622,서울,양천구,2,0,1,3,3,0,2019-07-09
2623,서울,양천구,8,1,1,10,6,0,2019-08-09
2624,서울,양천구,2,3,1,6,4,0,2019-09-09
2625,서울,양천구,2,0,0,2,2,0,2019-10-09
2626,서울,양천구,2,0,3,5,5,0,2019-11-09
2627,서울,양천구,3,1,1,5,5,0,2019-12-09
2628,서울,영등포구,8,0,2,10,8,0,2019-01-09
2629,서울,영등포구,3,1,0,4,2,0,2019-02-09
2630,서울,영등포구,6,1,3,10,9,0,2019-03-09
2631,서울,영등포구,22,1,4,27,11,0,2019-04-09
2632,서울,영등포구,5,1,3,9,6,0,2019-05-09
2633,서울,영등포구,5,2,0,7,5,0,2019-06-09
2634,서울,영등포구,5,0,1,6,5,0,2019-07-09
2635,서울,영등포구,9,1,1,11,9,0,2019-08-09
2636,서울,영등포구,6,1,5,12,11,0,2019-09-09
2637,서울,영등포구,6,0,5,11,7,0,2019-10-09
2638,서울,영등포구,9,1,4,14,10,0,2019-11-09
2639,서울,영등포구,2,1,0,3,2,0,2019-12-09
2640,서울,용산구,2,0,1,3,3,0,2019-01-09
2641,서울,용산구,5,0,2,7,7,0,2019-02-09
2642,서울,용산구,3,2,1,6,6,1,2019-03-09
2643,서울,용산구,2,0,0,2,2,0,2019-04-09
2644,서울,용산구,5,1,1,7,4,0,2019-05-09
2645,서울,용산구,3,0,2,5,3,0,2019-06-09
2646,서울,용산구,1,0,0,1,1,0,2019-07-09
2647,서울,용산구,2,0,0,2,2,0,2019-08-09
2648,서울,용산구,6,0,1,7,6,0,2019-09-09
2649,서울,용산구,3,0,1,4,4,0,2019-10-09
2650,서울,용산구,0,0,0,0,0,0,2019-11-09
2651,서울,용산구,1,0,0,1,1,0,2019-12-09
2652,서울,은평구,0,1,0,1,1,0,2019-01-09
2653,서울,은평구,2,0,0,2,2,0,2019-02-09
2654,서울,은평구,3,1,1,5,4,0,2019-03-09
2655,서울,은평구,1,0,0,1,1,0,2019-04-09
2656,서울,은평구,4,0,2,6,6,1,2019-05-09
2657,서울,은평구,2,0,1,3,3,0,2019-06-09
2658,서울,은평구,3,1,1,5,4,0,2019-07-09
2659,서울,은평구,1,4,0,5,2,0,2019-08-09
2660,서울,은평구,2,0,0,2,2,0,2019-09-09
2661,서울,은평구,1,0,0,1,1,0,2019-10-09
2662,서울,은평구,0,0,0,0,0,0,2019-11-09
2663,서울,은평구,2,3,1,6,6,0,2019-12-09
2664,서울,종로구,5,2,1,8,5,0,2019-01-09
2665,서울,종로구,0,0,0,0,0,0,2019-02-09
2666,서울,종로구,5,0,0,5,4,0,2019-03-09
2667,서울,종로구,1,1,0,2,1,0,2019-04-09
2668,서울,종로구,13,0,0,13,9,0,2019-05-09
2669,서울,종로구,5,0,2,7,6,0,2019-06-09
2670,서울,종로구,3,0,1,4,3,0,2019-07-09
2671,서울,종로구,4,1,2,7,5,0,2019-08-09
2672,서울,종로구,6,0,5,11,5,0,2019-09-09
2673,서울,종로구,3,0,1,4,4,0,2019-10-09
2674,서울,종로구,4,0,1,5,3,0,2019-11-09
2675,서울,종로구,1,0,1,2,2,0,2019-12-09
2676,서울,중구,5,1,3,9,7,0,2019-01-09
2677,서울,중구,0,0,1,1,1,0,2019-02-09
2678,서울,중구,1,0,1,2,2,0,2019-03-09
2679,서울,중구,4,1,0,5,4,0,2019-04-09
2680,서울,중구,2,0,1,3,2,0,2019-05-09
2681,서울,중구,1,0,0,1,1,0,2019-06-09
2682,서울,중구,4,0,2,6,6,0,2019-07-09
2683,서울,중구,9,0,1,10,8,0,2019-08-09
2684,서울,중구,3,0,1,4,4,0,2019-09-09
2685,서울,중구,1,0,2,3,2,0,2019-10-09
2686,서울,중구,2,0,0,2,2,0,2019-11-09
2687,서울,중구,2,0,1,3,3,0,2019-12-09
2688,서울,중랑구,3,0,4,7,5,0,2019-01-09
2689,서울,중랑구,3,0,0,3,3,0,2019-02-09
2690,서울,중랑구,4,0,1,5,4,0,2019-03-09
2691,서울,중랑구,4,0,0,4,4,0,2019-04-09
2692,서울,중랑구,6,1,3,10,8,0,2019-05-09
2693,서울,중랑구,3,0,0,3,3,0,2019-06-09
2694,서울,중랑구,2,1,1,4,4,0,2019-07-09
2695,서울,중랑구,2,1,2,5,5,0,2019-08-09
2696,서울,중랑구,8,0,0,8,5,0,2019-09-09
2697,서울,중랑구,2,1,2,5,2,0,2019-10-09
2698,서울,중랑구,2,1,2,5,4,0,2019-11-09
2699,서울,중랑구,1,0,0,1,1,0,2019-12-09
2700,서울,강남구,6,0,2,8,8,0,2019-01-10
2701,서울,강남구,3,1,0,4,3,0,2019-02-10
2702,서울,강남구,5,0,1,6,4,0,2019-03-10
2703,서울,강남구,7,3,2,12,10,0,2019-04-10
2704,서울,강남구,14,2,7,23,16,0,2019-05-10
2705,서울,강남구,7,0,5,12,9,0,2019-06-10
2706,서울,강남구,15,0,0,15,9,0,2019-07-10
2707,서울,강남구,11,4,4,19,13,0,2019-08-10
2708,서울,강남구,23,3,3,29,23,0,2019-09-10
2709,서울,강남구,10,0,2,12,10,0,2019-10-10
2710,서울,강남구,11,0,0,11,6,0,2019-11-10
2711,서울,강남구,7,2,3,12,11,0,2019-12-10
2712,서울,강동구,1,1,0,2,2,0,2019-01-10
2713,서울,강동구,3,0,2,5,4,0,2019-02-10
2714,서울,강동구,2,0,1,3,2,0,2019-03-10
2715,서울,강동구,2,0,0,2,2,0,2019-04-10
2716,서울,강동구,6,0,0,6,3,0,2019-05-10
2717,서울,강동구,1,1,1,3,3,0,2019-06-10
2718,서울,강동구,5,0,1,6,5,0,2019-07-10
2719,서울,강동구,8,0,2,10,5,0,2019-08-10
2720,서울,강동구,3,0,0,3,3,0,2019-09-10
2721,서울,강동구,5,1,3,9,8,0,2019-10-10
2722,서울,강동구,2,0,0,2,2,0,2019-11-10
2723,서울,강동구,2,1,1,4,3,0,2019-12-10
2724,서울,강북구,3,0,1,4,3,0,2019-01-10
2725,서울,강북구,4,0,1,5,2,0,2019-02-10
2726,서울,강북구,1,0,0,1,1,0,2019-03-10
2727,서울,강북구,9,0,0,9,5,0,2019-04-10
2728,서울,강북구,2,1,2,5,4,0,2019-05-10
2729,서울,강북구,3,0,0,3,3,0,2019-06-10
2730,서울,강북구,1,0,0,1,1,0,2019-07-10
2731,서울,강북구,2,0,0,2,2,0,2019-08-10
2732,서울,강북구,8,1,3,12,10,1,2019-09-10
2733,서울,강북구,5,0,0,5,5,0,2019-10-10
2734,서울,강북구,3,0,0,3,2,0,2019-11-10
2735,서울,강북구,2,0,2,4,2,0,2019-12-10
2736,서울,강서구,3,2,2,7,4,0,2019-01-10
2737,서울,강서구,2,0,1,3,3,0,2019-02-10
2738,서울,강서구,9,0,1,10,5,0,2019-03-10
2739,서울,강서구,5,1,0,6,4,0,2019-04-10
2740,서울,강서구,3,0,2,5,5,0,2019-05-10
2741,서울,강서구,6,0,2,8,6,0,2019-06-10
2742,서울,강서구,8,1,1,10,6,0,2019-07-10
2743,서울,강서구,6,0,1,7,4,0,2019-08-10
2744,서울,강서구,7,0,2,9,8,0,2019-09-10
2745,서울,강서구,5,1,1,7,5,0,2019-10-10
2746,서울,강서구,7,0,2,9,7,0,2019-11-10
2747,서울,강서구,3,0,1,4,4,0,2019-12-10
2748,서울,관악구,3,0,0,3,2,0,2019-01-10
2749,서울,관악구,1,0,2,3,3,0,2019-02-10
2750,서울,관악구,5,0,2,7,4,0,2019-03-10
2751,서울,관악구,6,0,2,8,7,0,2019-04-10
2752,서울,관악구,8,0,2,10,8,0,2019-05-10
2753,서울,관악구,4,0,3,7,5,0,2019-06-10
2754,서울,관악구,3,1,2,6,4,0,2019-07-10
2755,서울,관악구,2,0,0,2,2,0,2019-08-10
2756,서울,관악구,7,0,5,12,8,0,2019-09-10
2757,서울,관악구,0,0,2,2,2,0,2019-10-10
2758,서울,관악구,1,0,0,1,1,0,2019-11-10
2759,서울,관악구,4,0,1,5,2,0,2019-12-10
2760,서울,광진구,1,0,1,2,2,0,2019-01-10
2761,서울,광진구,7,0,0,7,4,0,2019-02-10
2762,서울,광진구,4,0,0,4,3,0,2019-03-10
2763,서울,광진구,5,0,0,5,5,0,2019-04-10
2764,서울,광진구,9,0,0,9,6,0,2019-05-10
2765,서울,광진구,7,0,1,8,6,0,2019-06-10
2766,서울,광진구,1,0,0,1,1,0,2019-07-10
2767,서울,광진구,2,0,1,3,2,0,2019-08-10
2768,서울,광진구,0,0,2,2,2,0,2019-09-10
2769,서울,광진구,1,0,1,2,2,0,2019-10-10
2770,서울,광진구,4,0,1,5,4,0,2019-11-10
2771,서울,광진구,3,0,1,4,2,0,2019-12-10
2772,서울,구로구,5,0,2,7,4,0,2019-01-10
2773,서울,구로구,3,0,0,3,2,0,2019-02-10
2774,서울,구로구,1,0,1,2,2,0,2019-03-10
2775,서울,구로구,6,0,1,7,5,0,2019-04-10
2776,서울,구로구,1,0,0,1,1,0,2019-05-10
2777,서울,구로구,2,0,0,2,1,0,2019-06-10
2778,서울,구로구,6,0,1,7,6,0,2019-07-10
2779,서울,구로구,7,0,1,8,4,0,2019-08-10
2780,서울,구로구,11,1,2,14,11,0,2019-09-10
2781,서울,구로구,4,0,0,4,3,0,2019-10-10
2782,서울,구로구,9,0,0,9,5,0,2019-11-10
2783,서울,구로구,3,1,0,4,3,0,2019-12-10
2784,서울,금천구,1,0,1,2,2,0,2019-01-10
2785,서울,금천구,0,0,0,0,0,0,2019-02-10
2786,서울,금천구,1,0,2,3,3,0,2019-03-10
2787,서울,금천구,2,0,0,2,2,0,2019-04-10
2788,서울,금천구,4,0,0,4,2,0,2019-05-10
2789,서울,금천구,1,0,0,1,1,0,2019-06-10
2790,서울,금천구,4,0,2,6,3,0,2019-07-10
2791,서울,금천구,2,0,0,2,1,0,2019-08-10
2792,서울,금천구,5,0,3,8,5,0,2019-09-10
2793,서울,금천구,1,0,1,2,2,0,2019-10-10
2794,서울,금천구,3,0,0,3,1,0,2019-11-10
2795,서울,금천구,1,0,0,1,1,0,2019-12-10
2796,서울,노원구,6,2,3,11,6,0,2019-01-10
2797,서울,노원구,4,0,1,5,2,0,2019-02-10
2798,서울,노원구,2,0,0,2,2,0,2019-03-10
2799,서울,노원구,2,1,0,3,3,0,2019-04-10
2800,서울,노원구,8,1,0,9,6,0,2019-05-10
2801,서울,노원구,6,0,0,6,3,0,2019-06-10
2802,서울,노원구,2,0,1,3,2,0,2019-07-10
2803,서울,노원구,6,3,1,10,8,0,2019-08-10
2804,서울,노원구,5,3,1,9,8,0,2019-09-10
2805,서울,노원구,3,0,0,3,3,0,2019-10-10
2806,서울,노원구,6,0,0,6,3,0,2019-11-10
2807,서울,노원구,1,1,3,5,5,0,2019-12-10
2808,서울,도봉구,1,0,0,1,1,0,2019-01-10
2809,서울,도봉구,0,0,0,0,0,0,2019-02-10
2810,서울,도봉구,4,2,1,7,5,0,2019-03-10
2811,서울,도봉구,0,0,0,0,0,0,2019-04-10
2812,서울,도봉구,4,0,4,8,7,0,2019-05-10
2813,서울,도봉구,0,1,2,3,3,0,2019-06-10
2814,서울,도봉구,0,0,0,0,0,0,2019-07-10
2815,서울,도봉구,9,0,2,11,4,0,2019-08-10
2816,서울,도봉구,4,1,0,5,4,0,2019-09-10
2817,서울,도봉구,1,0,2,3,3,0,2019-10-10
2818,서울,도봉구,0,0,0,0,0,0,2019-11-10
2819,서울,도봉구,1,1,0,2,2,0,2019-12-10
2820,서울,동대문구,4,0,5,9,8,0,2019-01-10
2821,서울,동대문구,2,0,3,5,3,0,2019-02-10
2822,서울,동대문구,1,0,0,1,1,0,2019-03-10
2823,서울,동대문구,1,1,2,4,4,0,2019-04-10
2824,서울,동대문구,6,0,0,6,6,0,2019-05-10
2825,서울,동대문구,4,3,2,9,8,1,2019-06-10
2826,서울,동대문구,2,0,0,2,2,0,2019-07-10
2827,서울,동대문구,1,1,0,2,3,1,2019-08-10
2828,서울,동대문구,3,0,3,6,6,0,2019-09-10
2829,서울,동대문구,3,2,2,7,7,0,2019-10-10
2830,서울,동대문구,1,0,2,3,3,0,2019-11-10
2831,서울,동대문구,2,1,2,5,5,0,2019-12-10
2832,서울,동작구,4,4,0,8,4,0,2019-01-10
2833,서울,동작구,4,1,0,5,4,0,2019-02-10
2834,서울,동작구,3,0,0,3,2,1,2019-03-10
2835,서울,동작구,2,0,2,4,3,0,2019-04-10
2836,서울,동작구,1,0,3,4,4,0,2019-05-10
2837,서울,동작구,5,4,2,11,6,0,2019-06-10
2838,서울,동작구,17,1,5,23,14,0,2019-07-10
2839,서울,동작구,9,1,1,11,3,0,2019-08-10
2840,서울,동작구,3,0,2,5,3,0,2019-09-10
2841,서울,동작구,2,0,0,2,1,0,2019-10-10
2842,서울,동작구,7,3,4,14,6,0,2019-11-10
2843,서울,동작구,4,0,1,5,5,0,2019-12-10
2844,서울,마포구,2,0,0,2,1,0,2019-01-10
2845,서울,마포구,3,1,1,5,5,0,2019-02-10
2846,서울,마포구,4,1,0,5,4,0,2019-03-10
2847,서울,마포구,2,0,2,4,4,0,2019-04-10
2848,서울,마포구,6,1,0,7,5,0,2019-05-10
2849,서울,마포구,3,0,0,3,2,0,2019-06-10
2850,서울,마포구,2,1,0,3,3,0,2019-07-10
2851,서울,마포구,8,0,0,8,6,0,2019-08-10
2852,서울,마포구,7,2,2,11,5,0,2019-09-10
2853,서울,마포구,4,0,3,7,6,0,2019-10-10
2854,서울,마포구,5,2,1,8,6,0,2019-11-10
2855,서울,마포구,2,0,0,2,1,0,2019-12-10
2856,서울,서대문구,2,1,0,3,3,0,2019-01-10
2857,서울,서대문구,2,1,0,3,3,0,2019-02-10
2858,서울,서대문구,1,0,0,1,1,0,2019-03-10
2859,서울,서대문구,2,0,1,3,3,0,2019-04-10
2860,서울,서대문구,1,0,0,1,1,0,2019-05-10
2861,서울,서대문구,2,0,1,3,3,0,2019-06-10
2862,서울,서대문구,3,3,1,7,4,0,2019-07-10
2863,서울,서대문구,1,0,0,1,1,0,2019-08-10
2864,서울,서대문구,3,0,2,5,3,0,2019-09-10
2865,서울,서대문구,0,0,0,0,0,0,2019-10-10
2866,서울,서대문구,5,0,0,5,2,0,2019-11-10
2867,서울,서대문구,6,0,1,7,5,0,2019-12-10
2868,서울,서초구,1,2,1,4,4,0,2019-01-10
2869,서울,서초구,2,0,1,3,3,0,2019-02-10
2870,서울,서초구,3,0,0,3,3,0,2019-03-10
2871,서울,서초구,7,1,6,14,10,0,2019-04-10
2872,서울,서초구,13,0,3,16,9,0,2019-05-10
2873,서울,서초구,5,0,4,9,6,0,2019-06-10
2874,서울,서초구,8,0,1,9,7,0,2019-07-10
2875,서울,서초구,10,0,3,13,9,0,2019-08-10
2876,서울,서초구,13,1,3,17,14,0,2019-09-10
2877,서울,서초구,6,0,0,6,6,0,2019-10-10
2878,서울,서초구,8,0,4,12,9,0,2019-11-10
2879,서울,서초구,4,1,2,7,6,0,2019-12-10
2880,서울,성동구,2,0,1,3,3,0,2019-01-10
2881,서울,성동구,5,0,0,5,2,0,2019-02-10
2882,서울,성동구,0,0,0,0,0,0,2019-03-10
2883,서울,성동구,9,0,2,11,10,0,2019-04-10
2884,서울,성동구,7,0,1,8,6,0,2019-05-10
2885,서울,성동구,6,0,1,7,5,0,2019-06-10
2886,서울,성동구,2,0,0,2,2,0,2019-07-10
2887,서울,성동구,1,0,1,2,2,0,2019-08-10
2888,서울,성동구,3,0,0,3,3,0,2019-09-10
2889,서울,성동구,2,0,1,3,2,0,2019-10-10
2890,서울,성동구,0,0,1,1,1,0,2019-11-10
2891,서울,성동구,3,1,1,5,4,0,2019-12-10
2892,서울,성북구,4,0,1,5,4,0,2019-01-10
2893,서울,성북구,2,0,0,2,2,0,2019-02-10
2894,서울,성북구,6,0,3,9,6,0,2019-03-10
2895,서울,성북구,13,0,0,13,9,0,2019-04-10
2896,서울,성북구,4,0,1,5,5,0,2019-05-10
2897,서울,성북구,7,1,0,8,4,0,2019-06-10
2898,서울,성북구,3,0,0,3,3,0,2019-07-10
2899,서울,성북구,2,0,2,4,3,0,2019-08-10
2900,서울,성북구,2,0,3,5,5,0,2019-09-10
2901,서울,성북구,5,0,0,5,3,0,2019-10-10
2902,서울,성북구,6,0,0,6,5,0,2019-11-10
2903,서울,성북구,5,1,2,8,8,1,2019-12-10
2904,서울,송파구,10,1,2,13,7,0,2019-01-10
2905,서울,송파구,5,1,1,7,3,0,2019-02-10
2906,서울,송파구,0,1,3,4,4,0,2019-03-10
2907,서울,송파구,6,1,1,8,6,0,2019-04-10
2908,서울,송파구,11,0,4,15,10,0,2019-05-10
2909,서울,송파구,9,2,5,16,11,0,2019-06-10
2910,서울,송파구,15,1,3,19,11,0,2019-07-10
2911,서울,송파구,10,0,1,11,8,0,2019-08-10
2912,서울,송파구,7,1,3,11,10,0,2019-09-10
2913,서울,송파구,4,1,4,9,9,0,2019-10-10
2914,서울,송파구,3,1,5,9,5,0,2019-11-10
2915,서울,송파구,7,0,1,8,8,0,2019-12-10
2916,서울,양천구,5,0,3,8,5,0,2019-01-10
2917,서울,양천구,0,0,0,0,0,0,2019-02-10
2918,서울,양천구,0,1,0,1,1,0,2019-03-10
2919,서울,양천구,11,0,1,12,9,0,2019-04-10
2920,서울,양천구,5,6,3,14,8,0,2019-05-10
2921,서울,양천구,2,0,1,3,2,0,2019-06-10
2922,서울,양천구,5,0,2,7,7,0,2019-07-10
2923,서울,양천구,12,2,0,14,8,0,2019-08-10
2924,서울,양천구,8,0,2,10,8,0,2019-09-10
2925,서울,양천구,3,0,0,3,3,0,2019-10-10
2926,서울,양천구,5,2,1,8,6,0,2019-11-10
2927,서울,양천구,3,0,0,3,3,0,2019-12-10
2928,서울,영등포구,5,0,2,7,7,0,2019-01-10
2929,서울,영등포구,5,0,1,6,5,0,2019-02-10
2930,서울,영등포구,6,0,0,6,5,0,2019-03-10
2931,서울,영등포구,7,0,3,10,7,0,2019-04-10
2932,서울,영등포구,11,1,2,14,7,0,2019-05-10
2933,서울,영등포구,6,0,1,7,6,0,2019-06-10
2934,서울,영등포구,4,2,3,9,8,0,2019-07-10
2935,서울,영등포구,2,2,1,5,5,0,2019-08-10
2936,서울,영등포구,3,0,1,4,3,0,2019-09-10
2937,서울,영등포구,9,3,1,13,10,0,2019-10-10
2938,서울,영등포구,15,1,0,16,9,0,2019-11-10
2939,서울,영등포구,5,2,2,9,8,0,2019-12-10
2940,서울,용산구,8,0,0,8,5,0,2019-01-10
2941,서울,용산구,0,0,0,0,0,0,2019-02-10
2942,서울,용산구,2,2,3,7,3,0,2019-03-10
2943,서울,용산구,4,0,3,7,6,0,2019-04-10
2944,서울,용산구,3,0,0,3,2,0,2019-05-10
2945,서울,용산구,3,0,1,4,4,0,2019-06-10
2946,서울,용산구,6,0,3,9,8,0,2019-07-10
2947,서울,용산구,5,0,1,6,4,0,2019-08-10
2948,서울,용산구,4,0,0,4,4,0,2019-09-10
2949,서울,용산구,7,0,2,9,7,0,2019-10-10
2950,서울,용산구,2,0,2,4,2,0,2019-11-10
2951,서울,용산구,2,0,0,2,2,0,2019-12-10
2952,서울,은평구,2,0,1,3,2,0,2019-01-10
2953,서울,은평구,3,0,0,3,3,0,2019-02-10
2954,서울,은평구,0,0,1,1,1,0,2019-03-10
2955,서울,은평구,9,2,2,13,5,0,2019-04-10
2956,서울,은평구,3,0,1,4,2,0,2019-05-10
2957,서울,은평구,5,1,2,8,6,0,2019-06-10
2958,서울,은평구,1,0,1,2,2,0,2019-07-10
2959,서울,은평구,3,2,1,6,3,0,2019-08-10
2960,서울,은평구,3,0,2,5,4,0,2019-09-10
2961,서울,은평구,5,0,3,8,5,0,2019-10-10
2962,서울,은평구,11,2,1,14,7,0,2019-11-10
2963,서울,은평구,2,0,0,2,2,0,2019-12-10
2964,서울,종로구,3,0,0,3,3,0,2019-01-10
2965,서울,종로구,3,1,3,7,2,0,2019-02-10
2966,서울,종로구,0,2,0,2,2,0,2019-03-10
2967,서울,종로구,2,0,1,3,2,0,2019-04-10
2968,서울,종로구,4,1,1,6,5,0,2019-05-10
2969,서울,종로구,4,0,0,4,4,0,2019-06-10
2970,서울,종로구,4,1,1,6,4,0,2019-07-10
2971,서울,종로구,3,1,1,5,4,0,2019-08-10
2972,서울,종로구,8,1,2,11,5,0,2019-09-10
2973,서울,종로구,1,0,1,2,2,0,2019-10-10
2974,서울,종로구,2,0,0,2,1,0,2019-11-10
2975,서울,종로구,5,2,1,8,6,0,2019-12-10
2976,서울,중구,2,1,0,3,3,0,2019-01-10
2977,서울,중구,1,1,3,5,2,0,2019-02-10
2978,서울,중구,5,0,1,6,4,0,2019-03-10
2979,서울,중구,3,0,2,5,5,0,2019-04-10
2980,서울,중구,5,0,4,9,7,0,2019-05-10
2981,서울,중구,2,0,1,3,3,0,2019-06-10
2982,서울,중구,4,0,3,7,7,0,2019-07-10
2983,서울,중구,3,0,1,4,3,0,2019-08-10
2984,서울,중구,8,0,2,10,8,0,2019-09-10
2985,서울,중구,2,0,2,4,2,0,2019-10-10
2986,서울,중구,1,0,0,1,1,0,2019-11-10
2987,서울,중구,9,0,3,12,8,0,2019-12-10
2988,서울,중랑구,6,1,2,9,7,0,2019-01-10
2989,서울,중랑구,2,0,1,3,3,0,2019-02-10
2990,서울,중랑구,1,0,1,2,2,0,2019-03-10
2991,서울,중랑구,3,0,1,4,4,0,2019-04-10
2992,서울,중랑구,1,0,0,1,1,0,2019-05-10
2993,서울,중랑구,1,1,3,5,4,0,2019-06-10
2994,서울,중랑구,3,1,0,4,4,0,2019-07-10
2995,서울,중랑구,4,0,0,4,3,0,2019-08-10
2996,서울,중랑구,2,2,2,6,5,0,2019-09-10
2997,서울,중랑구,1,0,2,3,2,0,2019-10-10
2998,서울,중랑구,17,1,1,19,8,0,2019-11-10
2999,서울,중랑구,2,0,1,3,3,0,2019-12-10
3000,서울,강남구,12,2,3,17,15,0,2019-01-11
3001,서울,강남구,17,3,0,20,11,0,2019-02-11
3002,서울,강남구,11,2,2,15,13,0,2019-03-11
3003,서울,강남구,18,1,5,24,19,0,2019-04-11
3004,서울,강남구,45,9,4,58,17,0,2019-05-11
3005,서울,강남구,9,1,0,10,9,0,2019-06-11
3006,서울,강남구,16,0,4,20,14,0,2019-07-11
3007,서울,강남구,14,0,2,16,10,0,2019-08-11
3008,서울,강남구,8,0,3,11,9,0,2019-09-11
3009,서울,강남구,7,0,0,7,7,0,2019-10-11
3010,서울,강남구,17,0,3,20,17,0,2019-11-11
3011,서울,강남구,12,0,1,13,10,0,2019-12-11
3012,서울,강동구,8,0,1,9,8,0,2019-01-11
3013,서울,강동구,2,0,1,3,3,0,2019-02-11
3014,서울,강동구,2,0,2,4,4,0,2019-03-11
3015,서울,강동구,5,0,1,6,2,0,2019-04-11
3016,서울,강동구,5,0,4,9,6,0,2019-05-11
3017,서울,강동구,2,2,1,5,3,0,2019-06-11
3018,서울,강동구,4,0,0,4,4,0,2019-07-11
3019,서울,강동구,2,0,1,3,3,0,2019-08-11
3020,서울,강동구,4,0,0,4,3,0,2019-09-11
3021,서울,강동구,1,2,3,6,5,0,2019-10-11
3022,서울,강동구,5,0,0,5,5,0,2019-11-11
3023,서울,강동구,2,0,1,3,3,0,2019-12-11
3024,서울,강북구,1,0,1,2,2,0,2019-01-11
3025,서울,강북구,0,0,0,0,0,0,2019-02-11
3026,서울,강북구,5,1,2,8,5,0,2019-03-11
3027,서울,강북구,7,1,1,9,4,0,2019-04-11
3028,서울,강북구,6,0,0,6,6,0,2019-05-11
3029,서울,강북구,4,0,1,5,5,0,2019-06-11
3030,서울,강북구,5,0,3,8,6,0,2019-07-11
3031,서울,강북구,3,0,3,6,5,0,2019-08-11
3032,서울,강북구,4,0,0,4,3,0,2019-09-11
3033,서울,강북구,2,1,2,5,5,0,2019-10-11
3034,서울,강북구,2,0,0,2,1,0,2019-11-11
3035,서울,강북구,4,1,1,6,3,0,2019-12-11
3036,서울,강서구,1,0,1,2,2,0,2019-01-11
3037,서울,강서구,4,0,1,5,4,0,2019-02-11
3038,서울,강서구,3,0,1,4,3,0,2019-03-11
3039,서울,강서구,2,0,0,2,2,0,2019-04-11
3040,서울,강서구,8,1,1,10,6,0,2019-05-11
3041,서울,강서구,5,2,0,7,5,0,2019-06-11
3042,서울,강서구,5,0,2,7,4,0,2019-07-11
3043,서울,강서구,6,1,3,10,8,0,2019-08-11
3044,서울,강서구,8,0,3,11,8,0,2019-09-11
3045,서울,강서구,4,2,4,10,9,0,2019-10-11
3046,서울,강서구,5,0,0,5,4,0,2019-11-11
3047,서울,강서구,3,1,2,6,6,0,2019-12-11
3048,서울,관악구,2,1,1,4,4,0,2019-01-11
3049,서울,관악구,3,0,2,5,4,0,2019-02-11
3050,서울,관악구,5,0,0,5,4,0,2019-03-11
3051,서울,관악구,5,0,2,7,5,0,2019-04-11
3052,서울,관악구,0,0,2,2,2,0,2019-05-11
3053,서울,관악구,3,0,0,3,3,0,2019-06-11
3054,서울,관악구,3,0,2,5,5,0,2019-07-11
3055,서울,관악구,2,0,1,3,3,0,2019-08-11
3056,서울,관악구,2,0,3,5,5,0,2019-09-11
3057,서울,관악구,8,0,0,8,6,0,2019-10-11
3058,서울,관악구,1,0,0,1,1,0,2019-11-11
3059,서울,관악구,3,0,0,3,2,0,2019-12-11
3060,서울,광진구,3,0,0,3,2,0,2019-01-11
3061,서울,광진구,0,0,1,1,1,0,2019-02-11
3062,서울,광진구,2,1,0,3,3,0,2019-03-11
3063,서울,광진구,5,0,2,7,5,0,2019-04-11
3064,서울,광진구,3,0,0,3,3,0,2019-05-11
3065,서울,광진구,0,1,0,1,1,0,2019-06-11
3066,서울,광진구,1,0,0,1,1,0,2019-07-11
3067,서울,광진구,1,1,3,5,5,0,2019-08-11
3068,서울,광진구,4,2,2,8,7,0,2019-09-11
3069,서울,광진구,3,0,2,5,3,0,2019-10-11
3070,서울,광진구,4,2,0,6,3,0,2019-11-11
3071,서울,광진구,3,0,0,3,3,0,2019-12-11
3072,서울,구로구,5,1,0,6,4,0,2019-01-11
3073,서울,구로구,4,0,1,5,4,0,2019-02-11
3074,서울,구로구,3,0,0,3,3,0,2019-03-11
3075,서울,구로구,3,0,1,4,2,0,2019-04-11
3076,서울,구로구,5,0,2,7,4,0,2019-05-11
3077,서울,구로구,1,1,2,4,3,0,2019-06-11
3078,서울,구로구,10,0,0,10,5,0,2019-07-11
3079,서울,구로구,13,0,2,15,4,0,2019-08-11
3080,서울,구로구,1,1,2,4,4,0,2019-09-11
3081,서울,구로구,1,2,0,3,3,0,2019-10-11
3082,서울,구로구,3,0,2,5,4,0,2019-11-11
3083,서울,구로구,4,0,1,5,4,0,2019-12-11
3084,서울,금천구,4,0,0,4,2,0,2019-01-11
3085,서울,금천구,1,0,0,1,1,0,2019-02-11
3086,서울,금천구,1,0,1,2,2,0,2019-03-11
3087,서울,금천구,2,0,1,3,3,0,2019-04-11
3088,서울,금천구,0,0,0,0,0,0,2019-05-11
3089,서울,금천구,3,0,2,5,3,0,2019-06-11
3090,서울,금천구,6,0,1,7,4,0,2019-07-11
3091,서울,금천구,0,0,1,1,1,0,2019-08-11
3092,서울,금천구,6,0,0,6,3,0,2019-09-11
3093,서울,금천구,8,0,4,12,9,1,2019-10-11
3094,서울,금천구,1,0,3,4,3,0,2019-11-11
3095,서울,금천구,1,0,0,1,1,0,2019-12-11
3096,서울,노원구,8,3,1,12,7,0,2019-01-11
3097,서울,노원구,7,1,1,9,3,0,2019-02-11
3098,서울,노원구,3,1,1,5,4,0,2019-03-11
3099,서울,노원구,7,1,1,9,5,0,2019-04-11
3100,서울,노원구,10,0,0,10,5,0,2019-05-11
3101,서울,노원구,3,0,0,3,3,0,2019-06-11
3102,서울,노원구,2,1,2,5,5,0,2019-07-11
3103,서울,노원구,5,0,1,6,3,0,2019-08-11
3104,서울,노원구,9,2,1,12,10,0,2019-09-11
3105,서울,노원구,9,1,0,10,5,0,2019-10-11
3106,서울,노원구,5,0,1,6,3,0,2019-11-11
3107,서울,노원구,0,0,1,1,1,0,2019-12-11
3108,서울,도봉구,1,0,0,1,1,0,2019-01-11
3109,서울,도봉구,1,0,1,2,2,0,2019-02-11
3110,서울,도봉구,7,1,2,10,6,0,2019-03-11
3111,서울,도봉구,3,0,2,5,4,0,2019-04-11
3112,서울,도봉구,0,1,0,1,1,0,2019-05-11
3113,서울,도봉구,0,1,1,2,2,0,2019-06-11
3114,서울,도봉구,5,0,0,5,4,0,2019-07-11
3115,서울,도봉구,0,0,0,0,0,0,2019-08-11
3116,서울,도봉구,2,0,3,5,4,0,2019-09-11
3117,서울,도봉구,2,1,3,6,5,0,2019-10-11
3118,서울,도봉구,4,0,0,4,2,0,2019-11-11
3119,서울,도봉구,1,0,2,3,2,0,2019-12-11
3120,서울,동대문구,6,0,0,6,3,0,2019-01-11
3121,서울,동대문구,2,0,1,3,3,0,2019-02-11
3122,서울,동대문구,1,0,3,4,4,0,2019-03-11
3123,서울,동대문구,1,0,1,2,2,0,2019-04-11
3124,서울,동대문구,0,1,1,2,2,0,2019-05-11
3125,서울,동대문구,2,2,0,4,3,0,2019-06-11
3126,서울,동대문구,6,0,2,8,6,0,2019-07-11
3127,서울,동대문구,4,0,2,6,4,0,2019-08-11
3128,서울,동대문구,6,0,4,10,10,0,2019-09-11
3129,서울,동대문구,7,0,1,8,6,1,2019-10-11
3130,서울,동대문구,2,0,2,4,3,0,2019-11-11
3131,서울,동대문구,3,1,1,5,4,0,2019-12-11
3132,서울,동작구,3,0,1,4,4,0,2019-01-11
3133,서울,동작구,4,0,0,4,3,0,2019-02-11
3134,서울,동작구,7,0,2,9,5,0,2019-03-11
3135,서울,동작구,2,1,0,3,3,0,2019-04-11
3136,서울,동작구,14,3,5,22,12,0,2019-05-11
3137,서울,동작구,2,0,2,4,4,0,2019-06-11
3138,서울,동작구,2,0,0,2,2,0,2019-07-11
3139,서울,동작구,0,1,0,1,1,0,2019-08-11
3140,서울,동작구,12,0,1,13,9,0,2019-09-11
3141,서울,동작구,6,2,0,8,6,0,2019-10-11
3142,서울,동작구,6,1,3,10,7,0,2019-11-11
3143,서울,동작구,3,1,0,4,3,0,2019-12-11
3144,서울,마포구,1,0,2,3,3,0,2019-01-11
3145,서울,마포구,3,0,1,4,4,0,2019-02-11
3146,서울,마포구,0,0,0,0,0,0,2019-03-11
3147,서울,마포구,13,0,1,14,11,0,2019-04-11
3148,서울,마포구,7,2,1,10,5,0,2019-05-11
3149,서울,마포구,0,0,1,1,1,0,2019-06-11
3150,서울,마포구,4,1,6,11,6,0,2019-07-11
3151,서울,마포구,2,1,0,3,3,0,2019-08-11
3152,서울,마포구,5,0,2,7,5,0,2019-09-11
3153,서울,마포구,3,0,2,5,4,0,2019-10-11
3154,서울,마포구,6,0,0,6,4,0,2019-11-11
3155,서울,마포구,4,0,2,6,4,0,2019-12-11
3156,서울,서대문구,3,1,0,4,3,0,2019-01-11
3157,서울,서대문구,4,0,0,4,3,0,2019-02-11
3158,서울,서대문구,4,1,1,6,6,0,2019-03-11
3159,서울,서대문구,0,1,0,1,2,1,2019-04-11
3160,서울,서대문구,4,0,1,5,4,0,2019-05-11
3161,서울,서대문구,3,0,0,3,3,0,2019-06-11
3162,서울,서대문구,7,0,1,8,5,0,2019-07-11
3163,서울,서대문구,0,0,1,1,1,0,2019-08-11
3164,서울,서대문구,2,2,0,4,3,0,2019-09-11
3165,서울,서대문구,5,0,1,6,3,0,2019-10-11
3166,서울,서대문구,4,0,0,4,4,0,2019-11-11
3167,서울,서대문구,2,1,0,3,2,0,2019-12-11
3168,서울,서초구,5,2,1,8,8,0,2019-01-11
3169,서울,서초구,9,0,1,10,8,0,2019-02-11
3170,서울,서초구,1,0,0,1,1,0,2019-03-11
3171,서울,서초구,16,0,2,18,11,0,2019-04-11
3172,서울,서초구,5,0,0,5,5,1,2019-05-11
3173,서울,서초구,5,1,0,6,6,0,2019-06-11
3174,서울,서초구,4,2,5,11,6,0,2019-07-11
3175,서울,서초구,8,2,1,11,6,0,2019-08-11
3176,서울,서초구,6,1,0,7,6,0,2019-09-11
3177,서울,서초구,12,1,2,15,5,0,2019-10-11
3178,서울,서초구,5,1,1,7,5,0,2019-11-11
3179,서울,서초구,5,1,2,8,8,0,2019-12-11
3180,서울,성동구,2,0,1,3,2,0,2019-01-11
3181,서울,성동구,1,0,0,1,1,0,2019-02-11
3182,서울,성동구,0,1,3,4,3,0,2019-03-11
3183,서울,성동구,2,0,1,3,3,0,2019-04-11
3184,서울,성동구,5,1,1,7,4,0,2019-05-11
3185,서울,성동구,5,0,0,5,4,0,2019-06-11
3186,서울,성동구,8,1,0,9,4,0,2019-07-11
3187,서울,성동구,3,0,2,5,5,0,2019-08-11
3188,서울,성동구,5,0,2,7,6,0,2019-09-11
3189,서울,성동구,5,1,1,7,6,0,2019-10-11
3190,서울,성동구,1,0,1,2,2,0,2019-11-11
3191,서울,성동구,1,0,1,2,1,0,2019-12-11
3192,서울,성북구,11,0,2,13,6,0,2019-01-11
3193,서울,성북구,3,0,0,3,2,0,2019-02-11
3194,서울,성북구,3,0,1,4,4,0,2019-03-11
3195,서울,성북구,2,0,2,4,4,0,2019-04-11
3196,서울,성북구,4,0,0,4,4,0,2019-05-11
3197,서울,성북구,2,0,3,5,5,0,2019-06-11
3198,서울,성북구,2,0,0,2,1,0,2019-07-11
3199,서울,성북구,1,0,0,1,1,0,2019-08-11
3200,서울,성북구,4,0,2,6,5,0,2019-09-11
3201,서울,성북구,1,0,0,1,1,0,2019-10-11
3202,서울,성북구,3,0,2,5,4,0,2019-11-11
3203,서울,성북구,6,2,0,8,5,0,2019-12-11
3204,서울,송파구,9,2,3,14,11,0,2019-01-11
3205,서울,송파구,3,0,1,4,4,0,2019-02-11
3206,서울,송파구,5,0,1,6,5,0,2019-03-11
3207,서울,송파구,7,0,3,10,6,0,2019-04-11
3208,서울,송파구,2,1,1,4,4,0,2019-05-11
3209,서울,송파구,7,2,3,12,11,0,2019-06-11
3210,서울,송파구,3,0,2,5,5,0,2019-07-11
3211,서울,송파구,9,1,1,11,7,0,2019-08-11
3212,서울,송파구,8,3,2,13,10,0,2019-09-11
3213,서울,송파구,4,1,0,5,4,0,2019-10-11
3214,서울,송파구,8,1,3,12,9,0,2019-11-11
3215,서울,송파구,4,0,1,5,4,0,2019-12-11
3216,서울,양천구,4,0,0,4,4,0,2019-01-11
3217,서울,양천구,4,3,0,7,5,0,2019-02-11
3218,서울,양천구,4,0,2,6,5,0,2019-03-11
3219,서울,양천구,1,1,1,3,3,0,2019-04-11
3220,서울,양천구,9,0,0,9,3,0,2019-05-11
3221,서울,양천구,2,0,0,2,2,0,2019-06-11
3222,서울,양천구,11,0,3,14,7,0,2019-07-11
3223,서울,양천구,3,1,0,4,2,0,2019-08-11
3224,서울,양천구,2,1,1,4,4,0,2019-09-11
3225,서울,양천구,8,3,1,12,8,0,2019-10-11
3226,서울,양천구,7,2,1,10,9,0,2019-11-11
3227,서울,양천구,2,0,1,3,3,0,2019-12-11
3228,서울,영등포구,3,1,1,5,4,0,2019-01-11
3229,서울,영등포구,8,0,1,9,8,0,2019-02-11
3230,서울,영등포구,3,0,2,5,4,0,2019-03-11
3231,서울,영등포구,4,2,0,6,5,0,2019-04-11
3232,서울,영등포구,9,0,3,12,9,0,2019-05-11
3233,서울,영등포구,6,2,2,10,7,0,2019-06-11
3234,서울,영등포구,5,0,1,6,6,0,2019-07-11
3235,서울,영등포구,8,1,0,9,7,0,2019-08-11
3236,서울,영등포구,9,0,0,9,7,0,2019-09-11
3237,서울,영등포구,6,0,4,10,9,0,2019-10-11
3238,서울,영등포구,5,2,0,7,4,0,2019-11-11
3239,서울,영등포구,4,1,2,7,6,0,2019-12-11
3240,서울,용산구,3,0,4,7,4,0,2019-01-11
3241,서울,용산구,1,0,0,1,1,0,2019-02-11
3242,서울,용산구,1,0,1,2,2,0,2019-03-11
3243,서울,용산구,1,0,0,1,1,0,2019-04-11
3244,서울,용산구,6,0,1,7,5,0,2019-05-11
3245,서울,용산구,0,0,1,1,1,0,2019-06-11
3246,서울,용산구,0,0,0,0,0,0,2019-07-11
3247,서울,용산구,4,0,1,5,2,0,2019-08-11
3248,서울,용산구,2,0,1,3,2,0,2019-09-11
3249,서울,용산구,1,0,1,2,2,0,2019-10-11
3250,서울,용산구,3,0,1,4,4,0,2019-11-11
3251,서울,용산구,2,0,2,4,1,0,2019-12-11
3252,서울,은평구,2,0,1,3,2,0,2019-01-11
3253,서울,은평구,0,0,0,0,0,0,2019-02-11
3254,서울,은평구,5,1,2,8,3,0,2019-03-11
3255,서울,은평구,0,0,3,3,2,0,2019-04-11
3256,서울,은평구,4,1,0,5,4,0,2019-05-11
3257,서울,은평구,3,1,0,4,3,0,2019-06-11
3258,서울,은평구,1,1,0,2,1,0,2019-07-11
3259,서울,은평구,3,0,1,4,3,0,2019-08-11
3260,서울,은평구,3,0,2,5,5,0,2019-09-11
3261,서울,은평구,8,0,4,12,5,0,2019-10-11
3262,서울,은평구,2,0,1,3,2,0,2019-11-11
3263,서울,은평구,3,1,1,5,5,0,2019-12-11
3264,서울,종로구,3,0,3,6,5,0,2019-01-11
3265,서울,종로구,1,0,0,1,2,1,2019-02-11
3266,서울,종로구,1,0,2,3,3,0,2019-03-11
3267,서울,종로구,8,0,0,8,4,0,2019-04-11
3268,서울,종로구,6,1,3,10,7,0,2019-05-11
3269,서울,종로구,11,2,4,17,11,0,2019-06-11
3270,서울,종로구,2,0,3,5,5,0,2019-07-11
3271,서울,종로구,1,0,0,1,1,0,2019-08-11
3272,서울,종로구,2,1,1,4,3,0,2019-09-11
3273,서울,종로구,2,0,3,5,5,0,2019-10-11
3274,서울,종로구,0,4,1,5,4,0,2019-11-11
3275,서울,종로구,6,0,0,6,4,0,2019-12-11
3276,서울,중구,1,0,1,2,2,0,2019-01-11
3277,서울,중구,1,0,0,1,1,0,2019-02-11
3278,서울,중구,1,2,1,4,3,0,2019-03-11
3279,서울,중구,4,1,1,6,4,0,2019-04-11
3280,서울,중구,2,0,1,3,1,0,2019-05-11
3281,서울,중구,12,1,2,15,4,0,2019-06-11
3282,서울,중구,7,1,1,9,6,0,2019-07-11
3283,서울,중구,2,0,0,2,2,0,2019-08-11
3284,서울,중구,8,1,4,13,6,0,2019-09-11
3285,서울,중구,6,1,0,7,6,0,2019-10-11
3286,서울,중구,6,1,2,9,7,0,2019-11-11
3287,서울,중구,6,2,2,10,6,0,2019-12-11
3288,서울,중랑구,2,0,2,4,4,0,2019-01-11
3289,서울,중랑구,4,0,0,4,4,0,2019-02-11
3290,서울,중랑구,1,0,1,2,2,0,2019-03-11
3291,서울,중랑구,3,0,1,4,2,0,2019-04-11
3292,서울,중랑구,7,1,1,9,7,0,2019-05-11
3293,서울,중랑구,1,0,1,2,2,0,2019-06-11
3294,서울,중랑구,5,1,0,6,4,0,2019-07-11
3295,서울,중랑구,5,0,0,5,4,0,2019-08-11
3296,서울,중랑구,5,3,1,9,9,1,2019-09-11
3297,서울,중랑구,1,1,1,3,2,0,2019-10-11
3298,서울,중랑구,3,3,2,8,7,0,2019-11-11
3299,서울,중랑구,2,1,1,4,3,0,2019-12-11
3300,서울,강남구,11,1,2,14,8,0,2019-01-12
3301,서울,강남구,6,1,6,13,13,2,2019-02-12
3302,서울,강남구,18,0,1,19,12,0,2019-03-12
3303,서울,강남구,11,1,3,15,13,0,2019-04-12
3304,서울,강남구,8,2,1,11,8,0,2019-05-12
3305,서울,강남구,2,0,0,2,2,0,2019-06-12
3306,서울,강남구,13,4,1,18,15,0,2019-07-12
3307,서울,강남구,6,2,1,9,8,0,2019-08-12
3308,서울,강남구,4,1,0,5,4,0,2019-09-12
3309,서울,강남구,10,0,2,12,10,0,2019-10-12
3310,서울,강남구,17,1,2,20,13,0,2019-11-12
3311,서울,강남구,14,2,4,20,10,0,2019-12-12
3312,서울,강동구,2,0,0,2,2,0,2019-01-12
3313,서울,강동구,1,0,1,2,1,0,2019-02-12
3314,서울,강동구,1,0,0,1,1,0,2019-03-12
3315,서울,강동구,5,1,1,7,5,0,2019-04-12
3316,서울,강동구,2,0,3,5,4,0,2019-05-12
3317,서울,강동구,3,0,1,4,2,0,2019-06-12
3318,서울,강동구,6,0,0,6,4,0,2019-07-12
3319,서울,강동구,5,1,0,6,6,0,2019-08-12
3320,서울,강동구,3,0,1,4,4,0,2019-09-12
3321,서울,강동구,4,0,0,4,3,0,2019-10-12
3322,서울,강동구,2,1,3,6,6,0,2019-11-12
3323,서울,강동구,6,0,0,6,3,0,2019-12-12
3324,서울,강북구,1,0,1,2,2,0,2019-01-12
3325,서울,강북구,3,0,0,3,2,0,2019-02-12
3326,서울,강북구,4,1,0,5,5,0,2019-03-12
3327,서울,강북구,4,0,0,4,2,0,2019-04-12
3328,서울,강북구,4,0,0,4,3,0,2019-05-12
3329,서울,강북구,3,0,1,4,4,0,2019-06-12
3330,서울,강북구,2,0,1,3,2,0,2019-07-12
3331,서울,강북구,6,0,1,7,5,0,2019-08-12
3332,서울,강북구,1,0,0,1,1,0,2019-09-12
3333,서울,강북구,2,0,0,2,2,0,2019-10-12
3334,서울,강북구,7,0,0,7,4,0,2019-11-12
3335,서울,강북구,3,1,0,4,4,0,2019-12-12
3336,서울,강서구,2,0,1,3,2,0,2019-01-12
3337,서울,강서구,4,1,1,6,5,0,2019-02-12
3338,서울,강서구,4,1,1,6,6,0,2019-03-12
3339,서울,강서구,6,0,0,6,5,1,2019-04-12
3340,서울,강서구,4,1,0,5,4,0,2019-05-12
3341,서울,강서구,4,0,0,4,4,0,2019-06-12
3342,서울,강서구,4,0,2,6,5,0,2019-07-12
3343,서울,강서구,8,0,3,11,5,0,2019-08-12
3344,서울,강서구,4,2,2,8,6,0,2019-09-12
3345,서울,강서구,4,1,2,7,5,0,2019-10-12
3346,서울,강서구,3,1,1,5,3,0,2019-11-12
3347,서울,강서구,3,1,1,5,4,0,2019-12-12
3348,서울,관악구,4,0,1,5,4,0,2019-01-12
3349,서울,관악구,2,0,0,2,2,0,2019-02-12
3350,서울,관악구,3,0,0,3,2,0,2019-03-12
3351,서울,관악구,9,0,1,10,4,0,2019-04-12
3352,서울,관악구,2,0,4,6,4,0,2019-05-12
3353,서울,관악구,2,0,1,3,2,0,2019-06-12
3354,서울,관악구,5,2,0,7,5,0,2019-07-12
3355,서울,관악구,5,3,1,9,8,0,2019-08-12
3356,서울,관악구,4,0,1,5,3,0,2019-09-12
3357,서울,관악구,0,0,1,1,1,0,2019-10-12
3358,서울,관악구,1,1,0,2,2,0,2019-11-12
3359,서울,관악구,7,2,0,9,8,0,2019-12-12
3360,서울,광진구,3,0,2,5,2,0,2019-01-12
3361,서울,광진구,0,0,0,0,0,0,2019-02-12
3362,서울,광진구,1,0,0,1,1,0,2019-03-12
3363,서울,광진구,4,0,2,6,4,0,2019-04-12
3364,서울,광진구,5,1,3,9,6,0,2019-05-12
3365,서울,광진구,9,0,2,11,6,0,2019-06-12
3366,서울,광진구,3,0,2,5,4,0,2019-07-12
3367,서울,광진구,1,1,1,3,3,0,2019-08-12
3368,서울,광진구,0,0,1,1,1,0,2019-09-12
3369,서울,광진구,5,0,1,6,6,0,2019-10-12
3370,서울,광진구,1,0,1,2,1,0,2019-11-12
3371,서울,광진구,0,0,0,0,0,0,2019-12-12
3372,서울,구로구,6,0,0,6,5,0,2019-01-12
3373,서울,구로구,1,0,0,1,1,0,2019-02-12
3374,서울,구로구,10,0,2,12,7,0,2019-03-12
3375,서울,구로구,5,0,2,7,6,0,2019-04-12
3376,서울,구로구,2,0,1,3,3,0,2019-05-12
3377,서울,구로구,6,0,1,7,5,0,2019-06-12
3378,서울,구로구,2,0,1,3,3,0,2019-07-12
3379,서울,구로구,5,0,4,9,4,0,2019-08-12
3380,서울,구로구,3,0,0,3,3,0,2019-09-12
3381,서울,구로구,7,1,1,9,6,0,2019-10-12
3382,서울,구로구,2,0,2,4,4,0,2019-11-12
3383,서울,구로구,1,1,1,3,3,0,2019-12-12
3384,서울,금천구,4,0,0,4,4,0,2019-01-12
3385,서울,금천구,2,0,0,2,2,0,2019-02-12
3386,서울,금천구,3,0,1,4,4,0,2019-03-12
3387,서울,금천구,1,0,0,1,1,0,2019-04-12
3388,서울,금천구,4,1,0,5,5,0,2019-05-12
3389,서울,금천구,7,0,0,7,5,0,2019-06-12
3390,서울,금천구,3,0,0,3,3,0,2019-07-12
3391,서울,금천구,0,0,1,1,1,0,2019-08-12
3392,서울,금천구,1,0,1,2,3,1,2019-09-12
3393,서울,금천구,0,1,1,2,2,0,2019-10-12
3394,서울,금천구,2,0,0,2,1,0,2019-11-12
3395,서울,금천구,1,0,3,4,2,0,2019-12-12
3396,서울,노원구,9,2,6,17,9,0,2019-01-12
3397,서울,노원구,5,0,1,6,6,0,2019-02-12
3398,서울,노원구,2,0,0,2,2,0,2019-03-12
3399,서울,노원구,1,0,1,2,2,0,2019-04-12
3400,서울,노원구,0,1,4,5,4,0,2019-05-12
3401,서울,노원구,3,2,0,5,4,0,2019-06-12
3402,서울,노원구,4,1,1,6,6,0,2019-07-12
3403,서울,노원구,5,0,1,6,3,0,2019-08-12
3404,서울,노원구,6,0,2,8,4,0,2019-09-12
3405,서울,노원구,5,1,1,7,5,0,2019-10-12
3406,서울,노원구,12,0,3,15,8,0,2019-11-12
3407,서울,노원구,10,1,3,14,11,0,2019-12-12
3408,서울,도봉구,8,0,1,9,1,0,2019-01-12
3409,서울,도봉구,0,0,0,0,0,0,2019-02-12
3410,서울,도봉구,1,0,1,2,2,0,2019-03-12
3411,서울,도봉구,4,0,1,5,3,0,2019-04-12
3412,서울,도봉구,3,3,1,7,3,0,2019-05-12
3413,서울,도봉구,2,0,1,3,2,0,2019-06-12
3414,서울,도봉구,3,0,2,5,3,0,2019-07-12
3415,서울,도봉구,1,0,1,2,2,0,2019-08-12
3416,서울,도봉구,5,1,0,6,5,0,2019-09-12
3417,서울,도봉구,9,0,3,12,6,0,2019-10-12
3418,서울,도봉구,2,0,4,6,4,0,2019-11-12
3419,서울,도봉구,0,0,0,0,0,0,2019-12-12
3420,서울,동대문구,0,0,7,7,4,0,2019-01-12
3421,서울,동대문구,5,0,3,8,6,0,2019-02-12
3422,서울,동대문구,3,1,1,5,5,0,2019-03-12
3423,서울,동대문구,1,0,2,3,3,0,2019-04-12
3424,서울,동대문구,3,0,0,3,3,0,2019-05-12
3425,서울,동대문구,1,0,5,6,5,0,2019-06-12
3426,서울,동대문구,4,0,0,4,4,0,2019-07-12
3427,서울,동대문구,0,0,1,1,1,0,2019-08-12
3428,서울,동대문구,3,0,0,3,3,0,2019-09-12
3429,서울,동대문구,17,0,0,17,7,0,2019-10-12
3430,서울,동대문구,4,0,3,7,7,0,2019-11-12
3431,서울,동대문구,4,0,0,4,4,0,2019-12-12
3432,서울,동작구,0,0,0,0,0,0,2019-01-12
3433,서울,동작구,11,0,1,12,8,0,2019-02-12
3434,서울,동작구,2,1,0,3,2,0,2019-03-12
3435,서울,동작구,4,0,0,4,3,0,2019-04-12
3436,서울,동작구,6,2,0,8,4,0,2019-05-12
3437,서울,동작구,0,0,0,0,0,0,2019-06-12
3438,서울,동작구,1,0,1,2,2,0,2019-07-12
3439,서울,동작구,2,0,0,2,2,0,2019-08-12
3440,서울,동작구,0,2,1,3,3,0,2019-09-12
3441,서울,동작구,6,0,4,10,7,0,2019-10-12
3442,서울,동작구,7,1,2,10,7,0,2019-11-12
3443,서울,동작구,4,1,1,6,3,0,2019-12-12
3444,서울,마포구,2,1,2,5,3,0,2019-01-12
3445,서울,마포구,3,0,0,3,2,0,2019-02-12
3446,서울,마포구,3,0,0,3,2,0,2019-03-12
3447,서울,마포구,5,0,1,6,4,0,2019-04-12
3448,서울,마포구,4,0,1,5,3,0,2019-05-12
3449,서울,마포구,2,2,1,5,4,0,2019-06-12
3450,서울,마포구,4,0,0,4,4,0,2019-07-12
3451,서울,마포구,2,0,1,3,3,0,2019-08-12
3452,서울,마포구,2,2,0,4,3,0,2019-09-12
3453,서울,마포구,13,0,1,14,9,0,2019-10-12
3454,서울,마포구,5,0,1,6,5,0,2019-11-12
3455,서울,마포구,3,1,0,4,4,0,2019-12-12
3456,서울,서대문구,4,1,1,6,5,0,2019-01-12
3457,서울,서대문구,0,0,4,4,4,0,2019-02-12
3458,서울,서대문구,3,2,1,6,5,0,2019-03-12
3459,서울,서대문구,2,0,0,2,2,0,2019-04-12
3460,서울,서대문구,3,2,2,7,4,0,2019-05-12
3461,서울,서대문구,2,0,0,2,3,1,2019-06-12
3462,서울,서대문구,2,0,1,3,2,0,2019-07-12
3463,서울,서대문구,0,3,0,3,1,0,2019-08-12
3464,서울,서대문구,9,0,4,13,9,2,2019-09-12
3465,서울,서대문구,21,3,2,26,4,0,2019-10-12
3466,서울,서대문구,3,0,0,3,2,0,2019-11-12
3467,서울,서대문구,0,0,0,0,0,0,2019-12-12
3468,서울,서초구,4,0,0,4,4,0,2019-01-12
3469,서울,서초구,6,0,0,6,6,0,2019-02-12
3470,서울,서초구,11,0,3,14,8,0,2019-03-12
3471,서울,서초구,5,1,4,10,9,0,2019-04-12
3472,서울,서초구,9,1,0,10,5,0,2019-05-12
3473,서울,서초구,17,0,3,20,9,0,2019-06-12
3474,서울,서초구,8,1,4,13,12,0,2019-07-12
3475,서울,서초구,7,1,0,8,7,0,2019-08-12
3476,서울,서초구,11,1,0,12,5,0,2019-09-12
3477,서울,서초구,18,2,0,20,10,0,2019-10-12
3478,서울,서초구,7,0,0,7,6,0,2019-11-12
3479,서울,서초구,7,0,3,10,5,1,2019-12-12
3480,서울,성동구,1,0,1,2,2,0,2019-01-12
3481,서울,성동구,4,0,4,8,5,0,2019-02-12
3482,서울,성동구,2,0,1,3,2,0,2019-03-12
3483,서울,성동구,2,1,1,4,3,0,2019-04-12
3484,서울,성동구,0,0,0,0,0,0,2019-05-12
3485,서울,성동구,1,0,0,1,1,0,2019-06-12
3486,서울,성동구,2,0,0,2,2,0,2019-07-12
3487,서울,성동구,4,1,0,5,1,0,2019-08-12
3488,서울,성동구,3,0,0,3,3,0,2019-09-12
3489,서울,성동구,2,0,1,3,3,1,2019-10-12
3490,서울,성동구,4,1,1,6,4,0,2019-11-12
3491,서울,성동구,8,0,1,9,6,0,2019-12-12
3492,서울,성북구,4,0,2,6,5,0,2019-01-12
3493,서울,성북구,2,1,0,3,1,0,2019-02-12
3494,서울,성북구,4,0,3,7,6,0,2019-03-12
3495,서울,성북구,4,0,1,5,5,0,2019-04-12
3496,서울,성북구,2,0,1,3,3,0,2019-05-12
3497,서울,성북구,2,0,2,4,4,0,2019-06-12
3498,서울,성북구,3,0,3,6,5,0,2019-07-12
3499,서울,성북구,6,4,1,11,9,0,2019-08-12
3500,서울,성북구,1,0,0,1,1,0,2019-09-12
3501,서울,성북구,7,0,2,9,9,0,2019-10-12
3502,서울,성북구,3,1,3,7,4,0,2019-11-12
3503,서울,성북구,7,1,1,9,7,0,2019-12-12
3504,서울,송파구,4,0,3,7,6,0,2019-01-12
3505,서울,송파구,8,0,1,9,5,0,2019-02-12
3506,서울,송파구,6,1,1,8,7,0,2019-03-12
3507,서울,송파구,6,1,1,8,8,0,2019-04-12
3508,서울,송파구,4,2,1,7,4,0,2019-05-12
3509,서울,송파구,7,4,2,13,13,0,2019-06-12
3510,서울,송파구,12,1,6,19,12,0,2019-07-12
3511,서울,송파구,3,1,1,5,5,0,2019-08-12
3512,서울,송파구,4,1,0,5,3,0,2019-09-12
3513,서울,송파구,6,5,2,13,7,0,2019-10-12
3514,서울,송파구,9,1,5,15,12,0,2019-11-12
3515,서울,송파구,6,0,1,7,6,0,2019-12-12
3516,서울,양천구,2,3,0,5,4,0,2019-01-12
3517,서울,양천구,7,0,0,7,3,0,2019-02-12
3518,서울,양천구,5,0,0,5,4,0,2019-03-12
3519,서울,양천구,4,0,0,4,3,0,2019-04-12
3520,서울,양천구,2,0,1,3,3,0,2019-05-12
3521,서울,양천구,4,0,0,4,4,0,2019-06-12
3522,서울,양천구,7,0,1,8,4,0,2019-07-12
3523,서울,양천구,4,1,1,6,6,0,2019-08-12
3524,서울,양천구,5,0,0,5,3,0,2019-09-12
3525,서울,양천구,2,0,0,2,1,0,2019-10-12
3526,서울,양천구,6,0,2,8,6,0,2019-11-12
3527,서울,양천구,7,1,0,8,8,1,2019-12-12
3528,서울,영등포구,10,1,1,12,7,0,2019-01-12
3529,서울,영등포구,6,0,0,6,5,0,2019-02-12
3530,서울,영등포구,4,0,2,6,5,0,2019-03-12
3531,서울,영등포구,8,1,2,11,10,0,2019-04-12
3532,서울,영등포구,8,4,8,20,9,0,2019-05-12
3533,서울,영등포구,6,4,0,10,5,0,2019-06-12
3534,서울,영등포구,14,2,2,18,11,0,2019-07-12
3535,서울,영등포구,10,1,1,12,9,0,2019-08-12
3536,서울,영등포구,4,0,0,4,3,0,2019-09-12
3537,서울,영등포구,3,2,1,6,5,0,2019-10-12
3538,서울,영등포구,6,0,1,7,7,0,2019-11-12
3539,서울,영등포구,1,0,1,2,2,0,2019-12-12
3540,서울,용산구,5,0,2,7,4,0,2019-01-12
3541,서울,용산구,5,0,1,6,4,0,2019-02-12
3542,서울,용산구,2,0,0,2,2,0,2019-03-12
3543,서울,용산구,4,0,0,4,3,0,2019-04-12
3544,서울,용산구,5,0,1,6,3,0,2019-05-12
3545,서울,용산구,2,0,0,2,1,0,2019-06-12
3546,서울,용산구,3,2,1,6,6,0,2019-07-12
3547,서울,용산구,4,0,0,4,3,0,2019-08-12
3548,서울,용산구,2,0,1,3,3,0,2019-09-12
3549,서울,용산구,7,0,1,8,4,0,2019-10-12
3550,서울,용산구,3,1,3,7,3,0,2019-11-12
3551,서울,용산구,5,1,0,6,5,1,2019-12-12
3552,서울,은평구,4,0,3,7,4,0,2019-01-12
3553,서울,은평구,2,1,0,3,3,0,2019-02-12
3554,서울,은평구,2,4,4,10,4,1,2019-03-12
3555,서울,은평구,1,0,1,2,2,0,2019-04-12
3556,서울,은평구,5,1,1,7,3,0,2019-05-12
3557,서울,은평구,3,0,0,3,3,0,2019-06-12
3558,서울,은평구,2,0,1,3,3,0,2019-07-12
3559,서울,은평구,3,0,1,4,4,0,2019-08-12
3560,서울,은평구,0,0,1,1,1,0,2019-09-12
3561,서울,은평구,1,0,1,2,1,0,2019-10-12
3562,서울,은평구,2,0,0,2,1,0,2019-11-12
3563,서울,은평구,2,0,2,4,4,0,2019-12-12
3564,서울,종로구,5,0,0,5,3,0,2019-01-12
3565,서울,종로구,2,0,2,4,4,0,2019-02-12
3566,서울,종로구,0,2,0,2,2,0,2019-03-12
3567,서울,종로구,5,2,2,9,7,0,2019-04-12
3568,서울,종로구,5,3,1,9,4,0,2019-05-12
3569,서울,종로구,3,0,0,3,3,0,2019-06-12
3570,서울,종로구,1,0,1,2,1,0,2019-07-12
3571,서울,종로구,7,1,3,11,5,0,2019-08-12
3572,서울,종로구,2,0,0,2,2,0,2019-09-12
3573,서울,종로구,9,1,2,12,5,0,2019-10-12
3574,서울,종로구,1,0,1,2,2,0,2019-11-12
3575,서울,종로구,2,0,0,2,2,0,2019-12-12
3576,서울,중구,2,0,0,2,2,0,2019-01-12
3577,서울,중구,0,0,2,2,2,0,2019-02-12
3578,서울,중구,1,0,2,3,3,0,2019-03-12
3579,서울,중구,0,0,0,0,0,0,2019-04-12
3580,서울,중구,0,0,0,0,0,0,2019-05-12
3581,서울,중구,0,0,0,0,0,0,2019-06-12
3582,서울,중구,3,0,0,3,3,0,2019-07-12
3583,서울,중구,10,1,1,12,9,0,2019-08-12
3584,서울,중구,1,0,0,1,1,0,2019-09-12
3585,서울,중구,6,0,2,8,4,0,2019-10-12
3586,서울,중구,2,0,0,2,2,0,2019-11-12
3587,서울,중구,10,0,1,11,7,0,2019-12-12
3588,서울,중랑구,1,0,1,2,2,0,2019-01-12
3589,서울,중랑구,2,0,2,4,4,0,2019-02-12
3590,서울,중랑구,4,0,2,6,5,0,2019-03-12
3591,서울,중랑구,0,0,2,2,2,0,2019-04-12
3592,서울,중랑구,2,0,0,2,1,0,2019-05-12
3593,서울,중랑구,2,0,1,3,3,0,2019-06-12
3594,서울,중랑구,3,0,3,6,5,0,2019-07-12
3595,서울,중랑구,5,0,1,6,4,0,2019-08-12
3596,서울,중랑구,5,0,0,5,3,0,2019-09-12
3597,서울,중랑구,2,0,2,4,4,0,2019-10-12
3598,서울,중랑구,1,0,3,4,3,0,2019-11-12
3599,서울,중랑구,5,0,1,6,5,0,2019-12-12
3600,서울,강남구,1,0,0,1,1,0,2019-01-13
3601,서울,강남구,10,1,4,15,10,1,2019-02-13
3602,서울,강남구,4,1,0,5,5,0,2019-03-13
3603,서울,강남구,17,1,2,20,13,0,2019-04-13
3604,서울,강남구,9,1,1,11,9,0,2019-05-13
3605,서울,강남구,14,2,4,20,13,0,2019-06-13
3606,서울,강남구,4,0,3,7,4,0,2019-07-13
3607,서울,강남구,8,2,2,12,9,0,2019-08-13
3608,서울,강남구,2,0,3,5,4,0,2019-09-13
3609,서울,강남구,6,0,7,13,8,0,2019-10-13
3610,서울,강남구,16,4,5,25,16,0,2019-11-13
3611,서울,강남구,12,1,5,18,14,0,2019-12-13
3612,서울,강동구,1,0,0,1,1,0,2019-01-13
3613,서울,강동구,2,1,1,4,4,0,2019-02-13
3614,서울,강동구,5,0,2,7,7,0,2019-03-13
3615,서울,강동구,4,0,0,4,4,0,2019-04-13
3616,서울,강동구,1,0,1,2,2,0,2019-05-13
3617,서울,강동구,1,2,0,3,2,0,2019-06-13
3618,서울,강동구,6,0,0,6,6,0,2019-07-13
3619,서울,강동구,3,0,3,6,6,0,2019-08-13
3620,서울,강동구,2,0,0,2,2,0,2019-09-13
3621,서울,강동구,4,0,1,5,5,0,2019-10-13
3622,서울,강동구,1,1,3,5,5,0,2019-11-13
3623,서울,강동구,2,1,1,4,4,0,2019-12-13
3624,서울,강북구,2,0,0,2,2,0,2019-01-13
3625,서울,강북구,10,1,1,12,9,0,2019-02-13
3626,서울,강북구,2,1,2,5,5,0,2019-03-13
3627,서울,강북구,3,0,1,4,4,0,2019-04-13
3628,서울,강북구,2,0,1,3,3,0,2019-05-13
3629,서울,강북구,2,0,0,2,2,0,2019-06-13
3630,서울,강북구,2,0,0,2,2,0,2019-07-13
3631,서울,강북구,4,0,0,4,3,0,2019-08-13
3632,서울,강북구,0,0,1,1,1,0,2019-09-13
3633,서울,강북구,3,0,0,3,2,0,2019-10-13
3634,서울,강북구,3,1,1,5,4,0,2019-11-13
3635,서울,강북구,4,0,0,4,4,0,2019-12-13
3636,서울,강서구,4,1,1,6,5,0,2019-01-13
3637,서울,강서구,7,0,3,10,7,0,2019-02-13
3638,서울,강서구,5,1,5,11,9,0,2019-03-13
3639,서울,강서구,11,0,3,14,9,0,2019-04-13
3640,서울,강서구,7,0,1,8,7,0,2019-05-13
3641,서울,강서구,3,0,1,4,3,0,2019-06-13
3642,서울,강서구,4,1,2,7,7,0,2019-07-13
3643,서울,강서구,1,0,0,1,1,0,2019-08-13
3644,서울,강서구,1,0,1,2,2,0,2019-09-13
3645,서울,강서구,4,0,1,5,2,0,2019-10-13
3646,서울,강서구,6,2,3,11,8,0,2019-11-13
3647,서울,강서구,3,0,0,3,3,0,2019-12-13
3648,서울,관악구,5,1,1,7,4,0,2019-01-13
3649,서울,관악구,2,0,0,2,2,0,2019-02-13
3650,서울,관악구,1,0,2,3,2,0,2019-03-13
3651,서울,관악구,4,0,2,6,6,0,2019-04-13
3652,서울,관악구,2,0,1,3,3,0,2019-05-13
3653,서울,관악구,3,0,0,3,2,0,2019-06-13
3654,서울,관악구,0,0,1,1,1,0,2019-07-13
3655,서울,관악구,8,0,2,10,5,0,2019-08-13
3656,서울,관악구,5,0,0,5,3,0,2019-09-13
3657,서울,관악구,6,0,0,6,4,0,2019-10-13
3658,서울,관악구,4,2,1,7,7,0,2019-11-13
3659,서울,관악구,0,0,0,0,0,0,2019-12-13
3660,서울,광진구,8,0,1,9,3,0,2019-01-13
3661,서울,광진구,5,0,1,6,5,0,2019-02-13
3662,서울,광진구,4,0,2,6,6,0,2019-03-13
3663,서울,광진구,0,0,1,1,1,0,2019-04-13
3664,서울,광진구,3,0,3,6,5,0,2019-05-13
3665,서울,광진구,2,0,0,2,2,0,2019-06-13
3666,서울,광진구,6,0,1,7,3,0,2019-07-13
3667,서울,광진구,2,0,1,3,3,0,2019-08-13
3668,서울,광진구,4,0,1,5,2,0,2019-09-13
3669,서울,광진구,2,0,1,3,3,0,2019-10-13
3670,서울,광진구,2,0,1,3,3,0,2019-11-13
3671,서울,광진구,2,0,0,2,2,0,2019-12-13
3672,서울,구로구,2,0,2,4,3,0,2019-01-13
3673,서울,구로구,8,1,2,11,6,0,2019-02-13
3674,서울,구로구,4,0,2,6,5,0,2019-03-13
3675,서울,구로구,7,1,1,9,7,0,2019-04-13
3676,서울,구로구,3,0,2,5,4,0,2019-05-13
3677,서울,구로구,2,0,1,3,3,0,2019-06-13
3678,서울,구로구,7,1,0,8,5,0,2019-07-13
3679,서울,구로구,1,0,2,3,4,1,2019-08-13
3680,서울,구로구,8,0,0,8,1,0,2019-09-13
3681,서울,구로구,1,0,1,2,1,0,2019-10-13
3682,서울,구로구,1,0,2,3,3,0,2019-11-13
3683,서울,구로구,5,0,2,7,6,0,2019-12-13
3684,서울,금천구,3,0,1,4,4,0,2019-01-13
3685,서울,금천구,2,0,0,2,2,0,2019-02-13
3686,서울,금천구,4,0,0,4,4,0,2019-03-13
3687,서울,금천구,2,0,0,2,2,0,2019-04-13
3688,서울,금천구,2,0,0,2,2,0,2019-05-13
3689,서울,금천구,4,0,1,5,3,0,2019-06-13
3690,서울,금천구,3,0,2,5,3,0,2019-07-13
3691,서울,금천구,7,0,0,7,3,0,2019-08-13
3692,서울,금천구,7,0,0,7,3,0,2019-09-13
3693,서울,금천구,4,1,0,5,2,0,2019-10-13
3694,서울,금천구,4,0,1,5,4,0,2019-11-13
3695,서울,금천구,11,0,0,11,5,0,2019-12-13
3696,서울,노원구,6,0,2,8,5,0,2019-01-13
3697,서울,노원구,1,0,1,2,2,0,2019-02-13
3698,서울,노원구,2,0,1,3,3,0,2019-03-13
3699,서울,노원구,5,0,1,6,6,0,2019-04-13
3700,서울,노원구,8,0,2,10,8,0,2019-05-13
3701,서울,노원구,5,0,1,6,6,0,2019-06-13
3702,서울,노원구,4,0,1,5,5,0,2019-07-13
3703,서울,노원구,7,1,0,8,5,0,2019-08-13
3704,서울,노원구,5,0,0,5,2,0,2019-09-13
3705,서울,노원구,3,1,4,8,4,0,2019-10-13
3706,서울,노원구,2,0,1,3,3,0,2019-11-13
3707,서울,노원구,5,0,2,7,7,0,2019-12-13
3708,서울,도봉구,1,0,0,1,1,0,2019-01-13
3709,서울,도봉구,2,2,0,4,3,0,2019-02-13
3710,서울,도봉구,5,2,0,7,6,0,2019-03-13
3711,서울,도봉구,2,0,1,3,3,0,2019-04-13
3712,서울,도봉구,3,0,0,3,3,0,2019-05-13
3713,서울,도봉구,0,0,1,1,1,0,2019-06-13
3714,서울,도봉구,0,0,0,0,0,0,2019-07-13
3715,서울,도봉구,3,0,1,4,2,0,2019-08-13
3716,서울,도봉구,2,0,1,3,3,0,2019-09-13
3717,서울,도봉구,2,0,0,2,1,0,2019-10-13
3718,서울,도봉구,0,0,1,1,1,0,2019-11-13
3719,서울,도봉구,4,2,0,6,5,0,2019-12-13
3720,서울,동대문구,3,0,1,4,3,0,2019-01-13
3721,서울,동대문구,2,0,3,5,2,0,2019-02-13
3722,서울,동대문구,1,1,1,3,3,0,2019-03-13
3723,서울,동대문구,1,0,1,2,2,0,2019-04-13
3724,서울,동대문구,3,0,1,4,4,0,2019-05-13
3725,서울,동대문구,1,1,0,2,2,0,2019-06-13
3726,서울,동대문구,5,0,0,5,3,0,2019-07-13
3727,서울,동대문구,1,1,0,2,2,0,2019-08-13
3728,서울,동대문구,4,0,0,4,2,0,2019-09-13
3729,서울,동대문구,2,0,2,4,3,0,2019-10-13
3730,서울,동대문구,3,0,0,3,3,0,2019-11-13
3731,서울,동대문구,4,0,4,8,6,0,2019-12-13
3732,서울,동작구,3,1,1,5,3,0,2019-01-13
3733,서울,동작구,0,0,0,0,0,0,2019-02-13
3734,서울,동작구,6,0,1,7,7,0,2019-03-13
3735,서울,동작구,7,2,1,10,8,0,2019-04-13
3736,서울,동작구,2,0,4,6,4,0,2019-05-13
3737,서울,동작구,0,0,0,0,0,0,2019-06-13
3738,서울,동작구,1,0,0,1,1,0,2019-07-13
3739,서울,동작구,6,1,2,9,6,0,2019-08-13
3740,서울,동작구,9,0,1,10,3,0,2019-09-13
3741,서울,동작구,6,1,1,8,5,0,2019-10-13
3742,서울,동작구,7,1,1,9,7,0,2019-11-13
3743,서울,동작구,8,0,2,10,6,0,2019-12-13
3744,서울,마포구,4,1,1,6,4,0,2019-01-13
3745,서울,마포구,7,3,1,11,6,0,2019-02-13
3746,서울,마포구,3,0,2,5,5,0,2019-03-13
3747,서울,마포구,4,1,1,6,5,0,2019-04-13
3748,서울,마포구,2,0,0,2,2,0,2019-05-13
3749,서울,마포구,1,0,0,1,1,0,2019-06-13
3750,서울,마포구,0,0,3,3,3,0,2019-07-13
3751,서울,마포구,8,0,1,9,8,0,2019-08-13
3752,서울,마포구,1,0,2,3,3,0,2019-09-13
3753,서울,마포구,0,0,0,0,0,0,2019-10-13
3754,서울,마포구,2,0,2,4,3,0,2019-11-13
3755,서울,마포구,4,0,0,4,4,0,2019-12-13
3756,서울,서대문구,1,0,0,1,1,0,2019-01-13
3757,서울,서대문구,1,0,3,4,3,0,2019-02-13
3758,서울,서대문구,1,0,0,1,1,0,2019-03-13
3759,서울,서대문구,1,0,0,1,1,0,2019-04-13
3760,서울,서대문구,0,1,0,1,1,0,2019-05-13
3761,서울,서대문구,10,0,0,10,5,0,2019-06-13
3762,서울,서대문구,3,0,0,3,3,0,2019-07-13
3763,서울,서대문구,1,2,0,3,3,0,2019-08-13
3764,서울,서대문구,5,0,0,5,1,0,2019-09-13
3765,서울,서대문구,2,0,0,2,2,0,2019-10-13
3766,서울,서대문구,2,0,0,2,1,0,2019-11-13
3767,서울,서대문구,3,1,2,6,6,0,2019-12-13
3768,서울,서초구,4,0,1,5,3,0,2019-01-13
3769,서울,서초구,13,0,0,13,9,0,2019-02-13
3770,서울,서초구,12,0,3,15,13,0,2019-03-13
3771,서울,서초구,12,1,0,13,6,0,2019-04-13
3772,서울,서초구,3,0,0,3,3,0,2019-05-13
3773,서울,서초구,9,3,0,12,5,0,2019-06-13
3774,서울,서초구,17,1,2,20,10,0,2019-07-13
3775,서울,서초구,12,0,0,12,8,0,2019-08-13
3776,서울,서초구,21,5,0,26,5,0,2019-09-13
3777,서울,서초구,3,1,2,6,5,0,2019-10-13
3778,서울,서초구,8,2,3,13,9,0,2019-11-13
3779,서울,서초구,10,1,1,12,9,0,2019-12-13
3780,서울,성동구,2,0,0,2,2,0,2019-01-13
3781,서울,성동구,5,0,1,6,4,0,2019-02-13
3782,서울,성동구,1,0,1,2,2,1,2019-03-13
3783,서울,성동구,0,1,1,2,2,0,2019-04-13
3784,서울,성동구,4,1,0,5,4,0,2019-05-13
3785,서울,성동구,9,0,3,12,7,0,2019-06-13
3786,서울,성동구,2,0,2,4,4,0,2019-07-13
3787,서울,성동구,1,0,0,1,1,0,2019-08-13
3788,서울,성동구,0,0,0,0,0,0,2019-09-13
3789,서울,성동구,2,1,0,3,2,0,2019-10-13
3790,서울,성동구,3,1,2,6,6,0,2019-11-13
3791,서울,성동구,2,0,0,2,2,0,2019-12-13
3792,서울,성북구,0,1,0,1,1,0,2019-01-13
3793,서울,성북구,7,0,0,7,4,0,2019-02-13
3794,서울,성북구,1,0,3,4,3,0,2019-03-13
3795,서울,성북구,6,0,2,8,7,0,2019-04-13
3796,서울,성북구,3,0,4,7,6,0,2019-05-13
3797,서울,성북구,2,1,3,6,5,0,2019-06-13
3798,서울,성북구,4,0,0,4,4,0,2019-07-13
3799,서울,성북구,2,0,0,2,1,0,2019-08-13
3800,서울,성북구,1,0,1,2,2,0,2019-09-13
3801,서울,성북구,4,0,2,6,5,0,2019-10-13
3802,서울,성북구,4,0,1,5,4,0,2019-11-13
3803,서울,성북구,1,1,1,3,3,0,2019-12-13
3804,서울,송파구,8,1,0,9,5,0,2019-01-13
3805,서울,송파구,4,0,1,5,5,0,2019-02-13
3806,서울,송파구,7,0,3,10,8,0,2019-03-13
3807,서울,송파구,12,2,4,18,11,0,2019-04-13
3808,서울,송파구,10,2,6,18,13,0,2019-05-13
3809,서울,송파구,4,0,3,7,4,0,2019-06-13
3810,서울,송파구,8,1,2,11,8,0,2019-07-13
3811,서울,송파구,11,1,0,12,10,0,2019-08-13
3812,서울,송파구,4,0,1,5,3,0,2019-09-13
3813,서울,송파구,8,3,0,11,9,0,2019-10-13
3814,서울,송파구,14,2,0,16,8,0,2019-11-13
3815,서울,송파구,10,2,1,13,11,0,2019-12-13
3816,서울,양천구,5,0,2,7,6,0,2019-01-13
3817,서울,양천구,2,2,0,4,2,0,2019-02-13
3818,서울,양천구,5,0,2,7,6,0,2019-03-13
3819,서울,양천구,7,2,2,11,6,0,2019-04-13
3820,서울,양천구,2,0,0,2,2,0,2019-05-13
3821,서울,양천구,2,0,2,4,4,0,2019-06-13
3822,서울,양천구,4,1,2,7,5,0,2019-07-13
3823,서울,양천구,7,0,0,7,5,0,2019-08-13
3824,서울,양천구,2,0,2,4,2,0,2019-09-13
3825,서울,양천구,1,1,1,3,2,0,2019-10-13
3826,서울,양천구,6,1,1,8,4,0,2019-11-13
3827,서울,양천구,4,1,0,5,5,0,2019-12-13
3828,서울,영등포구,7,0,0,7,5,0,2019-01-13
3829,서울,영등포구,4,0,0,4,3,0,2019-02-13
3830,서울,영등포구,19,0,2,21,8,0,2019-03-13
3831,서울,영등포구,8,0,1,9,7,0,2019-04-13
3832,서울,영등포구,11,1,0,12,7,0,2019-05-13
3833,서울,영등포구,4,0,1,5,5,0,2019-06-13
3834,서울,영등포구,5,0,2,7,6,0,2019-07-13
3835,서울,영등포구,9,0,1,10,8,0,2019-08-13
3836,서울,영등포구,8,0,1,9,3,0,2019-09-13
3837,서울,영등포구,7,0,1,8,5,0,2019-10-13
3838,서울,영등포구,4,0,1,5,5,0,2019-11-13
3839,서울,영등포구,13,2,4,19,17,0,2019-12-13
3840,서울,용산구,0,0,0,0,0,0,2019-01-13
3841,서울,용산구,5,0,0,5,4,0,2019-02-13
3842,서울,용산구,6,0,1,7,5,0,2019-03-13
3843,서울,용산구,2,0,0,2,2,0,2019-04-13
3844,서울,용산구,2,0,1,3,3,0,2019-05-13
3845,서울,용산구,2,0,0,2,2,0,2019-06-13
3846,서울,용산구,2,0,1,3,1,0,2019-07-13
3847,서울,용산구,4,0,2,6,5,0,2019-08-13
3848,서울,용산구,3,0,2,5,5,1,2019-09-13
3849,서울,용산구,4,0,0,4,3,0,2019-10-13
3850,서울,용산구,4,0,1,5,5,0,2019-11-13
3851,서울,용산구,2,0,0,2,1,0,2019-12-13
3852,서울,은평구,1,0,0,1,1,0,2019-01-13
3853,서울,은평구,2,0,1,3,3,0,2019-02-13
3854,서울,은평구,0,0,0,0,0,0,2019-03-13
3855,서울,은평구,4,0,2,6,5,0,2019-04-13
3856,서울,은평구,0,0,0,0,0,0,2019-05-13
3857,서울,은평구,0,0,1,1,1,0,2019-06-13
3858,서울,은평구,2,0,1,3,3,0,2019-07-13
3859,서울,은평구,1,0,0,1,1,0,2019-08-13
3860,서울,은평구,0,0,0,0,0,0,2019-09-13
3861,서울,은평구,2,1,0,3,2,0,2019-10-13
3862,서울,은평구,2,0,0,2,2,0,2019-11-13
3863,서울,은평구,2,0,1,3,3,0,2019-12-13
3864,서울,종로구,5,0,1,6,4,0,2019-01-13
3865,서울,종로구,2,0,0,2,1,0,2019-02-13
3866,서울,종로구,1,1,2,4,4,0,2019-03-13
3867,서울,종로구,6,0,2,8,5,0,2019-04-13
3868,서울,종로구,4,1,1,6,4,0,2019-05-13
3869,서울,종로구,4,0,0,4,4,0,2019-06-13
3870,서울,종로구,4,1,0,5,4,0,2019-07-13
3871,서울,종로구,2,0,0,2,2,0,2019-08-13
3872,서울,종로구,2,1,0,3,3,0,2019-09-13
3873,서울,종로구,6,1,0,7,3,0,2019-10-13
3874,서울,종로구,0,0,0,0,0,0,2019-11-13
3875,서울,종로구,4,1,1,6,5,0,2019-12-13
3876,서울,중구,0,0,0,0,0,0,2019-01-13
3877,서울,중구,3,0,3,6,5,0,2019-02-13
3878,서울,중구,1,1,1,3,2,0,2019-03-13
3879,서울,중구,7,2,2,11,9,0,2019-04-13
3880,서울,중구,2,0,1,3,3,0,2019-05-13
3881,서울,중구,3,2,3,8,7,0,2019-06-13
3882,서울,중구,0,0,0,0,0,0,2019-07-13
3883,서울,중구,3,1,0,4,3,0,2019-08-13
3884,서울,중구,3,0,0,3,1,0,2019-09-13
3885,서울,중구,2,0,0,2,2,0,2019-10-13
3886,서울,중구,1,0,1,2,2,0,2019-11-13
3887,서울,중구,7,1,2,10,9,0,2019-12-13
3888,서울,중랑구,3,0,1,4,4,0,2019-01-13
3889,서울,중랑구,1,0,1,2,2,0,2019-02-13
3890,서울,중랑구,2,0,1,3,3,0,2019-03-13
3891,서울,중랑구,10,1,1,12,5,0,2019-04-13
3892,서울,중랑구,4,0,0,4,3,0,2019-05-13
3893,서울,중랑구,0,1,0,1,1,0,2019-06-13
3894,서울,중랑구,0,0,1,1,2,1,2019-07-13
3895,서울,중랑구,2,0,2,4,4,0,2019-08-13
3896,서울,중랑구,2,1,1,4,2,0,2019-09-13
3897,서울,중랑구,1,0,1,2,2,0,2019-10-13
3898,서울,중랑구,3,1,1,5,5,0,2019-11-13
3899,서울,중랑구,1,0,1,2,2,0,2019-12-13
3900,서울,강남구,9,1,4,14,10,0,2019-01-14
3901,서울,강남구,12,1,0,13,11,0,2019-02-14
3902,서울,강남구,10,0,2,12,8,0,2019-03-14
3903,서울,강남구,6,0,0,6,5,0,2019-04-14
3904,서울,강남구,12,3,2,17,12,0,2019-05-14
3905,서울,강남구,15,0,1,16,12,0,2019-06-14
3906,서울,강남구,12,4,0,16,10,0,2019-07-14
3907,서울,강남구,11,0,2,13,10,0,2019-08-14
3908,서울,강남구,3,1,1,5,4,0,2019-09-14
3909,서울,강남구,12,2,2,16,12,0,2019-10-14
3910,서울,강남구,13,0,1,14,12,0,2019-11-14
3911,서울,강남구,16,5,4,25,17,0,2019-12-14
3912,서울,강동구,1,0,0,1,1,0,2019-01-14
3913,서울,강동구,2,0,1,3,3,0,2019-02-14
3914,서울,강동구,6,0,0,6,5,0,2019-03-14
3915,서울,강동구,7,0,2,9,3,0,2019-04-14
3916,서울,강동구,6,0,2,8,7,0,2019-05-14
3917,서울,강동구,5,1,0,6,5,0,2019-06-14
3918,서울,강동구,2,0,0,2,1,0,2019-07-14
3919,서울,강동구,1,0,4,5,4,0,2019-08-14
3920,서울,강동구,6,2,1,9,4,0,2019-09-14
3921,서울,강동구,7,0,0,7,3,0,2019-10-14
3922,서울,강동구,4,0,5,9,8,0,2019-11-14
3923,서울,강동구,3,2,2,7,6,0,2019-12-14
3924,서울,강북구,1,0,3,4,4,0,2019-01-14
3925,서울,강북구,2,0,0,2,2,0,2019-02-14
3926,서울,강북구,1,0,3,4,4,0,2019-03-14
3927,서울,강북구,3,1,3,7,6,1,2019-04-14
3928,서울,강북구,3,0,0,3,3,0,2019-05-14
3929,서울,강북구,7,0,0,7,3,0,2019-06-14
3930,서울,강북구,1,0,2,3,3,0,2019-07-14
3931,서울,강북구,10,0,4,14,10,0,2019-08-14
3932,서울,강북구,4,1,0,5,4,0,2019-09-14
3933,서울,강북구,8,0,1,9,6,0,2019-10-14
3934,서울,강북구,7,0,0,7,5,0,2019-11-14
3935,서울,강북구,6,0,1,7,7,0,2019-12-14
3936,서울,강서구,4,2,0,6,5,0,2019-01-14
3937,서울,강서구,6,1,0,7,7,0,2019-02-14
3938,서울,강서구,2,0,1,3,3,0,2019-03-14
3939,서울,강서구,7,0,0,7,4,0,2019-04-14
3940,서울,강서구,2,0,1,3,3,1,2019-05-14
3941,서울,강서구,5,0,1,6,4,0,2019-06-14
3942,서울,강서구,4,0,1,5,4,0,2019-07-14
3943,서울,강서구,5,0,1,6,6,0,2019-08-14
3944,서울,강서구,4,3,3,10,5,0,2019-09-14
3945,서울,강서구,8,0,1,9,8,0,2019-10-14
3946,서울,강서구,11,3,0,14,7,0,2019-11-14
3947,서울,강서구,2,0,5,7,7,0,2019-12-14
3948,서울,관악구,1,1,2,4,4,0,2019-01-14
3949,서울,관악구,3,0,0,3,2,0,2019-02-14
3950,서울,관악구,0,0,1,1,1,0,2019-03-14
3951,서울,관악구,1,0,0,1,1,0,2019-04-14
3952,서울,관악구,4,0,2,6,3,0,2019-05-14
3953,서울,관악구,7,0,3,10,5,0,2019-06-14
3954,서울,관악구,5,0,2,7,4,0,2019-07-14
3955,서울,관악구,7,1,1,9,5,0,2019-08-14
3956,서울,관악구,1,0,1,2,2,0,2019-09-14
3957,서울,관악구,2,0,1,3,2,0,2019-10-14
3958,서울,관악구,3,0,1,4,4,0,2019-11-14
3959,서울,관악구,5,1,1,7,4,0,2019-12-14
3960,서울,광진구,1,0,0,1,1,0,2019-01-14
3961,서울,광진구,6,0,2,8,4,0,2019-02-14
3962,서울,광진구,1,0,0,1,1,0,2019-03-14
3963,서울,광진구,3,1,0,4,4,0,2019-04-14
3964,서울,광진구,0,0,0,0,0,0,2019-05-14
3965,서울,광진구,5,0,0,5,3,0,2019-06-14
3966,서울,광진구,0,0,0,0,0,0,2019-07-14
3967,서울,광진구,6,0,2,8,4,0,2019-08-14
3968,서울,광진구,5,0,0,5,5,0,2019-09-14
3969,서울,광진구,1,0,3,4,3,0,2019-10-14
3970,서울,광진구,2,0,0,2,2,0,2019-11-14
3971,서울,광진구,1,0,0,1,1,0,2019-12-14
3972,서울,구로구,1,0,1,2,3,1,2019-01-14
3973,서울,구로구,0,0,2,2,2,0,2019-02-14
3974,서울,구로구,6,2,2,10,7,0,2019-03-14
3975,서울,구로구,4,4,0,8,3,0,2019-04-14
3976,서울,구로구,8,0,1,9,3,0,2019-05-14
3977,서울,구로구,17,0,3,20,10,1,2019-06-14
3978,서울,구로구,1,0,1,2,1,0,2019-07-14
3979,서울,구로구,12,2,1,15,10,0,2019-08-14
3980,서울,구로구,0,0,0,0,0,0,2019-09-14
3981,서울,구로구,2,0,0,2,2,0,2019-10-14
3982,서울,구로구,4,0,2,6,5,0,2019-11-14
3983,서울,구로구,3,0,1,4,3,0,2019-12-14
3984,서울,금천구,0,0,2,2,2,0,2019-01-14
3985,서울,금천구,4,0,1,5,4,0,2019-02-14
3986,서울,금천구,2,0,0,2,2,1,2019-03-14
3987,서울,금천구,3,0,0,3,1,0,2019-04-14
3988,서울,금천구,3,0,1,4,4,0,2019-05-14
3989,서울,금천구,3,1,0,4,4,0,2019-06-14
3990,서울,금천구,3,0,0,3,2,0,2019-07-14
3991,서울,금천구,2,1,0,3,3,0,2019-08-14
3992,서울,금천구,0,0,0,0,0,0,2019-09-14
3993,서울,금천구,1,0,1,2,2,0,2019-10-14
3994,서울,금천구,6,0,0,6,3,0,2019-11-14
3995,서울,금천구,4,0,1,5,5,0,2019-12-14
3996,서울,노원구,2,0,0,2,2,0,2019-01-14
3997,서울,노원구,3,0,1,4,4,0,2019-02-14
3998,서울,노원구,5,0,3,8,5,0,2019-03-14
3999,서울,노원구,10,0,2,12,7,0,2019-04-14
4000,서울,노원구,9,1,3,13,9,0,2019-05-14
4001,서울,노원구,5,3,1,9,9,0,2019-06-14
4002,서울,노원구,3,0,2,5,3,0,2019-07-14
4003,서울,노원구,3,2,1,6,3,0,2019-08-14
4004,서울,노원구,5,1,2,8,5,0,2019-09-14
4005,서울,노원구,5,0,1,6,6,0,2019-10-14
4006,서울,노원구,3,0,2,5,4,0,2019-11-14
4007,서울,노원구,4,1,0,5,4,0,2019-12-14
4008,서울,도봉구,2,1,1,4,4,0,2019-01-14
4009,서울,도봉구,2,0,1,3,3,0,2019-02-14
4010,서울,도봉구,0,1,1,2,2,0,2019-03-14
4011,서울,도봉구,0,3,0,3,2,0,2019-04-14
4012,서울,도봉구,0,0,1,1,1,0,2019-05-14
4013,서울,도봉구,0,0,1,1,1,0,2019-06-14
4014,서울,도봉구,1,2,2,5,5,0,2019-07-14
4015,서울,도봉구,0,0,3,3,3,0,2019-08-14
4016,서울,도봉구,1,0,0,1,1,0,2019-09-14
4017,서울,도봉구,2,0,1,3,2,0,2019-10-14
4018,서울,도봉구,0,0,0,0,0,0,2019-11-14
4019,서울,도봉구,1,1,0,2,2,0,2019-12-14
4020,서울,동대문구,3,0,0,3,2,0,2019-01-14
4021,서울,동대문구,9,0,2,11,7,0,2019-02-14
4022,서울,동대문구,3,0,3,6,3,0,2019-03-14
4023,서울,동대문구,3,0,2,5,4,0,2019-04-14
4024,서울,동대문구,4,2,1,7,6,0,2019-05-14
4025,서울,동대문구,3,0,0,3,3,0,2019-06-14
4026,서울,동대문구,0,0,0,0,0,0,2019-07-14
4027,서울,동대문구,2,0,3,5,4,0,2019-08-14
4028,서울,동대문구,4,1,0,5,1,0,2019-09-14
4029,서울,동대문구,4,1,2,7,6,0,2019-10-14
4030,서울,동대문구,2,0,2,4,3,0,2019-11-14
4031,서울,동대문구,14,0,1,15,6,0,2019-12-14
4032,서울,동작구,2,0,2,4,4,0,2019-01-14
4033,서울,동작구,3,2,2,7,6,0,2019-02-14
4034,서울,동작구,3,0,4,7,6,0,2019-03-14
4035,서울,동작구,2,0,0,2,2,0,2019-04-14
4036,서울,동작구,3,1,1,5,4,0,2019-05-14
4037,서울,동작구,5,0,1,6,4,0,2019-06-14
4038,서울,동작구,2,0,1,3,3,0,2019-07-14
4039,서울,동작구,5,0,1,6,6,0,2019-08-14
4040,서울,동작구,0,1,0,1,1,0,2019-09-14
4041,서울,동작구,3,0,1,4,4,0,2019-10-14
4042,서울,동작구,8,5,1,14,9,0,2019-11-14
4043,서울,동작구,5,1,1,7,5,0,2019-12-14
4044,서울,마포구,5,0,0,5,5,0,2019-01-14
4045,서울,마포구,3,0,1,4,4,0,2019-02-14
4046,서울,마포구,5,0,1,6,5,0,2019-03-14
4047,서울,마포구,1,0,0,1,1,0,2019-04-14
4048,서울,마포구,8,0,3,11,7,0,2019-05-14
4049,서울,마포구,2,1,2,5,5,0,2019-06-14
4050,서울,마포구,8,3,0,11,6,0,2019-07-14
4051,서울,마포구,2,0,1,3,3,0,2019-08-14
4052,서울,마포구,5,0,1,6,3,0,2019-09-14
4053,서울,마포구,5,5,2,12,8,0,2019-10-14
4054,서울,마포구,5,3,0,8,5,0,2019-11-14
4055,서울,마포구,10,1,3,14,7,0,2019-12-14
4056,서울,서대문구,4,1,2,7,6,0,2019-01-14
4057,서울,서대문구,3,1,4,8,6,0,2019-02-14
4058,서울,서대문구,1,0,0,1,2,1,2019-03-14
4059,서울,서대문구,2,0,2,4,3,0,2019-04-14
4060,서울,서대문구,6,0,0,6,4,0,2019-05-14
4061,서울,서대문구,3,0,3,6,3,0,2019-06-14
4062,서울,서대문구,3,1,0,4,3,0,2019-07-14
4063,서울,서대문구,3,3,0,6,4,0,2019-08-14
4064,서울,서대문구,5,0,1,6,3,0,2019-09-14
4065,서울,서대문구,1,0,0,1,2,1,2019-10-14
4066,서울,서대문구,6,0,1,7,3,0,2019-11-14
4067,서울,서대문구,2,2,0,4,2,0,2019-12-14
4068,서울,서초구,4,1,0,5,4,0,2019-01-14
4069,서울,서초구,10,0,1,11,9,0,2019-02-14
4070,서울,서초구,4,0,2,6,5,0,2019-03-14
4071,서울,서초구,1,0,0,1,1,0,2019-04-14
4072,서울,서초구,5,0,4,9,9,0,2019-05-14
4073,서울,서초구,8,0,3,11,7,0,2019-06-14
4074,서울,서초구,4,1,0,5,3,0,2019-07-14
4075,서울,서초구,6,2,1,9,8,0,2019-08-14
4076,서울,서초구,6,0,2,8,5,0,2019-09-14
4077,서울,서초구,5,3,2,10,9,0,2019-10-14
4078,서울,서초구,7,1,2,10,7,0,2019-11-14
4079,서울,서초구,10,0,2,12,7,0,2019-12-14
4080,서울,성동구,2,0,2,4,2,0,2019-01-14
4081,서울,성동구,1,2,2,5,3,0,2019-02-14
4082,서울,성동구,3,0,1,4,4,0,2019-03-14
4083,서울,성동구,4,1,1,6,4,0,2019-04-14
4084,서울,성동구,0,0,0,0,0,0,2019-05-14
4085,서울,성동구,0,0,0,0,1,1,2019-06-14
4086,서울,성동구,2,0,0,2,2,0,2019-07-14
4087,서울,성동구,1,0,1,2,2,0,2019-08-14
4088,서울,성동구,1,1,0,2,2,0,2019-09-14
4089,서울,성동구,0,0,1,1,1,0,2019-10-14
4090,서울,성동구,3,1,3,7,3,0,2019-11-14
4091,서울,성동구,1,0,1,2,3,1,2019-12-14
4092,서울,성북구,5,0,2,7,3,0,2019-01-14
4093,서울,성북구,4,0,0,4,4,0,2019-02-14
4094,서울,성북구,3,0,0,3,2,0,2019-03-14
4095,서울,성북구,1,0,0,1,1,0,2019-04-14
4096,서울,성북구,9,0,2,11,8,0,2019-05-14
4097,서울,성북구,6,0,1,7,4,0,2019-06-14
4098,서울,성북구,0,0,0,0,0,0,2019-07-14
4099,서울,성북구,2,0,2,4,4,0,2019-08-14
4100,서울,성북구,6,0,2,8,4,0,2019-09-14
4101,서울,성북구,2,0,2,4,4,0,2019-10-14
4102,서울,성북구,3,1,0,4,4,0,2019-11-14
4103,서울,성북구,14,0,3,17,6,1,2019-12-14
4104,서울,송파구,7,2,2,11,6,0,2019-01-14
4105,서울,송파구,8,3,3,14,11,0,2019-02-14
4106,서울,송파구,10,2,2,14,11,0,2019-03-14
4107,서울,송파구,6,1,2,9,8,0,2019-04-14
4108,서울,송파구,10,0,1,11,9,2,2019-05-14
4109,서울,송파구,4,1,2,7,6,0,2019-06-14
4110,서울,송파구,7,1,0,8,6,0,2019-07-14
4111,서울,송파구,12,4,3,19,10,0,2019-08-14
4112,서울,송파구,3,1,1,5,5,0,2019-09-14
4113,서울,송파구,4,2,4,10,10,0,2019-10-14
4114,서울,송파구,6,0,4,10,9,0,2019-11-14
4115,서울,송파구,5,1,5,11,7,0,2019-12-14
4116,서울,양천구,2,1,0,3,3,0,2019-01-14
4117,서울,양천구,4,1,3,8,7,0,2019-02-14
4118,서울,양천구,1,0,0,1,1,0,2019-03-14
4119,서울,양천구,3,0,1,4,3,0,2019-04-14
4120,서울,양천구,3,0,0,3,2,0,2019-05-14
4121,서울,양천구,1,1,1,3,3,0,2019-06-14
4122,서울,양천구,3,0,1,4,3,0,2019-07-14
4123,서울,양천구,10,0,0,10,6,0,2019-08-14
4124,서울,양천구,1,2,0,3,3,0,2019-09-14
4125,서울,양천구,7,1,1,9,5,0,2019-10-14
4126,서울,양천구,11,0,0,11,8,0,2019-11-14
4127,서울,양천구,9,0,1,10,5,0,2019-12-14
4128,서울,영등포구,4,1,3,8,7,0,2019-01-14
4129,서울,영등포구,7,0,1,8,7,0,2019-02-14
4130,서울,영등포구,8,2,5,15,12,0,2019-03-14
4131,서울,영등포구,3,0,0,3,3,0,2019-04-14
4132,서울,영등포구,1,0,0,1,1,0,2019-05-14
4133,서울,영등포구,14,2,1,17,11,0,2019-06-14
4134,서울,영등포구,3,2,2,7,5,0,2019-07-14
4135,서울,영등포구,5,2,0,7,7,1,2019-08-14
4136,서울,영등포구,3,0,0,3,1,0,2019-09-14
4137,서울,영등포구,4,5,2,11,9,0,2019-10-14
4138,서울,영등포구,8,0,0,8,7,0,2019-11-14
4139,서울,영등포구,3,1,0,4,3,0,2019-12-14
4140,서울,용산구,5,0,1,6,6,0,2019-01-14
4141,서울,용산구,5,0,2,7,5,0,2019-02-14
4142,서울,용산구,1,0,1,2,2,0,2019-03-14
4143,서울,용산구,2,0,0,2,2,0,2019-04-14
4144,서울,용산구,4,0,1,5,4,0,2019-05-14
4145,서울,용산구,5,0,0,5,4,0,2019-06-14
4146,서울,용산구,5,0,0,5,4,0,2019-07-14
4147,서울,용산구,9,0,2,11,5,0,2019-08-14
4148,서울,용산구,2,1,0,3,3,0,2019-09-14
4149,서울,용산구,2,0,1,3,2,0,2019-10-14
4150,서울,용산구,3,0,1,4,4,0,2019-11-14
4151,서울,용산구,11,0,2,13,7,0,2019-12-14
4152,서울,은평구,3,0,1,4,2,0,2019-01-14
4153,서울,은평구,0,0,0,0,0,0,2019-02-14
4154,서울,은평구,4,0,1,5,4,0,2019-03-14
4155,서울,은평구,1,0,0,1,1,0,2019-04-14
4156,서울,은평구,1,0,1,2,2,0,2019-05-14
4157,서울,은평구,3,0,0,3,3,0,2019-06-14
4158,서울,은평구,1,0,0,1,1,0,2019-07-14
4159,서울,은평구,3,0,3,6,5,0,2019-08-14
4160,서울,은평구,1,1,0,2,2,0,2019-09-14
4161,서울,은평구,10,2,3,15,6,0,2019-10-14
4162,서울,은평구,3,0,1,4,4,0,2019-11-14
4163,서울,은평구,2,0,1,3,3,0,2019-12-14
4164,서울,종로구,3,0,1,4,3,0,2019-01-14
4165,서울,종로구,2,0,1,3,2,0,2019-02-14
4166,서울,종로구,2,0,2,4,4,0,2019-03-14
4167,서울,종로구,1,0,0,1,1,0,2019-04-14
4168,서울,종로구,1,0,2,3,2,0,2019-05-14
4169,서울,종로구,0,0,1,1,1,0,2019-06-14
4170,서울,종로구,2,0,0,2,1,0,2019-07-14
4171,서울,종로구,4,0,1,5,5,0,2019-08-14
4172,서울,종로구,0,0,1,1,1,0,2019-09-14
4173,서울,종로구,1,1,2,4,4,0,2019-10-14
4174,서울,종로구,2,1,1,4,4,0,2019-11-14
4175,서울,종로구,12,0,4,16,3,0,2019-12-14
4176,서울,중구,6,0,1,7,5,0,2019-01-14
4177,서울,중구,0,0,1,1,1,0,2019-02-14
4178,서울,중구,1,1,0,2,2,0,2019-03-14
4179,서울,중구,2,0,0,2,2,0,2019-04-14
4180,서울,중구,1,1,3,5,4,0,2019-05-14
4181,서울,중구,4,0,4,8,4,0,2019-06-14
4182,서울,중구,0,0,0,0,0,0,2019-07-14
4183,서울,중구,0,1,2,3,3,0,2019-08-14
4184,서울,중구,0,0,0,0,0,0,2019-09-14
4185,서울,중구,1,1,2,4,3,0,2019-10-14
4186,서울,중구,3,0,1,4,3,0,2019-11-14
4187,서울,중구,3,1,0,4,4,0,2019-12-14
4188,서울,중랑구,3,4,2,9,7,0,2019-01-14
4189,서울,중랑구,9,0,0,9,5,0,2019-02-14
4190,서울,중랑구,1,0,3,4,4,0,2019-03-14
4191,서울,중랑구,2,2,0,4,2,0,2019-04-14
4192,서울,중랑구,6,3,1,10,8,0,2019-05-14
4193,서울,중랑구,1,1,1,3,3,0,2019-06-14
4194,서울,중랑구,4,2,4,10,5,0,2019-07-14
4195,서울,중랑구,7,1,2,10,7,0,2019-08-14
4196,서울,중랑구,5,0,0,5,5,0,2019-09-14
4197,서울,중랑구,2,0,4,6,6,0,2019-10-14
4198,서울,중랑구,3,1,1,5,5,0,2019-11-14
4199,서울,중랑구,5,0,2,7,3,0,2019-12-14
4200,서울,강남구,7,0,1,8,4,0,2019-01-15
4201,서울,강남구,12,0,2,14,10,0,2019-02-15
4202,서울,강남구,12,1,2,15,11,0,2019-03-15
4203,서울,강남구,7,0,3,10,9,0,2019-04-15
4204,서울,강남구,12,0,1,13,12,0,2019-05-15
4205,서울,강남구,15,5,6,26,15,0,2019-06-15
4206,서울,강남구,10,1,5,16,12,0,2019-07-15
4207,서울,강남구,15,1,0,16,9,0,2019-08-15
4208,서울,강남구,3,2,1,6,4,0,2019-09-15
4209,서울,강남구,9,5,1,15,10,0,2019-10-15
4210,서울,강남구,24,3,5,32,23,0,2019-11-15
4211,서울,강남구,2,0,0,2,2,0,2019-12-15
4212,서울,강동구,3,0,1,4,3,0,2019-01-15
4213,서울,강동구,7,0,4,11,6,0,2019-02-15
4214,서울,강동구,8,0,2,10,6,0,2019-03-15
4215,서울,강동구,1,0,3,4,3,0,2019-04-15
4216,서울,강동구,6,0,0,6,6,0,2019-05-15
4217,서울,강동구,4,1,2,7,3,0,2019-06-15
4218,서울,강동구,4,0,2,6,4,0,2019-07-15
4219,서울,강동구,10,0,1,11,6,0,2019-08-15
4220,서울,강동구,0,0,0,0,0,0,2019-09-15
4221,서울,강동구,1,0,1,2,2,0,2019-10-15
4222,서울,강동구,8,1,2,11,8,0,2019-11-15
4223,서울,강동구,4,1,1,6,4,0,2019-12-15
4224,서울,강북구,0,0,1,1,1,0,2019-01-15
4225,서울,강북구,8,0,0,8,4,0,2019-02-15
4226,서울,강북구,6,0,1,7,5,0,2019-03-15
4227,서울,강북구,2,0,0,2,2,0,2019-04-15
4228,서울,강북구,3,0,1,4,4,0,2019-05-15
4229,서울,강북구,6,1,3,10,8,0,2019-06-15
4230,서울,강북구,3,0,2,5,4,0,2019-07-15
4231,서울,강북구,5,1,0,6,4,0,2019-08-15
4232,서울,강북구,9,0,0,9,4,0,2019-09-15
4233,서울,강북구,12,0,0,12,8,0,2019-10-15
4234,서울,강북구,5,0,0,5,5,0,2019-11-15
4235,서울,강북구,5,0,0,5,3,0,2019-12-15
4236,서울,강서구,4,0,2,6,4,0,2019-01-15
4237,서울,강서구,13,0,0,13,6,0,2019-02-15
4238,서울,강서구,9,0,3,12,10,1,2019-03-15
4239,서울,강서구,4,0,0,4,3,0,2019-04-15
4240,서울,강서구,8,0,2,10,6,0,2019-05-15
4241,서울,강서구,6,0,1,7,6,0,2019-06-15
4242,서울,강서구,4,0,1,5,2,0,2019-07-15
4243,서울,강서구,1,0,0,1,1,0,2019-08-15
4244,서울,강서구,4,1,1,6,4,0,2019-09-15
4245,서울,강서구,3,5,3,11,8,0,2019-10-15
4246,서울,강서구,7,2,2,11,8,0,2019-11-15
4247,서울,강서구,1,0,1,2,2,0,2019-12-15
4248,서울,관악구,4,0,0,4,3,0,2019-01-15
4249,서울,관악구,5,0,0,5,4,0,2019-02-15
4250,서울,관악구,3,0,1,4,4,0,2019-03-15
4251,서울,관악구,3,0,3,6,6,0,2019-04-15
4252,서울,관악구,2,0,0,2,2,0,2019-05-15
4253,서울,관악구,3,0,0,3,3,0,2019-06-15
4254,서울,관악구,3,0,1,4,4,0,2019-07-15
4255,서울,관악구,5,0,1,6,5,0,2019-08-15
4256,서울,관악구,0,0,0,0,0,0,2019-09-15
4257,서울,관악구,2,0,2,4,4,0,2019-10-15
4258,서울,관악구,4,1,1,6,6,0,2019-11-15
4259,서울,관악구,4,0,0,4,3,0,2019-12-15
4260,서울,광진구,8,0,2,10,3,0,2019-01-15
4261,서울,광진구,3,0,3,6,4,0,2019-02-15
4262,서울,광진구,1,0,0,1,1,0,2019-03-15
4263,서울,광진구,3,1,5,9,8,0,2019-04-15
4264,서울,광진구,4,0,1,5,4,0,2019-05-15
4265,서울,광진구,2,2,1,5,4,0,2019-06-15
4266,서울,광진구,1,1,0,2,2,0,2019-07-15
4267,서울,광진구,2,0,0,2,2,0,2019-08-15
4268,서울,광진구,4,0,0,4,2,0,2019-09-15
4269,서울,광진구,4,1,2,7,6,0,2019-10-15
4270,서울,광진구,4,0,0,4,4,0,2019-11-15
4271,서울,광진구,0,1,0,1,1,0,2019-12-15
4272,서울,구로구,7,0,0,7,6,0,2019-01-15
4273,서울,구로구,3,0,0,3,3,0,2019-02-15
4274,서울,구로구,9,0,5,14,7,0,2019-03-15
4275,서울,구로구,7,0,1,8,7,0,2019-04-15
4276,서울,구로구,2,0,0,2,2,0,2019-05-15
4277,서울,구로구,5,0,0,5,3,0,2019-06-15
4278,서울,구로구,2,0,0,2,2,0,2019-07-15
4279,서울,구로구,0,0,1,1,1,0,2019-08-15
4280,서울,구로구,3,0,2,5,3,0,2019-09-15
4281,서울,구로구,10,1,1,12,9,0,2019-10-15
4282,서울,구로구,9,0,2,11,7,0,2019-11-15
4283,서울,구로구,3,1,0,4,4,0,2019-12-15
4284,서울,금천구,2,0,0,2,1,0,2019-01-15
4285,서울,금천구,5,0,3,8,5,0,2019-02-15
4286,서울,금천구,5,0,0,5,4,0,2019-03-15
4287,서울,금천구,3,1,2,6,6,0,2019-04-15
4288,서울,금천구,1,0,0,1,1,0,2019-05-15
4289,서울,금천구,0,0,0,0,0,0,2019-06-15
4290,서울,금천구,3,0,2,5,4,0,2019-07-15
4291,서울,금천구,1,0,1,2,2,0,2019-08-15
4292,서울,금천구,1,0,1,2,1,0,2019-09-15
4293,서울,금천구,13,2,1,16,3,0,2019-10-15
4294,서울,금천구,2,0,0,2,2,0,2019-11-15
4295,서울,금천구,1,0,0,1,1,0,2019-12-15
4296,서울,노원구,3,0,1,4,4,0,2019-01-15
4297,서울,노원구,9,1,2,12,7,0,2019-02-15
4298,서울,노원구,9,1,1,11,5,0,2019-03-15
4299,서울,노원구,3,0,3,6,5,0,2019-04-15
4300,서울,노원구,1,0,0,1,1,0,2019-05-15
4301,서울,노원구,3,0,4,7,4,0,2019-06-15
4302,서울,노원구,2,0,0,2,2,0,2019-07-15
4303,서울,노원구,3,0,1,4,3,0,2019-08-15
4304,서울,노원구,1,0,0,1,1,0,2019-09-15
4305,서울,노원구,6,2,2,10,8,0,2019-10-15
4306,서울,노원구,9,1,1,11,10,0,2019-11-15
4307,서울,노원구,2,0,1,3,3,0,2019-12-15
4308,서울,도봉구,7,0,0,7,2,0,2019-01-15
4309,서울,도봉구,2,0,1,3,3,0,2019-02-15
4310,서울,도봉구,4,0,0,4,3,0,2019-03-15
4311,서울,도봉구,4,0,0,4,4,0,2019-04-15
4312,서울,도봉구,3,0,0,3,2,0,2019-05-15
4313,서울,도봉구,0,0,5,5,5,0,2019-06-15
4314,서울,도봉구,6,0,1,7,3,0,2019-07-15
4315,서울,도봉구,2,1,0,3,3,0,2019-08-15
4316,서울,도봉구,5,1,4,10,6,0,2019-09-15
4317,서울,도봉구,1,0,0,1,1,0,2019-10-15
4318,서울,도봉구,0,0,1,1,1,0,2019-11-15
4319,서울,도봉구,0,0,0,0,0,0,2019-12-15
4320,서울,동대문구,2,0,2,4,3,0,2019-01-15
4321,서울,동대문구,4,0,0,4,3,0,2019-02-15
4322,서울,동대문구,1,1,1,3,2,0,2019-03-15
4323,서울,동대문구,2,0,3,5,5,0,2019-04-15
4324,서울,동대문구,0,0,1,1,1,0,2019-05-15
4325,서울,동대문구,6,0,1,7,7,1,2019-06-15
4326,서울,동대문구,3,0,0,3,3,0,2019-07-15
4327,서울,동대문구,3,1,0,4,3,0,2019-08-15
4328,서울,동대문구,3,0,3,6,4,0,2019-09-15
4329,서울,동대문구,2,0,1,3,3,0,2019-10-15
4330,서울,동대문구,8,0,2,10,9,0,2019-11-15
4331,서울,동대문구,3,0,1,4,4,0,2019-12-15
4332,서울,동작구,4,0,2,6,4,0,2019-01-15
4333,서울,동작구,3,0,1,4,4,0,2019-02-15
4334,서울,동작구,7,0,1,8,7,0,2019-03-15
4335,서울,동작구,5,2,1,8,7,0,2019-04-15
4336,서울,동작구,6,3,1,10,7,0,2019-05-15
4337,서울,동작구,7,1,4,12,4,0,2019-06-15
4338,서울,동작구,3,1,1,5,4,0,2019-07-15
4339,서울,동작구,0,0,0,0,0,0,2019-08-15
4340,서울,동작구,1,0,0,1,1,0,2019-09-15
4341,서울,동작구,4,2,1,7,4,0,2019-10-15
4342,서울,동작구,2,0,2,4,2,0,2019-11-15
4343,서울,동작구,1,0,0,1,1,0,2019-12-15
4344,서울,마포구,11,3,2,16,8,0,2019-01-15
4345,서울,마포구,6,3,1,10,6,0,2019-02-15
4346,서울,마포구,5,3,1,9,5,0,2019-03-15
4347,서울,마포구,0,0,0,0,0,0,2019-04-15
4348,서울,마포구,3,1,0,4,3,0,2019-05-15
4349,서울,마포구,2,1,1,4,3,0,2019-06-15
4350,서울,마포구,5,2,2,9,7,0,2019-07-15
4351,서울,마포구,2,0,1,3,2,0,2019-08-15
4352,서울,마포구,3,0,0,3,3,0,2019-09-15
4353,서울,마포구,5,2,1,8,7,0,2019-10-15
4354,서울,마포구,7,4,3,14,7,0,2019-11-15
4355,서울,마포구,5,0,1,6,6,0,2019-12-15
4356,서울,서대문구,6,1,0,7,4,0,2019-01-15
4357,서울,서대문구,6,0,1,7,6,0,2019-02-15
4358,서울,서대문구,2,1,0,3,2,0,2019-03-15
4359,서울,서대문구,2,0,0,2,1,0,2019-04-15
4360,서울,서대문구,3,0,0,3,2,0,2019-05-15
4361,서울,서대문구,5,0,1,6,5,0,2019-06-15
4362,서울,서대문구,4,1,1,6,5,0,2019-07-15
4363,서울,서대문구,4,1,1,6,3,0,2019-08-15
4364,서울,서대문구,1,1,2,4,3,0,2019-09-15
4365,서울,서대문구,0,0,0,0,0,0,2019-10-15
4366,서울,서대문구,7,1,1,9,7,0,2019-11-15
4367,서울,서대문구,3,1,0,4,3,0,2019-12-15
4368,서울,서초구,4,0,2,6,5,0,2019-01-15
4369,서울,서초구,5,0,3,8,7,0,2019-02-15
4370,서울,서초구,11,0,1,12,11,0,2019-03-15
4371,서울,서초구,10,2,3,15,9,0,2019-04-15
4372,서울,서초구,3,2,0,5,5,0,2019-05-15
4373,서울,서초구,10,1,2,13,7,0,2019-06-15
4374,서울,서초구,5,0,0,5,4,0,2019-07-15
4375,서울,서초구,1,0,0,1,1,0,2019-08-15
4376,서울,서초구,5,0,7,12,8,0,2019-09-15
4377,서울,서초구,4,1,1,6,6,0,2019-10-15
4378,서울,서초구,12,1,6,19,13,1,2019-11-15
4379,서울,서초구,2,0,1,3,3,0,2019-12-15
4380,서울,성동구,4,0,3,7,4,0,2019-01-15
4381,서울,성동구,2,0,1,3,3,0,2019-02-15
4382,서울,성동구,4,0,0,4,3,0,2019-03-15
4383,서울,성동구,1,0,0,1,1,0,2019-04-15
4384,서울,성동구,7,0,2,9,6,0,2019-05-15
4385,서울,성동구,0,0,2,2,1,0,2019-06-15
4386,서울,성동구,6,0,1,7,3,0,2019-07-15
4387,서울,성동구,1,0,1,2,2,0,2019-08-15
4388,서울,성동구,3,0,0,3,1,0,2019-09-15
4389,서울,성동구,9,0,1,10,8,0,2019-10-15
4390,서울,성동구,5,0,1,6,4,0,2019-11-15
4391,서울,성동구,9,0,0,9,5,0,2019-12-15
4392,서울,성북구,0,0,1,1,1,0,2019-01-15
4393,서울,성북구,3,0,0,3,3,1,2019-02-15
4394,서울,성북구,4,1,1,6,6,0,2019-03-15
4395,서울,성북구,2,0,0,2,2,0,2019-04-15
4396,서울,성북구,3,1,0,4,3,0,2019-05-15
4397,서울,성북구,7,3,0,10,7,0,2019-06-15
4398,서울,성북구,6,0,1,7,4,0,2019-07-15
4399,서울,성북구,6,0,2,8,8,0,2019-08-15
4400,서울,성북구,0,0,2,2,2,0,2019-09-15
4401,서울,성북구,8,1,2,11,9,0,2019-10-15
4402,서울,성북구,4,1,0,5,5,0,2019-11-15
4403,서울,성북구,7,0,2,9,6,0,2019-12-15
4404,서울,송파구,5,0,2,7,7,0,2019-01-15
4405,서울,송파구,5,0,4,9,8,0,2019-02-15
4406,서울,송파구,10,0,3,13,11,0,2019-03-15
4407,서울,송파구,10,1,4,15,12,0,2019-04-15
4408,서울,송파구,5,0,1,6,6,0,2019-05-15
4409,서울,송파구,10,3,5,18,15,0,2019-06-15
4410,서울,송파구,2,0,1,3,3,0,2019-07-15
4411,서울,송파구,6,1,3,10,9,0,2019-08-15
4412,서울,송파구,3,0,1,4,3,0,2019-09-15
4413,서울,송파구,7,1,5,13,12,0,2019-10-15
4414,서울,송파구,11,2,1,14,12,1,2019-11-15
4415,서울,송파구,3,1,1,5,4,0,2019-12-15
4416,서울,양천구,1,0,2,3,3,0,2019-01-15
4417,서울,양천구,2,0,0,2,2,0,2019-02-15
4418,서울,양천구,4,2,0,6,5,0,2019-03-15
4419,서울,양천구,4,0,0,4,4,0,2019-04-15
4420,서울,양천구,6,1,2,9,5,0,2019-05-15
4421,서울,양천구,2,0,3,5,4,0,2019-06-15
4422,서울,양천구,8,0,0,8,4,0,2019-07-15
4423,서울,양천구,4,0,1,5,2,0,2019-08-15
4424,서울,양천구,4,0,1,5,4,0,2019-09-15
4425,서울,양천구,1,0,1,2,2,0,2019-10-15
4426,서울,양천구,15,0,1,16,13,0,2019-11-15
4427,서울,양천구,3,0,2,5,5,0,2019-12-15
4428,서울,영등포구,4,2,3,9,8,0,2019-01-15
4429,서울,영등포구,9,0,5,14,12,0,2019-02-15
4430,서울,영등포구,9,3,1,13,10,0,2019-03-15
4431,서울,영등포구,3,0,2,5,5,0,2019-04-15
4432,서울,영등포구,7,0,2,9,8,0,2019-05-15
4433,서울,영등포구,9,1,5,15,11,0,2019-06-15
4434,서울,영등포구,5,0,0,5,5,0,2019-07-15
4435,서울,영등포구,5,0,0,5,3,0,2019-08-15
4436,서울,영등포구,9,5,0,14,8,0,2019-09-15
4437,서울,영등포구,11,0,3,14,12,0,2019-10-15
4438,서울,영등포구,7,0,2,9,6,0,2019-11-15
4439,서울,영등포구,6,0,2,8,8,0,2019-12-15
4440,서울,용산구,5,0,2,7,5,0,2019-01-15
4441,서울,용산구,3,0,1,4,4,0,2019-02-15
4442,서울,용산구,5,0,1,6,5,0,2019-03-15
4443,서울,용산구,4,0,0,4,3,0,2019-04-15
4444,서울,용산구,6,0,0,6,3,0,2019-05-15
4445,서울,용산구,8,0,4,12,7,0,2019-06-15
4446,서울,용산구,5,0,0,5,5,0,2019-07-15
4447,서울,용산구,6,0,1,7,6,0,2019-08-15
4448,서울,용산구,2,0,1,3,3,0,2019-09-15
4449,서울,용산구,2,0,0,2,1,0,2019-10-15
4450,서울,용산구,10,0,1,11,8,0,2019-11-15
4451,서울,용산구,3,0,0,3,2,0,2019-12-15
4452,서울,은평구,1,0,0,1,1,0,2019-01-15
4453,서울,은평구,2,2,0,4,3,0,2019-02-15
4454,서울,은평구,5,0,1,6,4,0,2019-03-15
4455,서울,은평구,1,0,1,2,2,0,2019-04-15
4456,서울,은평구,2,0,0,2,2,0,2019-05-15
4457,서울,은평구,3,2,2,7,5,0,2019-06-15
4458,서울,은평구,2,0,0,2,2,0,2019-07-15
4459,서울,은평구,2,0,1,3,2,0,2019-08-15
4460,서울,은평구,4,0,0,4,4,0,2019-09-15
4461,서울,은평구,1,0,1,2,2,0,2019-10-15
4462,서울,은평구,3,2,0,5,4,0,2019-11-15
4463,서울,은평구,6,1,1,8,4,0,2019-12-15
4464,서울,종로구,6,0,1,7,4,0,2019-01-15
4465,서울,종로구,2,0,1,3,3,0,2019-02-15
4466,서울,종로구,1,0,1,2,2,0,2019-03-15
4467,서울,종로구,2,1,0,3,2,0,2019-04-15
4468,서울,종로구,1,0,0,1,1,0,2019-05-15
4469,서울,종로구,7,0,3,10,7,0,2019-06-15
4470,서울,종로구,3,0,0,3,2,0,2019-07-15
4471,서울,종로구,8,0,0,8,5,0,2019-08-15
4472,서울,종로구,4,1,0,5,4,0,2019-09-15
4473,서울,종로구,10,0,3,13,6,0,2019-10-15
4474,서울,종로구,3,0,0,3,3,0,2019-11-15
4475,서울,종로구,3,0,1,4,1,0,2019-12-15
4476,서울,중구,3,1,1,5,4,0,2019-01-15
4477,서울,중구,1,0,0,1,1,0,2019-02-15
4478,서울,중구,1,0,3,4,4,0,2019-03-15
4479,서울,중구,1,1,1,3,3,0,2019-04-15
4480,서울,중구,3,0,1,4,3,0,2019-05-15
4481,서울,중구,1,0,2,3,3,0,2019-06-15
4482,서울,중구,1,0,2,3,3,0,2019-07-15
4483,서울,중구,3,1,0,4,3,0,2019-08-15
4484,서울,중구,0,0,0,0,0,0,2019-09-15
4485,서울,중구,1,0,2,3,2,0,2019-10-15
4486,서울,중구,9,1,6,16,12,0,2019-11-15
4487,서울,중구,2,0,0,2,2,0,2019-12-15
4488,서울,중랑구,2,1,1,4,3,0,2019-01-15
4489,서울,중랑구,1,0,5,6,6,0,2019-02-15
4490,서울,중랑구,2,2,3,7,6,1,2019-03-15
4491,서울,중랑구,7,0,1,8,4,0,2019-04-15
4492,서울,중랑구,4,0,1,5,2,0,2019-05-15
4493,서울,중랑구,7,0,0,7,5,0,2019-06-15
4494,서울,중랑구,3,0,1,4,4,0,2019-07-15
4495,서울,중랑구,0,0,1,1,1,0,2019-08-15
4496,서울,중랑구,0,0,1,1,1,0,2019-09-15
4497,서울,중랑구,9,0,2,11,9,0,2019-10-15
4498,서울,중랑구,5,1,1,7,5,0,2019-11-15
4499,서울,중랑구,5,1,1,7,4,0,2019-12-15
4500,서울,강남구,15,0,2,17,15,1,2019-01-16
4501,서울,강남구,19,1,1,21,13,0,2019-02-16
4502,서울,강남구,6,0,1,7,6,0,2019-03-16
4503,서울,강남구,7,0,2,9,7,0,2019-04-16
4504,서울,강남구,4,3,5,12,10,0,2019-05-16
4505,서울,강남구,9,3,0,12,4,0,2019-06-16
4506,서울,강남구,12,0,1,13,9,0,2019-07-16
4507,서울,강남구,8,1,0,9,9,0,2019-08-16
4508,서울,강남구,3,0,1,4,4,0,2019-09-16
4509,서울,강남구,8,2,1,11,6,0,2019-10-16
4510,서울,강남구,30,0,3,33,19,0,2019-11-16
4511,서울,강남구,7,2,3,12,10,0,2019-12-16
4512,서울,강동구,0,0,1,1,1,0,2019-01-16
4513,서울,강동구,0,2,1,3,2,0,2019-02-16
4514,서울,강동구,8,1,1,10,6,0,2019-03-16
4515,서울,강동구,4,1,5,10,6,0,2019-04-16
4516,서울,강동구,3,0,0,3,2,0,2019-05-16
4517,서울,강동구,1,0,3,4,4,0,2019-06-16
4518,서울,강동구,5,2,1,8,7,0,2019-07-16
4519,서울,강동구,6,2,0,8,4,0,2019-08-16
4520,서울,강동구,5,1,0,6,4,0,2019-09-16
4521,서울,강동구,5,0,0,5,4,0,2019-10-16
4522,서울,강동구,1,0,2,3,3,0,2019-11-16
4523,서울,강동구,0,0,0,0,0,0,2019-12-16
4524,서울,강북구,2,1,1,4,4,0,2019-01-16
4525,서울,강북구,5,0,1,6,4,0,2019-02-16
4526,서울,강북구,1,1,0,2,2,0,2019-03-16
4527,서울,강북구,2,0,1,3,3,0,2019-04-16
4528,서울,강북구,3,0,0,3,3,0,2019-05-16
4529,서울,강북구,10,1,1,12,8,0,2019-06-16
4530,서울,강북구,3,0,3,6,5,0,2019-07-16
4531,서울,강북구,1,1,0,2,2,0,2019-08-16
4532,서울,강북구,3,1,0,4,4,0,2019-09-16
4533,서울,강북구,1,0,0,1,1,0,2019-10-16
4534,서울,강북구,3,0,0,3,3,1,2019-11-16
4535,서울,강북구,1,1,0,2,2,0,2019-12-16
4536,서울,강서구,2,0,1,3,3,0,2019-01-16
4537,서울,강서구,6,0,2,8,5,0,2019-02-16
4538,서울,강서구,4,1,0,5,5,0,2019-03-16
4539,서울,강서구,6,1,2,9,7,0,2019-04-16
4540,서울,강서구,8,1,0,9,7,0,2019-05-16
4541,서울,강서구,1,1,1,3,3,0,2019-06-16
4542,서울,강서구,6,0,0,6,6,0,2019-07-16
4543,서울,강서구,7,1,2,10,9,0,2019-08-16
4544,서울,강서구,7,0,1,8,6,0,2019-09-16
4545,서울,강서구,4,0,0,4,4,0,2019-10-16
4546,서울,강서구,10,4,0,14,10,0,2019-11-16
4547,서울,강서구,6,1,2,9,7,1,2019-12-16
4548,서울,관악구,7,2,1,10,3,0,2019-01-16
4549,서울,관악구,0,0,1,1,1,0,2019-02-16
4550,서울,관악구,6,0,1,7,6,0,2019-03-16
4551,서울,관악구,1,0,0,1,1,0,2019-04-16
4552,서울,관악구,2,0,1,3,3,0,2019-05-16
4553,서울,관악구,1,1,0,2,2,0,2019-06-16
4554,서울,관악구,6,0,2,8,6,0,2019-07-16
4555,서울,관악구,6,1,1,8,6,0,2019-08-16
4556,서울,관악구,2,0,0,2,2,0,2019-09-16
4557,서울,관악구,3,0,0,3,2,0,2019-10-16
4558,서울,관악구,4,0,3,7,5,0,2019-11-16
4559,서울,관악구,6,0,0,6,4,1,2019-12-16
4560,서울,광진구,3,0,0,3,2,0,2019-01-16
4561,서울,광진구,4,1,2,7,3,0,2019-02-16
4562,서울,광진구,0,0,1,1,1,0,2019-03-16
4563,서울,광진구,7,1,0,8,6,0,2019-04-16
4564,서울,광진구,5,0,2,7,5,0,2019-05-16
4565,서울,광진구,0,0,0,0,0,0,2019-06-16
4566,서울,광진구,0,0,0,0,0,0,2019-07-16
4567,서울,광진구,7,0,2,9,4,0,2019-08-16
4568,서울,광진구,0,0,1,1,1,0,2019-09-16
4569,서울,광진구,4,0,1,5,3,0,2019-10-16
4570,서울,광진구,3,0,2,5,3,0,2019-11-16
4571,서울,광진구,0,1,0,1,1,0,2019-12-16
4572,서울,구로구,11,0,2,13,5,0,2019-01-16
4573,서울,구로구,4,0,1,5,4,0,2019-02-16
4574,서울,구로구,4,0,0,4,3,0,2019-03-16
4575,서울,구로구,4,0,0,4,2,0,2019-04-16
4576,서울,구로구,4,0,3,7,6,0,2019-05-16
4577,서울,구로구,3,0,0,3,3,0,2019-06-16
4578,서울,구로구,2,0,3,5,3,0,2019-07-16
4579,서울,구로구,4,0,0,4,3,0,2019-08-16
4580,서울,구로구,4,0,2,6,5,0,2019-09-16
4581,서울,구로구,5,0,0,5,3,0,2019-10-16
4582,서울,구로구,3,1,0,4,2,0,2019-11-16
4583,서울,구로구,2,0,1,3,3,0,2019-12-16
4584,서울,금천구,3,1,0,4,1,0,2019-01-16
4585,서울,금천구,2,0,0,2,1,0,2019-02-16
4586,서울,금천구,2,0,0,2,2,0,2019-03-16
4587,서울,금천구,2,3,1,6,3,0,2019-04-16
4588,서울,금천구,0,1,0,1,1,0,2019-05-16
4589,서울,금천구,0,0,0,0,0,0,2019-06-16
4590,서울,금천구,1,0,1,2,2,0,2019-07-16
4591,서울,금천구,4,0,0,4,2,0,2019-08-16
4592,서울,금천구,4,0,0,4,1,0,2019-09-16
4593,서울,금천구,0,0,0,0,0,0,2019-10-16
4594,서울,금천구,1,0,1,2,2,0,2019-11-16
4595,서울,금천구,2,1,0,3,2,0,2019-12-16
4596,서울,노원구,3,1,3,7,6,0,2019-01-16
4597,서울,노원구,6,0,1,7,5,0,2019-02-16
4598,서울,노원구,6,1,1,8,5,0,2019-03-16
4599,서울,노원구,5,0,1,6,4,0,2019-04-16
4600,서울,노원구,2,0,1,3,3,0,2019-05-16
4601,서울,노원구,4,1,2,7,5,0,2019-06-16
4602,서울,노원구,2,1,0,3,3,0,2019-07-16
4603,서울,노원구,4,1,5,10,9,0,2019-08-16
4604,서울,노원구,5,0,1,6,4,0,2019-09-16
4605,서울,노원구,3,0,1,4,4,0,2019-10-16
4606,서울,노원구,5,3,1,9,9,0,2019-11-16
4607,서울,노원구,0,0,0,0,0,0,2019-12-16
4608,서울,도봉구,6,1,2,9,4,0,2019-01-16
4609,서울,도봉구,1,0,0,1,1,0,2019-02-16
4610,서울,도봉구,0,0,0,0,0,0,2019-03-16
4611,서울,도봉구,2,0,2,4,3,0,2019-04-16
4612,서울,도봉구,3,0,0,3,3,0,2019-05-16
4613,서울,도봉구,0,0,1,1,1,0,2019-06-16
4614,서울,도봉구,1,0,1,2,2,0,2019-07-16
4615,서울,도봉구,2,0,2,4,4,0,2019-08-16
4616,서울,도봉구,1,0,0,1,1,0,2019-09-16
4617,서울,도봉구,2,2,2,6,5,0,2019-10-16
4618,서울,도봉구,2,0,1,3,3,0,2019-11-16
4619,서울,도봉구,0,2,0,2,2,0,2019-12-16
4620,서울,동대문구,2,0,0,2,2,0,2019-01-16
4621,서울,동대문구,2,1,0,3,2,0,2019-02-16
4622,서울,동대문구,7,0,0,7,5,0,2019-03-16
4623,서울,동대문구,3,3,2,8,5,0,2019-04-16
4624,서울,동대문구,7,2,2,11,8,0,2019-05-16
4625,서울,동대문구,2,2,1,5,5,0,2019-06-16
4626,서울,동대문구,0,0,2,2,2,0,2019-07-16
4627,서울,동대문구,2,0,5,7,7,0,2019-08-16
4628,서울,동대문구,9,0,3,12,8,0,2019-09-16
4629,서울,동대문구,5,1,0,6,6,0,2019-10-16
4630,서울,동대문구,6,1,3,10,4,0,2019-11-16
4631,서울,동대문구,4,0,4,8,4,0,2019-12-16
4632,서울,동작구,2,0,0,2,1,0,2019-01-16
4633,서울,동작구,7,1,6,14,9,0,2019-02-16
4634,서울,동작구,5,2,1,8,4,0,2019-03-16
4635,서울,동작구,4,3,3,10,6,0,2019-04-16
4636,서울,동작구,4,1,2,7,6,0,2019-05-16
4637,서울,동작구,3,5,0,8,4,0,2019-06-16
4638,서울,동작구,1,1,1,3,3,0,2019-07-16
4639,서울,동작구,4,2,0,6,5,0,2019-08-16
4640,서울,동작구,1,0,0,1,1,0,2019-09-16
4641,서울,동작구,7,0,4,11,6,0,2019-10-16
4642,서울,동작구,0,1,0,1,1,0,2019-11-16
4643,서울,동작구,7,0,1,8,6,0,2019-12-16
4644,서울,마포구,5,1,0,6,5,0,2019-01-16
4645,서울,마포구,2,1,1,4,4,0,2019-02-16
4646,서울,마포구,8,0,1,9,4,0,2019-03-16
4647,서울,마포구,2,1,0,3,3,0,2019-04-16
4648,서울,마포구,2,1,2,5,5,0,2019-05-16
4649,서울,마포구,2,1,2,5,4,0,2019-06-16
4650,서울,마포구,3,0,1,4,3,0,2019-07-16
4651,서울,마포구,3,0,2,5,3,0,2019-08-16
4652,서울,마포구,2,0,2,4,4,0,2019-09-16
4653,서울,마포구,3,1,3,7,6,0,2019-10-16
4654,서울,마포구,1,2,0,3,3,0,2019-11-16
4655,서울,마포구,0,0,1,1,1,0,2019-12-16
4656,서울,서대문구,0,0,1,1,1,0,2019-01-16
4657,서울,서대문구,1,0,1,2,2,0,2019-02-16
4658,서울,서대문구,2,2,0,4,3,0,2019-03-16
4659,서울,서대문구,2,0,0,2,2,0,2019-04-16
4660,서울,서대문구,3,0,1,4,3,0,2019-05-16
4661,서울,서대문구,1,0,0,1,1,0,2019-06-16
4662,서울,서대문구,1,0,0,1,1,0,2019-07-16
4663,서울,서대문구,4,0,0,4,2,0,2019-08-16
4664,서울,서대문구,2,2,1,5,4,0,2019-09-16
4665,서울,서대문구,0,0,0,0,0,0,2019-10-16
4666,서울,서대문구,6,0,1,7,6,0,2019-11-16
4667,서울,서대문구,3,2,0,5,4,0,2019-12-16
4668,서울,서초구,4,0,0,4,4,0,2019-01-16
4669,서울,서초구,21,0,0,21,7,0,2019-02-16
4670,서울,서초구,8,1,3,12,9,0,2019-03-16
4671,서울,서초구,6,0,2,8,7,0,2019-04-16
4672,서울,서초구,6,1,3,10,9,0,2019-05-16
4673,서울,서초구,10,1,5,16,7,0,2019-06-16
4674,서울,서초구,5,2,2,9,7,0,2019-07-16
4675,서울,서초구,3,0,1,4,3,0,2019-08-16
4676,서울,서초구,6,2,1,9,8,0,2019-09-16
4677,서울,서초구,8,0,1,9,8,0,2019-10-16
4678,서울,서초구,10,1,3,14,10,0,2019-11-16
4679,서울,서초구,9,0,0,9,7,0,2019-12-16
4680,서울,성동구,3,0,0,3,4,1,2019-01-16
4681,서울,성동구,6,0,0,6,4,0,2019-02-16
4682,서울,성동구,2,0,0,2,2,0,2019-03-16
4683,서울,성동구,3,2,0,5,4,0,2019-04-16
4684,서울,성동구,3,0,2,5,5,0,2019-05-16
4685,서울,성동구,8,0,2,10,4,0,2019-06-16
4686,서울,성동구,7,0,0,7,6,0,2019-07-16
4687,서울,성동구,2,1,0,3,3,0,2019-08-16
4688,서울,성동구,2,0,0,2,2,0,2019-09-16
4689,서울,성동구,1,1,0,2,2,0,2019-10-16
4690,서울,성동구,1,0,0,1,1,0,2019-11-16
4691,서울,성동구,1,0,1,2,2,0,2019-12-16
4692,서울,성북구,2,0,0,2,2,0,2019-01-16
4693,서울,성북구,2,2,0,4,4,0,2019-02-16
4694,서울,성북구,4,0,2,6,4,0,2019-03-16
4695,서울,성북구,3,0,0,3,3,0,2019-04-16
4696,서울,성북구,4,0,0,4,4,0,2019-05-16
4697,서울,성북구,5,0,1,6,4,0,2019-06-16
4698,서울,성북구,1,0,2,3,3,0,2019-07-16
4699,서울,성북구,3,1,1,5,4,0,2019-08-16
4700,서울,성북구,4,0,0,4,4,0,2019-09-16
4701,서울,성북구,1,0,0,1,1,0,2019-10-16
4702,서울,성북구,3,0,4,7,6,0,2019-11-16
4703,서울,성북구,1,0,1,2,2,0,2019-12-16
4704,서울,송파구,4,0,2,6,5,0,2019-01-16
4705,서울,송파구,6,0,1,7,6,0,2019-02-16
4706,서울,송파구,5,1,1,7,7,0,2019-03-16
4707,서울,송파구,13,1,2,16,10,0,2019-04-16
4708,서울,송파구,19,1,4,24,17,1,2019-05-16
4709,서울,송파구,6,2,1,9,5,0,2019-06-16
4710,서울,송파구,7,0,0,7,3,0,2019-07-16
4711,서울,송파구,10,4,2,16,14,0,2019-08-16
4712,서울,송파구,11,2,1,14,9,0,2019-09-16
4713,서울,송파구,12,1,6,19,13,0,2019-10-16
4714,서울,송파구,13,1,2,16,11,1,2019-11-16
4715,서울,송파구,3,2,0,5,4,0,2019-12-16
4716,서울,양천구,3,0,0,3,3,0,2019-01-16
4717,서울,양천구,0,0,0,0,0,0,2019-02-16
4718,서울,양천구,4,2,1,7,3,0,2019-03-16
4719,서울,양천구,3,1,3,7,6,0,2019-04-16
4720,서울,양천구,6,1,0,7,5,0,2019-05-16
4721,서울,양천구,0,1,0,1,1,0,2019-06-16
4722,서울,양천구,6,1,0,7,5,0,2019-07-16
4723,서울,양천구,3,0,1,4,3,0,2019-08-16
4724,서울,양천구,2,3,1,6,4,0,2019-09-16
4725,서울,양천구,3,1,0,4,4,0,2019-10-16
4726,서울,양천구,1,0,0,1,1,0,2019-11-16
4727,서울,양천구,4,0,1,5,4,0,2019-12-16
4728,서울,영등포구,9,1,0,10,7,0,2019-01-16
4729,서울,영등포구,0,0,2,2,2,0,2019-02-16
4730,서울,영등포구,8,1,1,10,7,0,2019-03-16
4731,서울,영등포구,5,2,2,9,7,0,2019-04-16
4732,서울,영등포구,9,2,4,15,11,0,2019-05-16
4733,서울,영등포구,6,1,1,8,7,0,2019-06-16
4734,서울,영등포구,0,0,0,0,0,0,2019-07-16
4735,서울,영등포구,4,0,1,5,5,0,2019-08-16
4736,서울,영등포구,1,0,2,3,3,0,2019-09-16
4737,서울,영등포구,9,0,2,11,8,0,2019-10-16
4738,서울,영등포구,12,0,1,13,8,0,2019-11-16
4739,서울,영등포구,7,1,5,13,11,0,2019-12-16
4740,서울,용산구,2,0,1,3,3,0,2019-01-16
4741,서울,용산구,4,1,4,9,6,0,2019-02-16
4742,서울,용산구,8,0,1,9,7,0,2019-03-16
4743,서울,용산구,0,0,0,0,0,0,2019-04-16
4744,서울,용산구,6,0,3,9,5,0,2019-05-16
4745,서울,용산구,6,1,2,9,5,0,2019-06-16
4746,서울,용산구,4,0,1,5,2,0,2019-07-16
4747,서울,용산구,1,0,0,1,1,0,2019-08-16
4748,서울,용산구,3,0,1,4,4,0,2019-09-16
4749,서울,용산구,3,0,0,3,3,0,2019-10-16
4750,서울,용산구,1,0,2,3,3,0,2019-11-16
4751,서울,용산구,0,0,4,4,2,0,2019-12-16
4752,서울,은평구,8,0,2,10,7,0,2019-01-16
4753,서울,은평구,4,0,2,6,3,0,2019-02-16
4754,서울,은평구,0,0,1,1,1,0,2019-03-16
4755,서울,은평구,3,1,4,8,4,0,2019-04-16
4756,서울,은평구,2,0,1,3,3,0,2019-05-16
4757,서울,은평구,3,1,0,4,3,0,2019-06-16
4758,서울,은평구,3,0,1,4,4,0,2019-07-16
4759,서울,은평구,3,0,1,4,3,0,2019-08-16
4760,서울,은평구,2,0,1,3,3,0,2019-09-16
4761,서울,은평구,3,0,0,3,3,0,2019-10-16
4762,서울,은평구,2,0,1,3,3,0,2019-11-16
4763,서울,은평구,2,1,0,3,3,0,2019-12-16
4764,서울,종로구,2,1,1,4,2,0,2019-01-16
4765,서울,종로구,3,0,2,5,4,0,2019-02-16
4766,서울,종로구,0,1,0,1,1,0,2019-03-16
4767,서울,종로구,4,1,1,6,5,0,2019-04-16
4768,서울,종로구,3,1,0,4,3,0,2019-05-16
4769,서울,종로구,2,0,1,3,2,0,2019-06-16
4770,서울,종로구,1,0,0,1,1,0,2019-07-16
4771,서울,종로구,1,2,0,3,3,0,2019-08-16
4772,서울,종로구,5,1,0,6,3,0,2019-09-16
4773,서울,종로구,5,1,4,10,8,0,2019-10-16
4774,서울,종로구,0,0,0,0,0,0,2019-11-16
4775,서울,종로구,4,0,1,5,4,0,2019-12-16
4776,서울,중구,5,0,0,5,5,0,2019-01-16
4777,서울,중구,4,0,2,6,4,0,2019-02-16
4778,서울,중구,5,0,0,5,3,0,2019-03-16
4779,서울,중구,2,0,1,3,3,0,2019-04-16
4780,서울,중구,3,0,0,3,2,0,2019-05-16
4781,서울,중구,2,0,0,2,2,0,2019-06-16
4782,서울,중구,5,1,0,6,6,0,2019-07-16
4783,서울,중구,4,1,1,6,4,0,2019-08-16
4784,서울,중구,1,0,1,2,2,0,2019-09-16
4785,서울,중구,3,0,2,5,4,0,2019-10-16
4786,서울,중구,2,0,1,3,3,0,2019-11-16
4787,서울,중구,1,0,1,2,2,0,2019-12-16
4788,서울,중랑구,1,0,0,1,1,0,2019-01-16
4789,서울,중랑구,4,1,2,7,6,0,2019-02-16
4790,서울,중랑구,9,2,0,11,8,0,2019-03-16
4791,서울,중랑구,7,0,4,11,8,0,2019-04-16
4792,서울,중랑구,18,1,4,23,10,0,2019-05-16
4793,서울,중랑구,9,3,1,13,7,0,2019-06-16
4794,서울,중랑구,10,0,1,11,9,0,2019-07-16
4795,서울,중랑구,4,1,1,6,5,0,2019-08-16
4796,서울,중랑구,1,0,2,3,3,0,2019-09-16
4797,서울,중랑구,2,0,1,3,3,0,2019-10-16
4798,서울,중랑구,5,0,3,8,8,0,2019-11-16
4799,서울,중랑구,4,0,2,6,5,0,2019-12-16
4800,서울,강남구,6,1,3,10,8,0,2019-01-17
4801,서울,강남구,10,0,2,12,7,0,2019-02-17
4802,서울,강남구,10,0,3,13,10,0,2019-03-17
4803,서울,강남구,8,1,3,12,10,0,2019-04-17
4804,서울,강남구,16,1,1,18,13,0,2019-05-17
4805,서울,강남구,14,3,4,21,16,0,2019-06-17
4806,서울,강남구,11,2,1,14,12,0,2019-07-17
4807,서울,강남구,6,1,3,10,10,0,2019-08-17
4808,서울,강남구,8,0,4,12,12,0,2019-09-17
4809,서울,강남구,11,0,4,15,12,0,2019-10-17
4810,서울,강남구,12,5,5,22,14,0,2019-11-17
4811,서울,강남구,8,0,2,10,9,0,2019-12-17
4812,서울,강동구,1,1,2,4,5,1,2019-01-17
4813,서울,강동구,4,0,0,4,4,0,2019-02-17
4814,서울,강동구,2,1,0,3,3,0,2019-03-17
4815,서울,강동구,2,1,1,4,3,0,2019-04-17
4816,서울,강동구,7,0,1,8,7,0,2019-05-17
4817,서울,강동구,1,0,0,1,1,0,2019-06-17
4818,서울,강동구,2,1,2,5,5,0,2019-07-17
4819,서울,강동구,4,0,6,10,6,1,2019-08-17
4820,서울,강동구,1,2,0,3,2,0,2019-09-17
4821,서울,강동구,1,1,0,2,2,0,2019-10-17
4822,서울,강동구,4,0,0,4,3,0,2019-11-17
4823,서울,강동구,7,2,1,10,9,0,2019-12-17
4824,서울,강북구,4,0,2,6,5,0,2019-01-17
4825,서울,강북구,0,0,0,0,0,0,2019-02-17
4826,서울,강북구,1,1,1,3,2,0,2019-03-17
4827,서울,강북구,1,0,0,1,1,0,2019-04-17
4828,서울,강북구,8,1,0,9,6,0,2019-05-17
4829,서울,강북구,5,0,0,5,3,0,2019-06-17
4830,서울,강북구,1,1,0,2,2,0,2019-07-17
4831,서울,강북구,8,0,2,10,4,0,2019-08-17
4832,서울,강북구,5,0,1,6,3,0,2019-09-17
4833,서울,강북구,4,0,2,6,6,0,2019-10-17
4834,서울,강북구,3,1,0,4,3,0,2019-11-17
4835,서울,강북구,1,0,0,1,1,0,2019-12-17
4836,서울,강서구,5,0,2,7,5,0,2019-01-17
4837,서울,강서구,6,1,3,10,9,0,2019-02-17
4838,서울,강서구,3,0,0,3,2,0,2019-03-17
4839,서울,강서구,2,0,2,4,4,0,2019-04-17
4840,서울,강서구,2,1,0,3,3,0,2019-05-17
4841,서울,강서구,3,0,2,5,4,0,2019-06-17
4842,서울,강서구,4,0,0,4,4,0,2019-07-17
4843,서울,강서구,3,0,0,3,3,0,2019-08-17
4844,서울,강서구,12,1,3,16,7,0,2019-09-17
4845,서울,강서구,4,0,1,5,4,0,2019-10-17
4846,서울,강서구,4,0,1,5,4,0,2019-11-17
4847,서울,강서구,5,3,0,8,6,0,2019-12-17
4848,서울,관악구,1,0,2,3,3,0,2019-01-17
4849,서울,관악구,7,0,1,8,5,0,2019-02-17
4850,서울,관악구,3,0,3,6,4,0,2019-03-17
4851,서울,관악구,2,0,0,2,2,0,2019-04-17
4852,서울,관악구,3,0,2,5,4,0,2019-05-17
4853,서울,관악구,3,1,1,5,5,0,2019-06-17
4854,서울,관악구,7,0,0,7,5,0,2019-07-17
4855,서울,관악구,5,0,1,6,4,0,2019-08-17
4856,서울,관악구,5,0,2,7,6,0,2019-09-17
4857,서울,관악구,2,0,0,2,2,0,2019-10-17
4858,서울,관악구,0,0,1,1,1,0,2019-11-17
4859,서울,관악구,1,1,0,2,3,1,2019-12-17
4860,서울,광진구,0,0,0,0,0,0,2019-01-17
4861,서울,광진구,6,0,0,6,4,0,2019-02-17
4862,서울,광진구,5,0,0,5,4,0,2019-03-17
4863,서울,광진구,8,0,0,8,4,0,2019-04-17
4864,서울,광진구,1,2,0,3,2,0,2019-05-17
4865,서울,광진구,3,0,0,3,2,0,2019-06-17
4866,서울,광진구,2,0,1,3,3,0,2019-07-17
4867,서울,광진구,11,0,1,12,5,0,2019-08-17
4868,서울,광진구,0,0,2,2,2,0,2019-09-17
4869,서울,광진구,2,2,2,6,3,0,2019-10-17
4870,서울,광진구,2,1,0,3,3,0,2019-11-17
4871,서울,광진구,1,0,0,1,1,0,2019-12-17
4872,서울,구로구,10,0,2,12,10,0,2019-01-17
4873,서울,구로구,3,0,0,3,1,0,2019-02-17
4874,서울,구로구,8,0,2,10,7,0,2019-03-17
4875,서울,구로구,10,2,0,12,7,0,2019-04-17
4876,서울,구로구,5,0,0,5,5,0,2019-05-17
4877,서울,구로구,3,1,0,4,4,0,2019-06-17
4878,서울,구로구,3,1,3,7,6,0,2019-07-17
4879,서울,구로구,4,0,1,5,5,0,2019-08-17
4880,서울,구로구,6,1,1,8,4,0,2019-09-17
4881,서울,구로구,8,0,1,9,9,0,2019-10-17
4882,서울,구로구,0,0,1,1,1,0,2019-11-17
4883,서울,구로구,3,2,1,6,4,0,2019-12-17
4884,서울,금천구,2,0,0,2,2,0,2019-01-17
4885,서울,금천구,0,0,0,0,0,0,2019-02-17
4886,서울,금천구,4,0,1,5,4,0,2019-03-17
4887,서울,금천구,2,0,1,3,2,0,2019-04-17
4888,서울,금천구,0,0,1,1,1,0,2019-05-17
4889,서울,금천구,4,0,1,5,3,0,2019-06-17
4890,서울,금천구,1,0,2,3,3,0,2019-07-17
4891,서울,금천구,3,1,3,7,5,0,2019-08-17
4892,서울,금천구,1,1,1,3,3,0,2019-09-17
4893,서울,금천구,0,1,0,1,1,0,2019-10-17
4894,서울,금천구,1,0,2,3,3,0,2019-11-17
4895,서울,금천구,1,0,0,1,1,0,2019-12-17
4896,서울,노원구,6,0,2,8,6,0,2019-01-17
4897,서울,노원구,3,0,3,6,5,0,2019-02-17
4898,서울,노원구,2,0,0,2,2,0,2019-03-17
4899,서울,노원구,3,1,1,5,4,0,2019-04-17
4900,서울,노원구,7,0,3,10,7,0,2019-05-17
4901,서울,노원구,1,0,1,2,1,0,2019-06-17
4902,서울,노원구,5,0,1,6,3,0,2019-07-17
4903,서울,노원구,4,1,0,5,4,0,2019-08-17
4904,서울,노원구,10,0,0,10,6,0,2019-09-17
4905,서울,노원구,7,1,3,11,8,0,2019-10-17
4906,서울,노원구,4,1,1,6,5,0,2019-11-17
4907,서울,노원구,3,0,2,5,4,0,2019-12-17
4908,서울,도봉구,2,0,2,4,3,0,2019-01-17
4909,서울,도봉구,1,1,0,2,2,0,2019-02-17
4910,서울,도봉구,0,1,0,1,1,0,2019-03-17
4911,서울,도봉구,0,0,0,0,0,0,2019-04-17
4912,서울,도봉구,1,1,1,3,3,0,2019-05-17
4913,서울,도봉구,5,0,1,6,3,0,2019-06-17
4914,서울,도봉구,2,0,0,2,2,0,2019-07-17
4915,서울,도봉구,1,1,1,3,3,0,2019-08-17
4916,서울,도봉구,2,0,0,2,2,0,2019-09-17
4917,서울,도봉구,1,2,3,6,6,0,2019-10-17
4918,서울,도봉구,1,0,0,1,1,0,2019-11-17
4919,서울,도봉구,4,1,0,5,2,0,2019-12-17
4920,서울,동대문구,3,1,2,6,5,0,2019-01-17
4921,서울,동대문구,4,0,0,4,3,0,2019-02-17
4922,서울,동대문구,1,0,0,1,1,0,2019-03-17
4923,서울,동대문구,6,0,1,7,5,0,2019-04-17
4924,서울,동대문구,4,0,0,4,4,0,2019-05-17
4925,서울,동대문구,1,0,2,3,3,0,2019-06-17
4926,서울,동대문구,5,0,2,7,7,0,2019-07-17
4927,서울,동대문구,4,0,0,4,3,0,2019-08-17
4928,서울,동대문구,2,1,1,4,3,0,2019-09-17
4929,서울,동대문구,1,0,1,2,2,0,2019-10-17
4930,서울,동대문구,4,1,1,6,4,0,2019-11-17
4931,서울,동대문구,8,0,0,8,6,0,2019-12-17
4932,서울,동작구,4,0,3,7,4,1,2019-01-17
4933,서울,동작구,3,1,0,4,3,0,2019-02-17
4934,서울,동작구,6,1,0,7,3,0,2019-03-17
4935,서울,동작구,2,0,0,2,2,0,2019-04-17
4936,서울,동작구,3,0,1,4,1,0,2019-05-17
4937,서울,동작구,4,0,0,4,4,0,2019-06-17
4938,서울,동작구,7,0,1,8,6,0,2019-07-17
4939,서울,동작구,4,1,1,6,4,0,2019-08-17
4940,서울,동작구,5,0,2,7,8,1,2019-09-17
4941,서울,동작구,6,2,1,9,6,0,2019-10-17
4942,서울,동작구,6,1,2,9,5,0,2019-11-17
4943,서울,동작구,1,0,0,1,1,0,2019-12-17
4944,서울,마포구,4,0,0,4,3,0,2019-01-17
4945,서울,마포구,3,0,4,7,6,0,2019-02-17
4946,서울,마포구,6,1,2,9,2,0,2019-03-17
4947,서울,마포구,10,0,5,15,8,0,2019-04-17
4948,서울,마포구,2,0,1,3,3,0,2019-05-17
4949,서울,마포구,2,0,1,3,2,0,2019-06-17
4950,서울,마포구,1,2,0,3,2,0,2019-07-17
4951,서울,마포구,11,0,2,13,8,0,2019-08-17
4952,서울,마포구,1,0,1,2,2,0,2019-09-17
4953,서울,마포구,3,0,1,4,3,0,2019-10-17
4954,서울,마포구,5,0,1,6,4,0,2019-11-17
4955,서울,마포구,9,0,0,9,4,0,2019-12-17
4956,서울,서대문구,4,1,1,6,1,0,2019-01-17
4957,서울,서대문구,1,1,1,3,3,0,2019-02-17
4958,서울,서대문구,0,0,1,1,1,0,2019-03-17
4959,서울,서대문구,2,2,0,4,4,0,2019-04-17
4960,서울,서대문구,1,1,0,2,2,0,2019-05-17
4961,서울,서대문구,2,2,0,4,4,0,2019-06-17
4962,서울,서대문구,1,0,2,3,2,0,2019-07-17
4963,서울,서대문구,3,1,2,6,5,0,2019-08-17
4964,서울,서대문구,1,2,0,3,3,0,2019-09-17
4965,서울,서대문구,7,2,2,11,6,0,2019-10-17
4966,서울,서대문구,2,0,3,5,4,0,2019-11-17
4967,서울,서대문구,7,1,1,9,8,0,2019-12-17
4968,서울,서초구,7,1,0,8,6,0,2019-01-17
4969,서울,서초구,7,1,1,9,7,0,2019-02-17
4970,서울,서초구,1,1,1,3,3,0,2019-03-17
4971,서울,서초구,14,3,1,18,15,0,2019-04-17
4972,서울,서초구,9,0,3,12,9,0,2019-05-17
4973,서울,서초구,6,0,2,8,5,0,2019-06-17
4974,서울,서초구,7,1,0,8,7,0,2019-07-17
4975,서울,서초구,3,0,2,5,4,0,2019-08-17
4976,서울,서초구,15,1,4,20,12,0,2019-09-17
4977,서울,서초구,5,1,1,7,7,0,2019-10-17
4978,서울,서초구,7,1,0,8,6,0,2019-11-17
4979,서울,서초구,6,3,1,10,9,0,2019-12-17
4980,서울,성동구,0,1,0,1,1,0,2019-01-17
4981,서울,성동구,1,0,3,4,4,0,2019-02-17
4982,서울,성동구,3,0,1,4,2,0,2019-03-17
4983,서울,성동구,3,1,0,4,4,0,2019-04-17
4984,서울,성동구,4,0,0,4,4,0,2019-05-17
4985,서울,성동구,2,0,1,3,2,0,2019-06-17
4986,서울,성동구,3,0,1,4,2,0,2019-07-17
4987,서울,성동구,2,0,0,2,1,0,2019-08-17
4988,서울,성동구,1,0,0,1,1,0,2019-09-17
4989,서울,성동구,5,0,0,5,5,0,2019-10-17
4990,서울,성동구,9,1,0,10,5,0,2019-11-17
4991,서울,성동구,2,0,3,5,5,0,2019-12-17
4992,서울,성북구,1,0,0,1,1,0,2019-01-17
4993,서울,성북구,10,0,2,12,9,0,2019-02-17
4994,서울,성북구,4,0,1,5,3,0,2019-03-17
4995,서울,성북구,3,0,1,4,4,0,2019-04-17
4996,서울,성북구,2,0,0,2,2,0,2019-05-17
4997,서울,성북구,6,1,2,9,6,0,2019-06-17
4998,서울,성북구,5,0,1,6,6,0,2019-07-17
4999,서울,성북구,1,0,1,2,1,0,2019-08-17
5000,서울,성북구,5,0,2,7,3,0,2019-09-17
5001,서울,성북구,3,0,3,6,5,0,2019-10-17
5002,서울,성북구,5,0,0,5,3,0,2019-11-17
5003,서울,성북구,4,0,2,6,5,0,2019-12-17
5004,서울,송파구,2,1,3,6,6,0,2019-01-17
5005,서울,송파구,4,1,2,7,7,0,2019-02-17
5006,서울,송파구,5,1,2,8,7,0,2019-03-17
5007,서울,송파구,4,1,0,5,3,0,2019-04-17
5008,서울,송파구,15,0,1,16,11,0,2019-05-17
5009,서울,송파구,7,2,5,14,12,0,2019-06-17
5010,서울,송파구,4,2,2,8,5,0,2019-07-17
5011,서울,송파구,7,0,5,12,12,0,2019-08-17
5012,서울,송파구,2,2,4,8,6,0,2019-09-17
5013,서울,송파구,11,1,0,12,11,0,2019-10-17
5014,서울,송파구,5,0,1,6,5,0,2019-11-17
5015,서울,송파구,4,4,1,9,6,0,2019-12-17
5016,서울,양천구,2,0,2,4,4,0,2019-01-17
5017,서울,양천구,4,0,0,4,3,0,2019-02-17
5018,서울,양천구,3,2,0,5,3,0,2019-03-17
5019,서울,양천구,3,1,2,6,5,0,2019-04-17
5020,서울,양천구,1,0,1,2,2,0,2019-05-17
5021,서울,양천구,3,1,1,5,5,0,2019-06-17
5022,서울,양천구,7,0,1,8,7,0,2019-07-17
5023,서울,양천구,7,1,0,8,6,0,2019-08-17
5024,서울,양천구,2,0,0,2,1,0,2019-09-17
5025,서울,양천구,12,0,2,14,9,1,2019-10-17
5026,서울,양천구,2,0,1,3,2,0,2019-11-17
5027,서울,양천구,4,0,0,4,3,0,2019-12-17
5028,서울,영등포구,7,0,1,8,8,0,2019-01-17
5029,서울,영등포구,5,0,2,7,5,0,2019-02-17
5030,서울,영등포구,4,2,1,7,2,0,2019-03-17
5031,서울,영등포구,9,0,1,10,8,0,2019-04-17
5032,서울,영등포구,7,1,1,9,7,0,2019-05-17
5033,서울,영등포구,3,3,0,6,5,0,2019-06-17
5034,서울,영등포구,7,3,2,12,8,0,2019-07-17
5035,서울,영등포구,8,1,4,13,10,0,2019-08-17
5036,서울,영등포구,9,0,2,11,9,0,2019-09-17
5037,서울,영등포구,3,1,3,7,6,0,2019-10-17
5038,서울,영등포구,8,0,2,10,7,0,2019-11-17
5039,서울,영등포구,8,2,0,10,7,0,2019-12-17
5040,서울,용산구,2,0,0,2,1,0,2019-01-17
5041,서울,용산구,8,0,1,9,6,0,2019-02-17
5042,서울,용산구,2,0,1,3,2,0,2019-03-17
5043,서울,용산구,4,0,1,5,5,0,2019-04-17
5044,서울,용산구,3,0,0,3,2,0,2019-05-17
5045,서울,용산구,4,0,0,4,3,0,2019-06-17
5046,서울,용산구,4,0,1,5,3,0,2019-07-17
5047,서울,용산구,4,3,0,7,2,0,2019-08-17
5048,서울,용산구,2,0,0,2,2,0,2019-09-17
5049,서울,용산구,5,0,0,5,5,0,2019-10-17
5050,서울,용산구,1,0,2,3,2,0,2019-11-17
5051,서울,용산구,2,0,0,2,2,0,2019-12-17
5052,서울,은평구,5,0,0,5,5,0,2019-01-17
5053,서울,은평구,1,0,1,2,2,0,2019-02-17
5054,서울,은평구,0,0,0,0,0,0,2019-03-17
5055,서울,은평구,1,0,0,1,1,0,2019-04-17
5056,서울,은평구,4,0,1,5,3,0,2019-05-17
5057,서울,은평구,5,0,2,7,6,0,2019-06-17
5058,서울,은평구,2,0,1,3,2,0,2019-07-17
5059,서울,은평구,1,1,3,5,5,0,2019-08-17
5060,서울,은평구,3,0,0,3,3,0,2019-09-17
5061,서울,은평구,0,2,2,4,1,0,2019-10-17
5062,서울,은평구,1,1,2,4,4,0,2019-11-17
5063,서울,은평구,2,1,0,3,3,0,2019-12-17
5064,서울,종로구,1,0,3,4,4,0,2019-01-17
5065,서울,종로구,4,0,3,7,6,0,2019-02-17
5066,서울,종로구,2,0,2,4,3,0,2019-03-17
5067,서울,종로구,0,0,1,1,1,0,2019-04-17
5068,서울,종로구,3,0,1,4,4,0,2019-05-17
5069,서울,종로구,3,0,0,3,4,1,2019-06-17
5070,서울,종로구,3,0,0,3,3,0,2019-07-17
5071,서울,종로구,4,0,0,4,4,0,2019-08-17
5072,서울,종로구,2,0,0,2,2,0,2019-09-17
5073,서울,종로구,1,0,2,3,3,0,2019-10-17
5074,서울,종로구,3,1,1,5,5,0,2019-11-17
5075,서울,종로구,0,0,1,1,1,0,2019-12-17
5076,서울,중구,2,0,0,2,2,0,2019-01-17
5077,서울,중구,9,0,0,9,3,0,2019-02-17
5078,서울,중구,2,0,2,4,4,0,2019-03-17
5079,서울,중구,1,0,3,4,3,0,2019-04-17
5080,서울,중구,3,0,0,3,3,0,2019-05-17
5081,서울,중구,4,0,1,5,5,0,2019-06-17
5082,서울,중구,2,1,0,3,3,0,2019-07-17
5083,서울,중구,3,0,0,3,1,0,2019-08-17
5084,서울,중구,0,0,0,0,0,0,2019-09-17
5085,서울,중구,1,2,0,3,2,0,2019-10-17
5086,서울,중구,4,0,0,4,3,0,2019-11-17
5087,서울,중구,6,1,1,8,6,0,2019-12-17
5088,서울,중랑구,3,1,1,5,5,0,2019-01-17
5089,서울,중랑구,4,1,4,9,7,0,2019-02-17
5090,서울,중랑구,4,1,3,8,5,0,2019-03-17
5091,서울,중랑구,3,0,1,4,3,0,2019-04-17
5092,서울,중랑구,2,0,1,3,3,0,2019-05-17
5093,서울,중랑구,7,1,1,9,9,1,2019-06-17
5094,서울,중랑구,0,1,1,2,2,0,2019-07-17
5095,서울,중랑구,4,0,1,5,3,0,2019-08-17
5096,서울,중랑구,8,2,1,11,7,0,2019-09-17
5097,서울,중랑구,2,0,2,4,4,0,2019-10-17
5098,서울,중랑구,4,0,2,6,4,0,2019-11-17
5099,서울,중랑구,9,0,1,10,5,0,2019-12-17
5100,서울,강남구,13,1,1,15,6,0,2019-01-18
5101,서울,강남구,4,2,1,7,7,0,2019-02-18
5102,서울,강남구,7,0,4,11,9,0,2019-03-18
5103,서울,강남구,7,1,2,10,8,0,2019-04-18
5104,서울,강남구,17,1,3,21,7,0,2019-05-18
5105,서울,강남구,8,0,1,9,6,0,2019-06-18
5106,서울,강남구,7,1,2,10,7,0,2019-07-18
5107,서울,강남구,3,0,2,5,3,0,2019-08-18
5108,서울,강남구,16,3,4,23,17,0,2019-09-18
5109,서울,강남구,14,0,4,18,15,0,2019-10-18
5110,서울,강남구,14,3,1,18,14,0,2019-11-18
5111,서울,강남구,11,3,3,17,13,0,2019-12-18
5112,서울,강동구,5,1,1,7,6,0,2019-01-18
5113,서울,강동구,6,0,2,8,4,0,2019-02-18
5114,서울,강동구,7,0,1,8,4,0,2019-03-18
5115,서울,강동구,4,0,3,7,6,0,2019-04-18
5116,서울,강동구,8,1,0,9,3,0,2019-05-18
5117,서울,강동구,5,0,2,7,5,0,2019-06-18
5118,서울,강동구,2,3,1,6,4,0,2019-07-18
5119,서울,강동구,0,0,0,0,0,0,2019-08-18
5120,서울,강동구,3,2,1,6,5,0,2019-09-18
5121,서울,강동구,3,0,1,4,4,0,2019-10-18
5122,서울,강동구,7,0,2,9,3,0,2019-11-18
5123,서울,강동구,1,1,1,3,3,0,2019-12-18
5124,서울,강북구,2,0,2,4,4,0,2019-01-18
5125,서울,강북구,1,0,2,3,3,0,2019-02-18
5126,서울,강북구,0,0,0,0,0,0,2019-03-18
5127,서울,강북구,2,0,1,3,3,0,2019-04-18
5128,서울,강북구,2,1,0,3,3,0,2019-05-18
5129,서울,강북구,6,1,1,8,5,0,2019-06-18
5130,서울,강북구,0,1,1,2,2,0,2019-07-18
5131,서울,강북구,2,1,0,3,3,0,2019-08-18
5132,서울,강북구,8,1,2,11,7,0,2019-09-18
5133,서울,강북구,1,0,0,1,1,0,2019-10-18
5134,서울,강북구,8,1,2,11,8,0,2019-11-18
5135,서울,강북구,3,1,1,5,5,0,2019-12-18
5136,서울,강서구,10,0,1,11,5,0,2019-01-18
5137,서울,강서구,4,1,1,6,5,0,2019-02-18
5138,서울,강서구,0,0,0,0,0,0,2019-03-18
5139,서울,강서구,0,0,0,0,0,0,2019-04-18
5140,서울,강서구,3,0,5,8,6,0,2019-05-18
5141,서울,강서구,4,0,1,5,5,0,2019-06-18
5142,서울,강서구,1,1,2,4,4,0,2019-07-18
5143,서울,강서구,6,2,2,10,8,0,2019-08-18
5144,서울,강서구,1,0,0,1,1,0,2019-09-18
5145,서울,강서구,6,2,6,14,12,0,2019-10-18
5146,서울,강서구,8,1,3,12,9,0,2019-11-18
5147,서울,강서구,14,0,0,14,5,0,2019-12-18
5148,서울,관악구,3,0,4,7,7,0,2019-01-18
5149,서울,관악구,3,0,0,3,3,0,2019-02-18
5150,서울,관악구,3,0,1,4,4,0,2019-03-18
5151,서울,관악구,1,0,2,3,3,0,2019-04-18
5152,서울,관악구,4,0,1,5,4,0,2019-05-18
5153,서울,관악구,3,0,3,6,5,0,2019-06-18
5154,서울,관악구,4,0,1,5,4,0,2019-07-18
5155,서울,관악구,0,0,1,1,1,0,2019-08-18
5156,서울,관악구,2,0,1,3,2,0,2019-09-18
5157,서울,관악구,4,2,2,8,5,0,2019-10-18
5158,서울,관악구,3,0,1,4,4,0,2019-11-18
5159,서울,관악구,4,0,0,4,2,0,2019-12-18
5160,서울,광진구,5,1,0,6,5,0,2019-01-18
5161,서울,광진구,5,0,2,7,2,0,2019-02-18
5162,서울,광진구,1,0,1,2,2,0,2019-03-18
5163,서울,광진구,2,0,1,3,3,0,2019-04-18
5164,서울,광진구,10,0,0,10,6,0,2019-05-18
5165,서울,광진구,2,1,3,6,6,0,2019-06-18
5166,서울,광진구,1,0,0,1,1,0,2019-07-18
5167,서울,광진구,4,0,1,5,2,0,2019-08-18
5168,서울,광진구,2,0,0,2,2,0,2019-09-18
5169,서울,광진구,4,0,0,4,3,0,2019-10-18
5170,서울,광진구,0,0,1,1,1,0,2019-11-18
5171,서울,광진구,2,0,3,5,2,0,2019-12-18
5172,서울,구로구,7,1,2,10,9,1,2019-01-18
5173,서울,구로구,0,0,1,1,1,0,2019-02-18
5174,서울,구로구,3,0,0,3,2,0,2019-03-18
5175,서울,구로구,6,0,0,6,2,0,2019-04-18
5176,서울,구로구,3,1,1,5,4,0,2019-05-18
5177,서울,구로구,3,1,1,5,5,0,2019-06-18
5178,서울,구로구,2,0,1,3,3,0,2019-07-18
5179,서울,구로구,2,0,0,2,2,0,2019-08-18
5180,서울,구로구,8,0,1,9,5,0,2019-09-18
5181,서울,구로구,6,1,0,7,4,0,2019-10-18
5182,서울,구로구,5,0,3,8,7,0,2019-11-18
5183,서울,구로구,4,0,1,5,4,0,2019-12-18
5184,서울,금천구,5,0,0,5,3,0,2019-01-18
5185,서울,금천구,3,0,1,4,4,0,2019-02-18
5186,서울,금천구,2,0,2,4,4,0,2019-03-18
5187,서울,금천구,1,0,0,1,1,0,2019-04-18
5188,서울,금천구,10,1,0,11,7,0,2019-05-18
5189,서울,금천구,1,0,0,1,1,0,2019-06-18
5190,서울,금천구,0,0,1,1,1,0,2019-07-18
5191,서울,금천구,3,1,0,4,3,0,2019-08-18
5192,서울,금천구,0,0,0,0,0,0,2019-09-18
5193,서울,금천구,14,0,4,18,4,0,2019-10-18
5194,서울,금천구,1,0,1,2,2,0,2019-11-18
5195,서울,금천구,1,1,0,2,2,0,2019-12-18
5196,서울,노원구,3,0,0,3,2,0,2019-01-18
5197,서울,노원구,6,1,2,9,7,0,2019-02-18
5198,서울,노원구,3,0,1,4,5,1,2019-03-18
5199,서울,노원구,3,0,1,4,4,0,2019-04-18
5200,서울,노원구,3,0,0,3,3,0,2019-05-18
5201,서울,노원구,4,1,1,6,5,0,2019-06-18
5202,서울,노원구,3,0,1,4,1,0,2019-07-18
5203,서울,노원구,6,0,2,8,5,0,2019-08-18
5204,서울,노원구,2,1,2,5,4,0,2019-09-18
5205,서울,노원구,7,1,3,11,9,0,2019-10-18
5206,서울,노원구,5,0,0,5,5,0,2019-11-18
5207,서울,노원구,4,0,1,5,3,0,2019-12-18
5208,서울,도봉구,4,0,0,4,3,1,2019-01-18
5209,서울,도봉구,0,0,0,0,0,0,2019-02-18
5210,서울,도봉구,3,0,1,4,2,0,2019-03-18
5211,서울,도봉구,1,1,0,2,2,0,2019-04-18
5212,서울,도봉구,1,2,1,4,3,0,2019-05-18
5213,서울,도봉구,5,1,0,6,4,0,2019-06-18
5214,서울,도봉구,0,0,0,0,0,0,2019-07-18
5215,서울,도봉구,0,0,2,2,2,0,2019-08-18
5216,서울,도봉구,1,0,0,1,1,0,2019-09-18
5217,서울,도봉구,2,1,2,5,3,0,2019-10-18
5218,서울,도봉구,11,1,3,15,5,0,2019-11-18
5219,서울,도봉구,1,0,1,2,2,0,2019-12-18
5220,서울,동대문구,4,0,1,5,5,0,2019-01-18
5221,서울,동대문구,3,0,0,3,2,0,2019-02-18
5222,서울,동대문구,1,0,1,2,2,0,2019-03-18
5223,서울,동대문구,4,0,0,4,4,0,2019-04-18
5224,서울,동대문구,2,0,3,5,4,0,2019-05-18
5225,서울,동대문구,3,0,2,5,4,0,2019-06-18
5226,서울,동대문구,3,0,0,3,3,0,2019-07-18
5227,서울,동대문구,4,0,1,5,4,0,2019-08-18
5228,서울,동대문구,4,0,4,8,8,0,2019-09-18
5229,서울,동대문구,3,0,3,6,6,1,2019-10-18
5230,서울,동대문구,2,1,0,3,3,0,2019-11-18
5231,서울,동대문구,3,0,1,4,4,0,2019-12-18
5232,서울,동작구,3,0,1,4,4,0,2019-01-18
5233,서울,동작구,3,1,1,5,3,0,2019-02-18
5234,서울,동작구,3,1,1,5,4,0,2019-03-18
5235,서울,동작구,5,1,2,8,6,0,2019-04-18
5236,서울,동작구,5,0,3,8,7,0,2019-05-18
5237,서울,동작구,4,0,1,5,3,0,2019-06-18
5238,서울,동작구,1,0,1,2,2,0,2019-07-18
5239,서울,동작구,2,0,0,2,2,0,2019-08-18
5240,서울,동작구,1,0,2,3,3,0,2019-09-18
5241,서울,동작구,3,0,0,3,3,0,2019-10-18
5242,서울,동작구,12,1,7,20,9,0,2019-11-18
5243,서울,동작구,2,1,0,3,3,0,2019-12-18
5244,서울,마포구,4,2,0,6,4,0,2019-01-18
5245,서울,마포구,1,0,1,2,2,0,2019-02-18
5246,서울,마포구,4,0,3,7,4,0,2019-03-18
5247,서울,마포구,4,0,1,5,3,0,2019-04-18
5248,서울,마포구,3,1,0,4,4,0,2019-05-18
5249,서울,마포구,10,0,0,10,8,0,2019-06-18
5250,서울,마포구,7,1,0,8,7,0,2019-07-18
5251,서울,마포구,1,0,0,1,1,0,2019-08-18
5252,서울,마포구,5,1,2,8,4,0,2019-09-18
5253,서울,마포구,8,0,3,11,7,0,2019-10-18
5254,서울,마포구,7,1,0,8,7,0,2019-11-18
5255,서울,마포구,2,1,1,4,4,0,2019-12-18
5256,서울,서대문구,1,0,0,1,1,0,2019-01-18
5257,서울,서대문구,2,0,2,4,4,0,2019-02-18
5258,서울,서대문구,2,0,0,2,2,0,2019-03-18
5259,서울,서대문구,2,0,0,2,2,0,2019-04-18
5260,서울,서대문구,3,0,2,5,4,0,2019-05-18
5261,서울,서대문구,2,1,1,4,3,0,2019-06-18
5262,서울,서대문구,2,1,0,3,3,0,2019-07-18
5263,서울,서대문구,1,1,1,3,2,0,2019-08-18
5264,서울,서대문구,5,1,1,7,5,0,2019-09-18
5265,서울,서대문구,3,1,0,4,4,0,2019-10-18
5266,서울,서대문구,3,0,3,6,5,0,2019-11-18
5267,서울,서대문구,1,1,1,3,2,0,2019-12-18
5268,서울,서초구,6,0,2,8,7,0,2019-01-18
5269,서울,서초구,4,0,1,5,3,0,2019-02-18
5270,서울,서초구,6,1,1,8,7,0,2019-03-18
5271,서울,서초구,12,1,0,13,10,0,2019-04-18
5272,서울,서초구,2,2,5,9,8,0,2019-05-18
5273,서울,서초구,10,1,2,13,9,0,2019-06-18
5274,서울,서초구,8,2,4,14,11,0,2019-07-18
5275,서울,서초구,3,0,0,3,2,0,2019-08-18
5276,서울,서초구,17,2,2,21,14,0,2019-09-18
5277,서울,서초구,8,3,0,11,6,0,2019-10-18
5278,서울,서초구,8,0,0,8,6,0,2019-11-18
5279,서울,서초구,8,0,0,8,6,0,2019-12-18
5280,서울,성동구,4,0,0,4,4,0,2019-01-18
5281,서울,성동구,9,1,0,10,7,0,2019-02-18
5282,서울,성동구,3,0,1,4,4,0,2019-03-18
5283,서울,성동구,2,0,0,2,2,0,2019-04-18
5284,서울,성동구,8,1,1,10,3,0,2019-05-18
5285,서울,성동구,2,0,2,4,4,0,2019-06-18
5286,서울,성동구,5,0,0,5,3,0,2019-07-18
5287,서울,성동구,3,0,0,3,1,0,2019-08-18
5288,서울,성동구,5,1,1,7,5,0,2019-09-18
5289,서울,성동구,4,0,1,5,4,0,2019-10-18
5290,서울,성동구,3,0,1,4,4,0,2019-11-18
5291,서울,성동구,1,0,1,2,2,0,2019-12-18
5292,서울,성북구,6,0,0,6,3,0,2019-01-18
5293,서울,성북구,1,0,1,2,2,0,2019-02-18
5294,서울,성북구,14,1,1,16,8,0,2019-03-18
5295,서울,성북구,6,0,2,8,6,0,2019-04-18
5296,서울,성북구,2,0,2,4,3,0,2019-05-18
5297,서울,성북구,2,1,1,4,4,0,2019-06-18
5298,서울,성북구,4,0,2,6,5,0,2019-07-18
5299,서울,성북구,4,2,0,6,6,0,2019-08-18
5300,서울,성북구,1,0,0,1,1,0,2019-09-18
5301,서울,성북구,3,1,1,5,5,0,2019-10-18
5302,서울,성북구,7,0,1,8,6,0,2019-11-18
5303,서울,성북구,3,0,1,4,3,0,2019-12-18
5304,서울,송파구,7,0,2,9,7,0,2019-01-18
5305,서울,송파구,8,2,0,10,8,0,2019-02-18
5306,서울,송파구,10,0,5,15,8,0,2019-03-18
5307,서울,송파구,10,1,4,15,9,0,2019-04-18
5308,서울,송파구,11,1,2,14,11,0,2019-05-18
5309,서울,송파구,6,2,2,10,8,0,2019-06-18
5310,서울,송파구,9,1,0,10,8,0,2019-07-18
5311,서울,송파구,8,1,0,9,6,0,2019-08-18
5312,서울,송파구,5,2,1,8,5,0,2019-09-18
5313,서울,송파구,8,1,4,13,12,0,2019-10-18
5314,서울,송파구,12,2,0,14,10,0,2019-11-18
5315,서울,송파구,6,3,0,9,8,0,2019-12-18
5316,서울,양천구,6,0,0,6,5,0,2019-01-18
5317,서울,양천구,5,0,2,7,7,0,2019-02-18
5318,서울,양천구,7,0,1,8,6,0,2019-03-18
5319,서울,양천구,4,0,0,4,4,0,2019-04-18
5320,서울,양천구,6,0,1,7,4,0,2019-05-18
5321,서울,양천구,4,0,1,5,4,0,2019-06-18
5322,서울,양천구,3,1,0,4,4,0,2019-07-18
5323,서울,양천구,6,1,0,7,8,1,2019-08-18
5324,서울,양천구,2,0,0,2,1,0,2019-09-18
5325,서울,양천구,7,0,0,7,5,0,2019-10-18
5326,서울,양천구,3,0,1,4,3,0,2019-11-18
5327,서울,양천구,5,1,1,7,4,0,2019-12-18
5328,서울,영등포구,5,0,2,7,5,0,2019-01-18
5329,서울,영등포구,5,1,1,7,6,0,2019-02-18
5330,서울,영등포구,3,2,0,5,4,0,2019-03-18
5331,서울,영등포구,2,1,0,3,3,0,2019-04-18
5332,서울,영등포구,6,2,3,11,9,0,2019-05-18
5333,서울,영등포구,14,1,3,18,13,0,2019-06-18
5334,서울,영등포구,2,0,0,2,2,0,2019-07-18
5335,서울,영등포구,4,0,0,4,4,0,2019-08-18
5336,서울,영등포구,12,2,2,16,9,0,2019-09-18
5337,서울,영등포구,7,1,1,9,8,0,2019-10-18
5338,서울,영등포구,5,1,4,10,10,0,2019-11-18
5339,서울,영등포구,7,1,2,10,6,0,2019-12-18
5340,서울,용산구,2,0,3,5,2,0,2019-01-18
5341,서울,용산구,1,0,3,4,4,0,2019-02-18
5342,서울,용산구,2,0,0,2,2,0,2019-03-18
5343,서울,용산구,1,0,0,1,1,0,2019-04-18
5344,서울,용산구,1,0,0,1,1,0,2019-05-18
5345,서울,용산구,8,0,1,9,4,0,2019-06-18
5346,서울,용산구,3,0,0,3,2,0,2019-07-18
5347,서울,용산구,2,0,2,4,3,0,2019-08-18
5348,서울,용산구,1,0,3,4,3,0,2019-09-18
5349,서울,용산구,8,0,0,8,6,0,2019-10-18
5350,서울,용산구,4,0,3,7,5,0,2019-11-18
5351,서울,용산구,2,1,0,3,2,0,2019-12-18
5352,서울,은평구,0,0,0,0,0,0,2019-01-18
5353,서울,은평구,3,0,1,4,4,0,2019-02-18
5354,서울,은평구,1,0,2,3,3,0,2019-03-18
5355,서울,은평구,5,0,1,6,5,0,2019-04-18
5356,서울,은평구,3,0,1,4,3,0,2019-05-18
5357,서울,은평구,2,0,0,2,2,0,2019-06-18
5358,서울,은평구,0,0,2,2,2,0,2019-07-18
5359,서울,은평구,0,0,0,0,0,0,2019-08-18
5360,서울,은평구,3,0,0,3,3,0,2019-09-18
5361,서울,은평구,5,0,0,5,3,0,2019-10-18
5362,서울,은평구,5,0,1,6,6,0,2019-11-18
5363,서울,은평구,12,2,0,14,8,0,2019-12-18
5364,서울,종로구,1,0,2,3,2,0,2019-01-18
5365,서울,종로구,2,0,0,2,2,0,2019-02-18
5366,서울,종로구,2,1,2,5,4,0,2019-03-18
5367,서울,종로구,0,0,0,0,0,0,2019-04-18
5368,서울,종로구,0,0,1,1,1,0,2019-05-18
5369,서울,종로구,2,0,2,4,3,0,2019-06-18
5370,서울,종로구,4,0,0,4,4,0,2019-07-18
5371,서울,종로구,0,0,2,2,1,0,2019-08-18
5372,서울,종로구,3,1,0,4,3,0,2019-09-18
5373,서울,종로구,0,1,0,1,1,0,2019-10-18
5374,서울,종로구,7,2,1,10,5,0,2019-11-18
5375,서울,종로구,1,0,0,1,1,0,2019-12-18
5376,서울,중구,2,0,2,4,3,0,2019-01-18
5377,서울,중구,3,1,0,4,2,0,2019-02-18
5378,서울,중구,4,0,3,7,5,0,2019-03-18
5379,서울,중구,6,1,0,7,4,0,2019-04-18
5380,서울,중구,3,0,0,3,3,0,2019-05-18
5381,서울,중구,1,1,0,2,2,0,2019-06-18
5382,서울,중구,3,0,0,3,3,0,2019-07-18
5383,서울,중구,0,0,0,0,0,0,2019-08-18
5384,서울,중구,5,1,1,7,6,0,2019-09-18
5385,서울,중구,1,0,0,1,1,0,2019-10-18
5386,서울,중구,7,0,3,10,6,0,2019-11-18
5387,서울,중구,4,0,0,4,2,0,2019-12-18
5388,서울,중랑구,2,0,0,2,1,0,2019-01-18
5389,서울,중랑구,3,3,1,7,6,0,2019-02-18
5390,서울,중랑구,1,0,1,2,2,0,2019-03-18
5391,서울,중랑구,0,0,0,0,0,0,2019-04-18
5392,서울,중랑구,6,2,0,8,6,0,2019-05-18
5393,서울,중랑구,0,0,0,0,0,0,2019-06-18
5394,서울,중랑구,3,0,1,4,3,0,2019-07-18
5395,서울,중랑구,1,1,0,2,2,0,2019-08-18
5396,서울,중랑구,3,0,2,5,5,0,2019-09-18
5397,서울,중랑구,12,2,5,19,13,0,2019-10-18
5398,서울,중랑구,8,1,0,9,5,0,2019-11-18
5399,서울,중랑구,4,0,0,4,3,0,2019-12-18
5400,서울,강남구,8,0,2,10,6,0,2019-01-19
5401,서울,강남구,9,1,1,11,9,0,2019-02-19
5402,서울,강남구,10,1,1,12,8,0,2019-03-19
5403,서울,강남구,15,2,6,23,15,0,2019-04-19
5404,서울,강남구,11,2,2,15,10,0,2019-05-19
5405,서울,강남구,13,4,6,23,13,0,2019-06-19
5406,서울,강남구,7,1,2,10,10,0,2019-07-19
5407,서울,강남구,8,3,2,13,9,0,2019-08-19
5408,서울,강남구,10,0,1,11,11,0,2019-09-19
5409,서울,강남구,13,3,2,18,15,0,2019-10-19
5410,서울,강남구,13,0,5,18,13,0,2019-11-19
5411,서울,강남구,11,2,2,15,15,0,2019-12-19
5412,서울,강동구,5,0,0,5,3,0,2019-01-19
5413,서울,강동구,1,0,1,2,2,0,2019-02-19
5414,서울,강동구,2,1,1,4,4,0,2019-03-19
5415,서울,강동구,6,1,0,7,5,0,2019-04-19
5416,서울,강동구,1,0,1,2,2,0,2019-05-19
5417,서울,강동구,6,0,0,6,2,0,2019-06-19
5418,서울,강동구,2,0,0,2,2,0,2019-07-19
5419,서울,강동구,5,1,0,6,4,0,2019-08-19
5420,서울,강동구,6,2,2,10,9,0,2019-09-19
5421,서울,강동구,3,0,0,3,2,0,2019-10-19
5422,서울,강동구,4,0,5,9,8,0,2019-11-19
5423,서울,강동구,4,0,2,6,6,0,2019-12-19
5424,서울,강북구,3,0,1,4,3,0,2019-01-19
5425,서울,강북구,0,0,0,0,0,0,2019-02-19
5426,서울,강북구,2,0,3,5,5,0,2019-03-19
5427,서울,강북구,4,1,1,6,5,0,2019-04-19
5428,서울,강북구,2,0,2,4,4,0,2019-05-19
5429,서울,강북구,3,0,0,3,3,0,2019-06-19
5430,서울,강북구,2,1,0,3,3,0,2019-07-19
5431,서울,강북구,6,0,1,7,4,0,2019-08-19
5432,서울,강북구,5,0,2,7,6,0,2019-09-19
5433,서울,강북구,5,0,3,8,4,0,2019-10-19
5434,서울,강북구,4,1,2,7,6,0,2019-11-19
5435,서울,강북구,2,0,1,3,2,0,2019-12-19
5436,서울,강서구,5,0,1,6,5,0,2019-01-19
5437,서울,강서구,5,1,2,8,5,0,2019-02-19
5438,서울,강서구,4,0,5,9,5,0,2019-03-19
5439,서울,강서구,6,0,1,7,7,0,2019-04-19
5440,서울,강서구,8,0,1,9,4,0,2019-05-19
5441,서울,강서구,12,0,2,14,4,0,2019-06-19
5442,서울,강서구,4,0,2,6,6,0,2019-07-19
5443,서울,강서구,5,1,0,6,4,0,2019-08-19
5444,서울,강서구,6,3,3,12,8,0,2019-09-19
5445,서울,강서구,1,1,1,3,3,0,2019-10-19
5446,서울,강서구,7,0,3,10,6,0,2019-11-19
5447,서울,강서구,5,0,2,7,6,0,2019-12-19
5448,서울,관악구,0,0,2,2,2,0,2019-01-19
5449,서울,관악구,1,5,3,9,5,0,2019-02-19
5450,서울,관악구,2,0,1,3,4,1,2019-03-19
5451,서울,관악구,4,1,2,7,5,0,2019-04-19
5452,서울,관악구,10,0,4,14,10,0,2019-05-19
5453,서울,관악구,2,0,2,4,4,0,2019-06-19
5454,서울,관악구,2,0,1,3,3,0,2019-07-19
5455,서울,관악구,0,5,0,5,1,0,2019-08-19
5456,서울,관악구,3,1,0,4,3,0,2019-09-19
5457,서울,관악구,5,3,1,9,4,0,2019-10-19
5458,서울,관악구,5,0,1,6,3,0,2019-11-19
5459,서울,관악구,0,0,3,3,2,0,2019-12-19
5460,서울,광진구,4,0,0,4,2,0,2019-01-19
5461,서울,광진구,3,0,0,3,2,0,2019-02-19
5462,서울,광진구,0,0,1,1,1,0,2019-03-19
5463,서울,광진구,6,0,0,6,5,0,2019-04-19
5464,서울,광진구,3,0,2,5,2,0,2019-05-19
5465,서울,광진구,1,2,0,3,3,0,2019-06-19
5466,서울,광진구,0,1,0,1,1,0,2019-07-19
5467,서울,광진구,7,0,1,8,6,0,2019-08-19
5468,서울,광진구,2,0,2,4,4,0,2019-09-19
5469,서울,광진구,2,0,1,3,3,0,2019-10-19
5470,서울,광진구,2,0,1,3,3,0,2019-11-19
5471,서울,광진구,8,0,0,8,5,0,2019-12-19
5472,서울,구로구,4,0,1,5,5,1,2019-01-19
5473,서울,구로구,2,0,1,3,3,0,2019-02-19
5474,서울,구로구,9,2,0,11,8,0,2019-03-19
5475,서울,구로구,0,1,1,2,2,0,2019-04-19
5476,서울,구로구,0,0,0,0,0,0,2019-05-19
5477,서울,구로구,4,0,2,6,5,0,2019-06-19
5478,서울,구로구,2,0,1,3,3,0,2019-07-19
5479,서울,구로구,4,1,2,7,5,0,2019-08-19
5480,서울,구로구,3,0,0,3,2,0,2019-09-19
5481,서울,구로구,5,0,0,5,3,0,2019-10-19
5482,서울,구로구,2,0,2,4,4,0,2019-11-19
5483,서울,구로구,0,0,4,4,3,0,2019-12-19
5484,서울,금천구,0,0,1,1,1,0,2019-01-19
5485,서울,금천구,0,0,0,0,0,0,2019-02-19
5486,서울,금천구,9,0,2,11,2,0,2019-03-19
5487,서울,금천구,0,0,0,0,0,0,2019-04-19
5488,서울,금천구,4,0,1,5,5,0,2019-05-19
5489,서울,금천구,0,0,0,0,0,0,2019-06-19
5490,서울,금천구,1,1,0,2,2,0,2019-07-19
5491,서울,금천구,9,0,0,9,4,0,2019-08-19
5492,서울,금천구,0,0,0,0,0,0,2019-09-19
5493,서울,금천구,7,1,0,8,3,0,2019-10-19
5494,서울,금천구,5,1,3,9,6,0,2019-11-19
5495,서울,금천구,3,0,1,4,4,0,2019-12-19
5496,서울,노원구,3,1,1,5,3,0,2019-01-19
5497,서울,노원구,3,0,1,4,4,0,2019-02-19
5498,서울,노원구,9,0,2,11,8,0,2019-03-19
5499,서울,노원구,2,1,0,3,2,0,2019-04-19
5500,서울,노원구,2,0,2,4,4,0,2019-05-19
5501,서울,노원구,9,0,2,11,6,0,2019-06-19
5502,서울,노원구,10,1,1,12,9,0,2019-07-19
5503,서울,노원구,7,0,2,9,6,0,2019-08-19
5504,서울,노원구,2,0,0,2,2,0,2019-09-19
5505,서울,노원구,5,0,4,9,9,0,2019-10-19
5506,서울,노원구,5,0,2,7,3,0,2019-11-19
5507,서울,노원구,2,0,0,2,2,0,2019-12-19
5508,서울,도봉구,1,0,1,2,2,0,2019-01-19
5509,서울,도봉구,3,0,2,5,3,0,2019-02-19
5510,서울,도봉구,0,0,0,0,0,0,2019-03-19
5511,서울,도봉구,4,1,1,6,5,0,2019-04-19
5512,서울,도봉구,1,0,1,2,2,0,2019-05-19
5513,서울,도봉구,6,0,0,6,4,0,2019-06-19
5514,서울,도봉구,1,1,1,3,3,0,2019-07-19
5515,서울,도봉구,6,0,0,6,4,1,2019-08-19
5516,서울,도봉구,0,1,0,1,1,0,2019-09-19
5517,서울,도봉구,4,0,0,4,3,0,2019-10-19
5518,서울,도봉구,1,0,0,1,1,0,2019-11-19
5519,서울,도봉구,3,0,1,4,3,0,2019-12-19
5520,서울,동대문구,7,1,0,8,3,0,2019-01-19
5521,서울,동대문구,2,0,0,2,2,0,2019-02-19
5522,서울,동대문구,3,0,1,4,4,0,2019-03-19
5523,서울,동대문구,5,1,2,8,6,0,2019-04-19
5524,서울,동대문구,2,0,1,3,3,0,2019-05-19
5525,서울,동대문구,1,1,0,2,3,1,2019-06-19
5526,서울,동대문구,8,0,2,10,8,0,2019-07-19
5527,서울,동대문구,2,0,1,3,3,0,2019-08-19
5528,서울,동대문구,2,1,0,3,3,0,2019-09-19
5529,서울,동대문구,6,0,0,6,4,0,2019-10-19
5530,서울,동대문구,5,0,1,6,5,0,2019-11-19
5531,서울,동대문구,5,0,4,9,9,0,2019-12-19
5532,서울,동작구,6,0,2,8,4,0,2019-01-19
5533,서울,동작구,5,0,0,5,4,0,2019-02-19
5534,서울,동작구,4,1,0,5,4,0,2019-03-19
5535,서울,동작구,1,1,1,3,2,0,2019-04-19
5536,서울,동작구,3,0,0,3,3,0,2019-05-19
5537,서울,동작구,5,0,2,7,7,0,2019-06-19
5538,서울,동작구,4,1,1,6,6,0,2019-07-19
5539,서울,동작구,3,0,0,3,2,0,2019-08-19
5540,서울,동작구,8,0,0,8,4,0,2019-09-19
5541,서울,동작구,2,0,1,3,3,0,2019-10-19
5542,서울,동작구,2,0,2,4,3,0,2019-11-19
5543,서울,동작구,7,0,0,7,7,0,2019-12-19
5544,서울,마포구,6,0,0,6,3,0,2019-01-19
5545,서울,마포구,4,0,1,5,5,0,2019-02-19
5546,서울,마포구,4,2,1,7,5,0,2019-03-19
5547,서울,마포구,2,1,0,3,3,0,2019-04-19
5548,서울,마포구,6,0,0,6,4,0,2019-05-19
5549,서울,마포구,0,0,1,1,1,0,2019-06-19
5550,서울,마포구,6,3,1,10,4,0,2019-07-19
5551,서울,마포구,6,0,0,6,2,0,2019-08-19
5552,서울,마포구,3,0,0,3,3,0,2019-09-19
5553,서울,마포구,6,2,2,10,7,0,2019-10-19
5554,서울,마포구,0,0,1,1,1,0,2019-11-19
5555,서울,마포구,0,0,0,0,0,0,2019-12-19
5556,서울,서대문구,2,0,0,2,1,0,2019-01-19
5557,서울,서대문구,1,0,0,1,1,0,2019-02-19
5558,서울,서대문구,1,2,0,3,2,0,2019-03-19
5559,서울,서대문구,5,0,1,6,5,0,2019-04-19
5560,서울,서대문구,14,7,1,22,4,0,2019-05-19
5561,서울,서대문구,16,8,5,29,6,0,2019-06-19
5562,서울,서대문구,4,1,2,7,5,0,2019-07-19
5563,서울,서대문구,4,0,1,5,4,0,2019-08-19
5564,서울,서대문구,4,0,3,7,6,0,2019-09-19
5565,서울,서대문구,1,0,0,1,1,0,2019-10-19
5566,서울,서대문구,2,1,1,4,3,0,2019-11-19
5567,서울,서대문구,2,0,0,2,2,0,2019-12-19
5568,서울,서초구,9,2,2,13,8,0,2019-01-19
5569,서울,서초구,6,0,1,7,4,0,2019-02-19
5570,서울,서초구,2,0,0,2,2,0,2019-03-19
5571,서울,서초구,4,0,1,5,4,0,2019-04-19
5572,서울,서초구,16,2,2,20,9,0,2019-05-19
5573,서울,서초구,4,0,0,4,4,0,2019-06-19
5574,서울,서초구,4,1,0,5,5,0,2019-07-19
5575,서울,서초구,2,1,1,4,4,0,2019-08-19
5576,서울,서초구,5,1,0,6,5,0,2019-09-19
5577,서울,서초구,11,1,2,14,10,0,2019-10-19
5578,서울,서초구,13,1,3,17,8,0,2019-11-19
5579,서울,서초구,13,0,2,15,8,0,2019-12-19
5580,서울,성동구,1,0,0,1,1,0,2019-01-19
5581,서울,성동구,7,1,0,8,4,0,2019-02-19
5582,서울,성동구,4,2,0,6,3,0,2019-03-19
5583,서울,성동구,3,1,0,4,3,0,2019-04-19
5584,서울,성동구,0,0,1,1,1,0,2019-05-19
5585,서울,성동구,5,0,2,7,6,0,2019-06-19
5586,서울,성동구,11,0,1,12,7,0,2019-07-19
5587,서울,성동구,5,0,0,5,4,0,2019-08-19
5588,서울,성동구,3,0,0,3,2,0,2019-09-19
5589,서울,성동구,6,0,2,8,6,0,2019-10-19
5590,서울,성동구,5,1,0,6,4,0,2019-11-19
5591,서울,성동구,2,0,1,3,3,0,2019-12-19
5592,서울,성북구,9,1,2,12,7,0,2019-01-19
5593,서울,성북구,2,0,1,3,3,0,2019-02-19
5594,서울,성북구,5,0,0,5,2,0,2019-03-19
5595,서울,성북구,10,2,3,15,9,0,2019-04-19
5596,서울,성북구,2,0,0,2,2,0,2019-05-19
5597,서울,성북구,2,2,1,5,5,0,2019-06-19
5598,서울,성북구,14,0,1,15,4,0,2019-07-19
5599,서울,성북구,9,0,1,10,6,0,2019-08-19
5600,서울,성북구,1,0,1,2,2,0,2019-09-19
5601,서울,성북구,0,1,3,4,2,0,2019-10-19
5602,서울,성북구,5,0,8,13,10,0,2019-11-19
5603,서울,성북구,1,1,1,3,3,0,2019-12-19
5604,서울,송파구,6,0,3,9,6,0,2019-01-19
5605,서울,송파구,3,0,2,5,5,0,2019-02-19
5606,서울,송파구,13,1,3,17,12,0,2019-03-19
5607,서울,송파구,5,2,3,10,8,0,2019-04-19
5608,서울,송파구,12,2,1,15,10,0,2019-05-19
5609,서울,송파구,8,1,3,12,11,0,2019-06-19
5610,서울,송파구,17,3,1,21,14,1,2019-07-19
5611,서울,송파구,4,2,3,9,6,0,2019-08-19
5612,서울,송파구,9,2,4,15,9,0,2019-09-19
5613,서울,송파구,8,3,2,13,7,0,2019-10-19
5614,서울,송파구,13,3,2,18,16,0,2019-11-19
5615,서울,송파구,7,1,1,9,8,0,2019-12-19
5616,서울,양천구,4,0,3,7,3,0,2019-01-19
5617,서울,양천구,0,0,0,0,0,0,2019-02-19
5618,서울,양천구,1,0,1,2,2,0,2019-03-19
5619,서울,양천구,3,0,1,4,3,0,2019-04-19
5620,서울,양천구,1,4,1,6,3,0,2019-05-19
5621,서울,양천구,5,1,0,6,4,0,2019-06-19
5622,서울,양천구,1,1,1,3,3,0,2019-07-19
5623,서울,양천구,6,0,2,8,5,0,2019-08-19
5624,서울,양천구,1,0,0,1,1,0,2019-09-19
5625,서울,양천구,14,3,3,20,11,0,2019-10-19
5626,서울,양천구,4,0,1,5,4,0,2019-11-19
5627,서울,양천구,6,1,2,9,8,0,2019-12-19
5628,서울,영등포구,11,0,3,14,7,0,2019-01-19
5629,서울,영등포구,5,0,0,5,5,1,2019-02-19
5630,서울,영등포구,5,0,1,6,5,0,2019-03-19
5631,서울,영등포구,15,2,2,19,12,0,2019-04-19
5632,서울,영등포구,13,0,1,14,8,0,2019-05-19
5633,서울,영등포구,5,2,2,9,6,0,2019-06-19
5634,서울,영등포구,6,2,3,11,10,0,2019-07-19
5635,서울,영등포구,4,1,1,6,4,0,2019-08-19
5636,서울,영등포구,8,3,1,12,6,0,2019-09-19
5637,서울,영등포구,16,0,0,16,6,0,2019-10-19
5638,서울,영등포구,8,2,4,14,12,0,2019-11-19
5639,서울,영등포구,3,0,3,6,5,0,2019-12-19
5640,서울,용산구,5,0,0,5,3,0,2019-01-19
5641,서울,용산구,4,0,1,5,5,0,2019-02-19
5642,서울,용산구,2,0,1,3,2,0,2019-03-19
5643,서울,용산구,7,0,2,9,7,0,2019-04-19
5644,서울,용산구,4,1,0,5,4,0,2019-05-19
5645,서울,용산구,1,0,3,4,4,0,2019-06-19
5646,서울,용산구,1,1,1,3,2,0,2019-07-19
5647,서울,용산구,2,0,0,2,2,0,2019-08-19
5648,서울,용산구,3,0,0,3,3,0,2019-09-19
5649,서울,용산구,3,0,2,5,4,0,2019-10-19
5650,서울,용산구,7,0,2,9,8,0,2019-11-19
5651,서울,용산구,4,0,0,4,2,0,2019-12-19
5652,서울,은평구,2,0,3,5,3,0,2019-01-19
5653,서울,은평구,4,1,1,6,5,0,2019-02-19
5654,서울,은평구,5,0,0,5,4,0,2019-03-19
5655,서울,은평구,0,1,4,5,5,0,2019-04-19
5656,서울,은평구,4,0,1,5,5,0,2019-05-19
5657,서울,은평구,1,3,0,4,2,0,2019-06-19
5658,서울,은평구,1,0,0,1,1,0,2019-07-19
5659,서울,은평구,0,0,0,0,0,0,2019-08-19
5660,서울,은평구,7,0,0,7,6,0,2019-09-19
5661,서울,은평구,1,0,2,3,3,0,2019-10-19
5662,서울,은평구,1,0,3,4,4,0,2019-11-19
5663,서울,은평구,9,1,2,12,2,0,2019-12-19
5664,서울,종로구,6,1,1,8,2,0,2019-01-19
5665,서울,종로구,1,0,0,1,1,0,2019-02-19
5666,서울,종로구,0,0,0,0,0,0,2019-03-19
5667,서울,종로구,1,1,1,3,3,0,2019-04-19
5668,서울,종로구,1,0,2,3,2,0,2019-05-19
5669,서울,종로구,2,1,2,5,5,0,2019-06-19
5670,서울,종로구,2,1,0,3,3,0,2019-07-19
5671,서울,종로구,0,0,0,0,0,0,2019-08-19
5672,서울,종로구,2,1,1,4,3,0,2019-09-19
5673,서울,종로구,2,0,0,2,2,0,2019-10-19
5674,서울,종로구,7,0,0,7,6,0,2019-11-19
5675,서울,종로구,1,1,3,5,5,0,2019-12-19
5676,서울,중구,1,0,0,1,1,0,2019-01-19
5677,서울,중구,0,0,0,0,0,0,2019-02-19
5678,서울,중구,0,0,1,1,1,0,2019-03-19
5679,서울,중구,2,0,4,6,5,0,2019-04-19
5680,서울,중구,1,0,0,1,1,0,2019-05-19
5681,서울,중구,4,1,1,6,5,0,2019-06-19
5682,서울,중구,1,0,2,3,3,0,2019-07-19
5683,서울,중구,2,0,0,2,2,0,2019-08-19
5684,서울,중구,3,0,0,3,3,0,2019-09-19
5685,서울,중구,2,0,0,2,2,0,2019-10-19
5686,서울,중구,3,0,0,3,3,0,2019-11-19
5687,서울,중구,3,0,1,4,4,0,2019-12-19
5688,서울,중랑구,4,0,3,7,4,0,2019-01-19
5689,서울,중랑구,1,0,1,2,2,0,2019-02-19
5690,서울,중랑구,3,0,1,4,3,0,2019-03-19
5691,서울,중랑구,3,0,3,6,6,0,2019-04-19
5692,서울,중랑구,2,1,1,4,4,0,2019-05-19
5693,서울,중랑구,2,1,2,5,5,0,2019-06-19
5694,서울,중랑구,4,1,1,6,3,0,2019-07-19
5695,서울,중랑구,5,2,2,9,5,0,2019-08-19
5696,서울,중랑구,4,0,2,6,6,0,2019-09-19
5697,서울,중랑구,7,0,0,7,6,0,2019-10-19
5698,서울,중랑구,6,1,1,8,6,0,2019-11-19
5699,서울,중랑구,3,0,0,3,2,0,2019-12-19
5700,서울,강남구,6,1,3,10,7,0,2019-01-20
5701,서울,강남구,10,1,1,12,11,0,2019-02-20
5702,서울,강남구,12,0,4,16,11,0,2019-03-20
5703,서울,강남구,12,1,2,15,10,0,2019-04-20
5704,서울,강남구,14,1,1,16,11,0,2019-05-20
5705,서울,강남구,10,2,1,13,10,0,2019-06-20
5706,서울,강남구,2,0,1,3,3,0,2019-07-20
5707,서울,강남구,3,1,1,5,4,0,2019-08-20
5708,서울,강남구,15,2,1,18,13,0,2019-09-20
5709,서울,강남구,5,0,0,5,3,0,2019-10-20
5710,서울,강남구,24,6,0,30,15,0,2019-11-20
5711,서울,강남구,11,3,3,17,11,0,2019-12-20
5712,서울,강동구,0,0,1,1,1,0,2019-01-20
5713,서울,강동구,4,0,1,5,3,0,2019-02-20
5714,서울,강동구,3,0,0,3,3,0,2019-03-20
5715,서울,강동구,0,0,0,0,0,0,2019-04-20
5716,서울,강동구,4,2,2,8,7,0,2019-05-20
5717,서울,강동구,8,0,1,9,4,0,2019-06-20
5718,서울,강동구,5,1,0,6,5,0,2019-07-20
5719,서울,강동구,6,1,3,10,9,0,2019-08-20
5720,서울,강동구,2,0,0,2,2,0,2019-09-20
5721,서울,강동구,5,0,2,7,4,0,2019-10-20
5722,서울,강동구,2,0,3,5,4,0,2019-11-20
5723,서울,강동구,1,0,1,2,2,0,2019-12-20
5724,서울,강북구,7,0,5,12,5,0,2019-01-20
5725,서울,강북구,3,0,1,4,3,0,2019-02-20
5726,서울,강북구,8,0,1,9,5,0,2019-03-20
5727,서울,강북구,6,0,1,7,4,0,2019-04-20
5728,서울,강북구,1,0,0,1,1,0,2019-05-20
5729,서울,강북구,2,1,0,3,3,0,2019-06-20
5730,서울,강북구,4,0,4,8,4,0,2019-07-20
5731,서울,강북구,4,0,1,5,2,0,2019-08-20
5732,서울,강북구,7,0,0,7,7,0,2019-09-20
5733,서울,강북구,2,0,2,4,3,0,2019-10-20
5734,서울,강북구,4,0,1,5,5,0,2019-11-20
5735,서울,강북구,3,3,0,6,2,0,2019-12-20
5736,서울,강서구,6,0,2,8,5,0,2019-01-20
5737,서울,강서구,7,1,0,8,7,0,2019-02-20
5738,서울,강서구,10,1,3,14,14,1,2019-03-20
5739,서울,강서구,8,0,1,9,7,0,2019-04-20
5740,서울,강서구,8,0,0,8,8,0,2019-05-20
5741,서울,강서구,8,1,3,12,7,0,2019-06-20
5742,서울,강서구,6,0,0,6,4,0,2019-07-20
5743,서울,강서구,6,0,2,8,8,0,2019-08-20
5744,서울,강서구,4,4,0,8,4,0,2019-09-20
5745,서울,강서구,2,0,2,4,4,0,2019-10-20
5746,서울,강서구,4,0,2,6,5,0,2019-11-20
5747,서울,강서구,12,0,2,14,8,0,2019-12-20
5748,서울,관악구,2,1,3,6,5,0,2019-01-20
5749,서울,관악구,1,0,1,2,2,0,2019-02-20
5750,서울,관악구,1,0,2,3,3,0,2019-03-20
5751,서울,관악구,3,0,2,5,3,0,2019-04-20
5752,서울,관악구,4,0,1,5,4,0,2019-05-20
5753,서울,관악구,3,2,1,6,3,0,2019-06-20
5754,서울,관악구,10,0,4,14,9,0,2019-07-20
5755,서울,관악구,5,0,1,6,5,0,2019-08-20
5756,서울,관악구,1,1,2,4,5,1,2019-09-20
5757,서울,관악구,6,1,0,7,6,0,2019-10-20
5758,서울,관악구,4,0,2,6,6,0,2019-11-20
5759,서울,관악구,5,0,0,5,4,0,2019-12-20
5760,서울,광진구,0,1,0,1,1,0,2019-01-20
5761,서울,광진구,0,0,2,2,2,0,2019-02-20
5762,서울,광진구,3,0,1,4,3,0,2019-03-20
5763,서울,광진구,0,0,0,0,0,0,2019-04-20
5764,서울,광진구,3,1,1,5,4,0,2019-05-20
5765,서울,광진구,4,0,0,4,3,0,2019-06-20
5766,서울,광진구,1,0,0,1,1,0,2019-07-20
5767,서울,광진구,3,0,1,4,4,0,2019-08-20
5768,서울,광진구,1,1,0,2,2,0,2019-09-20
5769,서울,광진구,0,0,0,0,0,0,2019-10-20
5770,서울,광진구,1,0,1,2,2,0,2019-11-20
5771,서울,광진구,0,0,1,1,1,0,2019-12-20
5772,서울,구로구,5,0,2,7,5,0,2019-01-20
5773,서울,구로구,5,0,1,6,6,0,2019-02-20
5774,서울,구로구,2,0,1,3,2,0,2019-03-20
5775,서울,구로구,1,0,0,1,1,0,2019-04-20
5776,서울,구로구,2,1,3,6,4,0,2019-05-20
5777,서울,구로구,6,2,2,10,9,0,2019-06-20
5778,서울,구로구,1,0,1,2,2,0,2019-07-20
5779,서울,구로구,5,1,1,7,4,0,2019-08-20
5780,서울,구로구,4,0,0,4,3,0,2019-09-20
5781,서울,구로구,1,0,1,2,2,0,2019-10-20
5782,서울,구로구,2,0,0,2,1,0,2019-11-20
5783,서울,구로구,3,1,2,6,6,1,2019-12-20
5784,서울,금천구,1,0,0,1,1,0,2019-01-20
5785,서울,금천구,5,1,0,6,3,0,2019-02-20
5786,서울,금천구,3,0,0,3,2,0,2019-03-20
5787,서울,금천구,0,0,1,1,1,0,2019-04-20
5788,서울,금천구,2,0,0,2,2,0,2019-05-20
5789,서울,금천구,1,0,1,2,2,0,2019-06-20
5790,서울,금천구,5,0,0,5,2,0,2019-07-20
5791,서울,금천구,1,0,1,2,2,0,2019-08-20
5792,서울,금천구,2,0,2,4,3,0,2019-09-20
5793,서울,금천구,19,0,1,20,2,0,2019-10-20
5794,서울,금천구,0,0,0,0,0,0,2019-11-20
5795,서울,금천구,4,0,1,5,3,0,2019-12-20
5796,서울,노원구,4,0,2,6,4,0,2019-01-20
5797,서울,노원구,0,0,0,0,0,0,2019-02-20
5798,서울,노원구,2,1,1,4,4,0,2019-03-20
5799,서울,노원구,6,0,1,7,3,0,2019-04-20
5800,서울,노원구,7,0,2,9,5,0,2019-05-20
5801,서울,노원구,1,0,1,2,2,0,2019-06-20
5802,서울,노원구,6,1,1,8,5,0,2019-07-20
5803,서울,노원구,1,0,1,2,2,0,2019-08-20
5804,서울,노원구,7,0,0,7,6,0,2019-09-20
5805,서울,노원구,6,0,1,7,4,0,2019-10-20
5806,서울,노원구,7,0,1,8,5,0,2019-11-20
5807,서울,노원구,8,0,1,9,5,0,2019-12-20
5808,서울,도봉구,3,0,0,3,3,0,2019-01-20
5809,서울,도봉구,5,0,1,6,3,0,2019-02-20
5810,서울,도봉구,0,0,0,0,0,0,2019-03-20
5811,서울,도봉구,1,0,0,1,1,0,2019-04-20
5812,서울,도봉구,3,1,0,4,3,0,2019-05-20
5813,서울,도봉구,3,0,0,3,3,0,2019-06-20
5814,서울,도봉구,1,0,2,3,3,0,2019-07-20
5815,서울,도봉구,2,2,0,4,4,0,2019-08-20
5816,서울,도봉구,2,1,1,4,3,0,2019-09-20
5817,서울,도봉구,1,0,0,1,1,0,2019-10-20
5818,서울,도봉구,1,0,5,6,5,0,2019-11-20
5819,서울,도봉구,2,0,3,5,4,0,2019-12-20
5820,서울,동대문구,0,0,0,0,0,0,2019-01-20
5821,서울,동대문구,2,0,1,3,3,0,2019-02-20
5822,서울,동대문구,6,0,0,6,4,0,2019-03-20
5823,서울,동대문구,6,1,3,10,8,0,2019-04-20
5824,서울,동대문구,1,0,0,1,1,0,2019-05-20
5825,서울,동대문구,2,0,1,3,2,0,2019-06-20
5826,서울,동대문구,3,0,1,4,3,0,2019-07-20
5827,서울,동대문구,4,1,0,5,2,0,2019-08-20
5828,서울,동대문구,4,0,0,4,4,0,2019-09-20
5829,서울,동대문구,4,0,2,6,4,0,2019-10-20
5830,서울,동대문구,3,0,1,4,3,0,2019-11-20
5831,서울,동대문구,5,0,1,6,5,0,2019-12-20
5832,서울,동작구,2,0,0,2,2,0,2019-01-20
5833,서울,동작구,1,0,2,3,3,0,2019-02-20
5834,서울,동작구,6,4,2,12,9,0,2019-03-20
5835,서울,동작구,2,0,2,4,4,0,2019-04-20
5836,서울,동작구,3,0,1,4,2,0,2019-05-20
5837,서울,동작구,7,1,0,8,5,0,2019-06-20
5838,서울,동작구,1,0,2,3,3,0,2019-07-20
5839,서울,동작구,4,0,1,5,3,0,2019-08-20
5840,서울,동작구,3,0,1,4,4,0,2019-09-20
5841,서울,동작구,2,1,0,3,3,0,2019-10-20
5842,서울,동작구,2,0,2,4,3,0,2019-11-20
5843,서울,동작구,4,2,0,6,5,0,2019-12-20
5844,서울,마포구,5,1,1,7,4,0,2019-01-20
5845,서울,마포구,8,1,2,11,7,0,2019-02-20
5846,서울,마포구,2,1,1,4,4,0,2019-03-20
5847,서울,마포구,1,0,2,3,3,0,2019-04-20
5848,서울,마포구,2,2,0,4,4,0,2019-05-20
5849,서울,마포구,7,1,2,10,8,0,2019-06-20
5850,서울,마포구,2,0,1,3,3,0,2019-07-20
5851,서울,마포구,3,0,2,5,4,0,2019-08-20
5852,서울,마포구,3,2,1,6,5,0,2019-09-20
5853,서울,마포구,2,1,0,3,3,0,2019-10-20
5854,서울,마포구,2,1,0,3,3,0,2019-11-20
5855,서울,마포구,6,1,1,8,6,0,2019-12-20
5856,서울,서대문구,3,1,2,6,5,0,2019-01-20
5857,서울,서대문구,1,0,1,2,2,0,2019-02-20
5858,서울,서대문구,4,0,1,5,2,0,2019-03-20
5859,서울,서대문구,3,1,0,4,3,0,2019-04-20
5860,서울,서대문구,1,0,1,2,2,0,2019-05-20
5861,서울,서대문구,0,0,0,0,0,0,2019-06-20
5862,서울,서대문구,3,0,0,3,3,0,2019-07-20
5863,서울,서대문구,1,0,1,2,2,0,2019-08-20
5864,서울,서대문구,1,1,1,3,2,0,2019-09-20
5865,서울,서대문구,5,1,1,7,5,0,2019-10-20
5866,서울,서대문구,5,0,0,5,5,0,2019-11-20
5867,서울,서대문구,5,4,2,11,8,0,2019-12-20
5868,서울,서초구,8,0,5,13,11,0,2019-01-20
5869,서울,서초구,3,0,0,3,3,0,2019-02-20
5870,서울,서초구,6,0,1,7,5,0,2019-03-20
5871,서울,서초구,5,1,1,7,6,0,2019-04-20
5872,서울,서초구,6,0,3,9,7,0,2019-05-20
5873,서울,서초구,13,0,0,13,8,0,2019-06-20
5874,서울,서초구,9,1,2,12,9,0,2019-07-20
5875,서울,서초구,14,1,1,16,6,0,2019-08-20
5876,서울,서초구,6,2,3,11,8,0,2019-09-20
5877,서울,서초구,4,2,0,6,4,0,2019-10-20
5878,서울,서초구,9,1,3,13,10,0,2019-11-20
5879,서울,서초구,4,2,3,9,9,0,2019-12-20
5880,서울,성동구,0,0,0,0,0,0,2019-01-20
5881,서울,성동구,5,0,0,5,5,0,2019-02-20
5882,서울,성동구,10,0,1,11,7,0,2019-03-20
5883,서울,성동구,3,0,1,4,4,1,2019-04-20
5884,서울,성동구,1,1,1,3,2,0,2019-05-20
5885,서울,성동구,6,0,1,7,5,0,2019-06-20
5886,서울,성동구,0,0,0,0,0,0,2019-07-20
5887,서울,성동구,4,0,0,4,3,0,2019-08-20
5888,서울,성동구,4,0,0,4,2,0,2019-09-20
5889,서울,성동구,0,0,1,1,1,0,2019-10-20
5890,서울,성동구,4,1,1,6,5,0,2019-11-20
5891,서울,성동구,3,0,0,3,3,0,2019-12-20
5892,서울,성북구,2,0,1,3,3,0,2019-01-20
5893,서울,성북구,4,0,0,4,3,0,2019-02-20
5894,서울,성북구,6,0,3,9,6,0,2019-03-20
5895,서울,성북구,4,1,1,6,5,0,2019-04-20
5896,서울,성북구,1,0,3,4,4,1,2019-05-20
5897,서울,성북구,2,0,2,4,4,0,2019-06-20
5898,서울,성북구,7,0,3,10,6,0,2019-07-20
5899,서울,성북구,9,0,0,9,5,0,2019-08-20
5900,서울,성북구,6,0,1,7,6,0,2019-09-20
5901,서울,성북구,1,0,0,1,1,0,2019-10-20
5902,서울,성북구,4,0,1,5,4,0,2019-11-20
5903,서울,성북구,1,0,1,2,2,0,2019-12-20
5904,서울,송파구,5,0,0,5,3,0,2019-01-20
5905,서울,송파구,6,0,1,7,4,0,2019-02-20
5906,서울,송파구,15,1,1,17,13,0,2019-03-20
5907,서울,송파구,4,0,2,6,5,0,2019-04-20
5908,서울,송파구,6,0,2,8,7,0,2019-05-20
5909,서울,송파구,5,1,3,9,7,0,2019-06-20
5910,서울,송파구,5,0,2,7,7,0,2019-07-20
5911,서울,송파구,5,0,3,8,8,1,2019-08-20
5912,서울,송파구,13,5,0,18,15,0,2019-09-20
5913,서울,송파구,11,1,2,14,7,0,2019-10-20
5914,서울,송파구,8,2,4,14,12,0,2019-11-20
5915,서울,송파구,7,0,3,10,8,0,2019-12-20
5916,서울,양천구,3,0,3,6,4,0,2019-01-20
5917,서울,양천구,6,1,2,9,4,0,2019-02-20
5918,서울,양천구,7,0,4,11,9,0,2019-03-20
5919,서울,양천구,8,0,3,11,9,0,2019-04-20
5920,서울,양천구,3,1,0,4,4,0,2019-05-20
5921,서울,양천구,6,1,2,9,4,0,2019-06-20
5922,서울,양천구,5,0,0,5,2,0,2019-07-20
5923,서울,양천구,9,0,3,12,8,0,2019-08-20
5924,서울,양천구,0,1,0,1,1,0,2019-09-20
5925,서울,양천구,3,0,0,3,1,0,2019-10-20
5926,서울,양천구,5,2,1,8,5,0,2019-11-20
5927,서울,양천구,1,0,1,2,2,0,2019-12-20
5928,서울,영등포구,4,2,1,7,5,0,2019-01-20
5929,서울,영등포구,2,2,0,4,3,0,2019-02-20
5930,서울,영등포구,5,1,0,6,5,0,2019-03-20
5931,서울,영등포구,9,2,1,12,5,0,2019-04-20
5932,서울,영등포구,9,0,0,9,2,0,2019-05-20
5933,서울,영등포구,3,0,0,3,3,0,2019-06-20
5934,서울,영등포구,14,4,6,24,11,1,2019-07-20
5935,서울,영등포구,5,0,1,6,5,0,2019-08-20
5936,서울,영등포구,7,1,1,9,6,0,2019-09-20
5937,서울,영등포구,7,1,4,12,7,0,2019-10-20
5938,서울,영등포구,10,0,0,10,8,0,2019-11-20
5939,서울,영등포구,13,0,3,16,10,0,2019-12-20
5940,서울,용산구,8,0,1,9,6,0,2019-01-20
5941,서울,용산구,0,0,0,0,0,0,2019-02-20
5942,서울,용산구,6,3,1,10,6,0,2019-03-20
5943,서울,용산구,1,0,1,2,2,0,2019-04-20
5944,서울,용산구,4,0,0,4,4,0,2019-05-20
5945,서울,용산구,1,0,0,1,1,0,2019-06-20
5946,서울,용산구,2,0,0,2,2,0,2019-07-20
5947,서울,용산구,2,0,0,2,2,0,2019-08-20
5948,서울,용산구,4,0,3,7,3,0,2019-09-20
5949,서울,용산구,2,1,1,4,3,0,2019-10-20
5950,서울,용산구,3,0,1,4,4,0,2019-11-20
5951,서울,용산구,4,0,1,5,5,0,2019-12-20
5952,서울,은평구,4,0,2,6,5,0,2019-01-20
5953,서울,은평구,0,0,1,1,1,0,2019-02-20
5954,서울,은평구,2,0,0,2,2,0,2019-03-20
5955,서울,은평구,1,1,0,2,1,0,2019-04-20
5956,서울,은평구,3,1,2,6,5,0,2019-05-20
5957,서울,은평구,3,0,0,3,3,0,2019-06-20
5958,서울,은평구,1,0,0,1,1,0,2019-07-20
5959,서울,은평구,0,0,0,0,0,0,2019-08-20
5960,서울,은평구,3,0,3,6,6,0,2019-09-20
5961,서울,은평구,4,0,0,4,3,0,2019-10-20
5962,서울,은평구,6,0,2,8,8,0,2019-11-20
5963,서울,은평구,2,0,2,4,2,0,2019-12-20
5964,서울,종로구,0,0,0,0,0,0,2019-01-20
5965,서울,종로구,1,0,1,2,2,0,2019-02-20
5966,서울,종로구,1,0,0,1,1,0,2019-03-20
5967,서울,종로구,5,0,2,7,6,0,2019-04-20
5968,서울,종로구,1,0,0,1,1,0,2019-05-20
5969,서울,종로구,4,1,0,5,2,0,2019-06-20
5970,서울,종로구,2,0,1,3,3,0,2019-07-20
5971,서울,종로구,2,0,0,2,2,0,2019-08-20
5972,서울,종로구,4,1,2,7,6,0,2019-09-20
5973,서울,종로구,1,0,2,3,3,0,2019-10-20
5974,서울,종로구,4,0,0,4,3,0,2019-11-20
5975,서울,종로구,2,0,0,2,2,0,2019-12-20
5976,서울,중구,5,1,0,6,4,0,2019-01-20
5977,서울,중구,2,0,2,4,3,0,2019-02-20
5978,서울,중구,5,0,2,7,6,0,2019-03-20
5979,서울,중구,4,0,1,5,3,0,2019-04-20
5980,서울,중구,0,0,0,0,0,0,2019-05-20
5981,서울,중구,3,0,1,4,4,0,2019-06-20
5982,서울,중구,3,0,0,3,2,0,2019-07-20
5983,서울,중구,1,1,1,3,3,0,2019-08-20
5984,서울,중구,3,2,4,9,9,0,2019-09-20
5985,서울,중구,3,0,0,3,2,0,2019-10-20
5986,서울,중구,2,0,0,2,1,0,2019-11-20
5987,서울,중구,1,0,0,1,1,0,2019-12-20
5988,서울,중랑구,3,0,0,3,3,0,2019-01-20
5989,서울,중랑구,4,1,1,6,5,0,2019-02-20
5990,서울,중랑구,8,2,0,10,7,1,2019-03-20
5991,서울,중랑구,2,0,1,3,2,0,2019-04-20
5992,서울,중랑구,2,0,1,3,3,0,2019-05-20
5993,서울,중랑구,6,1,3,10,6,0,2019-06-20
5994,서울,중랑구,2,0,0,2,2,0,2019-07-20
5995,서울,중랑구,2,0,1,3,3,0,2019-08-20
5996,서울,중랑구,1,0,0,1,1,0,2019-09-20
5997,서울,중랑구,8,2,2,12,5,0,2019-10-20
5998,서울,중랑구,4,0,1,5,5,0,2019-11-20
5999,서울,중랑구,6,1,2,9,8,0,2019-12-20
6000,서울,강남구,5,0,2,7,7,0,2019-01-21
6001,서울,강남구,19,0,3,22,12,0,2019-02-21
6002,서울,강남구,17,2,6,25,16,1,2019-03-21
6003,서울,강남구,7,1,3,11,7,0,2019-04-21
6004,서울,강남구,14,0,4,18,11,0,2019-05-21
6005,서울,강남구,13,0,3,16,13,0,2019-06-21
6006,서울,강남구,18,1,1,20,12,0,2019-07-21
6007,서울,강남구,14,1,4,19,15,0,2019-08-21
6008,서울,강남구,9,0,3,12,9,0,2019-09-21
6009,서울,강남구,9,1,3,13,11,1,2019-10-21
6010,서울,강남구,19,1,3,23,17,1,2019-11-21
6011,서울,강남구,10,0,1,11,9,0,2019-12-21
6012,서울,강동구,9,0,2,11,8,0,2019-01-21
6013,서울,강동구,1,0,3,4,4,0,2019-02-21
6014,서울,강동구,0,1,2,3,2,0,2019-03-21
6015,서울,강동구,4,0,0,4,3,0,2019-04-21
6016,서울,강동구,7,0,1,8,5,0,2019-05-21
6017,서울,강동구,8,2,0,10,5,0,2019-06-21
6018,서울,강동구,5,0,0,5,3,0,2019-07-21
6019,서울,강동구,4,2,0,6,3,0,2019-08-21
6020,서울,강동구,1,0,6,7,5,1,2019-09-21
6021,서울,강동구,6,1,2,9,7,0,2019-10-21
6022,서울,강동구,9,1,1,11,7,0,2019-11-21
6023,서울,강동구,1,0,1,2,2,0,2019-12-21
6024,서울,강북구,2,0,3,5,3,0,2019-01-21
6025,서울,강북구,3,0,1,4,4,0,2019-02-21
6026,서울,강북구,0,0,0,0,0,0,2019-03-21
6027,서울,강북구,1,0,1,2,2,0,2019-04-21
6028,서울,강북구,6,0,0,6,6,0,2019-05-21
6029,서울,강북구,3,0,1,4,3,0,2019-06-21
6030,서울,강북구,6,0,1,7,4,0,2019-07-21
6031,서울,강북구,3,0,1,4,3,0,2019-08-21
6032,서울,강북구,4,0,0,4,1,0,2019-09-21
6033,서울,강북구,6,0,1,7,7,0,2019-10-21
6034,서울,강북구,2,0,2,4,4,0,2019-11-21
6035,서울,강북구,2,0,1,3,3,0,2019-12-21
6036,서울,강서구,3,0,0,3,3,0,2019-01-21
6037,서울,강서구,5,0,4,9,8,0,2019-02-21
6038,서울,강서구,1,0,1,2,2,0,2019-03-21
6039,서울,강서구,6,0,2,8,5,0,2019-04-21
6040,서울,강서구,6,0,0,6,6,0,2019-05-21
6041,서울,강서구,6,1,0,7,6,0,2019-06-21
6042,서울,강서구,4,0,1,5,4,0,2019-07-21
6043,서울,강서구,1,0,1,2,2,0,2019-08-21
6044,서울,강서구,14,1,5,20,12,0,2019-09-21
6045,서울,강서구,4,0,0,4,3,0,2019-10-21
6046,서울,강서구,3,0,1,4,3,0,2019-11-21
6047,서울,강서구,7,0,3,10,10,0,2019-12-21
6048,서울,관악구,1,0,0,1,1,0,2019-01-21
6049,서울,관악구,4,1,0,5,5,0,2019-02-21
6050,서울,관악구,4,0,1,5,5,0,2019-03-21
6051,서울,관악구,4,0,0,4,3,0,2019-04-21
6052,서울,관악구,4,0,1,5,4,0,2019-05-21
6053,서울,관악구,2,0,0,2,2,0,2019-06-21
6054,서울,관악구,1,0,2,3,3,0,2019-07-21
6055,서울,관악구,4,2,0,6,6,0,2019-08-21
6056,서울,관악구,2,0,4,6,4,0,2019-09-21
6057,서울,관악구,3,1,2,6,5,0,2019-10-21
6058,서울,관악구,8,0,0,8,6,0,2019-11-21
6059,서울,관악구,7,0,4,11,3,0,2019-12-21
6060,서울,광진구,1,0,0,1,1,0,2019-01-21
6061,서울,광진구,1,1,1,3,3,0,2019-02-21
6062,서울,광진구,3,0,1,4,4,0,2019-03-21
6063,서울,광진구,6,1,2,9,5,0,2019-04-21
6064,서울,광진구,1,0,1,2,2,0,2019-05-21
6065,서울,광진구,5,1,1,7,7,0,2019-06-21
6066,서울,광진구,1,0,1,2,2,0,2019-07-21
6067,서울,광진구,7,0,0,7,3,0,2019-08-21
6068,서울,광진구,7,0,1,8,4,0,2019-09-21
6069,서울,광진구,1,0,0,1,1,0,2019-10-21
6070,서울,광진구,0,0,0,0,0,0,2019-11-21
6071,서울,광진구,3,0,2,5,4,0,2019-12-21
6072,서울,구로구,5,0,1,6,7,1,2019-01-21
6073,서울,구로구,4,1,0,5,5,0,2019-02-21
6074,서울,구로구,4,0,1,5,5,0,2019-03-21
6075,서울,구로구,4,0,1,5,3,0,2019-04-21
6076,서울,구로구,4,1,2,7,5,0,2019-05-21
6077,서울,구로구,1,1,3,5,3,0,2019-06-21
6078,서울,구로구,2,0,0,2,2,0,2019-07-21
6079,서울,구로구,4,0,2,6,3,0,2019-08-21
6080,서울,구로구,4,0,1,5,4,0,2019-09-21
6081,서울,구로구,0,0,1,1,1,0,2019-10-21
6082,서울,구로구,3,1,4,8,6,0,2019-11-21
6083,서울,구로구,2,0,0,2,2,0,2019-12-21
6084,서울,금천구,0,0,0,0,1,1,2019-01-21
6085,서울,금천구,0,0,2,2,1,0,2019-02-21
6086,서울,금천구,1,1,0,2,1,0,2019-03-21
6087,서울,금천구,6,0,2,8,5,0,2019-04-21
6088,서울,금천구,2,1,0,3,3,0,2019-05-21
6089,서울,금천구,2,1,1,4,3,0,2019-06-21
6090,서울,금천구,5,0,0,5,4,0,2019-07-21
6091,서울,금천구,2,0,2,4,4,0,2019-08-21
6092,서울,금천구,0,0,1,1,1,0,2019-09-21
6093,서울,금천구,6,0,0,6,5,0,2019-10-21
6094,서울,금천구,4,0,2,6,4,0,2019-11-21
6095,서울,금천구,6,0,1,7,5,0,2019-12-21
6096,서울,노원구,1,0,2,3,3,0,2019-01-21
6097,서울,노원구,3,1,1,5,5,0,2019-02-21
6098,서울,노원구,2,0,1,3,3,0,2019-03-21
6099,서울,노원구,3,1,0,4,3,0,2019-04-21
6100,서울,노원구,1,0,1,2,2,0,2019-05-21
6101,서울,노원구,6,0,2,8,6,0,2019-06-21
6102,서울,노원구,8,0,1,9,6,0,2019-07-21
6103,서울,노원구,4,0,2,6,6,0,2019-08-21
6104,서울,노원구,3,0,3,6,4,0,2019-09-21
6105,서울,노원구,5,0,0,5,4,0,2019-10-21
6106,서울,노원구,4,0,1,5,5,0,2019-11-21
6107,서울,노원구,1,0,0,1,1,0,2019-12-21
6108,서울,도봉구,5,3,0,8,4,0,2019-01-21
6109,서울,도봉구,4,0,0,4,3,0,2019-02-21
6110,서울,도봉구,8,1,0,9,4,0,2019-03-21
6111,서울,도봉구,2,0,0,2,1,0,2019-04-21
6112,서울,도봉구,0,0,3,3,3,0,2019-05-21
6113,서울,도봉구,4,0,1,5,2,0,2019-06-21
6114,서울,도봉구,0,1,0,1,1,0,2019-07-21
6115,서울,도봉구,2,0,1,3,3,0,2019-08-21
6116,서울,도봉구,0,1,0,1,1,0,2019-09-21
6117,서울,도봉구,1,1,0,2,1,0,2019-10-21
6118,서울,도봉구,1,1,4,6,6,0,2019-11-21
6119,서울,도봉구,1,0,0,1,1,0,2019-12-21
6120,서울,동대문구,2,0,0,2,1,0,2019-01-21
6121,서울,동대문구,1,0,0,1,1,0,2019-02-21
6122,서울,동대문구,0,0,4,4,4,0,2019-03-21
6123,서울,동대문구,2,1,0,3,3,0,2019-04-21
6124,서울,동대문구,4,0,1,5,3,0,2019-05-21
6125,서울,동대문구,3,3,2,8,5,0,2019-06-21
6126,서울,동대문구,4,0,1,5,5,0,2019-07-21
6127,서울,동대문구,7,1,3,11,10,0,2019-08-21
6128,서울,동대문구,2,0,0,2,1,0,2019-09-21
6129,서울,동대문구,3,0,1,4,4,0,2019-10-21
6130,서울,동대문구,2,1,1,4,3,0,2019-11-21
6131,서울,동대문구,2,1,0,3,3,0,2019-12-21
6132,서울,동작구,0,0,0,0,0,0,2019-01-21
6133,서울,동작구,0,0,0,0,0,0,2019-02-21
6134,서울,동작구,1,0,1,2,2,0,2019-03-21
6135,서울,동작구,5,0,2,7,4,0,2019-04-21
6136,서울,동작구,1,0,0,1,1,0,2019-05-21
6137,서울,동작구,1,1,1,3,3,0,2019-06-21
6138,서울,동작구,2,0,0,2,2,0,2019-07-21
6139,서울,동작구,2,0,1,3,3,0,2019-08-21
6140,서울,동작구,2,2,2,6,6,1,2019-09-21
6141,서울,동작구,8,1,4,13,7,0,2019-10-21
6142,서울,동작구,4,0,0,4,4,0,2019-11-21
6143,서울,동작구,9,1,0,10,3,0,2019-12-21
6144,서울,마포구,4,0,0,4,3,0,2019-01-21
6145,서울,마포구,4,0,3,7,5,0,2019-02-21
6146,서울,마포구,6,0,2,8,8,0,2019-03-21
6147,서울,마포구,1,0,0,1,1,0,2019-04-21
6148,서울,마포구,3,0,1,4,4,0,2019-05-21
6149,서울,마포구,4,0,1,5,4,0,2019-06-21
6150,서울,마포구,4,0,2,6,6,0,2019-07-21
6151,서울,마포구,6,0,1,7,4,0,2019-08-21
6152,서울,마포구,3,4,3,10,5,0,2019-09-21
6153,서울,마포구,2,0,0,2,2,0,2019-10-21
6154,서울,마포구,2,0,1,3,3,0,2019-11-21
6155,서울,마포구,2,0,2,4,4,0,2019-12-21
6156,서울,서대문구,1,0,0,1,1,0,2019-01-21
6157,서울,서대문구,2,0,1,3,3,0,2019-02-21
6158,서울,서대문구,1,0,0,1,1,0,2019-03-21
6159,서울,서대문구,0,0,0,0,0,0,2019-04-21
6160,서울,서대문구,3,0,1,4,3,0,2019-05-21
6161,서울,서대문구,5,1,0,6,3,0,2019-06-21
6162,서울,서대문구,1,2,2,5,4,0,2019-07-21
6163,서울,서대문구,0,1,0,1,1,0,2019-08-21
6164,서울,서대문구,5,1,2,8,6,0,2019-09-21
6165,서울,서대문구,0,0,0,0,0,0,2019-10-21
6166,서울,서대문구,3,1,0,4,4,0,2019-11-21
6167,서울,서대문구,1,1,1,3,3,0,2019-12-21
6168,서울,서초구,11,1,5,17,12,0,2019-01-21
6169,서울,서초구,8,0,2,10,8,0,2019-02-21
6170,서울,서초구,13,0,5,18,12,0,2019-03-21
6171,서울,서초구,5,1,0,6,3,0,2019-04-21
6172,서울,서초구,12,0,3,15,11,0,2019-05-21
6173,서울,서초구,7,1,1,9,7,1,2019-06-21
6174,서울,서초구,2,0,0,2,2,0,2019-07-21
6175,서울,서초구,10,0,2,12,7,0,2019-08-21
6176,서울,서초구,4,1,2,7,6,0,2019-09-21
6177,서울,서초구,9,1,2,12,9,0,2019-10-21
6178,서울,서초구,7,4,4,15,12,0,2019-11-21
6179,서울,서초구,8,0,2,10,8,0,2019-12-21
6180,서울,성동구,0,0,0,0,0,0,2019-01-21
6181,서울,성동구,2,0,0,2,2,0,2019-02-21
6182,서울,성동구,2,0,0,2,1,0,2019-03-21
6183,서울,성동구,2,0,0,2,1,0,2019-04-21
6184,서울,성동구,1,0,2,3,3,0,2019-05-21
6185,서울,성동구,5,1,1,7,6,0,2019-06-21
6186,서울,성동구,0,0,0,0,0,0,2019-07-21
6187,서울,성동구,6,0,0,6,5,0,2019-08-21
6188,서울,성동구,2,0,0,2,1,0,2019-09-21
6189,서울,성동구,4,0,3,7,6,0,2019-10-21
6190,서울,성동구,2,0,0,2,2,0,2019-11-21
6191,서울,성동구,1,0,1,2,1,0,2019-12-21
6192,서울,성북구,1,0,1,2,2,0,2019-01-21
6193,서울,성북구,6,0,1,7,7,0,2019-02-21
6194,서울,성북구,5,0,3,8,3,0,2019-03-21
6195,서울,성북구,5,0,2,7,6,0,2019-04-21
6196,서울,성북구,6,1,2,9,7,0,2019-05-21
6197,서울,성북구,4,0,2,6,4,0,2019-06-21
6198,서울,성북구,3,0,1,4,3,0,2019-07-21
6199,서울,성북구,5,1,0,6,6,0,2019-08-21
6200,서울,성북구,7,2,0,9,6,0,2019-09-21
6201,서울,성북구,3,1,3,7,7,0,2019-10-21
6202,서울,성북구,2,0,4,6,6,0,2019-11-21
6203,서울,성북구,5,1,0,6,3,0,2019-12-21
6204,서울,송파구,8,2,1,11,9,0,2019-01-21
6205,서울,송파구,10,0,1,11,8,0,2019-02-21
6206,서울,송파구,7,0,2,9,6,0,2019-03-21
6207,서울,송파구,9,0,7,16,9,0,2019-04-21
6208,서울,송파구,19,0,2,21,9,0,2019-05-21
6209,서울,송파구,6,1,1,8,7,0,2019-06-21
6210,서울,송파구,5,0,0,5,3,0,2019-07-21
6211,서울,송파구,11,2,0,13,11,0,2019-08-21
6212,서울,송파구,11,0,3,14,8,0,2019-09-21
6213,서울,송파구,5,2,0,7,6,0,2019-10-21
6214,서울,송파구,10,1,1,12,10,0,2019-11-21
6215,서울,송파구,5,2,2,9,7,0,2019-12-21
6216,서울,양천구,1,0,1,2,2,0,2019-01-21
6217,서울,양천구,1,0,0,1,1,0,2019-02-21
6218,서울,양천구,6,1,2,9,4,0,2019-03-21
6219,서울,양천구,4,0,0,4,2,0,2019-04-21
6220,서울,양천구,5,1,0,6,5,0,2019-05-21
6221,서울,양천구,2,1,0,3,3,0,2019-06-21
6222,서울,양천구,0,0,1,1,1,0,2019-07-21
6223,서울,양천구,6,0,3,9,7,0,2019-08-21
6224,서울,양천구,4,0,0,4,3,0,2019-09-21
6225,서울,양천구,5,2,1,8,6,0,2019-10-21
6226,서울,양천구,2,1,1,4,4,0,2019-11-21
6227,서울,양천구,3,0,2,5,5,0,2019-12-21
6228,서울,영등포구,7,0,6,13,11,0,2019-01-21
6229,서울,영등포구,8,0,1,9,6,0,2019-02-21
6230,서울,영등포구,4,1,2,7,6,0,2019-03-21
6231,서울,영등포구,37,4,9,50,7,1,2019-04-21
6232,서울,영등포구,21,2,3,26,13,0,2019-05-21
6233,서울,영등포구,13,1,2,16,10,0,2019-06-21
6234,서울,영등포구,6,0,0,6,5,0,2019-07-21
6235,서울,영등포구,7,0,4,11,8,0,2019-08-21
6236,서울,영등포구,15,0,1,16,14,0,2019-09-21
6237,서울,영등포구,9,0,3,12,8,0,2019-10-21
6238,서울,영등포구,5,0,1,6,6,1,2019-11-21
6239,서울,영등포구,9,3,1,13,8,0,2019-12-21
6240,서울,용산구,3,0,1,4,4,0,2019-01-21
6241,서울,용산구,2,0,1,3,3,0,2019-02-21
6242,서울,용산구,6,1,2,9,7,0,2019-03-21
6243,서울,용산구,5,0,4,9,5,0,2019-04-21
6244,서울,용산구,0,0,0,0,0,0,2019-05-21
6245,서울,용산구,1,2,1,4,1,0,2019-06-21
6246,서울,용산구,3,0,0,3,2,0,2019-07-21
6247,서울,용산구,4,1,0,5,6,1,2019-08-21
6248,서울,용산구,2,0,1,3,3,0,2019-09-21
6249,서울,용산구,3,0,0,3,2,0,2019-10-21
6250,서울,용산구,3,0,1,4,4,0,2019-11-21
6251,서울,용산구,3,1,0,4,3,0,2019-12-21
6252,서울,은평구,2,0,0,2,2,0,2019-01-21
6253,서울,은평구,6,1,1,8,5,0,2019-02-21
6254,서울,은평구,2,0,0,2,2,0,2019-03-21
6255,서울,은평구,1,0,1,2,2,0,2019-04-21
6256,서울,은평구,2,0,0,2,2,0,2019-05-21
6257,서울,은평구,0,0,0,0,0,0,2019-06-21
6258,서울,은평구,1,0,0,1,1,0,2019-07-21
6259,서울,은평구,3,0,3,6,6,0,2019-08-21
6260,서울,은평구,1,0,0,1,1,0,2019-09-21
6261,서울,은평구,2,1,1,4,3,0,2019-10-21
6262,서울,은평구,6,0,2,8,6,0,2019-11-21
6263,서울,은평구,4,1,0,5,3,0,2019-12-21
6264,서울,종로구,3,0,0,3,3,0,2019-01-21
6265,서울,종로구,5,0,2,7,6,0,2019-02-21
6266,서울,종로구,1,0,0,1,1,0,2019-03-21
6267,서울,종로구,1,0,1,2,2,0,2019-04-21
6268,서울,종로구,3,1,0,4,2,0,2019-05-21
6269,서울,종로구,4,0,0,4,3,0,2019-06-21
6270,서울,종로구,1,0,0,1,1,0,2019-07-21
6271,서울,종로구,4,0,1,5,4,0,2019-08-21
6272,서울,종로구,4,0,3,7,6,0,2019-09-21
6273,서울,종로구,1,0,0,1,1,0,2019-10-21
6274,서울,종로구,1,0,1,2,2,0,2019-11-21
6275,서울,종로구,7,0,2,9,6,0,2019-12-21
6276,서울,중구,2,1,1,4,2,0,2019-01-21
6277,서울,중구,0,0,0,0,0,0,2019-02-21
6278,서울,중구,0,0,0,0,0,0,2019-03-21
6279,서울,중구,5,0,0,5,2,0,2019-04-21
6280,서울,중구,1,0,1,2,2,0,2019-05-21
6281,서울,중구,2,0,1,3,3,0,2019-06-21
6282,서울,중구,4,0,0,4,2,0,2019-07-21
6283,서울,중구,2,0,1,3,3,0,2019-08-21
6284,서울,중구,2,0,1,3,2,0,2019-09-21
6285,서울,중구,2,0,2,4,2,0,2019-10-21
6286,서울,중구,6,0,0,6,5,0,2019-11-21
6287,서울,중구,6,2,1,9,3,0,2019-12-21
6288,서울,중랑구,1,1,0,2,2,0,2019-01-21
6289,서울,중랑구,2,1,1,4,3,0,2019-02-21
6290,서울,중랑구,8,1,0,9,7,0,2019-03-21
6291,서울,중랑구,5,1,2,8,4,0,2019-04-21
6292,서울,중랑구,1,0,1,2,2,0,2019-05-21
6293,서울,중랑구,8,0,1,9,8,0,2019-06-21
6294,서울,중랑구,3,0,0,3,2,0,2019-07-21
6295,서울,중랑구,4,0,1,5,4,0,2019-08-21
6296,서울,중랑구,3,0,1,4,4,0,2019-09-21
6297,서울,중랑구,2,1,0,3,2,0,2019-10-21
6298,서울,중랑구,4,1,1,6,5,0,2019-11-21
6299,서울,중랑구,8,0,1,9,5,0,2019-12-21
6300,서울,강남구,10,2,3,15,13,1,2019-01-22
6301,서울,강남구,4,0,2,6,6,0,2019-02-22
6302,서울,강남구,12,0,1,13,9,0,2019-03-22
6303,서울,강남구,8,3,4,15,11,0,2019-04-22
6304,서울,강남구,7,3,3,13,10,0,2019-05-22
6305,서울,강남구,26,1,3,30,14,0,2019-06-22
6306,서울,강남구,15,4,3,22,15,0,2019-07-22
6307,서울,강남구,11,0,2,13,12,0,2019-08-22
6308,서울,강남구,7,1,4,12,6,0,2019-09-22
6309,서울,강남구,12,2,6,20,19,0,2019-10-22
6310,서울,강남구,15,3,0,18,12,0,2019-11-22
6311,서울,강남구,0,0,1,1,1,0,2019-12-22
6312,서울,강동구,5,0,2,7,7,0,2019-01-22
6313,서울,강동구,10,1,2,13,8,0,2019-02-22
6314,서울,강동구,5,0,1,6,5,0,2019-03-22
6315,서울,강동구,0,2,0,2,1,0,2019-04-22
6316,서울,강동구,7,0,0,7,5,0,2019-05-22
6317,서울,강동구,4,2,2,8,5,0,2019-06-22
6318,서울,강동구,5,0,4,9,5,0,2019-07-22
6319,서울,강동구,9,1,0,10,7,0,2019-08-22
6320,서울,강동구,1,0,3,4,3,0,2019-09-22
6321,서울,강동구,3,0,1,4,4,0,2019-10-22
6322,서울,강동구,7,0,0,7,5,0,2019-11-22
6323,서울,강동구,2,0,1,3,2,0,2019-12-22
6324,서울,강북구,3,0,0,3,2,0,2019-01-22
6325,서울,강북구,6,0,0,6,5,0,2019-02-22
6326,서울,강북구,2,0,2,4,4,0,2019-03-22
6327,서울,강북구,1,0,4,5,5,0,2019-04-22
6328,서울,강북구,7,0,1,8,4,0,2019-05-22
6329,서울,강북구,2,0,3,5,4,0,2019-06-22
6330,서울,강북구,3,0,0,3,2,0,2019-07-22
6331,서울,강북구,3,0,0,3,3,0,2019-08-22
6332,서울,강북구,6,1,0,7,4,0,2019-09-22
6333,서울,강북구,9,0,0,9,4,0,2019-10-22
6334,서울,강북구,1,0,0,1,1,0,2019-11-22
6335,서울,강북구,4,1,0,5,3,0,2019-12-22
6336,서울,강서구,5,1,1,7,7,0,2019-01-22
6337,서울,강서구,6,0,0,6,4,0,2019-02-22
6338,서울,강서구,4,0,0,4,4,0,2019-03-22
6339,서울,강서구,5,0,0,5,3,0,2019-04-22
6340,서울,강서구,4,0,0,4,4,0,2019-05-22
6341,서울,강서구,4,0,0,4,3,0,2019-06-22
6342,서울,강서구,5,2,0,7,5,0,2019-07-22
6343,서울,강서구,10,0,1,11,9,0,2019-08-22
6344,서울,강서구,4,1,3,8,5,0,2019-09-22
6345,서울,강서구,4,0,2,6,5,0,2019-10-22
6346,서울,강서구,3,2,2,7,6,0,2019-11-22
6347,서울,강서구,6,0,3,9,6,0,2019-12-22
6348,서울,관악구,0,0,2,2,2,0,2019-01-22
6349,서울,관악구,4,0,0,4,4,0,2019-02-22
6350,서울,관악구,4,0,0,4,3,0,2019-03-22
6351,서울,관악구,0,0,0,0,0,0,2019-04-22
6352,서울,관악구,2,0,1,3,3,0,2019-05-22
6353,서울,관악구,4,0,0,4,4,0,2019-06-22
6354,서울,관악구,1,0,1,2,2,0,2019-07-22
6355,서울,관악구,5,1,1,7,6,0,2019-08-22
6356,서울,관악구,8,0,0,8,6,0,2019-09-22
6357,서울,관악구,0,0,0,0,0,0,2019-10-22
6358,서울,관악구,0,1,0,1,1,0,2019-11-22
6359,서울,관악구,7,0,0,7,4,0,2019-12-22
6360,서울,광진구,0,0,2,2,2,0,2019-01-22
6361,서울,광진구,2,0,1,3,2,0,2019-02-22
6362,서울,광진구,2,0,0,2,2,0,2019-03-22
6363,서울,광진구,1,0,0,1,1,0,2019-04-22
6364,서울,광진구,2,0,0,2,1,0,2019-05-22
6365,서울,광진구,2,0,1,3,3,0,2019-06-22
6366,서울,광진구,3,0,1,4,2,0,2019-07-22
6367,서울,광진구,4,0,0,4,2,0,2019-08-22
6368,서울,광진구,1,0,3,4,3,0,2019-09-22
6369,서울,광진구,3,0,1,4,3,0,2019-10-22
6370,서울,광진구,3,1,0,4,2,0,2019-11-22
6371,서울,광진구,0,1,4,5,3,0,2019-12-22
6372,서울,구로구,3,1,2,6,4,0,2019-01-22
6373,서울,구로구,1,0,1,2,2,0,2019-02-22
6374,서울,구로구,2,0,1,3,3,0,2019-03-22
6375,서울,구로구,10,0,3,13,11,0,2019-04-22
6376,서울,구로구,4,0,3,7,7,0,2019-05-22
6377,서울,구로구,4,0,2,6,6,0,2019-06-22
6378,서울,구로구,2,0,2,4,4,0,2019-07-22
6379,서울,구로구,5,0,1,6,5,0,2019-08-22
6380,서울,구로구,3,1,3,7,5,0,2019-09-22
6381,서울,구로구,3,5,3,11,7,0,2019-10-22
6382,서울,구로구,6,0,1,7,6,0,2019-11-22
6383,서울,구로구,2,0,0,2,1,0,2019-12-22
6384,서울,금천구,0,0,0,0,1,1,2019-01-22
6385,서울,금천구,7,1,0,8,3,0,2019-02-22
6386,서울,금천구,0,0,0,0,0,0,2019-03-22
6387,서울,금천구,2,0,4,6,6,0,2019-04-22
6388,서울,금천구,0,0,0,0,0,0,2019-05-22
6389,서울,금천구,3,0,1,4,3,0,2019-06-22
6390,서울,금천구,8,0,1,9,4,0,2019-07-22
6391,서울,금천구,2,1,0,3,3,0,2019-08-22
6392,서울,금천구,0,0,1,1,1,0,2019-09-22
6393,서울,금천구,2,0,0,2,2,0,2019-10-22
6394,서울,금천구,1,0,0,1,1,0,2019-11-22
6395,서울,금천구,5,1,2,8,3,0,2019-12-22
6396,서울,노원구,2,0,0,2,2,0,2019-01-22
6397,서울,노원구,4,0,3,7,7,0,2019-02-22
6398,서울,노원구,3,1,1,5,4,0,2019-03-22
6399,서울,노원구,5,0,2,7,6,0,2019-04-22
6400,서울,노원구,7,1,1,9,6,0,2019-05-22
6401,서울,노원구,6,0,1,7,3,0,2019-06-22
6402,서울,노원구,7,0,0,7,7,1,2019-07-22
6403,서울,노원구,5,1,1,7,6,0,2019-08-22
6404,서울,노원구,7,1,0,8,4,0,2019-09-22
6405,서울,노원구,6,1,1,8,7,0,2019-10-22
6406,서울,노원구,7,1,0,8,7,0,2019-11-22
6407,서울,노원구,4,0,0,4,2,0,2019-12-22
6408,서울,도봉구,3,0,1,4,4,0,2019-01-22
6409,서울,도봉구,1,0,0,1,1,0,2019-02-22
6410,서울,도봉구,2,2,1,5,4,0,2019-03-22
6411,서울,도봉구,2,0,0,2,2,0,2019-04-22
6412,서울,도봉구,1,0,1,2,2,0,2019-05-22
6413,서울,도봉구,1,1,0,2,2,0,2019-06-22
6414,서울,도봉구,0,0,0,0,0,0,2019-07-22
6415,서울,도봉구,1,1,1,3,2,0,2019-08-22
6416,서울,도봉구,0,0,2,2,2,0,2019-09-22
6417,서울,도봉구,2,0,0,2,2,0,2019-10-22
6418,서울,도봉구,2,1,0,3,3,0,2019-11-22
6419,서울,도봉구,0,0,0,0,0,0,2019-12-22
6420,서울,동대문구,0,0,2,2,2,0,2019-01-22
6421,서울,동대문구,7,1,4,12,6,0,2019-02-22
6422,서울,동대문구,6,0,0,6,3,0,2019-03-22
6423,서울,동대문구,2,0,4,6,6,0,2019-04-22
6424,서울,동대문구,4,1,2,7,5,0,2019-05-22
6425,서울,동대문구,4,0,2,6,5,0,2019-06-22
6426,서울,동대문구,5,1,0,6,4,0,2019-07-22
6427,서울,동대문구,9,0,2,11,8,0,2019-08-22
6428,서울,동대문구,3,1,0,4,4,1,2019-09-22
6429,서울,동대문구,6,1,1,8,8,0,2019-10-22
6430,서울,동대문구,4,0,1,5,4,0,2019-11-22
6431,서울,동대문구,1,0,0,1,1,0,2019-12-22
6432,서울,동작구,1,0,0,1,1,0,2019-01-22
6433,서울,동작구,0,1,3,4,4,0,2019-02-22
6434,서울,동작구,7,1,0,8,5,0,2019-03-22
6435,서울,동작구,1,0,0,1,1,0,2019-04-22
6436,서울,동작구,1,0,3,4,3,0,2019-05-22
6437,서울,동작구,7,0,0,7,3,0,2019-06-22
6438,서울,동작구,3,0,3,6,5,0,2019-07-22
6439,서울,동작구,6,1,1,8,6,0,2019-08-22
6440,서울,동작구,4,0,2,6,4,0,2019-09-22
6441,서울,동작구,5,0,5,10,6,0,2019-10-22
6442,서울,동작구,3,0,1,4,4,0,2019-11-22
6443,서울,동작구,1,0,0,1,1,0,2019-12-22
6444,서울,마포구,2,1,2,5,5,0,2019-01-22
6445,서울,마포구,5,1,1,7,5,0,2019-02-22
6446,서울,마포구,1,0,0,1,1,0,2019-03-22
6447,서울,마포구,6,0,0,6,4,0,2019-04-22
6448,서울,마포구,6,0,2,8,5,0,2019-05-22
6449,서울,마포구,2,2,2,6,5,0,2019-06-22
6450,서울,마포구,6,1,4,11,7,0,2019-07-22
6451,서울,마포구,8,1,0,9,5,0,2019-08-22
6452,서울,마포구,7,1,1,9,5,0,2019-09-22
6453,서울,마포구,8,0,2,10,6,0,2019-10-22
6454,서울,마포구,4,1,0,5,4,0,2019-11-22
6455,서울,마포구,5,1,0,6,4,0,2019-12-22
6456,서울,서대문구,0,1,2,3,2,0,2019-01-22
6457,서울,서대문구,1,0,1,2,2,0,2019-02-22
6458,서울,서대문구,1,0,1,2,2,0,2019-03-22
6459,서울,서대문구,2,1,2,5,4,0,2019-04-22
6460,서울,서대문구,3,2,2,7,6,0,2019-05-22
6461,서울,서대문구,6,0,1,7,4,0,2019-06-22
6462,서울,서대문구,8,7,1,16,4,0,2019-07-22
6463,서울,서대문구,1,0,0,1,1,0,2019-08-22
6464,서울,서대문구,4,2,0,6,2,0,2019-09-22
6465,서울,서대문구,1,0,1,2,2,0,2019-10-22
6466,서울,서대문구,2,1,1,4,4,0,2019-11-22
6467,서울,서대문구,2,2,0,4,4,0,2019-12-22
6468,서울,서초구,16,2,4,22,11,0,2019-01-22
6469,서울,서초구,3,0,0,3,3,0,2019-02-22
6470,서울,서초구,8,3,2,13,10,0,2019-03-22
6471,서울,서초구,14,0,0,14,6,0,2019-04-22
6472,서울,서초구,4,1,2,7,6,0,2019-05-22
6473,서울,서초구,15,1,1,17,10,0,2019-06-22
6474,서울,서초구,9,3,4,16,10,0,2019-07-22
6475,서울,서초구,5,1,5,11,10,0,2019-08-22
6476,서울,서초구,10,0,0,10,9,0,2019-09-22
6477,서울,서초구,8,0,2,10,6,0,2019-10-22
6478,서울,서초구,7,1,3,11,8,0,2019-11-22
6479,서울,서초구,10,2,3,15,8,1,2019-12-22
6480,서울,성동구,2,0,2,4,3,0,2019-01-22
6481,서울,성동구,6,1,0,7,2,0,2019-02-22
6482,서울,성동구,2,1,0,3,3,0,2019-03-22
6483,서울,성동구,1,0,2,3,3,0,2019-04-22
6484,서울,성동구,1,1,2,4,4,0,2019-05-22
6485,서울,성동구,0,0,1,1,1,0,2019-06-22
6486,서울,성동구,4,0,0,4,4,0,2019-07-22
6487,서울,성동구,3,0,1,4,4,0,2019-08-22
6488,서울,성동구,5,0,1,6,4,0,2019-09-22
6489,서울,성동구,5,1,0,6,6,0,2019-10-22
6490,서울,성동구,3,0,0,3,3,0,2019-11-22
6491,서울,성동구,4,0,0,4,3,0,2019-12-22
6492,서울,성북구,2,2,0,4,4,0,2019-01-22
6493,서울,성북구,16,1,2,19,8,0,2019-02-22
6494,서울,성북구,1,1,1,3,3,0,2019-03-22
6495,서울,성북구,5,0,1,6,5,0,2019-04-22
6496,서울,성북구,3,0,0,3,3,0,2019-05-22
6497,서울,성북구,1,0,2,3,3,0,2019-06-22
6498,서울,성북구,3,1,0,4,2,0,2019-07-22
6499,서울,성북구,7,0,2,9,4,0,2019-08-22
6500,서울,성북구,2,0,0,2,2,0,2019-09-22
6501,서울,성북구,4,1,1,6,5,0,2019-10-22
6502,서울,성북구,8,0,1,9,9,0,2019-11-22
6503,서울,성북구,4,0,2,6,3,0,2019-12-22
6504,서울,송파구,3,1,3,7,7,0,2019-01-22
6505,서울,송파구,7,1,2,10,7,0,2019-02-22
6506,서울,송파구,14,3,3,20,14,0,2019-03-22
6507,서울,송파구,5,2,5,12,8,0,2019-04-22
6508,서울,송파구,9,1,0,10,7,0,2019-05-22
6509,서울,송파구,7,1,6,14,11,0,2019-06-22
6510,서울,송파구,8,2,3,13,10,0,2019-07-22
6511,서울,송파구,11,1,2,14,9,0,2019-08-22
6512,서울,송파구,8,3,1,12,9,0,2019-09-22
6513,서울,송파구,13,1,1,15,12,0,2019-10-22
6514,서울,송파구,9,0,3,12,11,0,2019-11-22
6515,서울,송파구,11,0,2,13,5,0,2019-12-22
6516,서울,양천구,11,0,2,13,7,0,2019-01-22
6517,서울,양천구,9,1,1,11,7,0,2019-02-22
6518,서울,양천구,2,1,3,6,4,0,2019-03-22
6519,서울,양천구,3,0,1,4,3,0,2019-04-22
6520,서울,양천구,3,0,3,6,5,0,2019-05-22
6521,서울,양천구,7,2,1,10,6,0,2019-06-22
6522,서울,양천구,3,0,2,5,3,0,2019-07-22
6523,서울,양천구,7,0,0,7,5,0,2019-08-22
6524,서울,양천구,2,0,0,2,1,0,2019-09-22
6525,서울,양천구,5,2,0,7,4,0,2019-10-22
6526,서울,양천구,7,2,1,10,7,0,2019-11-22
6527,서울,양천구,2,1,1,4,3,0,2019-12-22
6528,서울,영등포구,3,1,2,6,5,0,2019-01-22
6529,서울,영등포구,11,2,0,13,7,0,2019-02-22
6530,서울,영등포구,4,2,0,6,4,0,2019-03-22
6531,서울,영등포구,1,2,3,6,6,0,2019-04-22
6532,서울,영등포구,17,3,2,22,13,0,2019-05-22
6533,서울,영등포구,11,2,2,15,7,0,2019-06-22
6534,서울,영등포구,13,1,1,15,12,0,2019-07-22
6535,서울,영등포구,2,2,1,5,5,0,2019-08-22
6536,서울,영등포구,8,2,1,11,6,0,2019-09-22
6537,서울,영등포구,11,1,3,15,10,0,2019-10-22
6538,서울,영등포구,3,1,2,6,6,0,2019-11-22
6539,서울,영등포구,3,1,1,5,5,0,2019-12-22
6540,서울,용산구,5,0,1,6,6,0,2019-01-22
6541,서울,용산구,6,1,1,8,7,0,2019-02-22
6542,서울,용산구,2,0,1,3,2,0,2019-03-22
6543,서울,용산구,4,0,0,4,2,0,2019-04-22
6544,서울,용산구,5,0,2,7,4,0,2019-05-22
6545,서울,용산구,7,0,0,7,6,0,2019-06-22
6546,서울,용산구,6,0,2,8,6,0,2019-07-22
6547,서울,용산구,0,0,2,2,2,0,2019-08-22
6548,서울,용산구,6,0,2,8,5,0,2019-09-22
6549,서울,용산구,1,0,0,1,1,0,2019-10-22
6550,서울,용산구,4,0,0,4,3,0,2019-11-22
6551,서울,용산구,4,0,1,5,4,0,2019-12-22
6552,서울,은평구,2,0,0,2,1,0,2019-01-22
6553,서울,은평구,3,0,2,5,5,0,2019-02-22
6554,서울,은평구,0,0,0,0,0,0,2019-03-22
6555,서울,은평구,0,0,0,0,0,0,2019-04-22
6556,서울,은평구,0,0,2,2,2,0,2019-05-22
6557,서울,은평구,7,0,1,8,7,0,2019-06-22
6558,서울,은평구,6,0,2,8,4,0,2019-07-22
6559,서울,은평구,3,1,1,5,4,0,2019-08-22
6560,서울,은평구,1,0,0,1,1,0,2019-09-22
6561,서울,은평구,2,0,0,2,2,0,2019-10-22
6562,서울,은평구,4,0,3,7,5,0,2019-11-22
6563,서울,은평구,0,0,0,0,0,0,2019-12-22
6564,서울,종로구,10,0,1,11,5,0,2019-01-22
6565,서울,종로구,4,0,0,4,3,0,2019-02-22
6566,서울,종로구,2,0,0,2,2,0,2019-03-22
6567,서울,종로구,1,1,0,2,1,0,2019-04-22
6568,서울,종로구,6,1,0,7,5,0,2019-05-22
6569,서울,종로구,1,1,1,3,3,0,2019-06-22
6570,서울,종로구,1,0,1,2,1,0,2019-07-22
6571,서울,종로구,4,5,0,9,5,0,2019-08-22
6572,서울,종로구,0,1,0,1,1,0,2019-09-22
6573,서울,종로구,1,0,1,2,2,0,2019-10-22
6574,서울,종로구,2,0,1,3,3,0,2019-11-22
6575,서울,종로구,2,1,0,3,2,0,2019-12-22
6576,서울,중구,0,0,0,0,0,0,2019-01-22
6577,서울,중구,8,2,1,11,3,0,2019-02-22
6578,서울,중구,1,0,1,2,2,0,2019-03-22
6579,서울,중구,3,0,1,4,2,0,2019-04-22
6580,서울,중구,1,0,1,2,1,0,2019-05-22
6581,서울,중구,2,0,1,3,2,0,2019-06-22
6582,서울,중구,1,1,1,3,3,0,2019-07-22
6583,서울,중구,3,0,0,3,3,0,2019-08-22
6584,서울,중구,0,3,0,3,1,0,2019-09-22
6585,서울,중구,4,0,1,5,4,0,2019-10-22
6586,서울,중구,5,0,2,7,4,0,2019-11-22
6587,서울,중구,5,4,0,9,2,0,2019-12-22
6588,서울,중랑구,2,0,2,4,1,0,2019-01-22
6589,서울,중랑구,1,0,2,3,3,0,2019-02-22
6590,서울,중랑구,2,0,2,4,4,0,2019-03-22
6591,서울,중랑구,9,0,2,11,9,0,2019-04-22
6592,서울,중랑구,2,2,0,4,4,0,2019-05-22
6593,서울,중랑구,0,0,1,1,1,0,2019-06-22
6594,서울,중랑구,8,0,2,10,9,0,2019-07-22
6595,서울,중랑구,3,0,4,7,4,0,2019-08-22
6596,서울,중랑구,3,0,1,4,4,0,2019-09-22
6597,서울,중랑구,6,0,2,8,5,0,2019-10-22
6598,서울,중랑구,6,0,0,6,5,0,2019-11-22
6599,서울,중랑구,1,1,2,4,3,0,2019-12-22
6600,서울,강남구,13,5,0,18,12,0,2019-01-23
6601,서울,강남구,13,2,4,19,12,0,2019-02-23
6602,서울,강남구,11,0,2,13,10,0,2019-03-23
6603,서울,강남구,8,0,1,9,8,0,2019-04-23
6604,서울,강남구,15,0,1,16,14,0,2019-05-23
6605,서울,강남구,9,1,2,12,6,0,2019-06-23
6606,서울,강남구,9,0,2,11,9,0,2019-07-23
6607,서울,강남구,11,2,3,16,13,0,2019-08-23
6608,서울,강남구,6,2,4,12,9,0,2019-09-23
6609,서울,강남구,5,3,1,9,9,0,2019-10-23
6610,서울,강남구,8,1,2,11,8,0,2019-11-23
6611,서울,강남구,5,0,2,7,6,0,2019-12-23
6612,서울,강동구,3,0,2,5,4,0,2019-01-23
6613,서울,강동구,3,0,0,3,2,0,2019-02-23
6614,서울,강동구,6,0,4,10,7,0,2019-03-23
6615,서울,강동구,2,0,1,3,2,0,2019-04-23
6616,서울,강동구,5,1,1,7,5,0,2019-05-23
6617,서울,강동구,11,2,2,15,7,0,2019-06-23
6618,서울,강동구,3,1,1,5,5,0,2019-07-23
6619,서울,강동구,1,1,2,4,4,0,2019-08-23
6620,서울,강동구,2,0,4,6,3,0,2019-09-23
6621,서울,강동구,2,6,7,15,7,0,2019-10-23
6622,서울,강동구,5,2,3,10,7,0,2019-11-23
6623,서울,강동구,3,1,2,6,5,0,2019-12-23
6624,서울,강북구,3,0,2,5,4,0,2019-01-23
6625,서울,강북구,0,0,0,0,0,0,2019-02-23
6626,서울,강북구,5,3,1,9,7,1,2019-03-23
6627,서울,강북구,5,1,0,6,3,0,2019-04-23
6628,서울,강북구,10,0,1,11,4,0,2019-05-23
6629,서울,강북구,6,0,1,7,5,0,2019-06-23
6630,서울,강북구,2,0,2,4,4,0,2019-07-23
6631,서울,강북구,5,0,1,6,6,0,2019-08-23
6632,서울,강북구,5,0,1,6,4,0,2019-09-23
6633,서울,강북구,1,0,1,2,2,1,2019-10-23
6634,서울,강북구,5,1,3,9,5,0,2019-11-23
6635,서울,강북구,1,0,0,1,1,0,2019-12-23
6636,서울,강서구,1,1,0,2,2,0,2019-01-23
6637,서울,강서구,5,0,1,6,6,0,2019-02-23
6638,서울,강서구,9,1,1,11,5,0,2019-03-23
6639,서울,강서구,7,0,2,9,8,0,2019-04-23
6640,서울,강서구,8,1,0,9,7,0,2019-05-23
6641,서울,강서구,8,1,0,9,3,0,2019-06-23
6642,서울,강서구,3,0,2,5,5,0,2019-07-23
6643,서울,강서구,6,0,1,7,5,0,2019-08-23
6644,서울,강서구,3,0,2,5,4,0,2019-09-23
6645,서울,강서구,4,0,2,6,6,1,2019-10-23
6646,서울,강서구,6,0,0,6,4,0,2019-11-23
6647,서울,강서구,4,0,1,5,5,0,2019-12-23
6648,서울,관악구,3,1,0,4,4,0,2019-01-23
6649,서울,관악구,0,0,3,3,3,0,2019-02-23
6650,서울,관악구,5,4,0,9,7,0,2019-03-23
6651,서울,관악구,8,0,0,8,5,0,2019-04-23
6652,서울,관악구,3,0,2,5,3,0,2019-05-23
6653,서울,관악구,2,0,4,6,5,0,2019-06-23
6654,서울,관악구,5,1,1,7,6,0,2019-07-23
6655,서울,관악구,1,0,0,1,1,0,2019-08-23
6656,서울,관악구,4,0,4,8,6,0,2019-09-23
6657,서울,관악구,2,0,1,3,2,0,2019-10-23
6658,서울,관악구,5,1,0,6,4,0,2019-11-23
6659,서울,관악구,3,1,2,6,4,0,2019-12-23
6660,서울,광진구,0,0,0,0,0,0,2019-01-23
6661,서울,광진구,2,0,1,3,2,0,2019-02-23
6662,서울,광진구,4,0,3,7,7,0,2019-03-23
6663,서울,광진구,9,0,3,12,4,0,2019-04-23
6664,서울,광진구,2,0,1,3,2,0,2019-05-23
6665,서울,광진구,2,0,1,3,3,0,2019-06-23
6666,서울,광진구,4,0,0,4,4,0,2019-07-23
6667,서울,광진구,1,0,0,1,1,0,2019-08-23
6668,서울,광진구,5,0,4,9,6,0,2019-09-23
6669,서울,광진구,4,0,1,5,5,0,2019-10-23
6670,서울,광진구,1,0,2,3,3,0,2019-11-23
6671,서울,광진구,2,0,2,4,4,0,2019-12-23
6672,서울,구로구,0,0,0,0,0,0,2019-01-23
6673,서울,구로구,4,0,0,4,3,0,2019-02-23
6674,서울,구로구,12,5,3,20,9,0,2019-03-23
6675,서울,구로구,6,0,3,9,6,0,2019-04-23
6676,서울,구로구,3,0,1,4,2,0,2019-05-23
6677,서울,구로구,3,0,0,3,2,0,2019-06-23
6678,서울,구로구,8,1,1,10,5,0,2019-07-23
6679,서울,구로구,3,2,1,6,4,0,2019-08-23
6680,서울,구로구,7,0,1,8,6,0,2019-09-23
6681,서울,구로구,4,0,2,6,4,0,2019-10-23
6682,서울,구로구,5,0,0,5,4,0,2019-11-23
6683,서울,구로구,8,0,4,12,8,0,2019-12-23
6684,서울,금천구,1,1,0,2,2,0,2019-01-23
6685,서울,금천구,2,0,1,3,2,0,2019-02-23
6686,서울,금천구,3,0,0,3,2,0,2019-03-23
6687,서울,금천구,5,0,0,5,4,0,2019-04-23
6688,서울,금천구,3,1,0,4,3,0,2019-05-23
6689,서울,금천구,0,0,2,2,2,0,2019-06-23
6690,서울,금천구,3,0,0,3,2,0,2019-07-23
6691,서울,금천구,7,1,3,11,8,0,2019-08-23
6692,서울,금천구,1,0,0,1,1,0,2019-09-23
6693,서울,금천구,0,0,1,1,1,0,2019-10-23
6694,서울,금천구,1,0,2,3,2,0,2019-11-23
6695,서울,금천구,2,0,1,3,3,0,2019-12-23
6696,서울,노원구,6,0,2,8,6,0,2019-01-23
6697,서울,노원구,3,1,1,5,4,0,2019-02-23
6698,서울,노원구,2,0,2,4,4,0,2019-03-23
6699,서울,노원구,2,0,0,2,2,0,2019-04-23
6700,서울,노원구,5,0,2,7,6,0,2019-05-23
6701,서울,노원구,4,0,2,6,4,0,2019-06-23
6702,서울,노원구,3,0,0,3,3,0,2019-07-23
6703,서울,노원구,1,0,3,4,3,0,2019-08-23
6704,서울,노원구,4,0,1,5,5,0,2019-09-23
6705,서울,노원구,4,0,0,4,5,1,2019-10-23
6706,서울,노원구,6,1,1,8,7,0,2019-11-23
6707,서울,노원구,11,2,3,16,13,0,2019-12-23
6708,서울,도봉구,0,0,1,1,1,0,2019-01-23
6709,서울,도봉구,3,0,0,3,3,0,2019-02-23
6710,서울,도봉구,4,0,0,4,3,0,2019-03-23
6711,서울,도봉구,1,0,1,2,2,0,2019-04-23
6712,서울,도봉구,1,0,1,2,2,0,2019-05-23
6713,서울,도봉구,5,0,1,6,2,0,2019-06-23
6714,서울,도봉구,1,0,0,1,1,0,2019-07-23
6715,서울,도봉구,4,0,2,6,4,0,2019-08-23
6716,서울,도봉구,0,0,1,1,1,0,2019-09-23
6717,서울,도봉구,1,1,0,2,2,0,2019-10-23
6718,서울,도봉구,0,0,1,1,1,0,2019-11-23
6719,서울,도봉구,0,0,0,0,0,0,2019-12-23
6720,서울,동대문구,1,0,0,1,1,0,2019-01-23
6721,서울,동대문구,8,0,2,10,5,0,2019-02-23
6722,서울,동대문구,4,0,2,6,4,0,2019-03-23
6723,서울,동대문구,7,0,0,7,6,0,2019-04-23
6724,서울,동대문구,6,0,0,6,4,0,2019-05-23
6725,서울,동대문구,3,0,2,5,4,0,2019-06-23
6726,서울,동대문구,1,0,3,4,4,0,2019-07-23
6727,서울,동대문구,7,1,2,10,9,0,2019-08-23
6728,서울,동대문구,2,0,2,4,4,0,2019-09-23
6729,서울,동대문구,1,1,0,2,1,0,2019-10-23
6730,서울,동대문구,7,0,3,10,8,0,2019-11-23
6731,서울,동대문구,10,2,3,15,10,0,2019-12-23
6732,서울,동작구,2,0,1,3,3,0,2019-01-23
6733,서울,동작구,4,3,4,11,8,0,2019-02-23
6734,서울,동작구,4,2,3,9,6,0,2019-03-23
6735,서울,동작구,2,0,1,3,3,0,2019-04-23
6736,서울,동작구,7,1,2,10,8,0,2019-05-23
6737,서울,동작구,0,0,0,0,0,0,2019-06-23
6738,서울,동작구,8,0,0,8,5,0,2019-07-23
6739,서울,동작구,1,0,0,1,1,0,2019-08-23
6740,서울,동작구,3,2,0,5,5,0,2019-09-23
6741,서울,동작구,2,0,0,2,2,0,2019-10-23
6742,서울,동작구,9,0,0,9,5,0,2019-11-23
6743,서울,동작구,5,0,1,6,4,0,2019-12-23
6744,서울,마포구,0,1,1,2,2,0,2019-01-23
6745,서울,마포구,4,1,2,7,6,0,2019-02-23
6746,서울,마포구,4,0,1,5,4,0,2019-03-23
6747,서울,마포구,2,0,1,3,3,0,2019-04-23
6748,서울,마포구,2,0,0,2,2,0,2019-05-23
6749,서울,마포구,2,1,1,4,3,0,2019-06-23
6750,서울,마포구,5,0,2,7,3,0,2019-07-23
6751,서울,마포구,8,1,1,10,4,0,2019-08-23
6752,서울,마포구,4,0,1,5,3,0,2019-09-23
6753,서울,마포구,2,0,0,2,2,0,2019-10-23
6754,서울,마포구,6,2,0,8,6,0,2019-11-23
6755,서울,마포구,1,0,1,2,2,0,2019-12-23
6756,서울,서대문구,2,0,3,5,4,0,2019-01-23
6757,서울,서대문구,7,2,0,9,5,0,2019-02-23
6758,서울,서대문구,6,1,0,7,5,0,2019-03-23
6759,서울,서대문구,8,0,3,11,6,0,2019-04-23
6760,서울,서대문구,4,6,0,10,6,0,2019-05-23
6761,서울,서대문구,6,2,3,11,5,0,2019-06-23
6762,서울,서대문구,3,2,0,5,5,0,2019-07-23
6763,서울,서대문구,4,1,0,5,5,0,2019-08-23
6764,서울,서대문구,2,0,1,3,3,0,2019-09-23
6765,서울,서대문구,44,2,9,55,3,0,2019-10-23
6766,서울,서대문구,7,2,1,10,5,0,2019-11-23
6767,서울,서대문구,3,2,0,5,5,0,2019-12-23
6768,서울,서초구,6,1,4,11,8,0,2019-01-23
6769,서울,서초구,13,1,0,14,8,0,2019-02-23
6770,서울,서초구,8,1,0,9,6,0,2019-03-23
6771,서울,서초구,3,1,2,6,5,0,2019-04-23
6772,서울,서초구,17,0,0,17,11,0,2019-05-23
6773,서울,서초구,7,2,0,9,5,0,2019-06-23
6774,서울,서초구,4,0,0,4,2,0,2019-07-23
6775,서울,서초구,16,0,1,17,9,0,2019-08-23
6776,서울,서초구,5,1,0,6,6,2,2019-09-23
6777,서울,서초구,3,0,2,5,5,0,2019-10-23
6778,서울,서초구,15,0,1,16,11,0,2019-11-23
6779,서울,서초구,10,0,1,11,7,0,2019-12-23
6780,서울,성동구,2,0,0,2,2,0,2019-01-23
6781,서울,성동구,6,0,2,8,3,0,2019-02-23
6782,서울,성동구,4,0,1,5,4,0,2019-03-23
6783,서울,성동구,7,1,1,9,6,0,2019-04-23
6784,서울,성동구,2,0,0,2,2,0,2019-05-23
6785,서울,성동구,1,0,3,4,2,0,2019-06-23
6786,서울,성동구,2,0,0,2,2,0,2019-07-23
6787,서울,성동구,3,0,2,5,2,0,2019-08-23
6788,서울,성동구,3,0,0,3,2,0,2019-09-23
6789,서울,성동구,8,0,1,9,7,1,2019-10-23
6790,서울,성동구,1,0,0,1,1,0,2019-11-23
6791,서울,성동구,2,0,1,3,3,0,2019-12-23
6792,서울,성북구,2,0,0,2,2,0,2019-01-23
6793,서울,성북구,5,0,3,8,6,0,2019-02-23
6794,서울,성북구,3,0,2,5,4,0,2019-03-23
6795,서울,성북구,1,0,0,1,1,0,2019-04-23
6796,서울,성북구,3,1,1,5,4,0,2019-05-23
6797,서울,성북구,2,0,1,3,3,0,2019-06-23
6798,서울,성북구,3,0,1,4,3,0,2019-07-23
6799,서울,성북구,5,2,1,8,5,0,2019-08-23
6800,서울,성북구,5,0,0,5,3,0,2019-09-23
6801,서울,성북구,7,1,2,10,6,0,2019-10-23
6802,서울,성북구,4,2,5,11,9,0,2019-11-23
6803,서울,성북구,1,0,1,2,2,0,2019-12-23
6804,서울,송파구,14,1,3,18,11,0,2019-01-23
6805,서울,송파구,6,2,4,12,8,0,2019-02-23
6806,서울,송파구,11,0,2,13,11,0,2019-03-23
6807,서울,송파구,1,0,1,2,2,0,2019-04-23
6808,서울,송파구,10,1,1,12,10,0,2019-05-23
6809,서울,송파구,3,1,0,4,4,0,2019-06-23
6810,서울,송파구,7,1,2,10,7,0,2019-07-23
6811,서울,송파구,3,0,1,4,3,0,2019-08-23
6812,서울,송파구,2,1,3,6,6,0,2019-09-23
6813,서울,송파구,13,2,2,17,10,1,2019-10-23
6814,서울,송파구,6,0,2,8,6,0,2019-11-23
6815,서울,송파구,6,0,2,8,4,0,2019-12-23
6816,서울,양천구,3,0,2,5,5,0,2019-01-23
6817,서울,양천구,2,0,0,2,2,0,2019-02-23
6818,서울,양천구,2,4,0,6,3,0,2019-03-23
6819,서울,양천구,3,1,1,5,3,0,2019-04-23
6820,서울,양천구,1,0,2,3,3,0,2019-05-23
6821,서울,양천구,5,2,2,9,6,0,2019-06-23
6822,서울,양천구,11,1,0,12,7,0,2019-07-23
6823,서울,양천구,5,0,2,7,7,0,2019-08-23
6824,서울,양천구,6,0,2,8,6,0,2019-09-23
6825,서울,양천구,2,0,0,2,2,0,2019-10-23
6826,서울,양천구,3,0,2,5,4,0,2019-11-23
6827,서울,양천구,5,0,1,6,3,0,2019-12-23
6828,서울,영등포구,5,3,3,11,8,0,2019-01-23
6829,서울,영등포구,7,1,2,10,7,0,2019-02-23
6830,서울,영등포구,7,1,0,8,6,0,2019-03-23
6831,서울,영등포구,8,3,2,13,8,0,2019-04-23
6832,서울,영등포구,5,1,0,6,4,0,2019-05-23
6833,서울,영등포구,5,0,0,5,5,0,2019-06-23
6834,서울,영등포구,5,1,0,6,6,0,2019-07-23
6835,서울,영등포구,7,1,2,10,9,0,2019-08-23
6836,서울,영등포구,18,2,2,22,12,0,2019-09-23
6837,서울,영등포구,5,0,2,7,6,0,2019-10-23
6838,서울,영등포구,9,2,1,12,6,0,2019-11-23
6839,서울,영등포구,7,2,2,11,8,0,2019-12-23
6840,서울,용산구,5,0,0,5,4,0,2019-01-23
6841,서울,용산구,2,0,1,3,3,0,2019-02-23
6842,서울,용산구,6,1,0,7,4,0,2019-03-23
6843,서울,용산구,0,2,0,2,2,0,2019-04-23
6844,서울,용산구,4,0,1,5,4,0,2019-05-23
6845,서울,용산구,0,0,0,0,0,0,2019-06-23
6846,서울,용산구,7,1,2,10,4,0,2019-07-23
6847,서울,용산구,1,1,4,6,5,0,2019-08-23
6848,서울,용산구,1,0,0,1,1,0,2019-09-23
6849,서울,용산구,0,0,0,0,0,0,2019-10-23
6850,서울,용산구,6,0,1,7,4,0,2019-11-23
6851,서울,용산구,2,0,0,2,2,0,2019-12-23
6852,서울,은평구,1,0,0,1,1,0,2019-01-23
6853,서울,은평구,3,0,2,5,4,0,2019-02-23
6854,서울,은평구,1,0,1,2,2,0,2019-03-23
6855,서울,은평구,1,1,2,4,4,0,2019-04-23
6856,서울,은평구,5,2,1,8,5,0,2019-05-23
6857,서울,은평구,0,0,0,0,0,0,2019-06-23
6858,서울,은평구,3,1,1,5,5,0,2019-07-23
6859,서울,은평구,2,0,1,3,2,0,2019-08-23
6860,서울,은평구,6,0,0,6,5,0,2019-09-23
6861,서울,은평구,3,0,2,5,5,0,2019-10-23
6862,서울,은평구,7,0,0,7,5,0,2019-11-23
6863,서울,은평구,4,0,1,5,3,0,2019-12-23
6864,서울,종로구,0,0,0,0,1,1,2019-01-23
6865,서울,종로구,1,4,0,5,4,0,2019-02-23
6866,서울,종로구,8,0,0,8,4,0,2019-03-23
6867,서울,종로구,0,0,0,0,0,0,2019-04-23
6868,서울,종로구,2,0,0,2,1,0,2019-05-23
6869,서울,종로구,2,0,0,2,2,0,2019-06-23
6870,서울,종로구,2,0,1,3,2,0,2019-07-23
6871,서울,종로구,0,2,1,3,2,0,2019-08-23
6872,서울,종로구,2,0,1,3,3,0,2019-09-23
6873,서울,종로구,1,2,0,3,2,0,2019-10-23
6874,서울,종로구,2,0,1,3,3,0,2019-11-23
6875,서울,종로구,3,0,1,4,4,0,2019-12-23
6876,서울,중구,9,1,3,13,7,0,2019-01-23
6877,서울,중구,1,1,0,2,2,0,2019-02-23
6878,서울,중구,0,0,0,0,0,0,2019-03-23
6879,서울,중구,2,0,0,2,2,0,2019-04-23
6880,서울,중구,5,3,2,10,7,0,2019-05-23
6881,서울,중구,2,0,1,3,3,0,2019-06-23
6882,서울,중구,2,0,0,2,2,0,2019-07-23
6883,서울,중구,3,0,1,4,4,0,2019-08-23
6884,서울,중구,4,1,3,8,7,0,2019-09-23
6885,서울,중구,1,0,0,1,1,0,2019-10-23
6886,서울,중구,3,0,1,4,2,0,2019-11-23
6887,서울,중구,0,4,0,4,4,0,2019-12-23
6888,서울,중랑구,1,1,2,4,4,0,2019-01-23
6889,서울,중랑구,3,0,3,6,6,0,2019-02-23
6890,서울,중랑구,4,0,1,5,4,0,2019-03-23
6891,서울,중랑구,3,0,1,4,3,0,2019-04-23
6892,서울,중랑구,3,0,0,3,2,0,2019-05-23
6893,서울,중랑구,3,0,0,3,3,0,2019-06-23
6894,서울,중랑구,4,0,0,4,4,0,2019-07-23
6895,서울,중랑구,9,0,1,10,7,0,2019-08-23
6896,서울,중랑구,4,0,0,4,2,0,2019-09-23
6897,서울,중랑구,4,1,2,7,4,0,2019-10-23
6898,서울,중랑구,5,0,2,7,5,0,2019-11-23
6899,서울,중랑구,2,0,1,3,3,0,2019-12-23
6900,서울,강남구,17,7,2,26,16,0,2019-01-24
6901,서울,강남구,4,1,2,7,6,0,2019-02-24
6902,서울,강남구,4,1,2,7,4,0,2019-03-24
6903,서울,강남구,15,0,1,16,10,0,2019-04-24
6904,서울,강남구,6,3,7,16,12,0,2019-05-24
6905,서울,강남구,11,0,1,12,7,0,2019-06-24
6906,서울,강남구,14,2,0,16,10,0,2019-07-24
6907,서울,강남구,10,0,3,13,10,0,2019-08-24
6908,서울,강남구,10,2,4,16,13,0,2019-09-24
6909,서울,강남구,10,1,3,14,12,0,2019-10-24
6910,서울,강남구,8,1,0,9,7,0,2019-11-24
6911,서울,강남구,19,1,2,22,19,0,2019-12-24
6912,서울,강동구,5,0,1,6,5,0,2019-01-24
6913,서울,강동구,5,3,2,10,4,0,2019-02-24
6914,서울,강동구,4,0,2,6,5,0,2019-03-24
6915,서울,강동구,1,0,1,2,2,0,2019-04-24
6916,서울,강동구,7,6,2,15,7,0,2019-05-24
6917,서울,강동구,5,0,0,5,5,0,2019-06-24
6918,서울,강동구,6,0,4,10,9,0,2019-07-24
6919,서울,강동구,2,0,0,2,2,0,2019-08-24
6920,서울,강동구,5,0,1,6,4,0,2019-09-24
6921,서울,강동구,5,1,0,6,3,0,2019-10-24
6922,서울,강동구,1,0,1,2,2,0,2019-11-24
6923,서울,강동구,6,1,0,7,5,0,2019-12-24
6924,서울,강북구,1,0,0,1,1,0,2019-01-24
6925,서울,강북구,1,0,2,3,3,0,2019-02-24
6926,서울,강북구,15,0,2,17,7,0,2019-03-24
6927,서울,강북구,4,0,3,7,5,0,2019-04-24
6928,서울,강북구,6,0,0,6,5,0,2019-05-24
6929,서울,강북구,3,0,1,4,3,0,2019-06-24
6930,서울,강북구,2,0,0,2,2,0,2019-07-24
6931,서울,강북구,4,0,0,4,3,0,2019-08-24
6932,서울,강북구,3,0,0,3,3,0,2019-09-24
6933,서울,강북구,1,0,2,3,3,0,2019-10-24
6934,서울,강북구,6,0,1,7,4,0,2019-11-24
6935,서울,강북구,3,1,1,5,5,0,2019-12-24
6936,서울,강서구,9,0,2,11,9,0,2019-01-24
6937,서울,강서구,3,0,2,5,4,0,2019-02-24
6938,서울,강서구,6,1,1,8,6,0,2019-03-24
6939,서울,강서구,12,0,0,12,6,0,2019-04-24
6940,서울,강서구,7,0,4,11,6,0,2019-05-24
6941,서울,강서구,7,2,3,12,9,0,2019-06-24
6942,서울,강서구,6,0,1,7,6,0,2019-07-24
6943,서울,강서구,4,0,4,8,7,0,2019-08-24
6944,서울,강서구,3,2,2,7,5,0,2019-09-24
6945,서울,강서구,7,2,0,9,6,0,2019-10-24
6946,서울,강서구,3,0,0,3,3,0,2019-11-24
6947,서울,강서구,4,0,0,4,2,0,2019-12-24
6948,서울,관악구,4,1,1,6,5,0,2019-01-24
6949,서울,관악구,5,0,3,8,2,0,2019-02-24
6950,서울,관악구,1,1,2,4,3,0,2019-03-24
6951,서울,관악구,4,0,1,5,5,0,2019-04-24
6952,서울,관악구,4,0,0,4,4,0,2019-05-24
6953,서울,관악구,3,0,1,4,2,0,2019-06-24
6954,서울,관악구,3,0,1,4,4,0,2019-07-24
6955,서울,관악구,4,4,1,9,6,0,2019-08-24
6956,서울,관악구,2,0,3,5,3,0,2019-09-24
6957,서울,관악구,0,2,3,5,5,0,2019-10-24
6958,서울,관악구,0,0,0,0,0,0,2019-11-24
6959,서울,관악구,5,1,0,6,6,0,2019-12-24
6960,서울,광진구,2,0,0,2,2,0,2019-01-24
6961,서울,광진구,0,0,0,0,0,0,2019-02-24
6962,서울,광진구,3,0,0,3,3,0,2019-03-24
6963,서울,광진구,1,1,0,2,2,0,2019-04-24
6964,서울,광진구,3,0,0,3,1,0,2019-05-24
6965,서울,광진구,3,0,1,4,3,0,2019-06-24
6966,서울,광진구,5,0,1,6,3,0,2019-07-24
6967,서울,광진구,2,1,0,3,3,0,2019-08-24
6968,서울,광진구,3,0,0,3,3,0,2019-09-24
6969,서울,광진구,9,0,1,10,5,0,2019-10-24
6970,서울,광진구,0,0,0,0,0,0,2019-11-24
6971,서울,광진구,1,0,1,2,1,0,2019-12-24
6972,서울,구로구,2,0,2,4,3,0,2019-01-24
6973,서울,구로구,1,0,0,1,2,1,2019-02-24
6974,서울,구로구,2,0,0,2,2,0,2019-03-24
6975,서울,구로구,3,1,0,4,3,0,2019-04-24
6976,서울,구로구,6,1,1,8,6,0,2019-05-24
6977,서울,구로구,4,1,2,7,5,0,2019-06-24
6978,서울,구로구,4,2,1,7,5,0,2019-07-24
6979,서울,구로구,5,0,0,5,4,0,2019-08-24
6980,서울,구로구,5,0,1,6,6,0,2019-09-24
6981,서울,구로구,4,0,2,6,6,0,2019-10-24
6982,서울,구로구,1,0,0,1,1,0,2019-11-24
6983,서울,구로구,11,0,1,12,6,0,2019-12-24
6984,서울,금천구,1,0,0,1,1,0,2019-01-24
6985,서울,금천구,0,0,2,2,2,0,2019-02-24
6986,서울,금천구,3,0,1,4,4,0,2019-03-24
6987,서울,금천구,0,0,0,0,0,0,2019-04-24
6988,서울,금천구,11,0,0,11,3,0,2019-05-24
6989,서울,금천구,4,0,1,5,5,0,2019-06-24
6990,서울,금천구,3,0,0,3,2,0,2019-07-24
6991,서울,금천구,0,0,0,0,0,0,2019-08-24
6992,서울,금천구,3,0,3,6,4,0,2019-09-24
6993,서울,금천구,3,0,0,3,2,0,2019-10-24
6994,서울,금천구,2,0,1,3,2,0,2019-11-24
6995,서울,금천구,0,0,0,0,0,0,2019-12-24
6996,서울,노원구,3,0,5,8,3,0,2019-01-24
6997,서울,노원구,0,0,0,0,0,0,2019-02-24
6998,서울,노원구,1,0,0,1,1,0,2019-03-24
6999,서울,노원구,4,0,0,4,2,0,2019-04-24
7000,서울,노원구,8,1,0,9,6,1,2019-05-24
7001,서울,노원구,2,0,3,5,3,0,2019-06-24
7002,서울,노원구,5,1,3,9,7,0,2019-07-24
7003,서울,노원구,9,2,0,11,6,0,2019-08-24
7004,서울,노원구,2,1,3,6,5,0,2019-09-24
7005,서울,노원구,2,2,1,5,5,0,2019-10-24
7006,서울,노원구,3,0,1,4,3,0,2019-11-24
7007,서울,노원구,8,1,0,9,6,0,2019-12-24
7008,서울,도봉구,1,0,0,1,1,0,2019-01-24
7009,서울,도봉구,1,0,0,1,1,0,2019-02-24
7010,서울,도봉구,2,0,1,3,2,0,2019-03-24
7011,서울,도봉구,1,0,0,1,1,0,2019-04-24
7012,서울,도봉구,2,0,0,2,2,0,2019-05-24
7013,서울,도봉구,3,0,0,3,3,0,2019-06-24
7014,서울,도봉구,0,0,0,0,0,0,2019-07-24
7015,서울,도봉구,4,0,0,4,4,0,2019-08-24
7016,서울,도봉구,1,1,0,2,2,0,2019-09-24
7017,서울,도봉구,0,0,1,1,1,0,2019-10-24
7018,서울,도봉구,4,0,3,7,6,0,2019-11-24
7019,서울,도봉구,2,0,0,2,2,0,2019-12-24
7020,서울,동대문구,0,0,5,5,5,0,2019-01-24
7021,서울,동대문구,1,0,1,2,2,0,2019-02-24
7022,서울,동대문구,5,1,0,6,3,0,2019-03-24
7023,서울,동대문구,2,1,1,4,4,0,2019-04-24
7024,서울,동대문구,7,0,2,9,9,0,2019-05-24
7025,서울,동대문구,3,2,2,7,7,0,2019-06-24
7026,서울,동대문구,3,0,0,3,2,1,2019-07-24
7027,서울,동대문구,0,0,1,1,1,0,2019-08-24
7028,서울,동대문구,7,0,5,12,10,0,2019-09-24
7029,서울,동대문구,7,0,0,7,5,0,2019-10-24
7030,서울,동대문구,5,1,2,8,8,0,2019-11-24
7031,서울,동대문구,3,0,2,5,5,0,2019-12-24
7032,서울,동작구,1,1,4,6,5,0,2019-01-24
7033,서울,동작구,1,1,0,2,2,0,2019-02-24
7034,서울,동작구,3,1,0,4,4,0,2019-03-24
7035,서울,동작구,2,2,0,4,4,0,2019-04-24
7036,서울,동작구,7,1,2,10,4,0,2019-05-24
7037,서울,동작구,15,0,6,21,4,0,2019-06-24
7038,서울,동작구,1,0,1,2,2,0,2019-07-24
7039,서울,동작구,10,1,0,11,7,0,2019-08-24
7040,서울,동작구,1,0,0,1,1,0,2019-09-24
7041,서울,동작구,4,1,1,6,4,0,2019-10-24
7042,서울,동작구,2,0,0,2,2,0,2019-11-24
7043,서울,동작구,5,2,1,8,5,0,2019-12-24
7044,서울,마포구,3,0,0,3,2,0,2019-01-24
7045,서울,마포구,4,2,1,7,4,0,2019-02-24
7046,서울,마포구,5,0,1,6,5,0,2019-03-24
7047,서울,마포구,4,1,1,6,5,0,2019-04-24
7048,서울,마포구,6,0,0,6,4,0,2019-05-24
7049,서울,마포구,7,0,2,9,5,0,2019-06-24
7050,서울,마포구,3,0,3,6,5,0,2019-07-24
7051,서울,마포구,2,1,3,6,6,0,2019-08-24
7052,서울,마포구,4,0,0,4,4,0,2019-09-24
7053,서울,마포구,5,0,5,10,6,0,2019-10-24
7054,서울,마포구,0,0,0,0,0,0,2019-11-24
7055,서울,마포구,14,0,2,16,8,0,2019-12-24
7056,서울,서대문구,0,0,2,2,2,0,2019-01-24
7057,서울,서대문구,1,1,0,2,2,0,2019-02-24
7058,서울,서대문구,1,1,0,2,2,0,2019-03-24
7059,서울,서대문구,4,0,0,4,3,0,2019-04-24
7060,서울,서대문구,2,2,4,8,4,0,2019-05-24
7061,서울,서대문구,2,0,0,2,2,0,2019-06-24
7062,서울,서대문구,7,1,0,8,5,0,2019-07-24
7063,서울,서대문구,6,2,0,8,6,0,2019-08-24
7064,서울,서대문구,0,1,1,2,2,0,2019-09-24
7065,서울,서대문구,3,0,0,3,3,0,2019-10-24
7066,서울,서대문구,3,0,1,4,3,0,2019-11-24
7067,서울,서대문구,0,0,0,0,0,0,2019-12-24
7068,서울,서초구,8,0,1,9,8,0,2019-01-24
7069,서울,서초구,10,0,3,13,6,0,2019-02-24
7070,서울,서초구,3,0,0,3,3,0,2019-03-24
7071,서울,서초구,5,1,1,7,6,0,2019-04-24
7072,서울,서초구,16,2,3,21,8,0,2019-05-24
7073,서울,서초구,4,4,2,10,7,0,2019-06-24
7074,서울,서초구,11,0,3,14,9,0,2019-07-24
7075,서울,서초구,3,0,1,4,4,0,2019-08-24
7076,서울,서초구,3,2,0,5,5,0,2019-09-24
7077,서울,서초구,13,1,4,18,16,0,2019-10-24
7078,서울,서초구,1,0,3,4,4,0,2019-11-24
7079,서울,서초구,9,0,3,12,6,0,2019-12-24
7080,서울,성동구,4,0,1,5,5,1,2019-01-24
7081,서울,성동구,3,0,1,4,3,0,2019-02-24
7082,서울,성동구,2,0,1,3,3,0,2019-03-24
7083,서울,성동구,4,0,0,4,4,0,2019-04-24
7084,서울,성동구,1,0,2,3,3,0,2019-05-24
7085,서울,성동구,2,0,2,4,3,0,2019-06-24
7086,서울,성동구,4,0,0,4,4,0,2019-07-24
7087,서울,성동구,2,1,0,3,3,0,2019-08-24
7088,서울,성동구,1,0,0,1,1,0,2019-09-24
7089,서울,성동구,2,2,0,4,4,0,2019-10-24
7090,서울,성동구,2,0,1,3,2,0,2019-11-24
7091,서울,성동구,3,0,1,4,4,0,2019-12-24
7092,서울,성북구,2,1,0,3,3,0,2019-01-24
7093,서울,성북구,7,0,1,8,5,0,2019-02-24
7094,서울,성북구,5,0,2,7,5,0,2019-03-24
7095,서울,성북구,5,0,0,5,4,0,2019-04-24
7096,서울,성북구,3,0,1,4,3,0,2019-05-24
7097,서울,성북구,1,0,0,1,1,0,2019-06-24
7098,서울,성북구,1,0,6,7,6,0,2019-07-24
7099,서울,성북구,6,0,3,9,6,0,2019-08-24
7100,서울,성북구,4,0,2,6,6,0,2019-09-24
7101,서울,성북구,3,1,4,8,5,0,2019-10-24
7102,서울,성북구,4,0,0,4,4,0,2019-11-24
7103,서울,성북구,5,0,3,8,7,0,2019-12-24
7104,서울,송파구,12,1,2,15,10,0,2019-01-24
7105,서울,송파구,6,2,3,11,8,0,2019-02-24
7106,서울,송파구,8,1,3,12,6,0,2019-03-24
7107,서울,송파구,5,3,1,9,8,0,2019-04-24
7108,서울,송파구,8,1,1,10,8,0,2019-05-24
7109,서울,송파구,2,0,2,4,4,0,2019-06-24
7110,서울,송파구,9,1,1,11,8,0,2019-07-24
7111,서울,송파구,13,2,1,16,12,0,2019-08-24
7112,서울,송파구,4,2,5,11,10,0,2019-09-24
7113,서울,송파구,7,0,3,10,10,0,2019-10-24
7114,서울,송파구,8,0,3,11,7,0,2019-11-24
7115,서울,송파구,14,2,0,16,8,0,2019-12-24
7116,서울,양천구,6,0,0,6,4,0,2019-01-24
7117,서울,양천구,1,0,0,1,1,0,2019-02-24
7118,서울,양천구,2,2,1,5,4,0,2019-03-24
7119,서울,양천구,6,1,1,8,6,0,2019-04-24
7120,서울,양천구,4,2,0,6,6,0,2019-05-24
7121,서울,양천구,8,2,0,10,8,0,2019-06-24
7122,서울,양천구,4,0,1,5,4,0,2019-07-24
7123,서울,양천구,4,0,0,4,3,0,2019-08-24
7124,서울,양천구,5,1,1,7,5,0,2019-09-24
7125,서울,양천구,5,3,3,11,7,0,2019-10-24
7126,서울,양천구,1,0,2,3,3,0,2019-11-24
7127,서울,양천구,3,1,0,4,4,0,2019-12-24
7128,서울,영등포구,10,1,1,12,7,0,2019-01-24
7129,서울,영등포구,9,0,4,13,7,0,2019-02-24
7130,서울,영등포구,6,4,2,12,6,0,2019-03-24
7131,서울,영등포구,10,1,2,13,8,0,2019-04-24
7132,서울,영등포구,8,0,1,9,8,0,2019-05-24
7133,서울,영등포구,8,1,2,11,8,0,2019-06-24
7134,서울,영등포구,10,0,4,14,11,0,2019-07-24
7135,서울,영등포구,9,0,4,13,12,0,2019-08-24
7136,서울,영등포구,4,0,1,5,5,0,2019-09-24
7137,서울,영등포구,3,1,4,8,8,1,2019-10-24
7138,서울,영등포구,10,0,2,12,5,0,2019-11-24
7139,서울,영등포구,7,0,2,9,6,0,2019-12-24
7140,서울,용산구,4,0,0,4,2,0,2019-01-24
7141,서울,용산구,0,0,1,1,1,0,2019-02-24
7142,서울,용산구,3,0,0,3,3,0,2019-03-24
7143,서울,용산구,4,0,4,8,5,0,2019-04-24
7144,서울,용산구,1,2,1,4,3,0,2019-05-24
7145,서울,용산구,9,0,0,9,6,0,2019-06-24
7146,서울,용산구,5,0,1,6,4,0,2019-07-24
7147,서울,용산구,9,0,1,10,4,0,2019-08-24
7148,서울,용산구,6,0,0,6,6,0,2019-09-24
7149,서울,용산구,2,0,1,3,2,0,2019-10-24
7150,서울,용산구,9,0,0,9,5,0,2019-11-24
7151,서울,용산구,4,0,0,4,4,0,2019-12-24
7152,서울,은평구,1,0,0,1,1,0,2019-01-24
7153,서울,은평구,1,0,0,1,1,0,2019-02-24
7154,서울,은평구,2,1,3,6,3,0,2019-03-24
7155,서울,은평구,4,0,2,6,6,0,2019-04-24
7156,서울,은평구,3,1,0,4,4,0,2019-05-24
7157,서울,은평구,2,0,1,3,3,0,2019-06-24
7158,서울,은평구,3,2,1,6,5,0,2019-07-24
7159,서울,은평구,9,2,4,15,11,0,2019-08-24
7160,서울,은평구,5,1,0,6,3,0,2019-09-24
7161,서울,은평구,5,0,0,5,3,0,2019-10-24
7162,서울,은평구,3,0,0,3,3,0,2019-11-24
7163,서울,은평구,2,0,0,2,2,0,2019-12-24
7164,서울,종로구,0,0,0,0,0,0,2019-01-24
7165,서울,종로구,2,1,0,3,2,0,2019-02-24
7166,서울,종로구,3,4,1,8,3,0,2019-03-24
7167,서울,종로구,2,0,1,3,2,0,2019-04-24
7168,서울,종로구,5,1,3,9,6,0,2019-05-24
7169,서울,종로구,1,0,0,1,1,0,2019-06-24
7170,서울,종로구,4,0,2,6,4,0,2019-07-24
7171,서울,종로구,10,1,1,12,9,0,2019-08-24
7172,서울,종로구,2,0,0,2,2,0,2019-09-24
7173,서울,종로구,1,1,1,3,3,0,2019-10-24
7174,서울,종로구,3,1,0,4,4,0,2019-11-24
7175,서울,종로구,3,0,1,4,3,0,2019-12-24
7176,서울,중구,3,1,1,5,4,0,2019-01-24
7177,서울,중구,0,0,1,1,1,0,2019-02-24
7178,서울,중구,6,1,0,7,5,0,2019-03-24
7179,서울,중구,8,1,1,10,7,0,2019-04-24
7180,서울,중구,7,0,1,8,6,0,2019-05-24
7181,서울,중구,3,0,2,5,5,0,2019-06-24
7182,서울,중구,2,1,2,5,4,0,2019-07-24
7183,서울,중구,5,0,0,5,3,0,2019-08-24
7184,서울,중구,1,1,0,2,2,0,2019-09-24
7185,서울,중구,1,1,3,5,3,0,2019-10-24
7186,서울,중구,4,0,1,5,3,0,2019-11-24
7187,서울,중구,1,0,2,3,3,0,2019-12-24
7188,서울,중랑구,6,0,0,6,4,0,2019-01-24
7189,서울,중랑구,3,1,1,5,5,0,2019-02-24
7190,서울,중랑구,11,1,2,14,6,0,2019-03-24
7191,서울,중랑구,3,1,3,7,6,1,2019-04-24
7192,서울,중랑구,14,0,1,15,9,0,2019-05-24
7193,서울,중랑구,3,1,1,5,5,0,2019-06-24
7194,서울,중랑구,2,0,0,2,2,0,2019-07-24
7195,서울,중랑구,9,1,2,12,4,0,2019-08-24
7196,서울,중랑구,5,2,2,9,8,0,2019-09-24
7197,서울,중랑구,6,1,0,7,3,0,2019-10-24
7198,서울,중랑구,8,0,1,9,7,0,2019-11-24
7199,서울,중랑구,3,1,0,4,4,0,2019-12-24
7200,서울,강남구,21,0,1,22,17,0,2019-01-25
7201,서울,강남구,12,1,3,16,11,0,2019-02-25
7202,서울,강남구,13,1,3,17,11,0,2019-03-25
7203,서울,강남구,8,5,4,17,12,0,2019-04-25
7204,서울,강남구,12,0,0,12,8,0,2019-05-25
7205,서울,강남구,9,2,1,12,12,0,2019-06-25
7206,서울,강남구,15,2,2,19,13,0,2019-07-25
7207,서울,강남구,13,1,3,17,8,0,2019-08-25
7208,서울,강남구,14,0,4,18,13,0,2019-09-25
7209,서울,강남구,17,3,3,23,15,0,2019-10-25
7210,서울,강남구,10,1,3,14,9,0,2019-11-25
7211,서울,강남구,5,1,1,7,6,0,2019-12-25
7212,서울,강동구,3,0,0,3,3,0,2019-01-25
7213,서울,강동구,5,0,2,7,6,0,2019-02-25
7214,서울,강동구,0,0,0,0,0,0,2019-03-25
7215,서울,강동구,4,2,0,6,4,0,2019-04-25
7216,서울,강동구,6,0,2,8,7,0,2019-05-25
7217,서울,강동구,3,0,0,3,3,0,2019-06-25
7218,서울,강동구,6,0,1,7,4,0,2019-07-25
7219,서울,강동구,5,0,1,6,3,0,2019-08-25
7220,서울,강동구,2,1,0,3,2,0,2019-09-25
7221,서울,강동구,4,0,1,5,4,0,2019-10-25
7222,서울,강동구,2,1,1,4,3,0,2019-11-25
7223,서울,강동구,1,2,0,3,3,0,2019-12-25
7224,서울,강북구,3,0,0,3,3,0,2019-01-25
7225,서울,강북구,0,0,0,0,0,0,2019-02-25
7226,서울,강북구,0,0,2,2,2,0,2019-03-25
7227,서울,강북구,3,0,0,3,3,0,2019-04-25
7228,서울,강북구,2,0,0,2,1,0,2019-05-25
7229,서울,강북구,2,0,0,2,2,1,2019-06-25
7230,서울,강북구,5,1,0,6,5,0,2019-07-25
7231,서울,강북구,2,0,1,3,2,0,2019-08-25
7232,서울,강북구,4,0,0,4,4,0,2019-09-25
7233,서울,강북구,5,0,1,6,4,0,2019-10-25
7234,서울,강북구,1,0,2,3,3,0,2019-11-25
7235,서울,강북구,4,1,0,5,3,0,2019-12-25
7236,서울,강서구,3,0,2,5,4,0,2019-01-25
7237,서울,강서구,5,0,1,6,4,0,2019-02-25
7238,서울,강서구,5,2,1,8,6,0,2019-03-25
7239,서울,강서구,2,1,1,4,4,0,2019-04-25
7240,서울,강서구,14,9,0,23,4,0,2019-05-25
7241,서울,강서구,4,1,1,6,4,0,2019-06-25
7242,서울,강서구,5,0,1,6,5,0,2019-07-25
7243,서울,강서구,9,0,1,10,6,0,2019-08-25
7244,서울,강서구,7,0,4,11,6,0,2019-09-25
7245,서울,강서구,3,0,0,3,3,0,2019-10-25
7246,서울,강서구,6,1,4,11,7,0,2019-11-25
7247,서울,강서구,2,0,0,2,2,0,2019-12-25
7248,서울,관악구,2,0,0,2,1,0,2019-01-25
7249,서울,관악구,4,0,1,5,5,0,2019-02-25
7250,서울,관악구,1,0,2,3,3,0,2019-03-25
7251,서울,관악구,1,0,3,4,4,0,2019-04-25
7252,서울,관악구,5,0,1,6,5,0,2019-05-25
7253,서울,관악구,6,0,3,9,8,0,2019-06-25
7254,서울,관악구,2,0,0,2,2,0,2019-07-25
7255,서울,관악구,2,0,0,2,1,0,2019-08-25
7256,서울,관악구,6,0,1,7,6,0,2019-09-25
7257,서울,관악구,1,0,2,3,3,0,2019-10-25
7258,서울,관악구,3,0,0,3,2,0,2019-11-25
7259,서울,관악구,5,0,0,5,4,0,2019-12-25
7260,서울,광진구,0,0,0,0,0,0,2019-01-25
7261,서울,광진구,2,0,0,2,2,0,2019-02-25
7262,서울,광진구,4,0,1,5,2,0,2019-03-25
7263,서울,광진구,1,2,2,5,3,0,2019-04-25
7264,서울,광진구,0,1,1,2,2,0,2019-05-25
7265,서울,광진구,5,0,0,5,2,0,2019-06-25
7266,서울,광진구,4,0,2,6,4,0,2019-07-25
7267,서울,광진구,4,0,0,4,3,0,2019-08-25
7268,서울,광진구,0,0,2,2,2,0,2019-09-25
7269,서울,광진구,1,0,2,3,3,0,2019-10-25
7270,서울,광진구,1,0,1,2,2,0,2019-11-25
7271,서울,광진구,0,0,0,0,0,0,2019-12-25
7272,서울,구로구,1,0,0,1,1,0,2019-01-25
7273,서울,구로구,3,0,1,4,4,0,2019-02-25
7274,서울,구로구,5,0,0,5,3,0,2019-03-25
7275,서울,구로구,6,0,1,7,2,0,2019-04-25
7276,서울,구로구,11,0,2,13,7,0,2019-05-25
7277,서울,구로구,2,0,1,3,3,0,2019-06-25
7278,서울,구로구,5,1,0,6,5,0,2019-07-25
7279,서울,구로구,0,0,0,0,0,0,2019-08-25
7280,서울,구로구,2,0,2,4,4,0,2019-09-25
7281,서울,구로구,5,0,1,6,5,0,2019-10-25
7282,서울,구로구,1,0,2,3,3,0,2019-11-25
7283,서울,구로구,3,0,1,4,4,0,2019-12-25
7284,서울,금천구,5,0,0,5,5,0,2019-01-25
7285,서울,금천구,1,0,1,2,2,0,2019-02-25
7286,서울,금천구,0,0,1,1,1,0,2019-03-25
7287,서울,금천구,2,0,1,3,2,0,2019-04-25
7288,서울,금천구,0,1,1,2,2,0,2019-05-25
7289,서울,금천구,2,1,1,4,2,0,2019-06-25
7290,서울,금천구,1,0,1,2,2,0,2019-07-25
7291,서울,금천구,8,5,0,13,5,0,2019-08-25
7292,서울,금천구,0,1,0,1,1,0,2019-09-25
7293,서울,금천구,3,0,1,4,4,0,2019-10-25
7294,서울,금천구,2,0,0,2,1,0,2019-11-25
7295,서울,금천구,1,1,0,2,2,0,2019-12-25
7296,서울,노원구,6,0,1,7,7,0,2019-01-25
7297,서울,노원구,1,0,2,3,2,0,2019-02-25
7298,서울,노원구,3,1,0,4,3,0,2019-03-25
7299,서울,노원구,4,0,4,8,8,0,2019-04-25
7300,서울,노원구,3,2,1,6,4,0,2019-05-25
7301,서울,노원구,9,3,3,15,12,0,2019-06-25
7302,서울,노원구,1,0,0,1,1,0,2019-07-25
7303,서울,노원구,2,1,1,4,4,0,2019-08-25
7304,서울,노원구,5,0,1,6,6,0,2019-09-25
7305,서울,노원구,6,0,0,6,6,0,2019-10-25
7306,서울,노원구,4,1,2,7,7,0,2019-11-25
7307,서울,노원구,3,0,0,3,2,0,2019-12-25
7308,서울,도봉구,1,1,2,4,5,2,2019-01-25
7309,서울,도봉구,1,0,0,1,1,0,2019-02-25
7310,서울,도봉구,2,0,1,3,3,0,2019-03-25
7311,서울,도봉구,5,1,1,7,3,0,2019-04-25
7312,서울,도봉구,8,1,1,10,5,0,2019-05-25
7313,서울,도봉구,0,0,1,1,1,0,2019-06-25
7314,서울,도봉구,1,0,1,2,2,0,2019-07-25
7315,서울,도봉구,1,0,0,1,1,0,2019-08-25
7316,서울,도봉구,3,0,1,4,4,0,2019-09-25
7317,서울,도봉구,3,0,2,5,2,0,2019-10-25
7318,서울,도봉구,0,0,1,1,1,0,2019-11-25
7319,서울,도봉구,2,0,0,2,2,0,2019-12-25
7320,서울,동대문구,3,0,1,4,4,0,2019-01-25
7321,서울,동대문구,4,2,4,10,7,0,2019-02-25
7322,서울,동대문구,4,0,2,6,7,1,2019-03-25
7323,서울,동대문구,3,1,0,4,4,0,2019-04-25
7324,서울,동대문구,2,0,1,3,3,0,2019-05-25
7325,서울,동대문구,1,3,2,6,5,0,2019-06-25
7326,서울,동대문구,5,0,3,8,7,0,2019-07-25
7327,서울,동대문구,5,0,1,6,5,0,2019-08-25
7328,서울,동대문구,10,3,1,14,10,0,2019-09-25
7329,서울,동대문구,4,0,1,5,5,0,2019-10-25
7330,서울,동대문구,6,0,1,7,5,0,2019-11-25
7331,서울,동대문구,0,0,0,0,0,0,2019-12-25
7332,서울,동작구,5,0,0,5,4,0,2019-01-25
7333,서울,동작구,5,1,0,6,4,0,2019-02-25
7334,서울,동작구,3,0,0,3,2,0,2019-03-25
7335,서울,동작구,2,0,0,2,2,0,2019-04-25
7336,서울,동작구,7,2,0,9,3,0,2019-05-25
7337,서울,동작구,6,3,4,13,9,0,2019-06-25
7338,서울,동작구,4,1,2,7,5,0,2019-07-25
7339,서울,동작구,1,0,0,1,1,0,2019-08-25
7340,서울,동작구,6,3,2,11,9,0,2019-09-25
7341,서울,동작구,2,0,3,5,5,0,2019-10-25
7342,서울,동작구,12,1,3,16,10,0,2019-11-25
7343,서울,동작구,0,0,0,0,0,0,2019-12-25
7344,서울,마포구,3,0,2,5,4,0,2019-01-25
7345,서울,마포구,7,0,2,9,4,0,2019-02-25
7346,서울,마포구,1,2,1,4,1,0,2019-03-25
7347,서울,마포구,1,0,0,1,1,0,2019-04-25
7348,서울,마포구,8,0,0,8,3,0,2019-05-25
7349,서울,마포구,5,1,1,7,6,0,2019-06-25
7350,서울,마포구,6,0,3,9,6,0,2019-07-25
7351,서울,마포구,9,1,1,11,6,0,2019-08-25
7352,서울,마포구,2,0,0,2,2,0,2019-09-25
7353,서울,마포구,1,0,2,3,2,0,2019-10-25
7354,서울,마포구,2,0,3,5,3,0,2019-11-25
7355,서울,마포구,6,0,0,6,4,0,2019-12-25
7356,서울,서대문구,5,1,0,6,5,0,2019-01-25
7357,서울,서대문구,2,3,0,5,4,0,2019-02-25
7358,서울,서대문구,1,0,1,2,2,0,2019-03-25
7359,서울,서대문구,5,0,0,5,4,0,2019-04-25
7360,서울,서대문구,2,0,2,4,4,0,2019-05-25
7361,서울,서대문구,0,1,1,2,2,0,2019-06-25
7362,서울,서대문구,5,0,0,5,3,0,2019-07-25
7363,서울,서대문구,1,1,0,2,2,0,2019-08-25
7364,서울,서대문구,3,1,0,4,3,0,2019-09-25
7365,서울,서대문구,5,1,4,10,6,0,2019-10-25
7366,서울,서대문구,3,1,0,4,3,0,2019-11-25
7367,서울,서대문구,1,0,1,2,2,0,2019-12-25
7368,서울,서초구,6,2,1,9,7,0,2019-01-25
7369,서울,서초구,7,1,5,13,9,0,2019-02-25
7370,서울,서초구,7,0,2,9,7,0,2019-03-25
7371,서울,서초구,10,4,1,15,12,0,2019-04-25
7372,서울,서초구,7,3,1,11,8,1,2019-05-25
7373,서울,서초구,4,2,3,9,7,0,2019-06-25
7374,서울,서초구,8,3,4,15,10,0,2019-07-25
7375,서울,서초구,6,0,0,6,5,0,2019-08-25
7376,서울,서초구,5,0,0,5,4,0,2019-09-25
7377,서울,서초구,4,1,0,5,4,0,2019-10-25
7378,서울,서초구,7,1,0,8,8,0,2019-11-25
7379,서울,서초구,8,1,1,10,5,0,2019-12-25
7380,서울,성동구,10,1,3,14,10,0,2019-01-25
7381,서울,성동구,0,0,1,1,1,0,2019-02-25
7382,서울,성동구,1,0,0,1,1,0,2019-03-25
7383,서울,성동구,3,0,0,3,2,0,2019-04-25
7384,서울,성동구,4,0,1,5,4,0,2019-05-25
7385,서울,성동구,10,0,3,13,10,0,2019-06-25
7386,서울,성동구,3,0,0,3,3,0,2019-07-25
7387,서울,성동구,4,0,0,4,2,0,2019-08-25
7388,서울,성동구,4,1,1,6,5,0,2019-09-25
7389,서울,성동구,0,0,2,2,2,0,2019-10-25
7390,서울,성동구,4,0,1,5,4,0,2019-11-25
7391,서울,성동구,0,0,0,0,0,0,2019-12-25
7392,서울,성북구,3,0,0,3,3,0,2019-01-25
7393,서울,성북구,5,0,3,8,8,1,2019-02-25
7394,서울,성북구,5,0,0,5,3,0,2019-03-25
7395,서울,성북구,2,0,1,3,2,0,2019-04-25
7396,서울,성북구,9,0,0,9,7,0,2019-05-25
7397,서울,성북구,2,0,3,5,5,0,2019-06-25
7398,서울,성북구,6,1,0,7,4,0,2019-07-25
7399,서울,성북구,6,1,1,8,8,0,2019-08-25
7400,서울,성북구,5,0,1,6,6,0,2019-09-25
7401,서울,성북구,3,0,3,6,5,0,2019-10-25
7402,서울,성북구,5,1,0,6,6,0,2019-11-25
7403,서울,성북구,1,0,0,1,1,0,2019-12-25
7404,서울,송파구,27,1,5,33,15,0,2019-01-25
7405,서울,송파구,7,2,2,11,11,0,2019-02-25
7406,서울,송파구,12,1,2,15,9,0,2019-03-25
7407,서울,송파구,13,2,4,19,11,0,2019-04-25
7408,서울,송파구,8,1,0,9,5,0,2019-05-25
7409,서울,송파구,13,2,0,15,11,0,2019-06-25
7410,서울,송파구,4,6,3,13,7,0,2019-07-25
7411,서울,송파구,5,3,3,11,7,0,2019-08-25
7412,서울,송파구,11,1,3,15,9,0,2019-09-25
7413,서울,송파구,25,4,8,37,17,1,2019-10-25
7414,서울,송파구,10,0,0,10,10,1,2019-11-25
7415,서울,송파구,16,4,2,22,10,0,2019-12-25
7416,서울,양천구,3,0,0,3,2,0,2019-01-25
7417,서울,양천구,3,1,1,5,4,0,2019-02-25
7418,서울,양천구,2,0,1,3,3,0,2019-03-25
7419,서울,양천구,3,0,0,3,2,0,2019-04-25
7420,서울,양천구,3,1,0,4,3,0,2019-05-25
7421,서울,양천구,2,0,2,4,4,0,2019-06-25
7422,서울,양천구,5,2,2,9,8,0,2019-07-25
7423,서울,양천구,0,1,2,3,3,0,2019-08-25
7424,서울,양천구,3,0,0,3,4,1,2019-09-25
7425,서울,양천구,8,0,2,10,9,0,2019-10-25
7426,서울,양천구,1,0,1,2,1,0,2019-11-25
7427,서울,양천구,16,2,1,19,5,0,2019-12-25
7428,서울,영등포구,7,1,2,10,7,0,2019-01-25
7429,서울,영등포구,7,0,1,8,6,0,2019-02-25
7430,서울,영등포구,4,1,1,6,6,0,2019-03-25
7431,서울,영등포구,13,1,3,17,12,0,2019-04-25
7432,서울,영등포구,6,1,3,10,7,0,2019-05-25
7433,서울,영등포구,11,5,1,17,10,0,2019-06-25
7434,서울,영등포구,5,0,2,7,6,0,2019-07-25
7435,서울,영등포구,3,3,2,8,5,0,2019-08-25
7436,서울,영등포구,2,0,1,3,3,0,2019-09-25
7437,서울,영등포구,8,0,1,9,6,0,2019-10-25
7438,서울,영등포구,7,0,1,8,6,0,2019-11-25
7439,서울,영등포구,16,0,0,16,7,0,2019-12-25
7440,서울,용산구,1,0,2,3,3,0,2019-01-25
7441,서울,용산구,1,0,0,1,1,0,2019-02-25
7442,서울,용산구,8,0,1,9,4,0,2019-03-25
7443,서울,용산구,8,0,2,10,7,0,2019-04-25
7444,서울,용산구,1,0,1,2,2,0,2019-05-25
7445,서울,용산구,3,0,2,5,5,0,2019-06-25
7446,서울,용산구,2,0,0,2,2,0,2019-07-25
7447,서울,용산구,2,0,0,2,2,0,2019-08-25
7448,서울,용산구,1,0,0,1,1,0,2019-09-25
7449,서울,용산구,17,1,2,20,9,0,2019-10-25
7450,서울,용산구,3,1,0,4,4,0,2019-11-25
7451,서울,용산구,10,0,0,10,6,0,2019-12-25
7452,서울,은평구,3,1,3,7,2,0,2019-01-25
7453,서울,은평구,0,0,1,1,1,0,2019-02-25
7454,서울,은평구,3,0,0,3,2,0,2019-03-25
7455,서울,은평구,3,0,2,5,5,0,2019-04-25
7456,서울,은평구,2,0,2,4,4,0,2019-05-25
7457,서울,은평구,0,1,2,3,1,0,2019-06-25
7458,서울,은평구,1,0,0,1,1,0,2019-07-25
7459,서울,은평구,0,0,0,0,0,0,2019-08-25
7460,서울,은평구,7,0,1,8,4,0,2019-09-25
7461,서울,은평구,4,0,1,5,3,0,2019-10-25
7462,서울,은평구,3,0,0,3,3,0,2019-11-25
7463,서울,은평구,0,0,3,3,2,0,2019-12-25
7464,서울,종로구,2,0,0,2,2,0,2019-01-25
7465,서울,종로구,0,1,0,1,1,0,2019-02-25
7466,서울,종로구,6,0,2,8,5,0,2019-03-25
7467,서울,종로구,2,1,0,3,2,0,2019-04-25
7468,서울,종로구,2,1,0,3,1,0,2019-05-25
7469,서울,종로구,3,0,3,6,5,0,2019-06-25
7470,서울,종로구,4,0,1,5,4,0,2019-07-25
7471,서울,종로구,3,0,0,3,3,0,2019-08-25
7472,서울,종로구,10,3,5,18,6,0,2019-09-25
7473,서울,종로구,8,0,5,13,9,0,2019-10-25
7474,서울,종로구,1,0,0,1,1,0,2019-11-25
7475,서울,종로구,4,0,1,5,3,0,2019-12-25
7476,서울,중구,6,0,1,7,7,0,2019-01-25
7477,서울,중구,1,1,1,3,2,0,2019-02-25
7478,서울,중구,6,0,0,6,2,0,2019-03-25
7479,서울,중구,1,0,1,2,2,0,2019-04-25
7480,서울,중구,5,1,0,6,6,0,2019-05-25
7481,서울,중구,3,1,2,6,6,0,2019-06-25
7482,서울,중구,2,0,1,3,3,0,2019-07-25
7483,서울,중구,2,0,2,4,2,0,2019-08-25
7484,서울,중구,0,0,0,0,0,0,2019-09-25
7485,서울,중구,2,0,1,3,3,0,2019-10-25
7486,서울,중구,2,0,1,3,3,0,2019-11-25
7487,서울,중구,2,0,0,2,2,0,2019-12-25
7488,서울,중랑구,5,1,2,8,7,0,2019-01-25
7489,서울,중랑구,2,0,2,4,4,0,2019-02-25
7490,서울,중랑구,2,1,1,4,4,0,2019-03-25
7491,서울,중랑구,5,0,2,7,6,0,2019-04-25
7492,서울,중랑구,4,0,0,4,3,0,2019-05-25
7493,서울,중랑구,6,1,0,7,5,0,2019-06-25
7494,서울,중랑구,7,1,2,10,9,0,2019-07-25
7495,서울,중랑구,0,1,0,1,2,1,2019-08-25
7496,서울,중랑구,2,0,1,3,3,0,2019-09-25
7497,서울,중랑구,7,1,2,10,7,0,2019-10-25
7498,서울,중랑구,4,0,0,4,4,0,2019-11-25
7499,서울,중랑구,1,0,0,1,1,0,2019-12-25
7500,서울,강남구,11,1,1,13,11,0,2019-01-26
7501,서울,강남구,8,0,3,11,11,0,2019-02-26
7502,서울,강남구,14,1,3,18,12,0,2019-03-26
7503,서울,강남구,7,0,1,8,7,0,2019-04-26
7504,서울,강남구,3,2,0,5,4,0,2019-05-26
7505,서울,강남구,10,1,4,15,11,0,2019-06-26
7506,서울,강남구,11,0,1,12,8,0,2019-07-26
7507,서울,강남구,15,0,2,17,14,0,2019-08-26
7508,서울,강남구,14,1,4,19,13,0,2019-09-26
7509,서울,강남구,6,2,1,9,8,0,2019-10-26
7510,서울,강남구,13,3,5,21,15,0,2019-11-26
7511,서울,강남구,8,0,2,10,8,0,2019-12-26
7512,서울,강동구,7,1,2,10,8,0,2019-01-26
7513,서울,강동구,0,0,0,0,0,0,2019-02-26
7514,서울,강동구,4,1,1,6,6,0,2019-03-26
7515,서울,강동구,7,4,1,12,10,0,2019-04-26
7516,서울,강동구,4,0,2,6,3,0,2019-05-26
7517,서울,강동구,5,0,1,6,4,0,2019-06-26
7518,서울,강동구,4,2,0,6,6,0,2019-07-26
7519,서울,강동구,2,0,2,4,4,0,2019-08-26
7520,서울,강동구,3,0,1,4,4,0,2019-09-26
7521,서울,강동구,1,0,2,3,3,0,2019-10-26
7522,서울,강동구,6,1,3,10,8,0,2019-11-26
7523,서울,강동구,0,0,0,0,0,0,2019-12-26
7524,서울,강북구,0,0,0,0,0,0,2019-01-26
7525,서울,강북구,5,0,1,6,4,0,2019-02-26
7526,서울,강북구,3,0,0,3,2,0,2019-03-26
7527,서울,강북구,5,0,0,5,3,0,2019-04-26
7528,서울,강북구,1,0,1,2,2,0,2019-05-26
7529,서울,강북구,3,0,1,4,3,0,2019-06-26
7530,서울,강북구,2,0,2,4,3,0,2019-07-26
7531,서울,강북구,6,0,1,7,3,0,2019-08-26
7532,서울,강북구,3,0,0,3,3,0,2019-09-26
7533,서울,강북구,3,0,1,4,3,0,2019-10-26
7534,서울,강북구,10,0,0,10,6,0,2019-11-26
7535,서울,강북구,2,0,3,5,5,0,2019-12-26
7536,서울,강서구,6,0,0,6,6,0,2019-01-26
7537,서울,강서구,1,0,1,2,2,0,2019-02-26
7538,서울,강서구,3,0,1,4,3,0,2019-03-26
7539,서울,강서구,4,0,0,4,4,0,2019-04-26
7540,서울,강서구,5,1,0,6,1,0,2019-05-26
7541,서울,강서구,7,1,0,8,6,0,2019-06-26
7542,서울,강서구,5,0,0,5,4,0,2019-07-26
7543,서울,강서구,2,0,1,3,3,0,2019-08-26
7544,서울,강서구,2,0,1,3,3,0,2019-09-26
7545,서울,강서구,6,2,0,8,7,0,2019-10-26
7546,서울,강서구,5,0,2,7,6,0,2019-11-26
7547,서울,강서구,5,0,2,7,4,0,2019-12-26
7548,서울,관악구,1,0,0,1,1,0,2019-01-26
7549,서울,관악구,1,1,0,2,2,0,2019-02-26
7550,서울,관악구,3,0,0,3,3,0,2019-03-26
7551,서울,관악구,9,0,3,12,10,0,2019-04-26
7552,서울,관악구,6,0,1,7,4,0,2019-05-26
7553,서울,관악구,2,0,2,4,4,0,2019-06-26
7554,서울,관악구,2,0,1,3,1,0,2019-07-26
7555,서울,관악구,1,0,0,1,1,0,2019-08-26
7556,서울,관악구,0,0,0,0,0,0,2019-09-26
7557,서울,관악구,2,0,2,4,4,0,2019-10-26
7558,서울,관악구,2,0,2,4,4,0,2019-11-26
7559,서울,관악구,3,0,1,4,3,0,2019-12-26
7560,서울,광진구,1,0,0,1,1,0,2019-01-26
7561,서울,광진구,1,0,0,1,1,0,2019-02-26
7562,서울,광진구,3,0,0,3,2,0,2019-03-26
7563,서울,광진구,3,0,2,5,4,0,2019-04-26
7564,서울,광진구,2,0,0,2,2,0,2019-05-26
7565,서울,광진구,2,1,0,3,2,0,2019-06-26
7566,서울,광진구,0,0,1,1,1,0,2019-07-26
7567,서울,광진구,2,0,0,2,2,0,2019-08-26
7568,서울,광진구,1,0,0,1,1,0,2019-09-26
7569,서울,광진구,2,0,2,4,3,0,2019-10-26
7570,서울,광진구,5,0,0,5,3,0,2019-11-26
7571,서울,광진구,3,0,0,3,3,0,2019-12-26
7572,서울,구로구,1,0,2,3,3,0,2019-01-26
7573,서울,구로구,6,0,0,6,4,0,2019-02-26
7574,서울,구로구,3,0,1,4,2,0,2019-03-26
7575,서울,구로구,4,2,2,8,8,0,2019-04-26
7576,서울,구로구,4,0,1,5,3,0,2019-05-26
7577,서울,구로구,3,0,1,4,4,0,2019-06-26
7578,서울,구로구,2,0,3,5,4,0,2019-07-26
7579,서울,구로구,3,1,2,6,5,0,2019-08-26
7580,서울,구로구,5,0,1,6,6,0,2019-09-26
7581,서울,구로구,7,1,2,10,5,0,2019-10-26
7582,서울,구로구,4,0,0,4,4,0,2019-11-26
7583,서울,구로구,8,1,1,10,6,0,2019-12-26
7584,서울,금천구,1,1,0,2,2,0,2019-01-26
7585,서울,금천구,2,0,0,2,1,0,2019-02-26
7586,서울,금천구,1,0,1,2,1,0,2019-03-26
7587,서울,금천구,0,0,0,0,0,0,2019-04-26
7588,서울,금천구,0,0,0,0,0,0,2019-05-26
7589,서울,금천구,1,0,0,1,1,0,2019-06-26
7590,서울,금천구,1,0,2,3,3,0,2019-07-26
7591,서울,금천구,3,0,1,4,3,0,2019-08-26
7592,서울,금천구,0,0,1,1,1,0,2019-09-26
7593,서울,금천구,2,0,0,2,2,0,2019-10-26
7594,서울,금천구,2,0,0,2,2,0,2019-11-26
7595,서울,금천구,1,0,0,1,1,0,2019-12-26
7596,서울,노원구,4,1,3,8,7,0,2019-01-26
7597,서울,노원구,2,0,2,4,4,0,2019-02-26
7598,서울,노원구,8,0,0,8,5,0,2019-03-26
7599,서울,노원구,11,3,0,14,7,0,2019-04-26
7600,서울,노원구,1,1,2,4,3,0,2019-05-26
7601,서울,노원구,5,0,0,5,4,0,2019-06-26
7602,서울,노원구,6,0,3,9,8,1,2019-07-26
7603,서울,노원구,6,2,1,9,6,0,2019-08-26
7604,서울,노원구,2,0,0,2,2,0,2019-09-26
7605,서울,노원구,1,0,1,2,2,0,2019-10-26
7606,서울,노원구,2,0,1,3,3,0,2019-11-26
7607,서울,노원구,8,0,1,9,5,0,2019-12-26
7608,서울,도봉구,2,0,0,2,1,0,2019-01-26
7609,서울,도봉구,1,0,0,1,1,0,2019-02-26
7610,서울,도봉구,2,0,1,3,2,0,2019-03-26
7611,서울,도봉구,2,0,1,3,3,0,2019-04-26
7612,서울,도봉구,3,0,0,3,2,0,2019-05-26
7613,서울,도봉구,0,1,0,1,1,0,2019-06-26
7614,서울,도봉구,0,0,3,3,3,0,2019-07-26
7615,서울,도봉구,4,4,1,9,5,0,2019-08-26
7616,서울,도봉구,1,1,0,2,2,0,2019-09-26
7617,서울,도봉구,1,0,0,1,1,0,2019-10-26
7618,서울,도봉구,0,0,0,0,0,0,2019-11-26
7619,서울,도봉구,8,0,5,13,3,0,2019-12-26
7620,서울,동대문구,4,0,1,5,4,0,2019-01-26
7621,서울,동대문구,2,0,1,3,3,0,2019-02-26
7622,서울,동대문구,2,0,0,2,2,0,2019-03-26
7623,서울,동대문구,0,1,1,2,2,0,2019-04-26
7624,서울,동대문구,6,0,2,8,7,0,2019-05-26
7625,서울,동대문구,6,0,2,8,7,1,2019-06-26
7626,서울,동대문구,1,0,1,2,2,0,2019-07-26
7627,서울,동대문구,5,2,0,7,7,0,2019-08-26
7628,서울,동대문구,2,2,3,7,6,0,2019-09-26
7629,서울,동대문구,4,2,1,7,6,0,2019-10-26
7630,서울,동대문구,4,0,4,8,5,0,2019-11-26
7631,서울,동대문구,5,0,0,5,3,0,2019-12-26
7632,서울,동작구,5,0,0,5,5,0,2019-01-26
7633,서울,동작구,2,1,1,4,4,0,2019-02-26
7634,서울,동작구,1,0,1,2,2,0,2019-03-26
7635,서울,동작구,2,2,3,7,7,0,2019-04-26
7636,서울,동작구,4,0,0,4,4,0,2019-05-26
7637,서울,동작구,3,1,0,4,3,0,2019-06-26
7638,서울,동작구,6,1,0,7,6,0,2019-07-26
7639,서울,동작구,2,0,0,2,1,0,2019-08-26
7640,서울,동작구,5,1,1,7,6,0,2019-09-26
7641,서울,동작구,8,0,2,10,6,0,2019-10-26
7642,서울,동작구,3,1,1,5,4,0,2019-11-26
7643,서울,동작구,3,0,2,5,5,0,2019-12-26
7644,서울,마포구,4,0,1,5,4,0,2019-01-26
7645,서울,마포구,5,0,0,5,5,0,2019-02-26
7646,서울,마포구,1,0,1,2,2,0,2019-03-26
7647,서울,마포구,1,0,1,2,1,0,2019-04-26
7648,서울,마포구,8,2,1,11,9,0,2019-05-26
7649,서울,마포구,2,0,3,5,4,0,2019-06-26
7650,서울,마포구,5,1,1,7,6,0,2019-07-26
7651,서울,마포구,3,0,0,3,3,0,2019-08-26
7652,서울,마포구,2,0,0,2,2,0,2019-09-26
7653,서울,마포구,5,0,2,7,6,0,2019-10-26
7654,서울,마포구,5,1,0,6,2,0,2019-11-26
7655,서울,마포구,4,2,1,7,6,0,2019-12-26
7656,서울,서대문구,4,1,1,6,4,0,2019-01-26
7657,서울,서대문구,2,1,0,3,2,0,2019-02-26
7658,서울,서대문구,2,1,3,6,4,0,2019-03-26
7659,서울,서대문구,10,3,0,13,9,0,2019-04-26
7660,서울,서대문구,1,1,0,2,2,0,2019-05-26
7661,서울,서대문구,3,0,0,3,3,0,2019-06-26
7662,서울,서대문구,2,0,2,4,4,0,2019-07-26
7663,서울,서대문구,6,1,1,8,5,0,2019-08-26
7664,서울,서대문구,7,3,1,11,4,0,2019-09-26
7665,서울,서대문구,0,0,1,1,2,1,2019-10-26
7666,서울,서대문구,0,1,1,2,2,0,2019-11-26
7667,서울,서대문구,1,2,0,3,3,0,2019-12-26
7668,서울,서초구,22,0,5,27,10,0,2019-01-26
7669,서울,서초구,8,0,0,8,8,0,2019-02-26
7670,서울,서초구,4,0,1,5,5,0,2019-03-26
7671,서울,서초구,4,0,2,6,5,0,2019-04-26
7672,서울,서초구,4,0,0,4,3,0,2019-05-26
7673,서울,서초구,6,0,4,10,9,0,2019-06-26
7674,서울,서초구,11,1,3,15,11,1,2019-07-26
7675,서울,서초구,1,1,0,2,2,0,2019-08-26
7676,서울,서초구,10,0,0,10,7,0,2019-09-26
7677,서울,서초구,8,0,1,9,7,0,2019-10-26
7678,서울,서초구,11,2,3,16,12,0,2019-11-26
7679,서울,서초구,4,1,2,7,6,0,2019-12-26
7680,서울,성동구,2,0,1,3,2,0,2019-01-26
7681,서울,성동구,2,0,2,4,3,0,2019-02-26
7682,서울,성동구,0,0,1,1,1,0,2019-03-26
7683,서울,성동구,0,0,1,1,1,0,2019-04-26
7684,서울,성동구,0,0,1,1,1,0,2019-05-26
7685,서울,성동구,3,0,1,4,3,0,2019-06-26
7686,서울,성동구,3,0,0,3,3,0,2019-07-26
7687,서울,성동구,4,0,1,5,3,0,2019-08-26
7688,서울,성동구,4,0,0,4,2,0,2019-09-26
7689,서울,성동구,8,0,1,9,3,0,2019-10-26
7690,서울,성동구,4,0,1,5,2,0,2019-11-26
7691,서울,성동구,1,0,0,1,1,0,2019-12-26
7692,서울,성북구,6,0,1,7,5,0,2019-01-26
7693,서울,성북구,2,0,2,4,4,0,2019-02-26
7694,서울,성북구,4,1,0,5,5,0,2019-03-26
7695,서울,성북구,7,0,1,8,5,0,2019-04-26
7696,서울,성북구,5,1,0,6,3,0,2019-05-26
7697,서울,성북구,3,0,2,5,5,0,2019-06-26
7698,서울,성북구,7,0,3,10,8,0,2019-07-26
7699,서울,성북구,5,0,1,6,5,0,2019-08-26
7700,서울,성북구,4,0,2,6,6,0,2019-09-26
7701,서울,성북구,2,0,0,2,2,0,2019-10-26
7702,서울,성북구,1,1,2,4,4,0,2019-11-26
7703,서울,성북구,0,0,0,0,0,0,2019-12-26
7704,서울,송파구,3,2,1,6,6,0,2019-01-26
7705,서울,송파구,14,3,2,19,11,0,2019-02-26
7706,서울,송파구,9,1,3,13,10,0,2019-03-26
7707,서울,송파구,6,0,1,7,5,0,2019-04-26
7708,서울,송파구,4,1,1,6,5,0,2019-05-26
7709,서울,송파구,3,1,3,7,5,0,2019-06-26
7710,서울,송파구,5,4,4,13,6,0,2019-07-26
7711,서울,송파구,7,2,5,14,9,0,2019-08-26
7712,서울,송파구,13,1,2,16,9,0,2019-09-26
7713,서울,송파구,4,3,3,10,7,0,2019-10-26
7714,서울,송파구,8,0,1,9,8,0,2019-11-26
7715,서울,송파구,5,0,0,5,5,0,2019-12-26
7716,서울,양천구,2,0,0,2,2,0,2019-01-26
7717,서울,양천구,3,0,0,3,3,0,2019-02-26
7718,서울,양천구,1,1,1,3,3,0,2019-03-26
7719,서울,양천구,1,0,1,2,2,0,2019-04-26
7720,서울,양천구,1,0,0,1,1,0,2019-05-26
7721,서울,양천구,6,1,2,9,8,0,2019-06-26
7722,서울,양천구,0,0,0,0,0,0,2019-07-26
7723,서울,양천구,8,0,1,9,7,0,2019-08-26
7724,서울,양천구,5,1,0,6,5,0,2019-09-26
7725,서울,양천구,6,1,1,8,6,0,2019-10-26
7726,서울,양천구,4,1,2,7,5,0,2019-11-26
7727,서울,양천구,5,1,2,8,5,0,2019-12-26
7728,서울,영등포구,4,1,1,6,3,0,2019-01-26
7729,서울,영등포구,6,0,2,8,7,0,2019-02-26
7730,서울,영등포구,6,0,3,9,8,0,2019-03-26
7731,서울,영등포구,9,1,1,11,9,0,2019-04-26
7732,서울,영등포구,5,1,0,6,4,0,2019-05-26
7733,서울,영등포구,3,0,0,3,2,0,2019-06-26
7734,서울,영등포구,8,0,2,10,8,0,2019-07-26
7735,서울,영등포구,5,2,0,7,6,0,2019-08-26
7736,서울,영등포구,6,0,2,8,7,0,2019-09-26
7737,서울,영등포구,11,0,0,11,9,0,2019-10-26
7738,서울,영등포구,2,0,0,2,2,0,2019-11-26
7739,서울,영등포구,4,0,2,6,4,0,2019-12-26
7740,서울,용산구,3,0,1,4,4,0,2019-01-26
7741,서울,용산구,0,0,1,1,1,0,2019-02-26
7742,서울,용산구,1,0,0,1,1,0,2019-03-26
7743,서울,용산구,7,0,1,8,5,0,2019-04-26
7744,서울,용산구,4,0,2,6,2,0,2019-05-26
7745,서울,용산구,3,0,0,3,3,0,2019-06-26
7746,서울,용산구,3,0,1,4,3,0,2019-07-26
7747,서울,용산구,1,0,0,1,1,0,2019-08-26
7748,서울,용산구,1,0,2,3,2,0,2019-09-26
7749,서울,용산구,2,0,1,3,3,0,2019-10-26
7750,서울,용산구,7,0,0,7,6,0,2019-11-26
7751,서울,용산구,0,1,0,1,1,0,2019-12-26
7752,서울,은평구,2,0,0,2,2,0,2019-01-26
7753,서울,은평구,0,0,0,0,0,0,2019-02-26
7754,서울,은평구,1,0,1,2,2,0,2019-03-26
7755,서울,은평구,4,0,2,6,6,0,2019-04-26
7756,서울,은평구,1,1,0,2,2,0,2019-05-26
7757,서울,은평구,0,0,0,0,0,0,2019-06-26
7758,서울,은평구,3,0,0,3,2,0,2019-07-26
7759,서울,은평구,1,0,3,4,5,1,2019-08-26
7760,서울,은평구,7,0,1,8,6,0,2019-09-26
7761,서울,은평구,1,0,2,3,3,0,2019-10-26
7762,서울,은평구,2,0,0,2,2,0,2019-11-26
7763,서울,은평구,2,0,1,3,4,1,2019-12-26
7764,서울,종로구,1,0,0,1,1,0,2019-01-26
7765,서울,종로구,1,1,2,4,4,0,2019-02-26
7766,서울,종로구,3,0,1,4,3,1,2019-03-26
7767,서울,종로구,7,2,3,12,5,0,2019-04-26
7768,서울,종로구,3,0,0,3,2,0,2019-05-26
7769,서울,종로구,1,0,0,1,1,0,2019-06-26
7770,서울,종로구,2,0,0,2,1,0,2019-07-26
7771,서울,종로구,1,0,0,1,1,0,2019-08-26
7772,서울,종로구,3,1,0,4,3,0,2019-09-26
7773,서울,종로구,1,0,0,1,1,0,2019-10-26
7774,서울,종로구,2,1,2,5,3,0,2019-11-26
7775,서울,종로구,6,0,0,6,6,0,2019-12-26
7776,서울,중구,3,0,2,5,5,0,2019-01-26
7777,서울,중구,4,0,0,4,3,0,2019-02-26
7778,서울,중구,9,1,2,12,8,0,2019-03-26
7779,서울,중구,7,0,1,8,7,0,2019-04-26
7780,서울,중구,1,2,0,3,1,0,2019-05-26
7781,서울,중구,5,0,0,5,4,0,2019-06-26
7782,서울,중구,8,0,0,8,4,0,2019-07-26
7783,서울,중구,2,0,2,4,4,0,2019-08-26
7784,서울,중구,3,0,0,3,2,0,2019-09-26
7785,서울,중구,2,1,2,5,3,0,2019-10-26
7786,서울,중구,3,1,1,5,3,0,2019-11-26
7787,서울,중구,0,0,0,0,0,0,2019-12-26
7788,서울,중랑구,2,0,0,2,2,0,2019-01-26
7789,서울,중랑구,8,1,0,9,8,0,2019-02-26
7790,서울,중랑구,7,1,2,10,7,0,2019-03-26
7791,서울,중랑구,4,2,0,6,4,0,2019-04-26
7792,서울,중랑구,3,1,0,4,4,0,2019-05-26
7793,서울,중랑구,3,5,0,8,5,0,2019-06-26
7794,서울,중랑구,4,0,1,5,2,0,2019-07-26
7795,서울,중랑구,11,2,4,17,11,0,2019-08-26
7796,서울,중랑구,5,0,3,8,8,0,2019-09-26
7797,서울,중랑구,5,2,0,7,6,0,2019-10-26
7798,서울,중랑구,9,0,2,11,6,0,2019-11-26
7799,서울,중랑구,2,0,2,4,4,0,2019-12-26
7800,서울,강남구,9,2,1,12,7,0,2019-01-27
7801,서울,강남구,5,1,2,8,8,0,2019-02-27
7802,서울,강남구,12,1,1,14,10,1,2019-03-27
7803,서울,강남구,8,1,0,9,7,0,2019-04-27
7804,서울,강남구,10,0,2,12,10,0,2019-05-27
7805,서울,강남구,17,1,1,19,13,0,2019-06-27
7806,서울,강남구,23,6,1,30,19,0,2019-07-27
7807,서울,강남구,15,1,2,18,13,0,2019-08-27
7808,서울,강남구,10,1,5,16,11,0,2019-09-27
7809,서울,강남구,6,0,2,8,7,0,2019-10-27
7810,서울,강남구,13,2,1,16,13,0,2019-11-27
7811,서울,강남구,10,1,1,12,9,0,2019-12-27
7812,서울,강동구,2,0,0,2,1,0,2019-01-27
7813,서울,강동구,0,0,0,0,0,0,2019-02-27
7814,서울,강동구,2,0,1,3,3,0,2019-03-27
7815,서울,강동구,3,1,1,5,4,0,2019-04-27
7816,서울,강동구,5,0,3,8,7,0,2019-05-27
7817,서울,강동구,6,1,1,8,7,0,2019-06-27
7818,서울,강동구,3,0,1,4,5,1,2019-07-27
7819,서울,강동구,6,0,0,6,4,0,2019-08-27
7820,서울,강동구,2,0,0,2,2,0,2019-09-27
7821,서울,강동구,1,0,0,1,1,0,2019-10-27
7822,서울,강동구,5,1,1,7,6,0,2019-11-27
7823,서울,강동구,6,0,2,8,6,0,2019-12-27
7824,서울,강북구,3,0,0,3,2,0,2019-01-27
7825,서울,강북구,3,0,0,3,3,0,2019-02-27
7826,서울,강북구,2,0,1,3,2,0,2019-03-27
7827,서울,강북구,4,0,2,6,4,0,2019-04-27
7828,서울,강북구,3,0,0,3,3,0,2019-05-27
7829,서울,강북구,6,0,1,7,7,0,2019-06-27
7830,서울,강북구,1,0,2,3,2,0,2019-07-27
7831,서울,강북구,6,2,0,8,5,0,2019-08-27
7832,서울,강북구,2,0,0,2,2,0,2019-09-27
7833,서울,강북구,3,0,1,4,4,0,2019-10-27
7834,서울,강북구,2,0,2,4,2,0,2019-11-27
7835,서울,강북구,2,0,0,2,2,0,2019-12-27
7836,서울,강서구,1,1,2,4,4,0,2019-01-27
7837,서울,강서구,1,1,1,3,3,0,2019-02-27
7838,서울,강서구,2,0,1,3,2,0,2019-03-27
7839,서울,강서구,4,3,1,8,3,0,2019-04-27
7840,서울,강서구,14,2,0,16,5,0,2019-05-27
7841,서울,강서구,7,0,1,8,6,0,2019-06-27
7842,서울,강서구,3,1,2,6,4,0,2019-07-27
7843,서울,강서구,11,1,3,15,13,0,2019-08-27
7844,서울,강서구,5,2,1,8,4,0,2019-09-27
7845,서울,강서구,4,0,1,5,4,0,2019-10-27
7846,서울,강서구,5,1,3,9,5,0,2019-11-27
7847,서울,강서구,4,1,1,6,5,0,2019-12-27
7848,서울,관악구,1,0,1,2,2,0,2019-01-27
7849,서울,관악구,3,0,0,3,3,0,2019-02-27
7850,서울,관악구,1,0,1,2,2,0,2019-03-27
7851,서울,관악구,3,1,0,4,4,0,2019-04-27
7852,서울,관악구,2,0,0,2,1,0,2019-05-27
7853,서울,관악구,5,2,3,10,7,0,2019-06-27
7854,서울,관악구,10,0,0,10,8,0,2019-07-27
7855,서울,관악구,2,0,2,4,4,0,2019-08-27
7856,서울,관악구,7,1,1,9,5,0,2019-09-27
7857,서울,관악구,4,1,2,7,5,0,2019-10-27
7858,서울,관악구,7,0,1,8,6,0,2019-11-27
7859,서울,관악구,1,0,1,2,2,0,2019-12-27
7860,서울,광진구,2,0,0,2,2,0,2019-01-27
7861,서울,광진구,2,0,0,2,2,0,2019-02-27
7862,서울,광진구,2,0,0,2,2,0,2019-03-27
7863,서울,광진구,6,0,2,8,7,0,2019-04-27
7864,서울,광진구,2,0,0,2,2,0,2019-05-27
7865,서울,광진구,1,0,0,1,1,0,2019-06-27
7866,서울,광진구,2,0,0,2,1,0,2019-07-27
7867,서울,광진구,5,1,1,7,3,0,2019-08-27
7868,서울,광진구,2,0,0,2,2,0,2019-09-27
7869,서울,광진구,3,0,0,3,2,0,2019-10-27
7870,서울,광진구,2,0,1,3,2,0,2019-11-27
7871,서울,광진구,2,0,2,4,4,0,2019-12-27
7872,서울,구로구,3,0,2,5,5,0,2019-01-27
7873,서울,구로구,3,0,0,3,3,0,2019-02-27
7874,서울,구로구,3,0,1,4,4,0,2019-03-27
7875,서울,구로구,7,0,3,10,6,0,2019-04-27
7876,서울,구로구,5,3,0,8,6,0,2019-05-27
7877,서울,구로구,7,3,0,10,6,0,2019-06-27
7878,서울,구로구,0,0,0,0,0,0,2019-07-27
7879,서울,구로구,1,0,1,2,2,0,2019-08-27
7880,서울,구로구,8,1,3,12,8,0,2019-09-27
7881,서울,구로구,4,0,2,6,4,0,2019-10-27
7882,서울,구로구,3,0,1,4,4,0,2019-11-27
7883,서울,구로구,6,0,1,7,4,0,2019-12-27
7884,서울,금천구,3,0,0,3,2,0,2019-01-27
7885,서울,금천구,0,0,1,1,1,0,2019-02-27
7886,서울,금천구,2,0,1,3,2,0,2019-03-27
7887,서울,금천구,3,0,0,3,3,0,2019-04-27
7888,서울,금천구,1,0,1,2,2,0,2019-05-27
7889,서울,금천구,0,0,0,0,0,0,2019-06-27
7890,서울,금천구,5,0,1,6,4,0,2019-07-27
7891,서울,금천구,2,0,2,4,3,0,2019-08-27
7892,서울,금천구,0,1,1,2,2,0,2019-09-27
7893,서울,금천구,6,0,1,7,3,0,2019-10-27
7894,서울,금천구,3,0,1,4,4,0,2019-11-27
7895,서울,금천구,5,0,3,8,2,0,2019-12-27
7896,서울,노원구,4,0,1,5,3,0,2019-01-27
7897,서울,노원구,1,0,1,2,2,0,2019-02-27
7898,서울,노원구,1,0,1,2,1,0,2019-03-27
7899,서울,노원구,5,0,0,5,3,0,2019-04-27
7900,서울,노원구,2,0,1,3,2,0,2019-05-27
7901,서울,노원구,2,1,1,4,4,0,2019-06-27
7902,서울,노원구,3,0,1,4,3,0,2019-07-27
7903,서울,노원구,6,0,1,7,6,0,2019-08-27
7904,서울,노원구,20,0,0,20,7,0,2019-09-27
7905,서울,노원구,3,1,0,4,4,0,2019-10-27
7906,서울,노원구,3,0,1,4,4,0,2019-11-27
7907,서울,노원구,7,4,0,11,8,0,2019-12-27
7908,서울,도봉구,2,0,0,2,2,0,2019-01-27
7909,서울,도봉구,1,0,0,1,1,0,2019-02-27
7910,서울,도봉구,1,0,0,1,1,0,2019-03-27
7911,서울,도봉구,2,0,0,2,1,0,2019-04-27
7912,서울,도봉구,4,1,0,5,2,0,2019-05-27
7913,서울,도봉구,0,0,2,2,2,0,2019-06-27
7914,서울,도봉구,0,0,0,0,0,0,2019-07-27
7915,서울,도봉구,1,0,0,1,1,0,2019-08-27
7916,서울,도봉구,0,0,0,0,0,0,2019-09-27
7917,서울,도봉구,7,0,1,8,5,0,2019-10-27
7918,서울,도봉구,5,4,1,10,5,0,2019-11-27
7919,서울,도봉구,0,0,2,2,2,0,2019-12-27
7920,서울,동대문구,1,0,4,5,3,0,2019-01-27
7921,서울,동대문구,2,0,0,2,2,0,2019-02-27
7922,서울,동대문구,3,0,2,5,5,0,2019-03-27
7923,서울,동대문구,1,0,0,1,1,0,2019-04-27
7924,서울,동대문구,4,0,1,5,4,0,2019-05-27
7925,서울,동대문구,3,0,3,6,5,0,2019-06-27
7926,서울,동대문구,6,0,2,8,6,0,2019-07-27
7927,서울,동대문구,3,0,1,4,4,1,2019-08-27
7928,서울,동대문구,9,0,1,10,5,0,2019-09-27
7929,서울,동대문구,10,0,1,11,7,0,2019-10-27
7930,서울,동대문구,1,0,1,2,2,0,2019-11-27
7931,서울,동대문구,1,1,0,2,2,0,2019-12-27
7932,서울,동작구,0,0,1,1,1,0,2019-01-27
7933,서울,동작구,0,0,0,0,0,0,2019-02-27
7934,서울,동작구,0,0,3,3,3,0,2019-03-27
7935,서울,동작구,2,3,2,7,5,0,2019-04-27
7936,서울,동작구,5,1,0,6,2,0,2019-05-27
7937,서울,동작구,6,1,2,9,4,0,2019-06-27
7938,서울,동작구,0,1,1,2,2,0,2019-07-27
7939,서울,동작구,3,0,1,4,3,0,2019-08-27
7940,서울,동작구,1,2,4,7,5,0,2019-09-27
7941,서울,동작구,2,0,0,2,2,0,2019-10-27
7942,서울,동작구,1,1,0,2,1,0,2019-11-27
7943,서울,동작구,4,1,1,6,5,0,2019-12-27
7944,서울,마포구,3,0,0,3,1,0,2019-01-27
7945,서울,마포구,0,0,0,0,0,0,2019-02-27
7946,서울,마포구,2,0,0,2,1,0,2019-03-27
7947,서울,마포구,4,1,1,6,4,0,2019-04-27
7948,서울,마포구,13,0,1,14,7,0,2019-05-27
7949,서울,마포구,3,0,4,7,6,0,2019-06-27
7950,서울,마포구,4,0,0,4,3,0,2019-07-27
7951,서울,마포구,7,0,0,7,5,0,2019-08-27
7952,서울,마포구,3,1,0,4,4,0,2019-09-27
7953,서울,마포구,11,0,1,12,7,0,2019-10-27
7954,서울,마포구,5,1,0,6,3,0,2019-11-27
7955,서울,마포구,2,0,0,2,2,0,2019-12-27
7956,서울,서대문구,0,0,0,0,0,0,2019-01-27
7957,서울,서대문구,2,1,1,4,4,0,2019-02-27
7958,서울,서대문구,3,0,0,3,3,0,2019-03-27
7959,서울,서대문구,2,3,0,5,3,0,2019-04-27
7960,서울,서대문구,2,1,2,5,5,0,2019-05-27
7961,서울,서대문구,1,3,1,5,4,0,2019-06-27
7962,서울,서대문구,2,3,2,7,5,0,2019-07-27
7963,서울,서대문구,2,0,0,2,1,0,2019-08-27
7964,서울,서대문구,7,3,0,10,7,0,2019-09-27
7965,서울,서대문구,1,1,0,2,1,0,2019-10-27
7966,서울,서대문구,3,1,0,4,3,0,2019-11-27
7967,서울,서대문구,0,0,0,0,0,0,2019-12-27
7968,서울,서초구,2,0,0,2,2,0,2019-01-27
7969,서울,서초구,1,1,2,4,4,0,2019-02-27
7970,서울,서초구,8,0,2,10,7,0,2019-03-27
7971,서울,서초구,6,0,0,6,4,0,2019-04-27
7972,서울,서초구,12,1,1,14,10,0,2019-05-27
7973,서울,서초구,11,0,2,13,9,0,2019-06-27
7974,서울,서초구,8,1,1,10,6,0,2019-07-27
7975,서울,서초구,14,2,2,18,11,0,2019-08-27
7976,서울,서초구,8,0,1,9,8,1,2019-09-27
7977,서울,서초구,12,0,0,12,6,0,2019-10-27
7978,서울,서초구,5,2,0,7,6,1,2019-11-27
7979,서울,서초구,3,1,0,4,3,0,2019-12-27
7980,서울,성동구,2,1,1,4,2,0,2019-01-27
7981,서울,성동구,2,0,0,2,2,0,2019-02-27
7982,서울,성동구,1,0,0,1,1,0,2019-03-27
7983,서울,성동구,5,1,0,6,5,0,2019-04-27
7984,서울,성동구,0,0,0,0,0,0,2019-05-27
7985,서울,성동구,0,0,0,0,0,0,2019-06-27
7986,서울,성동구,3,0,0,3,3,0,2019-07-27
7987,서울,성동구,0,0,1,1,1,0,2019-08-27
7988,서울,성동구,0,1,2,3,3,0,2019-09-27
7989,서울,성동구,3,0,0,3,3,0,2019-10-27
7990,서울,성동구,1,0,0,1,1,0,2019-11-27
7991,서울,성동구,2,1,1,4,3,0,2019-12-27
7992,서울,성북구,5,1,1,7,4,0,2019-01-27
7993,서울,성북구,2,0,3,5,4,0,2019-02-27
7994,서울,성북구,1,2,0,3,3,0,2019-03-27
7995,서울,성북구,7,0,0,7,3,0,2019-04-27
7996,서울,성북구,5,0,0,5,4,0,2019-05-27
7997,서울,성북구,1,0,0,1,1,0,2019-06-27
7998,서울,성북구,3,1,2,6,4,0,2019-07-27
7999,서울,성북구,2,0,0,2,2,0,2019-08-27
8000,서울,성북구,6,0,1,7,4,0,2019-09-27
8001,서울,성북구,2,0,0,2,1,0,2019-10-27
8002,서울,성북구,3,0,0,3,3,0,2019-11-27
8003,서울,성북구,11,0,3,14,5,0,2019-12-27
8004,서울,송파구,5,2,1,8,6,0,2019-01-27
8005,서울,송파구,9,2,1,12,10,1,2019-02-27
8006,서울,송파구,8,0,1,9,6,0,2019-03-27
8007,서울,송파구,6,0,4,10,9,0,2019-04-27
8008,서울,송파구,9,0,6,15,9,0,2019-05-27
8009,서울,송파구,9,0,3,12,10,0,2019-06-27
8010,서울,송파구,3,1,1,5,5,0,2019-07-27
8011,서울,송파구,3,1,4,8,7,0,2019-08-27
8012,서울,송파구,13,2,1,16,12,0,2019-09-27
8013,서울,송파구,22,0,0,22,15,0,2019-10-27
8014,서울,송파구,9,0,0,9,8,0,2019-11-27
8015,서울,송파구,4,2,4,10,8,0,2019-12-27
8016,서울,양천구,2,0,0,2,2,0,2019-01-27
8017,서울,양천구,2,0,2,4,3,0,2019-02-27
8018,서울,양천구,1,1,1,3,3,0,2019-03-27
8019,서울,양천구,4,0,0,4,3,0,2019-04-27
8020,서울,양천구,3,0,0,3,3,0,2019-05-27
8021,서울,양천구,2,0,0,2,2,0,2019-06-27
8022,서울,양천구,2,0,1,3,3,0,2019-07-27
8023,서울,양천구,8,1,3,12,9,0,2019-08-27
8024,서울,양천구,2,1,1,4,4,0,2019-09-27
8025,서울,양천구,3,1,2,6,2,0,2019-10-27
8026,서울,양천구,3,0,0,3,2,0,2019-11-27
8027,서울,양천구,1,0,2,3,3,0,2019-12-27
8028,서울,영등포구,2,1,3,6,4,0,2019-01-27
8029,서울,영등포구,1,0,0,1,1,0,2019-02-27
8030,서울,영등포구,0,2,0,2,2,0,2019-03-27
8031,서울,영등포구,6,0,2,8,6,0,2019-04-27
8032,서울,영등포구,6,1,0,7,6,0,2019-05-27
8033,서울,영등포구,5,0,0,5,5,1,2019-06-27
8034,서울,영등포구,12,1,0,13,7,0,2019-07-27
8035,서울,영등포구,3,2,1,6,4,0,2019-08-27
8036,서울,영등포구,10,0,3,13,9,0,2019-09-27
8037,서울,영등포구,10,1,3,14,9,0,2019-10-27
8038,서울,영등포구,8,1,2,11,7,0,2019-11-27
8039,서울,영등포구,4,2,1,7,7,0,2019-12-27
8040,서울,용산구,4,0,3,7,5,0,2019-01-27
8041,서울,용산구,2,0,2,4,2,0,2019-02-27
8042,서울,용산구,3,0,0,3,2,0,2019-03-27
8043,서울,용산구,2,1,1,4,4,0,2019-04-27
8044,서울,용산구,5,0,0,5,2,0,2019-05-27
8045,서울,용산구,2,0,1,3,3,0,2019-06-27
8046,서울,용산구,4,0,0,4,3,0,2019-07-27
8047,서울,용산구,4,0,0,4,2,0,2019-08-27
8048,서울,용산구,5,0,0,5,4,0,2019-09-27
8049,서울,용산구,13,0,1,14,7,0,2019-10-27
8050,서울,용산구,2,0,0,2,2,0,2019-11-27
8051,서울,용산구,3,0,1,4,3,0,2019-12-27
8052,서울,은평구,1,0,3,4,4,0,2019-01-27
8053,서울,은평구,2,1,2,5,3,0,2019-02-27
8054,서울,은평구,1,0,3,4,4,0,2019-03-27
8055,서울,은평구,3,0,2,5,4,0,2019-04-27
8056,서울,은평구,6,0,2,8,5,0,2019-05-27
8057,서울,은평구,2,0,1,3,3,0,2019-06-27
8058,서울,은평구,6,0,1,7,5,0,2019-07-27
8059,서울,은평구,1,0,1,2,2,0,2019-08-27
8060,서울,은평구,4,1,5,10,3,0,2019-09-27
8061,서울,은평구,3,1,0,4,3,0,2019-10-27
8062,서울,은평구,4,2,1,7,7,0,2019-11-27
8063,서울,은평구,5,0,1,6,6,0,2019-12-27
8064,서울,종로구,0,0,0,0,0,0,2019-01-27
8065,서울,종로구,3,0,1,4,4,0,2019-02-27
8066,서울,종로구,4,2,1,7,7,0,2019-03-27
8067,서울,종로구,1,0,0,1,1,0,2019-04-27
8068,서울,종로구,6,0,0,6,3,0,2019-05-27
8069,서울,종로구,2,1,0,3,3,0,2019-06-27
8070,서울,종로구,3,0,0,3,3,0,2019-07-27
8071,서울,종로구,2,2,1,5,5,0,2019-08-27
8072,서울,종로구,4,0,1,5,5,0,2019-09-27
8073,서울,종로구,0,0,0,0,0,0,2019-10-27
8074,서울,종로구,2,0,1,3,3,0,2019-11-27
8075,서울,종로구,2,0,0,2,1,0,2019-12-27
8076,서울,중구,0,0,2,2,1,0,2019-01-27
8077,서울,중구,6,0,3,9,8,0,2019-02-27
8078,서울,중구,1,0,0,1,1,0,2019-03-27
8079,서울,중구,3,0,1,4,3,0,2019-04-27
8080,서울,중구,4,0,0,4,3,0,2019-05-27
8081,서울,중구,4,0,4,8,6,0,2019-06-27
8082,서울,중구,5,1,1,7,6,0,2019-07-27
8083,서울,중구,1,0,2,3,3,0,2019-08-27
8084,서울,중구,2,0,1,3,3,0,2019-09-27
8085,서울,중구,2,0,0,2,2,0,2019-10-27
8086,서울,중구,7,1,1,9,7,0,2019-11-27
8087,서울,중구,0,0,0,0,0,0,2019-12-27
8088,서울,중랑구,0,0,0,0,0,0,2019-01-27
8089,서울,중랑구,1,1,3,5,5,0,2019-02-27
8090,서울,중랑구,4,1,0,5,5,0,2019-03-27
8091,서울,중랑구,9,1,0,10,7,0,2019-04-27
8092,서울,중랑구,1,1,1,3,3,0,2019-05-27
8093,서울,중랑구,2,1,0,3,2,0,2019-06-27
8094,서울,중랑구,2,1,2,5,3,0,2019-07-27
8095,서울,중랑구,0,1,0,1,1,0,2019-08-27
8096,서울,중랑구,6,0,1,7,8,1,2019-09-27
8097,서울,중랑구,0,0,3,3,2,0,2019-10-27
8098,서울,중랑구,3,2,1,6,6,0,2019-11-27
8099,서울,중랑구,3,0,0,3,2,0,2019-12-27
8100,서울,강남구,10,0,2,12,10,0,2019-01-28
8101,서울,강남구,9,0,4,13,11,0,2019-02-28
8102,서울,강남구,8,2,3,13,7,0,2019-03-28
8103,서울,강남구,1,0,2,3,3,0,2019-04-28
8104,서울,강남구,11,3,2,16,14,0,2019-05-28
8105,서울,강남구,15,2,1,18,13,0,2019-06-28
8106,서울,강남구,15,0,1,16,9,0,2019-07-28
8107,서울,강남구,8,0,0,8,8,0,2019-08-28
8108,서울,강남구,10,3,2,15,14,0,2019-09-28
8109,서울,강남구,9,2,3,14,12,0,2019-10-28
8110,서울,강남구,17,1,5,23,16,0,2019-11-28
8111,서울,강남구,20,1,3,24,14,0,2019-12-28
8112,서울,강동구,2,0,0,2,2,0,2019-01-28
8113,서울,강동구,5,0,0,5,5,0,2019-02-28
8114,서울,강동구,4,0,2,6,5,0,2019-03-28
8115,서울,강동구,1,0,1,2,2,0,2019-04-28
8116,서울,강동구,3,0,3,6,6,0,2019-05-28
8117,서울,강동구,4,3,0,7,6,0,2019-06-28
8118,서울,강동구,3,0,1,4,3,0,2019-07-28
8119,서울,강동구,5,0,0,5,3,0,2019-08-28
8120,서울,강동구,2,0,2,4,2,0,2019-09-28
8121,서울,강동구,1,0,0,1,1,0,2019-10-28
8122,서울,강동구,6,1,1,8,3,0,2019-11-28
8123,서울,강동구,8,1,0,9,7,0,2019-12-28
8124,서울,강북구,3,0,0,3,3,0,2019-01-28
8125,서울,강북구,8,0,2,10,8,0,2019-02-28
8126,서울,강북구,1,0,0,1,1,0,2019-03-28
8127,서울,강북구,2,1,0,3,3,0,2019-04-28
8128,서울,강북구,7,0,2,9,6,0,2019-05-28
8129,서울,강북구,3,0,1,4,4,0,2019-06-28
8130,서울,강북구,0,0,0,0,0,0,2019-07-28
8131,서울,강북구,4,0,1,5,4,0,2019-08-28
8132,서울,강북구,3,0,1,4,3,0,2019-09-28
8133,서울,강북구,5,0,1,6,5,0,2019-10-28
8134,서울,강북구,3,0,2,5,4,0,2019-11-28
8135,서울,강북구,12,0,3,15,5,0,2019-12-28
8136,서울,강서구,2,1,0,3,3,0,2019-01-28
8137,서울,강서구,2,0,2,4,4,0,2019-02-28
8138,서울,강서구,10,0,3,13,5,0,2019-03-28
8139,서울,강서구,2,0,1,3,2,0,2019-04-28
8140,서울,강서구,2,0,3,5,5,0,2019-05-28
8141,서울,강서구,7,0,2,9,9,0,2019-06-28
8142,서울,강서구,0,0,1,1,1,0,2019-07-28
8143,서울,강서구,9,1,3,13,8,0,2019-08-28
8144,서울,강서구,8,1,2,11,9,0,2019-09-28
8145,서울,강서구,10,0,2,12,11,2,2019-10-28
8146,서울,강서구,2,0,0,2,2,0,2019-11-28
8147,서울,강서구,1,2,2,5,3,0,2019-12-28
8148,서울,관악구,7,2,1,10,7,0,2019-01-28
8149,서울,관악구,5,0,1,6,4,0,2019-02-28
8150,서울,관악구,3,0,2,5,4,0,2019-03-28
8151,서울,관악구,5,1,4,10,6,0,2019-04-28
8152,서울,관악구,5,0,2,7,7,0,2019-05-28
8153,서울,관악구,3,1,1,5,5,0,2019-06-28
8154,서울,관악구,2,0,0,2,2,0,2019-07-28
8155,서울,관악구,4,0,2,6,5,0,2019-08-28
8156,서울,관악구,6,0,1,7,6,0,2019-09-28
8157,서울,관악구,4,0,1,5,5,0,2019-10-28
8158,서울,관악구,2,0,1,3,3,0,2019-11-28
8159,서울,관악구,2,0,1,3,3,0,2019-12-28
8160,서울,광진구,1,0,1,2,2,0,2019-01-28
8161,서울,광진구,2,0,0,2,2,0,2019-02-28
8162,서울,광진구,2,0,1,3,3,0,2019-03-28
8163,서울,광진구,1,1,0,2,2,0,2019-04-28
8164,서울,광진구,2,0,0,2,2,0,2019-05-28
8165,서울,광진구,1,0,0,1,1,0,2019-06-28
8166,서울,광진구,5,0,1,6,4,0,2019-07-28
8167,서울,광진구,2,0,1,3,2,0,2019-08-28
8168,서울,광진구,2,0,1,3,3,0,2019-09-28
8169,서울,광진구,1,0,0,1,1,0,2019-10-28
8170,서울,광진구,5,0,0,5,4,0,2019-11-28
8171,서울,광진구,1,0,0,1,1,0,2019-12-28
8172,서울,구로구,2,0,1,3,3,0,2019-01-28
8173,서울,구로구,8,1,0,9,7,0,2019-02-28
8174,서울,구로구,3,0,1,4,2,0,2019-03-28
8175,서울,구로구,5,2,1,8,5,0,2019-04-28
8176,서울,구로구,2,1,0,3,3,0,2019-05-28
8177,서울,구로구,5,3,3,11,7,0,2019-06-28
8178,서울,구로구,2,0,1,3,3,0,2019-07-28
8179,서울,구로구,2,1,0,3,3,0,2019-08-28
8180,서울,구로구,3,1,1,5,4,0,2019-09-28
8181,서울,구로구,2,0,4,6,5,0,2019-10-28
8182,서울,구로구,3,0,1,4,3,0,2019-11-28
8183,서울,구로구,7,0,2,9,7,0,2019-12-28
8184,서울,금천구,14,0,1,15,8,0,2019-01-28
8185,서울,금천구,1,0,3,4,4,0,2019-02-28
8186,서울,금천구,5,0,0,5,5,0,2019-03-28
8187,서울,금천구,6,0,0,6,4,0,2019-04-28
8188,서울,금천구,4,0,1,5,5,0,2019-05-28
8189,서울,금천구,3,0,0,3,3,0,2019-06-28
8190,서울,금천구,0,1,2,3,2,0,2019-07-28
8191,서울,금천구,3,0,0,3,1,0,2019-08-28
8192,서울,금천구,7,0,2,9,1,0,2019-09-28
8193,서울,금천구,3,0,0,3,2,0,2019-10-28
8194,서울,금천구,1,0,1,2,1,0,2019-11-28
8195,서울,금천구,1,0,3,4,3,0,2019-12-28
8196,서울,노원구,8,0,1,9,6,0,2019-01-28
8197,서울,노원구,2,0,0,2,2,0,2019-02-28
8198,서울,노원구,2,1,1,4,4,0,2019-03-28
8199,서울,노원구,7,1,3,11,9,0,2019-04-28
8200,서울,노원구,5,1,2,8,8,0,2019-05-28
8201,서울,노원구,6,0,0,6,4,0,2019-06-28
8202,서울,노원구,1,0,2,3,3,0,2019-07-28
8203,서울,노원구,1,0,2,3,3,0,2019-08-28
8204,서울,노원구,6,0,2,8,3,0,2019-09-28
8205,서울,노원구,2,0,0,2,2,0,2019-10-28
8206,서울,노원구,4,0,1,5,3,0,2019-11-28
8207,서울,노원구,2,0,2,4,3,0,2019-12-28
8208,서울,도봉구,2,2,0,4,3,0,2019-01-28
8209,서울,도봉구,0,0,1,1,1,0,2019-02-28
8210,서울,도봉구,0,0,2,2,2,0,2019-03-28
8211,서울,도봉구,0,0,0,0,0,0,2019-04-28
8212,서울,도봉구,1,0,1,2,1,0,2019-05-28
8213,서울,도봉구,2,0,1,3,3,0,2019-06-28
8214,서울,도봉구,2,0,2,4,4,0,2019-07-28
8215,서울,도봉구,2,0,0,2,1,0,2019-08-28
8216,서울,도봉구,0,0,1,1,1,0,2019-09-28
8217,서울,도봉구,5,0,0,5,3,0,2019-10-28
8218,서울,도봉구,1,0,0,1,1,0,2019-11-28
8219,서울,도봉구,0,0,2,2,2,0,2019-12-28
8220,서울,동대문구,1,0,1,2,2,0,2019-01-28
8221,서울,동대문구,3,0,0,3,3,0,2019-02-28
8222,서울,동대문구,5,2,3,10,7,0,2019-03-28
8223,서울,동대문구,3,0,2,5,3,0,2019-04-28
8224,서울,동대문구,10,1,0,11,5,0,2019-05-28
8225,서울,동대문구,1,0,0,1,1,0,2019-06-28
8226,서울,동대문구,2,0,2,4,3,0,2019-07-28
8227,서울,동대문구,6,0,1,7,6,0,2019-08-28
8228,서울,동대문구,5,0,0,5,4,0,2019-09-28
8229,서울,동대문구,2,0,0,2,2,0,2019-10-28
8230,서울,동대문구,3,0,2,5,5,0,2019-11-28
8231,서울,동대문구,3,0,0,3,2,0,2019-12-28
8232,서울,동작구,1,0,1,2,2,0,2019-01-28
8233,서울,동작구,1,0,1,2,2,0,2019-02-28
8234,서울,동작구,1,0,0,1,1,0,2019-03-28
8235,서울,동작구,0,0,0,0,0,0,2019-04-28
8236,서울,동작구,9,1,1,11,7,0,2019-05-28
8237,서울,동작구,2,0,4,6,4,0,2019-06-28
8238,서울,동작구,7,1,3,11,5,0,2019-07-28
8239,서울,동작구,7,2,0,9,6,0,2019-08-28
8240,서울,동작구,4,0,1,5,4,0,2019-09-28
8241,서울,동작구,2,0,0,2,2,0,2019-10-28
8242,서울,동작구,0,0,2,2,2,0,2019-11-28
8243,서울,동작구,7,0,3,10,2,0,2019-12-28
8244,서울,마포구,1,0,1,2,2,0,2019-01-28
8245,서울,마포구,3,0,3,6,6,0,2019-02-28
8246,서울,마포구,8,1,1,10,7,0,2019-03-28
8247,서울,마포구,1,0,0,1,1,0,2019-04-28
8248,서울,마포구,4,0,0,4,3,0,2019-05-28
8249,서울,마포구,5,0,0,5,5,0,2019-06-28
8250,서울,마포구,6,0,0,6,2,0,2019-07-28
8251,서울,마포구,0,0,1,1,1,0,2019-08-28
8252,서울,마포구,4,0,1,5,5,0,2019-09-28
8253,서울,마포구,3,0,0,3,1,0,2019-10-28
8254,서울,마포구,4,0,2,6,4,0,2019-11-28
8255,서울,마포구,3,1,2,6,5,0,2019-12-28
8256,서울,서대문구,4,0,3,7,4,0,2019-01-28
8257,서울,서대문구,2,0,0,2,2,0,2019-02-28
8258,서울,서대문구,0,0,0,0,0,0,2019-03-28
8259,서울,서대문구,4,0,0,4,3,0,2019-04-28
8260,서울,서대문구,2,0,0,2,2,0,2019-05-28
8261,서울,서대문구,2,1,1,4,3,0,2019-06-28
8262,서울,서대문구,1,1,0,2,1,0,2019-07-28
8263,서울,서대문구,0,0,6,6,3,0,2019-08-28
8264,서울,서대문구,4,1,1,6,3,0,2019-09-28
8265,서울,서대문구,5,1,2,8,5,0,2019-10-28
8266,서울,서대문구,2,0,2,4,4,0,2019-11-28
8267,서울,서대문구,1,1,0,2,1,0,2019-12-28
8268,서울,서초구,7,1,2,10,7,0,2019-01-28
8269,서울,서초구,6,0,1,7,5,0,2019-02-28
8270,서울,서초구,10,0,1,11,9,0,2019-03-28
8271,서울,서초구,8,4,4,16,7,0,2019-04-28
8272,서울,서초구,7,0,3,10,10,0,2019-05-28
8273,서울,서초구,3,0,2,5,4,0,2019-06-28
8274,서울,서초구,0,0,0,0,0,0,2019-07-28
8275,서울,서초구,14,0,0,14,10,0,2019-08-28
8276,서울,서초구,5,0,2,7,6,0,2019-09-28
8277,서울,서초구,2,2,0,4,4,0,2019-10-28
8278,서울,서초구,8,2,7,17,10,0,2019-11-28
8279,서울,서초구,7,1,0,8,6,0,2019-12-28
8280,서울,성동구,4,0,1,5,5,0,2019-01-28
8281,서울,성동구,6,0,0,6,2,0,2019-02-28
8282,서울,성동구,3,0,0,3,3,0,2019-03-28
8283,서울,성동구,10,0,1,11,4,0,2019-04-28
8284,서울,성동구,0,1,2,3,3,0,2019-05-28
8285,서울,성동구,5,0,2,7,5,0,2019-06-28
8286,서울,성동구,4,0,0,4,1,0,2019-07-28
8287,서울,성동구,0,0,0,0,0,0,2019-08-28
8288,서울,성동구,7,0,3,10,7,0,2019-09-28
8289,서울,성동구,1,0,0,1,1,0,2019-10-28
8290,서울,성동구,3,0,1,4,4,0,2019-11-28
8291,서울,성동구,3,1,2,6,5,0,2019-12-28
8292,서울,성북구,4,0,4,8,5,0,2019-01-28
8293,서울,성북구,4,0,1,5,4,0,2019-02-28
8294,서울,성북구,4,0,1,5,4,0,2019-03-28
8295,서울,성북구,4,0,1,5,4,0,2019-04-28
8296,서울,성북구,2,1,1,4,4,0,2019-05-28
8297,서울,성북구,10,0,4,14,9,0,2019-06-28
8298,서울,성북구,4,0,2,6,4,0,2019-07-28
8299,서울,성북구,3,2,0,5,3,0,2019-08-28
8300,서울,성북구,3,0,4,7,6,0,2019-09-28
8301,서울,성북구,6,0,2,8,8,0,2019-10-28
8302,서울,성북구,4,2,0,6,5,0,2019-11-28
8303,서울,성북구,7,0,1,8,7,0,2019-12-28
8304,서울,송파구,9,2,5,16,9,0,2019-01-28
8305,서울,송파구,14,0,1,15,10,0,2019-02-28
8306,서울,송파구,4,0,1,5,4,0,2019-03-28
8307,서울,송파구,3,1,1,5,2,0,2019-04-28
8308,서울,송파구,6,3,3,12,8,0,2019-05-28
8309,서울,송파구,12,1,1,14,12,0,2019-06-28
8310,서울,송파구,0,0,3,3,3,0,2019-07-28
8311,서울,송파구,11,1,1,13,10,0,2019-08-28
8312,서울,송파구,14,2,6,22,14,0,2019-09-28
8313,서울,송파구,11,25,0,36,8,0,2019-10-28
8314,서울,송파구,3,0,2,5,5,0,2019-11-28
8315,서울,송파구,3,0,0,3,3,0,2019-12-28
8316,서울,양천구,4,0,1,5,5,0,2019-01-28
8317,서울,양천구,1,1,1,3,2,0,2019-02-28
8318,서울,양천구,16,0,3,19,9,0,2019-03-28
8319,서울,양천구,7,2,3,12,3,0,2019-04-28
8320,서울,양천구,2,1,0,3,3,0,2019-05-28
8321,서울,양천구,3,0,1,4,4,0,2019-06-28
8322,서울,양천구,3,0,2,5,5,0,2019-07-28
8323,서울,양천구,3,0,0,3,3,0,2019-08-28
8324,서울,양천구,5,0,3,8,7,0,2019-09-28
8325,서울,양천구,4,0,1,5,4,0,2019-10-28
8326,서울,양천구,2,1,2,5,5,0,2019-11-28
8327,서울,양천구,0,0,0,0,0,0,2019-12-28
8328,서울,영등포구,4,2,0,6,5,0,2019-01-28
8329,서울,영등포구,6,0,0,6,5,0,2019-02-28
8330,서울,영등포구,8,0,2,10,8,0,2019-03-28
8331,서울,영등포구,3,2,0,5,3,0,2019-04-28
8332,서울,영등포구,11,1,2,14,9,0,2019-05-28
8333,서울,영등포구,7,2,5,14,12,0,2019-06-28
8334,서울,영등포구,4,0,4,8,4,0,2019-07-28
8335,서울,영등포구,10,1,0,11,9,0,2019-08-28
8336,서울,영등포구,18,1,3,22,9,0,2019-09-28
8337,서울,영등포구,7,1,1,9,7,0,2019-10-28
8338,서울,영등포구,6,0,0,6,5,0,2019-11-28
8339,서울,영등포구,6,0,1,7,6,0,2019-12-28
8340,서울,용산구,1,0,1,2,2,0,2019-01-28
8341,서울,용산구,1,0,0,1,1,0,2019-02-28
8342,서울,용산구,2,0,0,2,2,0,2019-03-28
8343,서울,용산구,4,2,0,6,5,0,2019-04-28
8344,서울,용산구,0,0,1,1,1,0,2019-05-28
8345,서울,용산구,2,0,0,2,2,0,2019-06-28
8346,서울,용산구,0,0,0,0,0,0,2019-07-28
8347,서울,용산구,1,0,0,1,1,0,2019-08-28
8348,서울,용산구,8,0,2,10,7,0,2019-09-28
8349,서울,용산구,0,0,1,1,1,0,2019-10-28
8350,서울,용산구,3,0,0,3,3,0,2019-11-28
8351,서울,용산구,4,0,0,4,3,0,2019-12-28
8352,서울,은평구,3,0,2,5,2,0,2019-01-28
8353,서울,은평구,4,1,1,6,5,0,2019-02-28
8354,서울,은평구,1,0,1,2,2,0,2019-03-28
8355,서울,은평구,2,0,1,3,3,0,2019-04-28
8356,서울,은평구,6,0,0,6,6,0,2019-05-28
8357,서울,은평구,2,4,3,9,8,0,2019-06-28
8358,서울,은평구,7,1,0,8,5,0,2019-07-28
8359,서울,은평구,0,0,0,0,0,0,2019-08-28
8360,서울,은평구,2,0,2,4,2,0,2019-09-28
8361,서울,은평구,2,0,1,3,3,0,2019-10-28
8362,서울,은평구,6,1,0,7,3,0,2019-11-28
8363,서울,은평구,2,1,0,3,2,0,2019-12-28
8364,서울,종로구,4,0,0,4,3,0,2019-01-28
8365,서울,종로구,2,0,0,2,2,0,2019-02-28
8366,서울,종로구,1,1,1,3,3,0,2019-03-28
8367,서울,종로구,3,0,0,3,1,0,2019-04-28
8368,서울,종로구,1,0,0,1,1,0,2019-05-28
8369,서울,종로구,4,0,1,5,3,0,2019-06-28
8370,서울,종로구,1,0,0,1,1,0,2019-07-28
8371,서울,종로구,7,4,3,14,8,0,2019-08-28
8372,서울,종로구,3,0,0,3,2,0,2019-09-28
8373,서울,종로구,0,0,0,0,0,0,2019-10-28
8374,서울,종로구,1,1,1,3,3,0,2019-11-28
8375,서울,종로구,2,0,0,2,1,0,2019-12-28
8376,서울,중구,9,0,2,11,8,0,2019-01-28
8377,서울,중구,0,0,0,0,0,0,2019-02-28
8378,서울,중구,5,0,1,6,6,0,2019-03-28
8379,서울,중구,2,0,2,4,3,0,2019-04-28
8380,서울,중구,7,2,0,9,6,0,2019-05-28
8381,서울,중구,4,1,2,7,7,0,2019-06-28
8382,서울,중구,4,1,0,5,3,0,2019-07-28
8383,서울,중구,2,2,0,4,2,0,2019-08-28
8384,서울,중구,3,0,0,3,2,0,2019-09-28
8385,서울,중구,4,0,1,5,4,0,2019-10-28
8386,서울,중구,2,1,1,4,3,0,2019-11-28
8387,서울,중구,1,0,0,1,1,0,2019-12-28
8388,서울,중랑구,3,1,2,6,5,0,2019-01-28
8389,서울,중랑구,6,1,2,9,6,0,2019-02-28
8390,서울,중랑구,1,0,0,1,1,0,2019-03-28
8391,서울,중랑구,0,2,0,2,2,0,2019-04-28
8392,서울,중랑구,2,0,3,5,4,1,2019-05-28
8393,서울,중랑구,3,1,0,4,4,0,2019-06-28
8394,서울,중랑구,10,0,1,11,4,0,2019-07-28
8395,서울,중랑구,4,0,0,4,4,0,2019-08-28
8396,서울,중랑구,0,2,3,5,4,0,2019-09-28
8397,서울,중랑구,1,0,1,2,2,0,2019-10-28
8398,서울,중랑구,1,0,1,2,2,0,2019-11-28
8399,서울,중랑구,2,1,0,3,2,0,2019-12-28
8400,서울,강남구,8,2,2,12,9,0,2019-01-29
8402,서울,강남구,14,1,1,16,13,0,2019-03-29
8403,서울,강남구,8,3,0,11,9,0,2019-04-29
8404,서울,강남구,12,2,5,19,11,0,2019-05-29
8405,서울,강남구,14,0,1,15,12,0,2019-06-29
8406,서울,강남구,7,0,0,7,7,0,2019-07-29
8407,서울,강남구,21,0,4,25,16,0,2019-08-29
8408,서울,강남구,8,3,5,16,10,0,2019-09-29
8409,서울,강남구,12,1,0,13,9,0,2019-10-29
8410,서울,강남구,11,1,4,16,14,0,2019-11-29
8411,서울,강남구,18,1,0,19,9,0,2019-12-29
8412,서울,강동구,2,0,0,2,2,0,2019-01-29
8414,서울,강동구,3,0,0,3,1,0,2019-03-29
8415,서울,강동구,3,0,2,5,4,0,2019-04-29
8416,서울,강동구,4,0,1,5,4,0,2019-05-29
8417,서울,강동구,4,1,0,5,4,0,2019-06-29
8418,서울,강동구,3,0,2,5,5,0,2019-07-29
8419,서울,강동구,1,0,0,1,2,1,2019-08-29
8420,서울,강동구,6,2,0,8,4,0,2019-09-29
8421,서울,강동구,3,0,0,3,3,0,2019-10-29
8422,서울,강동구,1,3,4,8,7,0,2019-11-29
8423,서울,강동구,0,0,0,0,0,0,2019-12-29
8424,서울,강북구,5,0,1,6,5,0,2019-01-29
8426,서울,강북구,7,0,2,9,8,0,2019-03-29
8427,서울,강북구,1,0,1,2,2,0,2019-04-29
8428,서울,강북구,2,0,1,3,3,0,2019-05-29
8429,서울,강북구,6,0,0,6,4,0,2019-06-29
8430,서울,강북구,3,0,0,3,3,0,2019-07-29
8431,서울,강북구,1,0,0,1,1,0,2019-08-29
8432,서울,강북구,8,0,0,8,3,0,2019-09-29
8433,서울,강북구,1,0,1,2,2,0,2019-10-29
8434,서울,강북구,6,0,0,6,6,0,2019-11-29
8435,서울,강북구,0,0,0,0,0,0,2019-12-29
8436,서울,강서구,2,0,0,2,2,0,2019-01-29
8438,서울,강서구,3,0,2,5,4,0,2019-03-29
8439,서울,강서구,3,0,0,3,3,0,2019-04-29
8440,서울,강서구,3,1,1,5,4,0,2019-05-29
8441,서울,강서구,7,0,1,8,6,0,2019-06-29
8442,서울,강서구,1,1,0,2,2,0,2019-07-29
8443,서울,강서구,8,1,0,9,8,1,2019-08-29
8444,서울,강서구,3,2,0,5,4,0,2019-09-29
8445,서울,강서구,3,0,1,4,4,0,2019-10-29
8446,서울,강서구,2,0,2,4,4,0,2019-11-29
8447,서울,강서구,3,0,3,6,4,0,2019-12-29
8448,서울,관악구,1,0,3,4,3,0,2019-01-29
8450,서울,관악구,14,0,2,16,7,0,2019-03-29
8451,서울,관악구,1,0,1,2,2,0,2019-04-29
8452,서울,관악구,4,0,0,4,4,0,2019-05-29
8453,서울,관악구,6,1,0,7,4,0,2019-06-29
8454,서울,관악구,0,0,2,2,2,0,2019-07-29
8455,서울,관악구,6,0,3,9,7,0,2019-08-29
8456,서울,관악구,1,0,0,1,1,0,2019-09-29
8457,서울,관악구,3,0,0,3,3,0,2019-10-29
8458,서울,관악구,8,0,1,9,5,0,2019-11-29
8459,서울,관악구,5,0,1,6,5,0,2019-12-29
8460,서울,광진구,3,0,0,3,3,0,2019-01-29
8462,서울,광진구,1,0,0,1,1,0,2019-03-29
8463,서울,광진구,4,3,1,8,7,0,2019-04-29
8464,서울,광진구,3,0,0,3,3,0,2019-05-29
8465,서울,광진구,6,0,1,7,4,0,2019-06-29
8466,서울,광진구,2,0,0,2,1,0,2019-07-29
8467,서울,광진구,5,1,0,6,4,0,2019-08-29
8468,서울,광진구,5,2,2,9,6,0,2019-09-29
8469,서울,광진구,5,0,1,6,3,0,2019-10-29
8470,서울,광진구,4,0,3,7,5,0,2019-11-29
8471,서울,광진구,8,0,2,10,4,0,2019-12-29
8472,서울,구로구,2,0,3,5,5,0,2019-01-29
8474,서울,구로구,4,0,1,5,4,0,2019-03-29
8475,서울,구로구,6,0,0,6,6,0,2019-04-29
8476,서울,구로구,5,0,1,6,5,0,2019-05-29
8477,서울,구로구,10,0,2,12,8,0,2019-06-29
8478,서울,구로구,7,0,0,7,5,0,2019-07-29
8479,서울,구로구,4,0,1,5,5,0,2019-08-29
8480,서울,구로구,2,0,0,2,2,0,2019-09-29
8481,서울,구로구,3,0,0,3,3,0,2019-10-29
8482,서울,구로구,6,0,2,8,7,0,2019-11-29
8483,서울,구로구,0,0,0,0,0,0,2019-12-29
8484,서울,금천구,3,0,0,3,2,0,2019-01-29
8486,서울,금천구,0,1,0,1,1,0,2019-03-29
8487,서울,금천구,1,0,1,2,2,0,2019-04-29
8488,서울,금천구,3,1,1,5,4,0,2019-05-29
8489,서울,금천구,5,0,0,5,3,0,2019-06-29
8490,서울,금천구,3,1,0,4,4,0,2019-07-29
8491,서울,금천구,4,0,2,6,5,0,2019-08-29
8492,서울,금천구,1,0,2,3,3,0,2019-09-29
8493,서울,금천구,11,0,2,13,7,0,2019-10-29
8494,서울,금천구,1,0,0,1,1,0,2019-11-29
8495,서울,금천구,1,0,1,2,2,0,2019-12-29
8496,서울,노원구,2,0,0,2,2,0,2019-01-29
8498,서울,노원구,7,1,3,11,8,0,2019-03-29
8499,서울,노원구,5,0,0,5,5,0,2019-04-29
8500,서울,노원구,3,0,1,4,4,0,2019-05-29
8501,서울,노원구,2,1,1,4,4,0,2019-06-29
8502,서울,노원구,5,2,1,8,5,0,2019-07-29
8503,서울,노원구,2,0,3,5,5,0,2019-08-29
8504,서울,노원구,2,1,2,5,4,0,2019-09-29
8505,서울,노원구,5,0,0,5,4,0,2019-10-29
8506,서울,노원구,9,0,2,11,7,0,2019-11-29
8507,서울,노원구,5,0,1,6,6,0,2019-12-29
8508,서울,도봉구,5,0,0,5,2,0,2019-01-29
8510,서울,도봉구,3,0,2,5,4,0,2019-03-29
8511,서울,도봉구,0,0,1,1,1,0,2019-04-29
8512,서울,도봉구,7,0,0,7,4,0,2019-05-29
8513,서울,도봉구,10,1,1,12,5,0,2019-06-29
8514,서울,도봉구,0,1,1,2,1,0,2019-07-29
8515,서울,도봉구,4,1,0,5,3,0,2019-08-29
8516,서울,도봉구,0,1,1,2,2,0,2019-09-29
8517,서울,도봉구,3,1,0,4,2,0,2019-10-29
8518,서울,도봉구,2,0,0,2,2,0,2019-11-29
8519,서울,도봉구,0,0,0,0,0,0,2019-12-29
8520,서울,동대문구,0,1,1,2,2,0,2019-01-29
8522,서울,동대문구,8,0,3,11,7,0,2019-03-29
8523,서울,동대문구,5,1,3,9,6,0,2019-04-29
8524,서울,동대문구,1,0,0,1,1,0,2019-05-29
8525,서울,동대문구,6,1,0,7,7,0,2019-06-29
8526,서울,동대문구,2,1,0,3,3,0,2019-07-29
8527,서울,동대문구,4,2,0,6,5,0,2019-08-29
8528,서울,동대문구,2,1,4,7,4,0,2019-09-29
8529,서울,동대문구,5,1,1,7,4,0,2019-10-29
8530,서울,동대문구,2,0,0,2,2,0,2019-11-29
8531,서울,동대문구,4,0,1,5,6,1,2019-12-29
8532,서울,동작구,3,0,0,3,2,0,2019-01-29
8534,서울,동작구,3,0,1,4,4,0,2019-03-29
8535,서울,동작구,4,0,0,4,3,0,2019-04-29
8536,서울,동작구,4,1,3,8,6,0,2019-05-29
8537,서울,동작구,10,4,1,15,8,0,2019-06-29
8538,서울,동작구,4,1,0,5,3,0,2019-07-29
8539,서울,동작구,5,0,0,5,4,0,2019-08-29
8540,서울,동작구,2,1,0,3,2,0,2019-09-29
8541,서울,동작구,3,0,1,4,4,0,2019-10-29
8542,서울,동작구,5,0,1,6,4,0,2019-11-29
8543,서울,동작구,3,0,0,3,2,0,2019-12-29
8544,서울,마포구,4,0,1,5,5,0,2019-01-29
8546,서울,마포구,9,0,2,11,9,0,2019-03-29
8547,서울,마포구,3,0,0,3,3,0,2019-04-29
8548,서울,마포구,1,0,4,5,2,0,2019-05-29
8549,서울,마포구,7,1,3,11,6,0,2019-06-29
8550,서울,마포구,7,0,1,8,9,1,2019-07-29
8551,서울,마포구,1,1,0,2,2,0,2019-08-29
8552,서울,마포구,3,0,0,3,3,1,2019-09-29
8553,서울,마포구,4,1,1,6,4,0,2019-10-29
8554,서울,마포구,1,0,0,1,1,0,2019-11-29
8555,서울,마포구,3,1,1,5,4,0,2019-12-29
8556,서울,서대문구,2,0,1,3,2,0,2019-01-29
8558,서울,서대문구,2,0,1,3,3,0,2019-03-29
8559,서울,서대문구,5,0,0,5,3,0,2019-04-29
8560,서울,서대문구,3,2,0,5,3,0,2019-05-29
8561,서울,서대문구,1,1,0,2,2,0,2019-06-29
8562,서울,서대문구,2,1,0,3,2,0,2019-07-29
8563,서울,서대문구,5,0,2,7,6,1,2019-08-29
8564,서울,서대문구,7,1,1,9,6,1,2019-09-29
8565,서울,서대문구,2,1,0,3,2,0,2019-10-29
8566,서울,서대문구,1,2,1,4,2,0,2019-11-29
8567,서울,서대문구,0,1,0,1,1,0,2019-12-29
8568,서울,서초구,12,1,2,15,7,0,2019-01-29
8570,서울,서초구,3,1,0,4,4,0,2019-03-29
8571,서울,서초구,3,1,0,4,4,0,2019-04-29
8572,서울,서초구,4,2,2,8,5,0,2019-05-29
8573,서울,서초구,5,0,0,5,4,0,2019-06-29
8574,서울,서초구,8,2,0,10,9,1,2019-07-29
8575,서울,서초구,9,1,2,12,8,0,2019-08-29
8576,서울,서초구,7,0,1,8,5,0,2019-09-29
8577,서울,서초구,12,0,3,15,11,0,2019-10-29
8578,서울,서초구,14,2,3,19,13,0,2019-11-29
8579,서울,서초구,7,1,2,10,5,0,2019-12-29
8580,서울,성동구,3,0,4,7,5,0,2019-01-29
8582,서울,성동구,10,0,1,11,9,0,2019-03-29
8583,서울,성동구,2,0,2,4,3,0,2019-04-29
8584,서울,성동구,7,0,2,9,6,0,2019-05-29
8585,서울,성동구,5,0,1,6,4,0,2019-06-29
8586,서울,성동구,2,0,0,2,2,0,2019-07-29
8587,서울,성동구,2,0,1,3,3,0,2019-08-29
8588,서울,성동구,4,0,5,9,5,0,2019-09-29
8589,서울,성동구,4,0,1,5,4,0,2019-10-29
8590,서울,성동구,0,1,1,2,2,0,2019-11-29
8591,서울,성동구,1,0,0,1,1,0,2019-12-29
8592,서울,성북구,4,0,1,5,5,0,2019-01-29
8594,서울,성북구,6,1,1,8,5,0,2019-03-29
8595,서울,성북구,1,0,1,2,2,0,2019-04-29
8596,서울,성북구,3,1,0,4,4,0,2019-05-29
8597,서울,성북구,8,0,1,9,5,0,2019-06-29
8598,서울,성북구,9,0,1,10,5,0,2019-07-29
8599,서울,성북구,7,0,1,8,7,0,2019-08-29
8600,서울,성북구,9,0,2,11,5,0,2019-09-29
8601,서울,성북구,3,0,1,4,3,0,2019-10-29
8602,서울,성북구,5,0,3,8,8,0,2019-11-29
8603,서울,성북구,0,0,1,1,1,0,2019-12-29
8604,서울,송파구,8,0,2,10,9,0,2019-01-29
8606,서울,송파구,4,0,0,4,4,0,2019-03-29
8607,서울,송파구,2,0,0,2,2,0,2019-04-29
8608,서울,송파구,9,2,3,14,10,0,2019-05-29
8609,서울,송파구,13,1,2,16,13,0,2019-06-29
8610,서울,송파구,14,2,2,18,14,0,2019-07-29
8611,서울,송파구,7,2,3,12,8,0,2019-08-29
8612,서울,송파구,11,2,3,16,10,0,2019-09-29
8613,서울,송파구,6,1,3,10,9,0,2019-10-29
8614,서울,송파구,10,0,3,13,9,0,2019-11-29
8615,서울,송파구,1,2,3,6,5,0,2019-12-29
8616,서울,양천구,5,1,1,7,4,0,2019-01-29
8618,서울,양천구,3,0,3,6,5,0,2019-03-29
8619,서울,양천구,1,1,1,3,3,0,2019-04-29
8620,서울,양천구,6,1,0,7,4,0,2019-05-29
8621,서울,양천구,2,0,0,2,2,0,2019-06-29
8622,서울,양천구,0,0,0,0,0,0,2019-07-29
8623,서울,양천구,3,0,0,3,3,0,2019-08-29
8624,서울,양천구,8,0,0,8,5,0,2019-09-29
8625,서울,양천구,10,0,1,11,7,0,2019-10-29
8626,서울,양천구,5,0,2,7,5,0,2019-11-29
8627,서울,양천구,3,0,0,3,3,0,2019-12-29
8628,서울,영등포구,9,0,0,9,9,0,2019-01-29
8630,서울,영등포구,8,1,1,10,8,0,2019-03-29
8631,서울,영등포구,6,1,1,8,5,0,2019-04-29
8632,서울,영등포구,6,0,2,8,6,0,2019-05-29
8633,서울,영등포구,5,1,2,8,7,0,2019-06-29
8634,서울,영등포구,6,0,0,6,6,0,2019-07-29
8635,서울,영등포구,5,0,1,6,6,0,2019-08-29
8636,서울,영등포구,5,1,1,7,6,0,2019-09-29
8637,서울,영등포구,4,0,2,6,6,0,2019-10-29
8638,서울,영등포구,4,0,4,8,5,0,2019-11-29
8639,서울,영등포구,16,0,1,17,6,0,2019-12-29
8640,서울,용산구,6,0,1,7,5,0,2019-01-29
8642,서울,용산구,6,0,2,8,5,0,2019-03-29
8643,서울,용산구,2,0,0,2,2,0,2019-04-29
8644,서울,용산구,0,0,4,4,3,0,2019-05-29
8645,서울,용산구,1,0,0,1,1,0,2019-06-29
8646,서울,용산구,3,0,0,3,4,1,2019-07-29
8647,서울,용산구,8,0,0,8,5,0,2019-08-29
8648,서울,용산구,8,1,1,10,5,0,2019-09-29
8649,서울,용산구,3,0,0,3,2,0,2019-10-29
8650,서울,용산구,2,0,0,2,2,0,2019-11-29
8651,서울,용산구,2,0,3,5,3,0,2019-12-29
8652,서울,은평구,1,0,0,1,1,0,2019-01-29
8654,서울,은평구,8,0,0,8,5,0,2019-03-29
8655,서울,은평구,4,2,1,7,6,0,2019-04-29
8656,서울,은평구,6,1,2,9,9,0,2019-05-29
8657,서울,은평구,1,1,1,3,3,0,2019-06-29
8658,서울,은평구,3,0,0,3,2,0,2019-07-29
8659,서울,은평구,1,0,0,1,1,0,2019-08-29
8660,서울,은평구,4,0,0,4,4,0,2019-09-29
8661,서울,은평구,2,1,0,3,3,0,2019-10-29
8662,서울,은평구,7,0,3,10,6,0,2019-11-29
8663,서울,은평구,0,0,3,3,2,0,2019-12-29
8664,서울,종로구,1,2,0,3,3,0,2019-01-29
8666,서울,종로구,4,0,0,4,4,0,2019-03-29
8667,서울,종로구,0,1,1,2,2,0,2019-04-29
8668,서울,종로구,1,0,1,2,2,0,2019-05-29
8669,서울,종로구,0,0,1,1,1,0,2019-06-29
8670,서울,종로구,2,0,1,3,2,0,2019-07-29
8671,서울,종로구,8,0,0,8,6,0,2019-08-29
8672,서울,종로구,0,0,0,0,0,0,2019-09-29
8673,서울,종로구,1,0,2,3,3,0,2019-10-29
8674,서울,종로구,4,0,2,6,6,0,2019-11-29
8675,서울,종로구,1,0,1,2,2,0,2019-12-29
8676,서울,중구,2,1,0,3,3,1,2019-01-29
8678,서울,중구,2,0,0,2,2,0,2019-03-29
8679,서울,중구,2,1,3,6,4,0,2019-04-29
8680,서울,중구,0,1,0,1,1,0,2019-05-29
8681,서울,중구,0,0,0,0,0,0,2019-06-29
8682,서울,중구,1,0,1,2,2,0,2019-07-29
8683,서울,중구,1,0,0,1,1,0,2019-08-29
8684,서울,중구,3,1,0,4,1,0,2019-09-29
8685,서울,중구,8,2,3,13,9,0,2019-10-29
8686,서울,중구,1,0,3,4,4,0,2019-11-29
8687,서울,중구,3,1,2,6,4,0,2019-12-29
8688,서울,중랑구,4,1,1,6,6,0,2019-01-29
8690,서울,중랑구,0,0,1,1,1,0,2019-03-29
8691,서울,중랑구,4,0,1,5,3,0,2019-04-29
8692,서울,중랑구,5,1,3,9,6,0,2019-05-29
8693,서울,중랑구,4,1,0,5,5,0,2019-06-29
8694,서울,중랑구,0,0,0,0,0,0,2019-07-29
8695,서울,중랑구,2,0,1,3,2,0,2019-08-29
8696,서울,중랑구,2,1,1,4,2,0,2019-09-29
8697,서울,중랑구,4,0,1,5,5,0,2019-10-29
8698,서울,중랑구,10,0,1,11,2,0,2019-11-29
8699,서울,중랑구,3,0,0,3,3,0,2019-12-29
8700,서울,강남구,10,0,1,11,9,0,2019-01-30
8702,서울,강남구,6,3,2,11,9,0,2019-03-30
8703,서울,강남구,8,0,1,9,7,0,2019-04-30
8704,서울,강남구,12,3,2,17,12,0,2019-05-30
8705,서울,강남구,5,1,0,6,3,0,2019-06-30
8706,서울,강남구,6,1,4,11,10,0,2019-07-30
8707,서울,강남구,11,4,2,17,11,0,2019-08-30
8708,서울,강남구,7,1,7,15,13,0,2019-09-30
8709,서울,강남구,14,2,4,20,13,0,2019-10-30
8710,서울,강남구,18,3,4,25,13,0,2019-11-30
8711,서울,강남구,19,1,1,21,12,0,2019-12-30
8712,서울,강동구,1,1,0,2,2,0,2019-01-30
8714,서울,강동구,7,0,4,11,7,0,2019-03-30
8715,서울,강동구,8,2,1,11,9,0,2019-04-30
8716,서울,강동구,0,0,0,0,0,0,2019-05-30
8717,서울,강동구,4,0,0,4,2,0,2019-06-30
8718,서울,강동구,11,0,1,12,7,0,2019-07-30
8719,서울,강동구,0,0,0,0,0,0,2019-08-30
8720,서울,강동구,4,0,0,4,4,0,2019-09-30
8721,서울,강동구,0,0,1,1,1,0,2019-10-30
8722,서울,강동구,4,0,5,9,5,0,2019-11-30
8723,서울,강동구,1,0,0,1,1,0,2019-12-30
8724,서울,강북구,1,0,2,3,3,0,2019-01-30
8726,서울,강북구,1,0,1,2,2,0,2019-03-30
8727,서울,강북구,1,0,1,2,2,0,2019-04-30
8728,서울,강북구,1,0,0,1,1,0,2019-05-30
8729,서울,강북구,3,0,1,4,3,0,2019-06-30
8730,서울,강북구,0,0,1,1,1,0,2019-07-30
8731,서울,강북구,10,0,1,11,8,0,2019-08-30
8732,서울,강북구,6,1,2,9,5,0,2019-09-30
8733,서울,강북구,4,0,0,4,3,0,2019-10-30
8734,서울,강북구,7,0,4,11,8,0,2019-11-30
8735,서울,강북구,2,0,0,2,2,0,2019-12-30
8736,서울,강서구,8,0,2,10,4,0,2019-01-30
8738,서울,강서구,6,0,3,9,6,0,2019-03-30
8739,서울,강서구,1,0,2,3,3,0,2019-04-30
8740,서울,강서구,10,2,1,13,6,0,2019-05-30
8741,서울,강서구,4,0,0,4,2,0,2019-06-30
8742,서울,강서구,3,0,0,3,3,0,2019-07-30
8743,서울,강서구,9,2,4,15,6,0,2019-08-30
8744,서울,강서구,4,0,0,4,3,0,2019-09-30
8745,서울,강서구,5,0,3,8,5,0,2019-10-30
8746,서울,강서구,6,0,1,7,5,0,2019-11-30
8747,서울,강서구,4,0,0,4,3,0,2019-12-30
8748,서울,관악구,10,0,1,11,4,0,2019-01-30
8750,서울,관악구,2,0,2,4,3,0,2019-03-30
8751,서울,관악구,3,0,0,3,3,0,2019-04-30
8752,서울,관악구,2,1,1,4,3,0,2019-05-30
8753,서울,관악구,1,0,1,2,2,0,2019-06-30
8754,서울,관악구,5,1,1,7,6,0,2019-07-30
8755,서울,관악구,10,1,3,14,10,0,2019-08-30
8756,서울,관악구,2,0,1,3,3,0,2019-09-30
8757,서울,관악구,5,0,2,7,6,1,2019-10-30
8758,서울,관악구,5,2,0,7,6,0,2019-11-30
8759,서울,관악구,2,0,0,2,2,1,2019-12-30
8760,서울,광진구,0,0,0,0,0,0,2019-01-30
8762,서울,광진구,3,1,1,5,5,0,2019-03-30
8763,서울,광진구,1,0,2,3,3,0,2019-04-30
8764,서울,광진구,0,0,0,0,0,0,2019-05-30
8765,서울,광진구,1,1,0,2,2,0,2019-06-30
8766,서울,광진구,2,0,6,8,2,0,2019-07-30
8767,서울,광진구,7,0,1,8,5,0,2019-08-30
8768,서울,광진구,5,0,1,6,4,0,2019-09-30
8769,서울,광진구,9,0,2,11,8,0,2019-10-30
8770,서울,광진구,2,0,1,3,3,0,2019-11-30
8771,서울,광진구,1,0,0,1,1,0,2019-12-30
8772,서울,구로구,1,0,0,1,1,0,2019-01-30
8774,서울,구로구,6,1,2,9,7,0,2019-03-30
8775,서울,구로구,5,0,2,7,4,0,2019-04-30
8776,서울,구로구,7,0,1,8,6,0,2019-05-30
8777,서울,구로구,8,0,0,8,6,0,2019-06-30
8778,서울,구로구,6,0,2,8,7,0,2019-07-30
8779,서울,구로구,6,0,1,7,4,0,2019-08-30
8780,서울,구로구,6,0,0,6,5,0,2019-09-30
8781,서울,구로구,2,0,2,4,4,0,2019-10-30
8782,서울,구로구,4,2,2,8,6,0,2019-11-30
8783,서울,구로구,3,1,0,4,3,0,2019-12-30
8784,서울,금천구,0,0,1,1,1,0,2019-01-30
8786,서울,금천구,3,0,1,4,3,0,2019-03-30
8787,서울,금천구,4,1,2,7,6,0,2019-04-30
8788,서울,금천구,1,0,2,3,3,0,2019-05-30
8789,서울,금천구,1,0,0,1,1,0,2019-06-30
8790,서울,금천구,5,0,0,5,4,0,2019-07-30
8791,서울,금천구,1,0,0,1,1,0,2019-08-30
8792,서울,금천구,2,0,1,3,4,1,2019-09-30
8793,서울,금천구,6,1,1,8,5,0,2019-10-30
8794,서울,금천구,0,0,0,0,0,0,2019-11-30
8795,서울,금천구,2,0,1,3,3,0,2019-12-30
8796,서울,노원구,6,0,2,8,7,0,2019-01-30
8798,서울,노원구,8,0,0,8,5,0,2019-03-30
8799,서울,노원구,5,0,6,11,7,0,2019-04-30
8800,서울,노원구,5,0,2,7,3,0,2019-05-30
8801,서울,노원구,3,0,2,5,4,0,2019-06-30
8802,서울,노원구,1,1,1,3,3,0,2019-07-30
8803,서울,노원구,2,0,1,3,3,0,2019-08-30
8804,서울,노원구,3,1,1,5,5,0,2019-09-30
8805,서울,노원구,5,0,1,6,6,0,2019-10-30
8806,서울,노원구,5,0,2,7,4,0,2019-11-30
8807,서울,노원구,5,1,1,7,4,0,2019-12-30
8808,서울,도봉구,0,0,2,2,2,0,2019-01-30
8810,서울,도봉구,6,0,0,6,3,0,2019-03-30
8811,서울,도봉구,1,0,1,2,2,0,2019-04-30
8812,서울,도봉구,7,0,0,7,1,0,2019-05-30
8813,서울,도봉구,0,2,2,4,4,0,2019-06-30
8814,서울,도봉구,1,0,1,2,2,0,2019-07-30
8815,서울,도봉구,0,0,1,1,1,0,2019-08-30
8816,서울,도봉구,3,0,1,4,3,0,2019-09-30
8817,서울,도봉구,5,0,2,7,5,0,2019-10-30
8818,서울,도봉구,1,0,0,1,1,0,2019-11-30
8819,서울,도봉구,2,0,2,4,4,0,2019-12-30
8820,서울,동대문구,2,0,2,4,4,0,2019-01-30
8822,서울,동대문구,5,0,3,8,6,0,2019-03-30
8823,서울,동대문구,1,0,1,2,2,0,2019-04-30
8824,서울,동대문구,3,0,1,4,3,0,2019-05-30
8825,서울,동대문구,2,2,0,4,2,0,2019-06-30
8826,서울,동대문구,7,0,0,7,6,0,2019-07-30
8827,서울,동대문구,9,1,1,11,8,0,2019-08-30
8828,서울,동대문구,2,1,2,5,5,0,2019-09-30
8829,서울,동대문구,2,0,2,4,3,0,2019-10-30
8830,서울,동대문구,9,0,0,9,4,0,2019-11-30
8831,서울,동대문구,5,0,2,7,6,0,2019-12-30
8832,서울,동작구,4,1,3,8,6,0,2019-01-30
8834,서울,동작구,3,0,0,3,2,0,2019-03-30
8835,서울,동작구,6,1,0,7,6,0,2019-04-30
8836,서울,동작구,3,0,0,3,3,0,2019-05-30
8837,서울,동작구,1,0,0,1,1,0,2019-06-30
8838,서울,동작구,0,3,0,3,1,0,2019-07-30
8839,서울,동작구,0,0,0,0,0,0,2019-08-30
8840,서울,동작구,1,0,0,1,1,0,2019-09-30
8841,서울,동작구,3,1,0,4,3,0,2019-10-30
8842,서울,동작구,5,0,0,5,4,0,2019-11-30
8843,서울,동작구,3,0,0,3,3,0,2019-12-30
8844,서울,마포구,8,0,1,9,7,0,2019-01-30
8846,서울,마포구,5,0,0,5,4,0,2019-03-30
8847,서울,마포구,5,1,0,6,5,0,2019-04-30
8848,서울,마포구,9,1,6,16,10,0,2019-05-30
8849,서울,마포구,7,1,3,11,4,0,2019-06-30
8850,서울,마포구,3,1,1,5,1,0,2019-07-30
8851,서울,마포구,4,2,1,7,7,0,2019-08-30
8852,서울,마포구,5,0,1,6,5,0,2019-09-30
8853,서울,마포구,4,0,1,5,3,0,2019-10-30
8854,서울,마포구,5,0,1,6,6,0,2019-11-30
8855,서울,마포구,1,0,1,2,1,0,2019-12-30
8856,서울,서대문구,2,0,1,3,3,0,2019-01-30
8858,서울,서대문구,3,0,0,3,3,0,2019-03-30
8859,서울,서대문구,3,0,1,4,4,0,2019-04-30
8860,서울,서대문구,2,1,1,4,4,0,2019-05-30
8861,서울,서대문구,1,0,1,2,2,0,2019-06-30
8862,서울,서대문구,3,1,1,5,5,1,2019-07-30
8863,서울,서대문구,5,1,0,6,5,0,2019-08-30
8864,서울,서대문구,5,0,1,6,4,0,2019-09-30
8865,서울,서대문구,1,1,1,3,3,0,2019-10-30
8866,서울,서대문구,6,2,1,9,6,0,2019-11-30
8867,서울,서대문구,0,0,1,1,1,0,2019-12-30
8868,서울,서초구,15,0,1,16,11,0,2019-01-30
8870,서울,서초구,8,0,3,11,11,0,2019-03-30
8871,서울,서초구,15,1,0,16,5,0,2019-04-30
8872,서울,서초구,2,1,0,3,2,0,2019-05-30
8873,서울,서초구,4,0,0,4,3,0,2019-06-30
8874,서울,서초구,3,1,0,4,4,0,2019-07-30
8875,서울,서초구,3,0,2,5,5,0,2019-08-30
8876,서울,서초구,12,0,5,17,13,0,2019-09-30
8877,서울,서초구,16,3,2,21,16,0,2019-10-30
8878,서울,서초구,15,6,0,21,11,0,2019-11-30
8879,서울,서초구,6,47,4,57,8,0,2019-12-30
8880,서울,성동구,5,2,0,7,3,0,2019-01-30
8882,서울,성동구,0,0,0,0,0,0,2019-03-30
8883,서울,성동구,2,0,3,5,3,0,2019-04-30
8884,서울,성동구,2,0,0,2,2,0,2019-05-30
8885,서울,성동구,3,0,0,3,3,0,2019-06-30
8886,서울,성동구,2,0,2,4,4,0,2019-07-30
8887,서울,성동구,4,0,0,4,3,0,2019-08-30
8888,서울,성동구,4,0,4,8,7,0,2019-09-30
8889,서울,성동구,4,1,2,7,6,0,2019-10-30
8890,서울,성동구,5,0,2,7,6,0,2019-11-30
8891,서울,성동구,5,0,2,7,6,0,2019-12-30
8892,서울,성북구,5,0,3,8,7,0,2019-01-30
8894,서울,성북구,0,0,0,0,0,0,2019-03-30
8895,서울,성북구,5,1,2,8,4,0,2019-04-30
8896,서울,성북구,0,0,0,0,0,0,2019-05-30
8897,서울,성북구,2,0,0,2,2,0,2019-06-30
8898,서울,성북구,9,3,1,13,5,0,2019-07-30
8899,서울,성북구,15,3,0,18,10,0,2019-08-30
8900,서울,성북구,6,0,0,6,5,0,2019-09-30
8901,서울,성북구,8,0,1,9,6,0,2019-10-30
8902,서울,성북구,7,0,2,9,8,0,2019-11-30
8903,서울,성북구,8,0,0,8,5,0,2019-12-30
8904,서울,송파구,4,1,1,6,4,0,2019-01-30
8906,서울,송파구,10,0,2,12,9,0,2019-03-30
8907,서울,송파구,13,1,0,14,9,0,2019-04-30
8908,서울,송파구,15,1,3,19,13,0,2019-05-30
8909,서울,송파구,6,0,2,8,5,0,2019-06-30
8910,서울,송파구,5,0,1,6,6,0,2019-07-30
8911,서울,송파구,1,3,2,6,5,0,2019-08-30
8912,서울,송파구,11,2,4,17,10,0,2019-09-30
8913,서울,송파구,10,1,1,12,9,0,2019-10-30
8914,서울,송파구,9,0,5,14,9,0,2019-11-30
8915,서울,송파구,7,0,0,7,7,0,2019-12-30
8916,서울,양천구,5,2,2,9,7,1,2019-01-30
8918,서울,양천구,11,3,0,14,7,0,2019-03-30
8919,서울,양천구,1,0,0,1,1,0,2019-04-30
8920,서울,양천구,9,0,0,9,7,0,2019-05-30
8921,서울,양천구,6,1,0,7,2,0,2019-06-30
8922,서울,양천구,3,0,0,3,2,0,2019-07-30
8923,서울,양천구,3,1,1,5,5,0,2019-08-30
8924,서울,양천구,2,0,0,2,2,0,2019-09-30
8925,서울,양천구,8,0,1,9,5,0,2019-10-30
8926,서울,양천구,6,0,0,6,4,0,2019-11-30
8927,서울,양천구,3,0,1,4,3,0,2019-12-30
8928,서울,영등포구,7,0,1,8,8,0,2019-01-30
8930,서울,영등포구,4,1,1,6,5,0,2019-03-30
8931,서울,영등포구,7,0,3,10,9,0,2019-04-30
8932,서울,영등포구,9,0,2,11,9,0,2019-05-30
8933,서울,영등포구,2,0,1,3,2,0,2019-06-30
8934,서울,영등포구,4,2,2,8,7,0,2019-07-30
8935,서울,영등포구,2,0,4,6,5,0,2019-08-30
8936,서울,영등포구,12,1,5,18,12,0,2019-09-30
8937,서울,영등포구,2,0,2,4,4,0,2019-10-30
8938,서울,영등포구,9,1,1,11,5,0,2019-11-30
8939,서울,영등포구,5,0,0,5,5,0,2019-12-30
8940,서울,용산구,1,0,1,2,3,1,2019-01-30
8942,서울,용산구,10,0,0,10,5,0,2019-03-30
8943,서울,용산구,4,0,0,4,4,0,2019-04-30
8944,서울,용산구,4,0,0,4,3,0,2019-05-30
8945,서울,용산구,2,0,1,3,2,0,2019-06-30
8946,서울,용산구,2,0,0,2,3,1,2019-07-30
8947,서울,용산구,1,0,0,1,1,0,2019-08-30
8948,서울,용산구,7,0,1,8,6,0,2019-09-30
8949,서울,용산구,2,0,0,2,2,0,2019-10-30
8950,서울,용산구,12,0,0,12,5,0,2019-11-30
8951,서울,용산구,2,0,0,2,2,0,2019-12-30
8952,서울,은평구,2,0,2,4,4,1,2019-01-30
8954,서울,은평구,6,2,3,11,7,0,2019-03-30
8955,서울,은평구,1,0,1,2,2,0,2019-04-30
8956,서울,은평구,0,0,0,0,0,0,2019-05-30
8957,서울,은평구,0,1,1,2,2,0,2019-06-30
8958,서울,은평구,2,1,2,5,5,0,2019-07-30
8959,서울,은평구,10,0,1,11,9,1,2019-08-30
8960,서울,은평구,4,0,2,6,4,0,2019-09-30
8961,서울,은평구,2,1,0,3,3,0,2019-10-30
8962,서울,은평구,4,1,1,6,4,0,2019-11-30
8963,서울,은평구,0,1,0,1,1,0,2019-12-30
8964,서울,종로구,1,0,1,2,2,0,2019-01-30
8966,서울,종로구,6,0,0,6,3,0,2019-03-30
8967,서울,종로구,12,1,2,15,5,0,2019-04-30
8968,서울,종로구,4,2,3,9,8,0,2019-05-30
8969,서울,종로구,1,0,0,1,1,0,2019-06-30
8970,서울,종로구,8,0,0,8,4,0,2019-07-30
8971,서울,종로구,4,0,1,5,5,0,2019-08-30
8972,서울,종로구,4,0,0,4,4,0,2019-09-30
8973,서울,종로구,1,2,1,4,4,0,2019-10-30
8974,서울,종로구,5,1,0,6,5,0,2019-11-30
8975,서울,종로구,3,2,1,6,3,0,2019-12-30
8976,서울,중구,4,0,3,7,5,0,2019-01-30
8978,서울,중구,7,1,0,8,5,0,2019-03-30
8979,서울,중구,0,0,2,2,2,0,2019-04-30
8980,서울,중구,10,1,2,13,10,0,2019-05-30
8981,서울,중구,1,2,1,4,2,0,2019-06-30
8982,서울,중구,0,0,1,1,1,0,2019-07-30
8983,서울,중구,5,0,0,5,5,0,2019-08-30
8984,서울,중구,0,0,0,0,0,0,2019-09-30
8985,서울,중구,3,1,0,4,3,0,2019-10-30
8986,서울,중구,4,1,3,8,3,0,2019-11-30
8987,서울,중구,2,0,0,2,1,0,2019-12-30
8988,서울,중랑구,7,1,2,10,6,0,2019-01-30
8990,서울,중랑구,3,1,2,6,5,0,2019-03-30
8991,서울,중랑구,3,1,1,5,5,0,2019-04-30
8992,서울,중랑구,6,2,0,8,7,0,2019-05-30
8993,서울,중랑구,1,3,2,6,5,1,2019-06-30
8994,서울,중랑구,4,0,0,4,3,0,2019-07-30
8995,서울,중랑구,3,3,5,11,9,0,2019-08-30
8996,서울,중랑구,4,1,1,6,6,0,2019-09-30
8997,서울,중랑구,9,1,4,14,12,1,2019-10-30
8998,서울,중랑구,4,0,3,7,6,0,2019-11-30
8999,서울,중랑구,2,0,2,4,4,0,2019-12-30
9000,서울,강남구,8,3,6,17,4,0,2019-01-31
9002,서울,강남구,18,0,4,22,11,0,2019-03-31
9004,서울,강남구,20,3,3,26,18,0,2019-05-31
9006,서울,강남구,9,1,2,12,11,0,2019-07-31
9007,서울,강남구,7,1,2,10,8,0,2019-08-31
9009,서울,강남구,7,1,0,8,7,0,2019-10-31
9011,서울,강남구,21,3,2,26,17,1,2019-12-31
9012,서울,강동구,2,0,1,3,3,0,2019-01-31
9014,서울,강동구,2,0,0,2,2,0,2019-03-31
9016,서울,강동구,9,2,1,12,6,0,2019-05-31
9018,서울,강동구,3,2,0,5,4,0,2019-07-31
9019,서울,강동구,4,1,3,8,6,0,2019-08-31
9021,서울,강동구,4,0,1,5,2,0,2019-10-31
9023,서울,강동구,3,0,3,6,6,0,2019-12-31
9024,서울,강북구,1,0,0,1,1,0,2019-01-31
9026,서울,강북구,2,1,0,3,3,0,2019-03-31
9028,서울,강북구,10,0,3,13,11,0,2019-05-31
9030,서울,강북구,4,0,0,4,4,0,2019-07-31
9031,서울,강북구,6,1,1,8,6,0,2019-08-31
9033,서울,강북구,0,0,0,0,0,0,2019-10-31
9035,서울,강북구,3,0,0,3,3,0,2019-12-31
9036,서울,강서구,5,0,2,7,5,0,2019-01-31
9038,서울,강서구,4,0,1,5,3,0,2019-03-31
9040,서울,강서구,6,1,1,8,5,0,2019-05-31
9042,서울,강서구,7,1,2,10,9,0,2019-07-31
9043,서울,강서구,15,0,1,16,9,0,2019-08-31
9045,서울,강서구,3,0,3,6,6,0,2019-10-31
9047,서울,강서구,7,1,1,9,7,0,2019-12-31
9048,서울,관악구,7,3,2,12,7,0,2019-01-31
9050,서울,관악구,0,1,1,2,2,0,2019-03-31
9052,서울,관악구,5,0,1,6,5,0,2019-05-31
9054,서울,관악구,11,1,0,12,10,0,2019-07-31
9055,서울,관악구,2,0,1,3,3,0,2019-08-31
9057,서울,관악구,2,0,2,4,2,0,2019-10-31
9059,서울,관악구,1,0,0,1,1,0,2019-12-31
9060,서울,광진구,0,0,0,0,0,0,2019-01-31
9062,서울,광진구,2,0,0,2,2,0,2019-03-31
9064,서울,광진구,0,0,1,1,1,0,2019-05-31
9066,서울,광진구,1,0,2,3,3,0,2019-07-31
9067,서울,광진구,3,0,2,5,5,0,2019-08-31
9069,서울,광진구,2,0,1,3,3,0,2019-10-31
9071,서울,광진구,4,0,0,4,3,0,2019-12-31
9072,서울,구로구,6,0,4,10,7,1,2019-01-31
9074,서울,구로구,3,0,0,3,3,0,2019-03-31
9076,서울,구로구,3,0,3,6,5,0,2019-05-31
9078,서울,구로구,8,0,0,8,5,0,2019-07-31
9079,서울,구로구,5,2,0,7,4,0,2019-08-31
9081,서울,구로구,0,0,0,0,0,0,2019-10-31
9083,서울,구로구,8,1,1,10,7,0,2019-12-31
9084,서울,금천구,5,0,1,6,4,0,2019-01-31
9086,서울,금천구,3,0,0,3,2,0,2019-03-31
9088,서울,금천구,4,0,1,5,4,0,2019-05-31
9090,서울,금천구,6,0,1,7,5,0,2019-07-31
9091,서울,금천구,4,0,1,5,4,0,2019-08-31
9093,서울,금천구,1,0,0,1,1,0,2019-10-31
9095,서울,금천구,3,0,1,4,2,0,2019-12-31
9096,서울,노원구,3,0,0,3,3,0,2019-01-31
9098,서울,노원구,4,0,2,6,5,0,2019-03-31
9100,서울,노원구,6,1,2,9,8,0,2019-05-31
9102,서울,노원구,4,1,2,7,7,0,2019-07-31
9103,서울,노원구,3,0,2,5,4,0,2019-08-31
9105,서울,노원구,4,1,2,7,6,0,2019-10-31
9107,서울,노원구,3,1,1,5,4,0,2019-12-31
9108,서울,도봉구,1,0,0,1,1,0,2019-01-31
9110,서울,도봉구,2,0,0,2,1,0,2019-03-31
9112,서울,도봉구,2,0,0,2,2,0,2019-05-31
9114,서울,도봉구,0,1,1,2,2,0,2019-07-31
9115,서울,도봉구,1,0,6,7,3,0,2019-08-31
9117,서울,도봉구,2,1,0,3,3,0,2019-10-31
9119,서울,도봉구,1,1,0,2,1,0,2019-12-31
9120,서울,동대문구,8,0,4,12,8,0,2019-01-31
9122,서울,동대문구,3,0,0,3,2,0,2019-03-31
9124,서울,동대문구,4,0,3,7,4,0,2019-05-31
9126,서울,동대문구,9,2,1,12,9,0,2019-07-31
9127,서울,동대문구,4,1,2,7,5,0,2019-08-31
9129,서울,동대문구,5,0,0,5,5,0,2019-10-31
9131,서울,동대문구,2,0,1,3,3,0,2019-12-31
9132,서울,동작구,2,2,2,6,2,0,2019-01-31
9134,서울,동작구,7,0,0,7,4,0,2019-03-31
9136,서울,동작구,7,4,0,11,5,0,2019-05-31
9138,서울,동작구,10,0,1,11,4,0,2019-07-31
9139,서울,동작구,3,1,3,7,7,0,2019-08-31
9141,서울,동작구,3,2,1,6,4,0,2019-10-31
9143,서울,동작구,3,0,1,4,4,0,2019-12-31
9144,서울,마포구,1,0,0,1,1,0,2019-01-31
9146,서울,마포구,2,0,0,2,2,0,2019-03-31
9148,서울,마포구,5,0,2,7,6,0,2019-05-31
9150,서울,마포구,3,0,1,4,2,0,2019-07-31
9151,서울,마포구,10,2,5,17,8,0,2019-08-31
9153,서울,마포구,4,0,0,4,3,0,2019-10-31
9155,서울,마포구,4,0,0,4,3,0,2019-12-31
9156,서울,서대문구,3,0,0,3,3,0,2019-01-31
9158,서울,서대문구,0,0,0,0,0,0,2019-03-31
9160,서울,서대문구,3,2,2,7,4,0,2019-05-31
9162,서울,서대문구,3,0,0,3,3,0,2019-07-31
9163,서울,서대문구,1,0,2,3,3,0,2019-08-31
9165,서울,서대문구,2,0,1,3,3,0,2019-10-31
9167,서울,서대문구,2,0,4,6,6,0,2019-12-31
9168,서울,서초구,7,1,5,13,7,0,2019-01-31
9170,서울,서초구,1,0,1,2,1,0,2019-03-31
9172,서울,서초구,7,0,2,9,7,0,2019-05-31
9174,서울,서초구,3,0,1,4,4,0,2019-07-31
9175,서울,서초구,7,1,3,11,10,0,2019-08-31
9177,서울,서초구,7,1,2,10,9,0,2019-10-31
9179,서울,서초구,2,0,1,3,4,1,2019-12-31
9180,서울,성동구,0,0,1,1,1,0,2019-01-31
9182,서울,성동구,1,0,0,1,1,0,2019-03-31
9184,서울,성동구,1,0,1,2,2,0,2019-05-31
9186,서울,성동구,1,0,1,2,2,0,2019-07-31
9187,서울,성동구,3,0,0,3,1,0,2019-08-31
9189,서울,성동구,4,0,2,6,5,0,2019-10-31
9191,서울,성동구,0,0,2,2,1,0,2019-12-31
9192,서울,성북구,1,0,3,4,4,0,2019-01-31
9194,서울,성북구,4,1,3,8,3,0,2019-03-31
9196,서울,성북구,6,0,4,10,9,0,2019-05-31
9198,서울,성북구,1,0,0,1,1,0,2019-07-31
9199,서울,성북구,1,0,0,1,1,0,2019-08-31
9201,서울,성북구,2,0,3,5,4,0,2019-10-31
9203,서울,성북구,6,0,0,6,4,0,2019-12-31
9204,서울,송파구,11,0,2,13,11,0,2019-01-31
9206,서울,송파구,3,1,0,4,4,0,2019-03-31
9208,서울,송파구,8,1,5,14,13,0,2019-05-31
9210,서울,송파구,5,1,2,8,7,0,2019-07-31
9211,서울,송파구,11,0,3,14,10,0,2019-08-31
9213,서울,송파구,7,3,1,11,6,0,2019-10-31
9215,서울,송파구,7,1,0,8,7,0,2019-12-31
9216,서울,양천구,1,0,2,3,3,0,2019-01-31
9218,서울,양천구,0,0,0,0,0,0,2019-03-31
9220,서울,양천구,5,1,2,8,6,0,2019-05-31
9222,서울,양천구,4,5,0,9,4,0,2019-07-31
9223,서울,양천구,8,0,0,8,5,0,2019-08-31
9225,서울,양천구,5,1,3,9,9,0,2019-10-31
9227,서울,양천구,5,0,0,5,4,0,2019-12-31
9228,서울,영등포구,6,0,1,7,4,0,2019-01-31
9230,서울,영등포구,3,0,1,4,4,0,2019-03-31
9232,서울,영등포구,10,1,0,11,6,0,2019-05-31
9234,서울,영등포구,11,1,2,14,8,0,2019-07-31
9235,서울,영등포구,15,1,2,18,9,0,2019-08-31
9237,서울,영등포구,7,0,3,10,8,0,2019-10-31
9239,서울,영등포구,3,1,1,5,4,0,2019-12-31
9240,서울,용산구,3,1,0,4,4,0,2019-01-31
9242,서울,용산구,8,3,4,15,9,1,2019-03-31
9244,서울,용산구,0,0,0,0,0,0,2019-05-31
9246,서울,용산구,3,0,1,4,4,0,2019-07-31
9247,서울,용산구,8,1,0,9,7,0,2019-08-31
9249,서울,용산구,3,0,1,4,4,0,2019-10-31
9251,서울,용산구,3,0,0,3,3,0,2019-12-31
9252,서울,은평구,1,1,1,3,3,0,2019-01-31
9254,서울,은평구,0,0,0,0,0,0,2019-03-31
9256,서울,은평구,3,2,1,6,6,0,2019-05-31
9258,서울,은평구,1,0,0,1,1,0,2019-07-31
9259,서울,은평구,2,0,4,6,4,0,2019-08-31
9261,서울,은평구,2,0,0,2,2,0,2019-10-31
9263,서울,은평구,4,1,0,5,2,0,2019-12-31
9264,서울,종로구,6,1,0,7,4,0,2019-01-31
9266,서울,종로구,2,0,3,5,3,0,2019-03-31
9268,서울,종로구,8,0,0,8,7,0,2019-05-31
9270,서울,종로구,3,0,0,3,3,0,2019-07-31
9271,서울,종로구,7,0,2,9,7,0,2019-08-31
9273,서울,종로구,7,0,3,10,7,0,2019-10-31
9275,서울,종로구,2,0,0,2,2,0,2019-12-31
9276,서울,중구,5,0,0,5,4,0,2019-01-31
9278,서울,중구,1,0,0,1,1,0,2019-03-31
9280,서울,중구,2,2,2,6,5,0,2019-05-31
9282,서울,중구,11,1,1,13,5,0,2019-07-31
9283,서울,중구,4,1,3,8,6,0,2019-08-31
9285,서울,중구,4,0,0,4,3,0,2019-10-31
9287,서울,중구,3,0,0,3,3,0,2019-12-31
9288,서울,중랑구,5,1,2,8,6,0,2019-01-31
9290,서울,중랑구,4,1,0,5,3,0,2019-03-31
9292,서울,중랑구,4,1,0,5,3,0,2019-05-31
9294,서울,중랑구,4,2,0,6,6,0,2019-07-31
9295,서울,중랑구,7,0,2,9,6,0,2019-08-31
9297,서울,중랑구,4,0,2,6,6,0,2019-10-31
9299,서울,중랑구,2,2,1,5,5,0,2019-12-31
0,경기,가평군,3,0,1,4,1,0,2018-01-01
1,경기,가평군,1,0,0,1,1,0,2018-02-01
2,경기,가평군,0,0,0,0,0,0,2018-03-01
3,경기,가평군,0,0,0,0,0,0,2018-04-01
4,경기,가평군,2,0,0,2,1,0,2018-05-01
5,경기,가평군,2,0,0,2,1,0,2018-06-01
6,경기,가평군,0,0,0,0,0,0,2018-07-01
7,경기,가평군,4,0,0,4,3,0,2018-08-01
8,경기,가평군,2,3,0,5,1,0,2018-09-01
9,경기,가평군,0,0,0,0,0,0,2018-10-01
10,경기,가평군,0,1,0,1,1,0,2018-11-01
11,경기,가평군,0,0,0,0,0,0,2018-12-01
12,경기,고양시,12,0,2,14,7,0,2018-01-01
13,경기,고양시,18,0,14,32,17,0,2018-02-01
14,경기,고양시,7,2,8,17,10,0,2018-03-01
15,경기,고양시,13,2,0,15,6,0,2018-04-01
16,경기,고양시,9,1,4,14,11,0,2018-05-01
17,경기,고양시,10,3,3,16,11,0,2018-06-01
18,경기,고양시,10,2,3,15,10,0,2018-07-01
19,경기,고양시,16,1,4,21,13,0,2018-08-01
20,경기,고양시,9,2,3,14,9,0,2018-09-01
21,경기,고양시,6,0,3,9,6,0,2018-10-01
22,경기,고양시,10,0,7,17,10,0,2018-11-01
23,경기,고양시,18,2,3,23,15,0,2018-12-01
24,경기,과천시,0,0,0,0,0,0,2018-01-01
25,경기,과천시,0,0,2,2,2,0,2018-02-01
26,경기,과천시,0,0,0,0,0,0,2018-03-01
27,경기,과천시,0,0,1,1,1,0,2018-04-01
28,경기,과천시,0,0,0,0,0,0,2018-05-01
29,경기,과천시,0,1,0,1,1,0,2018-06-01
30,경기,과천시,0,0,0,0,0,0,2018-07-01
31,경기,과천시,1,0,0,1,1,0,2018-08-01
32,경기,과천시,1,0,0,1,1,0,2018-09-01
33,경기,과천시,0,0,0,0,0,0,2018-10-01
34,경기,과천시,2,2,0,4,3,0,2018-11-01
35,경기,과천시,0,0,0,0,0,0,2018-12-01
36,경기,광명시,1,1,0,2,2,0,2018-01-01
37,경기,광명시,6,0,1,7,5,0,2018-02-01
38,경기,광명시,3,5,1,9,4,0,2018-03-01
39,경기,광명시,1,1,2,4,3,0,2018-04-01
40,경기,광명시,2,1,0,3,2,0,2018-05-01
41,경기,광명시,3,0,0,3,4,1,2018-06-01
42,경기,광명시,8,2,2,12,6,0,2018-07-01
43,경기,광명시,6,1,1,8,4,0,2018-08-01
44,경기,광명시,6,3,5,14,8,0,2018-09-01
45,경기,광명시,3,1,0,4,1,0,2018-10-01
46,경기,광명시,0,0,1,1,1,0,2018-11-01
47,경기,광명시,3,0,3,6,6,0,2018-12-01
48,경기,광주시,1,0,0,1,1,0,2018-01-01
49,경기,광주시,9,0,4,13,9,0,2018-02-01
50,경기,광주시,2,1,0,3,2,0,2018-03-01
51,경기,광주시,5,2,0,7,2,0,2018-04-01
52,경기,광주시,2,0,0,2,1,0,2018-05-01
53,경기,광주시,8,1,1,10,6,0,2018-06-01
54,경기,광주시,7,4,3,14,2,0,2018-07-01
55,경기,광주시,1,0,0,1,1,0,2018-08-01
56,경기,광주시,1,0,1,2,2,0,2018-09-01
57,경기,광주시,3,0,0,3,3,0,2018-10-01
58,경기,광주시,8,0,0,8,6,0,2018-11-01
59,경기,광주시,7,0,1,8,4,0,2018-12-01
60,경기,구리시,0,0,0,0,0,0,2018-01-01
61,경기,구리시,3,0,0,3,3,0,2018-02-01
62,경기,구리시,3,0,1,4,2,0,2018-03-01
63,경기,구리시,7,0,0,7,1,0,2018-04-01
64,경기,구리시,0,0,0,0,0,0,2018-05-01
65,경기,구리시,3,0,0,3,2,0,2018-06-01
66,경기,구리시,1,0,0,1,1,0,2018-07-01
67,경기,구리시,0,0,1,1,1,0,2018-08-01
68,경기,구리시,3,0,2,5,5,0,2018-09-01
69,경기,구리시,1,0,1,2,1,0,2018-10-01
70,경기,구리시,6,3,1,10,1,0,2018-11-01
71,경기,구리시,3,0,0,3,3,0,2018-12-01
72,경기,군포시,0,1,0,1,1,0,2018-01-01
73,경기,군포시,0,0,1,1,1,0,2018-02-01
74,경기,군포시,1,0,1,2,2,0,2018-03-01
75,경기,군포시,4,0,0,4,1,0,2018-04-01
76,경기,군포시,1,2,0,3,3,0,2018-05-01
77,경기,군포시,1,0,1,2,2,0,2018-06-01
78,경기,군포시,1,1,1,3,3,0,2018-07-01
79,경기,군포시,1,0,0,1,1,0,2018-08-01
80,경기,군포시,1,1,0,2,1,0,2018-09-01
81,경기,군포시,1,0,2,3,3,0,2018-10-01
82,경기,군포시,1,0,1,2,2,0,2018-11-01
83,경기,군포시,0,0,0,0,0,0,2018-12-01
84,경기,김포시,0,0,3,3,3,0,2018-01-01
85,경기,김포시,9,0,3,12,8,0,2018-02-01
86,경기,김포시,9,1,3,13,7,0,2018-03-01
87,경기,김포시,12,2,3,17,7,0,2018-04-01
88,경기,김포시,4,2,1,7,5,0,2018-05-01
89,경기,김포시,4,0,1,5,5,1,2018-06-01
90,경기,김포시,3,0,1,4,3,0,2018-07-01
91,경기,김포시,11,0,5,16,5,0,2018-08-01
92,경기,김포시,2,0,0,2,2,1,2018-09-01
93,경기,김포시,7,4,3,14,9,0,2018-10-01
94,경기,김포시,8,8,0,16,9,0,2018-11-01
95,경기,김포시,5,0,1,6,4,0,2018-12-01
96,경기,남양주시,12,0,1,13,6,0,2018-01-01
97,경기,남양주시,10,6,1,17,8,0,2018-02-01
98,경기,남양주시,2,0,0,2,2,0,2018-03-01
99,경기,남양주시,7,1,1,9,6,0,2018-04-01
100,경기,남양주시,4,0,4,8,6,0,2018-05-01
101,경기,남양주시,11,0,4,15,9,0,2018-06-01
102,경기,남양주시,7,1,0,8,6,0,2018-07-01
103,경기,남양주시,8,1,0,9,3,0,2018-08-01
104,경기,남양주시,8,0,2,10,7,0,2018-09-01
105,경기,남양주시,12,0,1,13,3,0,2018-10-01
106,경기,남양주시,4,2,1,7,5,0,2018-11-01
107,경기,남양주시,11,1,1,13,8,0,2018-12-01
108,경기,동두천시,0,0,1,1,1,0,2018-01-01
109,경기,동두천시,1,0,1,2,2,0,2018-02-01
110,경기,동두천시,0,0,0,0,0,0,2018-03-01
111,경기,동두천시,0,0,0,0,0,0,2018-04-01
112,경기,동두천시,2,0,1,3,2,0,2018-05-01
113,경기,동두천시,0,0,0,0,0,0,2018-06-01
114,경기,동두천시,1,0,0,1,1,0,2018-07-01
115,경기,동두천시,0,0,0,0,0,0,2018-08-01
116,경기,동두천시,0,0,0,0,0,0,2018-09-01
117,경기,동두천시,0,0,1,1,1,0,2018-10-01
118,경기,동두천시,1,0,0,1,1,0,2018-11-01
119,경기,동두천시,0,0,0,0,0,0,2018-12-01
120,경기,부천시,4,0,1,5,4,0,2018-01-01
121,경기,부천시,10,0,2,12,10,0,2018-02-01
122,경기,부천시,12,2,1,15,7,0,2018-03-01
123,경기,부천시,7,1,2,10,8,0,2018-04-01
124,경기,부천시,6,0,3,9,6,0,2018-05-01
125,경기,부천시,5,1,4,10,8,0,2018-06-01
126,경기,부천시,8,0,0,8,6,0,2018-07-01
127,경기,부천시,7,0,3,10,9,0,2018-08-01
128,경기,부천시,8,0,2,10,5,0,2018-09-01
129,경기,부천시,6,0,2,8,8,0,2018-10-01
130,경기,부천시,8,2,1,11,9,0,2018-11-01
131,경기,부천시,18,7,2,27,17,0,2018-12-01
132,경기,성남시,5,0,0,5,4,0,2018-01-01
133,경기,성남시,16,0,6,22,15,0,2018-02-01
134,경기,성남시,9,2,1,12,10,0,2018-03-01
135,경기,성남시,12,1,3,16,9,0,2018-04-01
136,경기,성남시,5,1,4,10,7,0,2018-05-01
137,경기,성남시,13,1,2,16,9,0,2018-06-01
138,경기,성남시,8,3,4,15,10,0,2018-07-01
139,경기,성남시,7,0,2,9,9,0,2018-08-01
140,경기,성남시,11,0,5,16,10,0,2018-09-01
141,경기,성남시,14,1,2,17,13,0,2018-10-01
142,경기,성남시,10,1,3,14,9,0,2018-11-01
143,경기,성남시,11,0,3,14,9,0,2018-12-01
144,경기,수원시,6,1,1,8,5,0,2018-01-01
145,경기,수원시,21,0,1,22,15,0,2018-02-01
146,경기,수원시,8,0,2,10,9,0,2018-03-01
147,경기,수원시,14,0,4,18,13,0,2018-04-01
148,경기,수원시,10,2,3,15,8,0,2018-05-01
149,경기,수원시,7,2,6,15,13,0,2018-06-01
150,경기,수원시,10,1,3,14,11,0,2018-07-01
151,경기,수원시,8,2,2,12,11,0,2018-08-01
152,경기,수원시,17,2,4,23,16,0,2018-09-01
153,경기,수원시,9,2,7,18,14,0,2018-10-01
154,경기,수원시,7,0,9,16,12,0,2018-11-01
155,경기,수원시,13,0,5,18,12,0,2018-12-01
156,경기,시흥시,4,0,2,6,4,0,2018-01-01
157,경기,시흥시,7,1,1,9,6,0,2018-02-01
158,경기,시흥시,6,0,2,8,5,0,2018-03-01
159,경기,시흥시,3,1,2,6,5,0,2018-04-01
160,경기,시흥시,11,0,2,13,6,0,2018-05-01
161,경기,시흥시,3,1,3,7,7,0,2018-06-01
162,경기,시흥시,5,0,2,7,6,0,2018-07-01
163,경기,시흥시,10,0,3,13,9,0,2018-08-01
164,경기,시흥시,5,2,2,9,5,0,2018-09-01
165,경기,시흥시,7,0,5,12,9,0,2018-10-01
166,경기,시흥시,16,0,4,20,14,0,2018-11-01
167,경기,시흥시,22,2,2,26,16,0,2018-12-01
168,경기,안산시,11,0,4,15,9,0,2018-01-01
169,경기,안산시,14,1,3,18,11,0,2018-02-01
170,경기,안산시,13,0,0,13,7,0,2018-03-01
171,경기,안산시,12,3,0,15,5,0,2018-04-01
172,경기,안산시,14,0,3,17,13,0,2018-05-01
173,경기,안산시,10,0,4,14,14,0,2018-06-01
174,경기,안산시,8,0,4,12,8,0,2018-07-01
175,경기,안산시,11,0,3,14,11,0,2018-08-01
176,경기,안산시,21,1,9,31,14,0,2018-09-01
177,경기,안산시,9,1,1,11,5,0,2018-10-01
178,경기,안산시,21,3,3,27,15,0,2018-11-01
179,경기,안산시,9,1,4,14,8,0,2018-12-01
180,경기,안성시,0,0,1,1,1,0,2018-01-01
181,경기,안성시,1,1,0,2,1,0,2018-02-01
182,경기,안성시,0,0,1,1,1,0,2018-03-01
183,경기,안성시,1,1,1,3,3,0,2018-04-01
184,경기,안성시,2,0,0,2,1,0,2018-05-01
185,경기,안성시,4,0,2,6,4,0,2018-06-01
186,경기,안성시,2,0,0,2,3,1,2018-07-01
187,경기,안성시,1,2,1,4,4,0,2018-08-01
188,경기,안성시,3,0,0,3,2,0,2018-09-01
189,경기,안성시,0,0,1,1,1,0,2018-10-01
190,경기,안성시,4,0,3,7,6,0,2018-11-01
191,경기,안성시,2,1,2,5,3,0,2018-12-01
192,경기,안양시,4,1,2,7,3,0,2018-01-01
193,경기,안양시,7,1,1,9,8,1,2018-02-01
194,경기,안양시,2,0,0,2,2,0,2018-03-01
195,경기,안양시,7,0,1,8,6,0,2018-04-01
196,경기,안양시,1,1,0,2,2,0,2018-05-01
197,경기,안양시,11,0,1,12,7,0,2018-06-01
198,경기,안양시,1,0,3,4,2,0,2018-07-01
199,경기,안양시,5,1,1,7,5,0,2018-08-01
200,경기,안양시,6,0,0,6,3,1,2018-09-01
201,경기,안양시,5,0,2,7,6,0,2018-10-01
202,경기,안양시,6,1,2,9,9,0,2018-11-01
203,경기,안양시,9,0,6,15,10,0,2018-12-01
204,경기,양주시,0,0,0,0,0,0,2018-01-01
205,경기,양주시,1,0,1,2,2,0,2018-02-01
206,경기,양주시,0,0,0,0,0,0,2018-03-01
207,경기,양주시,1,0,1,2,1,0,2018-04-01
208,경기,양주시,3,1,0,4,3,0,2018-05-01
209,경기,양주시,2,3,0,5,4,0,2018-06-01
210,경기,양주시,4,0,1,5,2,0,2018-07-01
211,경기,양주시,1,0,1,2,2,0,2018-08-01
212,경기,양주시,2,0,1,3,3,0,2018-09-01
213,경기,양주시,3,1,0,4,3,0,2018-10-01
214,경기,양주시,7,1,1,9,6,0,2018-11-01
215,경기,양주시,4,0,3,7,5,1,2018-12-01
216,경기,양평군,1,0,0,1,1,0,2018-01-01
217,경기,양평군,4,0,0,4,1,0,2018-02-01
218,경기,양평군,0,0,0,0,0,0,2018-03-01
219,경기,양평군,0,0,0,0,0,0,2018-04-01
220,경기,양평군,1,0,0,1,1,0,2018-05-01
221,경기,양평군,3,0,0,3,3,0,2018-06-01
222,경기,양평군,3,0,0,3,1,0,2018-07-01
223,경기,양평군,0,0,0,0,0,0,2018-08-01
224,경기,양평군,7,1,1,9,5,0,2018-09-01
225,경기,양평군,1,0,0,1,1,0,2018-10-01
226,경기,양평군,1,1,0,2,2,0,2018-11-01
227,경기,양평군,1,0,1,2,2,0,2018-12-01
228,경기,여주시,1,0,0,1,1,0,2018-01-01
229,경기,여주시,1,0,0,1,2,1,2018-02-01
230,경기,여주시,2,0,0,2,3,1,2018-03-01
231,경기,여주시,0,0,0,0,0,0,2018-04-01
232,경기,여주시,1,0,0,1,1,0,2018-05-01
233,경기,여주시,0,0,0,0,0,0,2018-06-01
234,경기,여주시,1,0,3,4,3,0,2018-07-01
235,경기,여주시,0,0,0,0,0,0,2018-08-01
236,경기,여주시,5,1,0,6,2,0,2018-09-01
237,경기,여주시,0,0,1,1,1,0,2018-10-01
238,경기,여주시,5,0,1,6,3,0,2018-11-01
239,경기,여주시,3,0,1,4,4,0,2018-12-01
240,경기,연천군,6,0,2,8,2,0,2018-01-01
241,경기,연천군,0,0,1,1,1,0,2018-02-01
242,경기,연천군,0,0,0,0,0,0,2018-03-01
243,경기,연천군,0,0,0,0,0,0,2018-04-01
244,경기,연천군,0,0,0,0,0,0,2018-05-01
245,경기,연천군,4,0,0,4,2,0,2018-06-01
246,경기,연천군,0,0,0,0,0,0,2018-07-01
247,경기,연천군,0,0,0,0,0,0,2018-08-01
248,경기,연천군,0,0,1,1,1,0,2018-09-01
249,경기,연천군,1,0,0,1,1,0,2018-10-01
250,경기,연천군,0,0,0,0,0,0,2018-11-01
251,경기,연천군,0,0,0,0,0,0,2018-12-01
252,경기,오산시,5,2,1,8,6,0,2018-01-01
253,경기,오산시,1,1,3,5,4,0,2018-02-01
254,경기,오산시,5,0,0,5,2,0,2018-03-01
255,경기,오산시,1,0,1,2,2,0,2018-04-01
256,경기,오산시,1,1,0,2,2,1,2018-05-01
257,경기,오산시,1,0,2,3,3,0,2018-06-01
258,경기,오산시,2,0,4,6,2,0,2018-07-01
259,경기,오산시,1,0,0,1,1,0,2018-08-01
260,경기,오산시,8,1,3,12,7,0,2018-09-01
261,경기,오산시,1,0,1,2,2,0,2018-10-01
262,경기,오산시,1,0,2,3,2,0,2018-11-01
263,경기,오산시,2,0,5,7,5,0,2018-12-01
264,경기,용인시,7,0,1,8,4,0,2018-01-01
265,경기,용인시,6,5,4,15,10,0,2018-02-01
266,경기,용인시,11,1,4,16,10,0,2018-03-01
267,경기,용인시,0,1,3,4,3,0,2018-04-01
268,경기,용인시,7,1,4,12,7,0,2018-05-01
269,경기,용인시,12,1,4,17,10,0,2018-06-01
270,경기,용인시,1,0,3,4,4,0,2018-07-01
271,경기,용인시,11,8,1,20,7,0,2018-08-01
272,경기,용인시,17,13,5,35,9,0,2018-09-01
273,경기,용인시,5,2,2,9,8,0,2018-10-01
274,경기,용인시,25,1,4,30,19,0,2018-11-01
275,경기,용인시,13,2,1,16,10,0,2018-12-01
276,경기,의왕시,0,0,0,0,0,0,2018-01-01
277,경기,의왕시,4,0,0,4,3,0,2018-02-01
278,경기,의왕시,0,0,0,0,0,0,2018-03-01
279,경기,의왕시,1,1,0,2,2,0,2018-04-01
280,경기,의왕시,1,0,1,2,2,0,2018-05-01
281,경기,의왕시,1,0,1,2,2,0,2018-06-01
282,경기,의왕시,6,0,3,9,3,0,2018-07-01
283,경기,의왕시,0,0,0,0,0,0,2018-08-01
284,경기,의왕시,8,0,2,10,5,0,2018-09-01
285,경기,의왕시,1,0,0,1,1,0,2018-10-01
286,경기,의왕시,1,0,0,1,1,0,2018-11-01
287,경기,의왕시,0,0,0,0,0,0,2018-12-01
288,경기,의정부시,3,3,0,6,3,0,2018-01-01
289,경기,의정부시,5,1,3,9,7,0,2018-02-01
290,경기,의정부시,6,1,0,7,4,0,2018-03-01
291,경기,의정부시,5,0,1,6,4,0,2018-04-01
292,경기,의정부시,6,0,0,6,2,0,2018-05-01
293,경기,의정부시,10,0,3,13,8,0,2018-06-01
294,경기,의정부시,5,1,0,6,6,0,2018-07-01
295,경기,의정부시,0,2,0,2,2,0,2018-08-01
296,경기,의정부시,2,1,3,6,6,0,2018-09-01
297,경기,의정부시,9,0,2,11,9,0,2018-10-01
298,경기,의정부시,3,0,1,4,3,0,2018-11-01
299,경기,의정부시,8,0,2,10,6,0,2018-12-01
300,경기,이천시,3,1,0,4,3,0,2018-01-01
301,경기,이천시,4,1,1,6,4,0,2018-02-01
302,경기,이천시,4,0,0,4,1,0,2018-03-01
303,경기,이천시,2,0,1,3,3,0,2018-04-01
304,경기,이천시,5,0,0,5,4,0,2018-05-01
305,경기,이천시,2,0,2,4,4,0,2018-06-01
306,경기,이천시,1,0,0,1,1,0,2018-07-01
307,경기,이천시,8,1,1,10,6,0,2018-08-01
308,경기,이천시,4,1,4,9,6,1,2018-09-01
309,경기,이천시,1,0,0,1,1,0,2018-10-01
310,경기,이천시,3,0,1,4,2,0,2018-11-01
311,경기,이천시,2,0,0,2,2,0,2018-12-01
312,경기,파주시,1,0,1,2,2,0,2018-01-01
313,경기,파주시,11,0,1,12,6,0,2018-02-01
314,경기,파주시,7,0,2,9,4,0,2018-03-01
315,경기,파주시,3,0,1,4,3,0,2018-04-01
316,경기,파주시,5,0,3,8,4,0,2018-05-01
317,경기,파주시,7,2,1,10,8,0,2018-06-01
318,경기,파주시,6,2,0,8,4,0,2018-07-01
319,경기,파주시,17,3,5,25,7,0,2018-08-01
320,경기,파주시,8,0,4,12,6,0,2018-09-01
321,경기,파주시,6,2,5,13,8,0,2018-10-01
322,경기,파주시,5,0,4,9,9,0,2018-11-01
323,경기,파주시,9,1,0,10,5,0,2018-12-01
324,경기,평택시,6,1,2,9,6,1,2018-01-01
325,경기,평택시,8,1,3,12,7,0,2018-02-01
326,경기,평택시,7,0,1,8,7,0,2018-03-01
327,경기,평택시,3,1,1,5,4,0,2018-04-01
328,경기,평택시,9,0,0,9,5,0,2018-05-01
329,경기,평택시,10,4,2,16,12,1,2018-06-01
330,경기,평택시,8,1,3,12,8,0,2018-07-01
331,경기,평택시,7,0,4,11,9,0,2018-08-01
332,경기,평택시,17,0,2,19,7,0,2018-09-01
333,경기,평택시,9,5,7,21,10,0,2018-10-01
334,경기,평택시,15,2,2,19,14,0,2018-11-01
335,경기,평택시,6,2,3,11,8,0,2018-12-01
336,경기,포천시,1,0,0,1,1,0,2018-01-01
337,경기,포천시,0,0,0,0,0,0,2018-02-01
338,경기,포천시,2,0,0,2,1,0,2018-03-01
339,경기,포천시,0,0,0,0,0,0,2018-04-01
340,경기,포천시,0,7,0,7,1,0,2018-05-01
341,경기,포천시,4,0,6,10,2,0,2018-06-01
342,경기,포천시,7,1,2,10,4,0,2018-07-01
343,경기,포천시,7,4,2,13,3,0,2018-08-01
344,경기,포천시,2,1,2,5,4,0,2018-09-01
345,경기,포천시,11,0,0,11,4,0,2018-10-01
346,경기,포천시,0,0,2,2,2,0,2018-11-01
347,경기,포천시,4,1,0,5,4,0,2018-12-01
348,경기,하남시,0,0,0,0,0,0,2018-01-01
349,경기,하남시,3,0,1,4,3,0,2018-02-01
350,경기,하남시,0,0,2,2,2,0,2018-03-01
351,경기,하남시,2,1,2,5,2,0,2018-04-01
352,경기,하남시,2,0,3,5,2,0,2018-05-01
353,경기,하남시,5,0,0,5,4,0,2018-06-01
354,경기,하남시,1,0,1,2,1,0,2018-07-01
355,경기,하남시,2,0,0,2,2,0,2018-08-01
356,경기,하남시,2,0,0,2,2,0,2018-09-01
357,경기,하남시,2,0,4,6,5,0,2018-10-01
358,경기,하남시,3,0,4,7,6,0,2018-11-01
359,경기,하남시,0,1,1,2,2,0,2018-12-01
360,경기,화성시,9,1,5,15,7,1,2018-01-01
361,경기,화성시,6,0,1,7,5,0,2018-02-01
362,경기,화성시,4,0,2,6,5,0,2018-03-01
363,경기,화성시,5,2,2,9,4,0,2018-04-01
364,경기,화성시,1,0,1,2,2,0,2018-05-01
365,경기,화성시,6,0,1,7,7,0,2018-06-01
366,경기,화성시,5,0,4,9,6,0,2018-07-01
367,경기,화성시,12,0,2,14,8,0,2018-08-01
368,경기,화성시,16,0,7,23,14,0,2018-09-01
369,경기,화성시,3,1,2,6,3,0,2018-10-01
370,경기,화성시,8,0,3,11,7,0,2018-11-01
371,경기,화성시,10,0,2,12,7,0,2018-12-01
372,경기,가평군,3,0,0,3,2,0,2018-01-02
373,경기,가평군,0,0,0,0,0,0,2018-02-02
374,경기,가평군,0,0,0,0,0,0,2018-03-02
375,경기,가평군,0,0,0,0,0,0,2018-04-02
376,경기,가평군,2,0,1,3,2,0,2018-05-02
377,경기,가평군,3,0,0,3,2,0,2018-06-02
378,경기,가평군,0,0,0,0,0,0,2018-07-02
379,경기,가평군,7,0,0,7,3,0,2018-08-02
380,경기,가평군,1,0,0,1,1,0,2018-09-02
381,경기,가평군,0,0,0,0,0,0,2018-10-02
382,경기,가평군,2,0,0,2,2,0,2018-11-02
383,경기,가평군,0,0,0,0,0,0,2018-12-02
384,경기,고양시,14,0,2,16,10,0,2018-01-02
385,경기,고양시,21,2,8,31,18,0,2018-02-02
386,경기,고양시,11,1,2,14,8,0,2018-03-02
387,경기,고양시,20,0,6,26,11,0,2018-04-02
388,경기,고양시,11,2,3,16,10,0,2018-05-02
389,경기,고양시,17,1,4,22,16,0,2018-06-02
390,경기,고양시,15,3,7,25,18,1,2018-07-02
391,경기,고양시,9,6,1,16,10,0,2018-08-02
392,경기,고양시,6,0,2,8,5,0,2018-09-02
393,경기,고양시,10,1,3,14,12,0,2018-10-02
394,경기,고양시,7,1,9,17,12,0,2018-11-02
395,경기,고양시,5,1,2,8,6,0,2018-12-02
396,경기,과천시,0,0,0,0,0,0,2018-01-02
397,경기,과천시,0,0,2,2,1,0,2018-02-02
398,경기,과천시,0,0,0,0,0,0,2018-03-02
399,경기,과천시,0,0,0,0,0,0,2018-04-02
400,경기,과천시,1,0,0,1,1,0,2018-05-02
401,경기,과천시,1,0,0,1,1,0,2018-06-02
402,경기,과천시,0,0,0,0,0,0,2018-07-02
403,경기,과천시,0,0,0,0,0,0,2018-08-02
404,경기,과천시,4,2,1,7,2,0,2018-09-02
405,경기,과천시,0,0,0,0,0,0,2018-10-02
406,경기,과천시,0,0,0,0,0,0,2018-11-02
407,경기,과천시,0,0,0,0,0,0,2018-12-02
408,경기,광명시,3,0,2,5,5,0,2018-01-02
409,경기,광명시,1,0,0,1,1,0,2018-02-02
410,경기,광명시,0,1,0,1,1,0,2018-03-02
411,경기,광명시,1,1,0,2,2,0,2018-04-02
412,경기,광명시,2,1,0,3,2,0,2018-05-02
413,경기,광명시,6,0,1,7,5,0,2018-06-02
414,경기,광명시,4,0,3,7,5,0,2018-07-02
415,경기,광명시,1,1,0,2,2,0,2018-08-02
416,경기,광명시,3,0,0,3,1,0,2018-09-02
417,경기,광명시,4,0,2,6,4,0,2018-10-02
418,경기,광명시,3,1,1,5,5,0,2018-11-02
419,경기,광명시,1,0,1,2,2,0,2018-12-02
420,경기,광주시,1,0,0,1,1,0,2018-01-02
421,경기,광주시,8,0,3,11,7,0,2018-02-02
422,경기,광주시,0,0,1,1,2,1,2018-03-02
423,경기,광주시,5,0,3,8,5,0,2018-04-02
424,경기,광주시,10,0,3,13,5,2,2018-05-02
425,경기,광주시,3,0,2,5,3,0,2018-06-02
426,경기,광주시,8,0,0,8,4,0,2018-07-02
427,경기,광주시,14,5,1,20,10,0,2018-08-02
428,경기,광주시,5,0,0,5,4,1,2018-09-02
429,경기,광주시,2,0,5,7,5,0,2018-10-02
430,경기,광주시,8,1,1,10,5,0,2018-11-02
431,경기,광주시,2,0,0,2,2,0,2018-12-02
432,경기,구리시,4,0,2,6,3,0,2018-01-02
433,경기,구리시,1,0,0,1,1,0,2018-02-02
434,경기,구리시,0,0,1,1,1,0,2018-03-02
435,경기,구리시,1,0,0,1,1,0,2018-04-02
436,경기,구리시,3,0,1,4,4,0,2018-05-02
437,경기,구리시,2,0,1,3,3,0,2018-06-02
438,경기,구리시,5,0,3,8,5,0,2018-07-02
439,경기,구리시,4,0,1,5,3,0,2018-08-02
440,경기,구리시,4,0,3,7,3,0,2018-09-02
441,경기,구리시,1,0,0,1,1,0,2018-10-02
442,경기,구리시,5,1,0,6,4,0,2018-11-02
443,경기,구리시,1,0,2,3,1,0,2018-12-02
444,경기,군포시,3,0,0,3,2,0,2018-01-02
445,경기,군포시,0,0,1,1,2,1,2018-02-02
446,경기,군포시,1,0,1,2,2,0,2018-03-02
447,경기,군포시,0,1,0,1,1,0,2018-04-02
448,경기,군포시,2,0,2,4,3,0,2018-05-02
449,경기,군포시,1,0,1,2,2,0,2018-06-02
450,경기,군포시,2,0,0,2,2,0,2018-07-02
451,경기,군포시,3,0,0,3,3,0,2018-08-02
452,경기,군포시,2,0,1,3,3,1,2018-09-02
453,경기,군포시,2,0,3,5,4,0,2018-10-02
454,경기,군포시,7,3,3,13,5,0,2018-11-02
455,경기,군포시,1,2,0,3,1,0,2018-12-02
456,경기,김포시,2,1,2,5,4,0,2018-01-02
457,경기,김포시,7,0,5,12,9,0,2018-02-02
458,경기,김포시,3,0,2,5,3,0,2018-03-02
459,경기,김포시,2,0,0,2,2,0,2018-04-02
460,경기,김포시,4,0,4,8,4,0,2018-05-02
461,경기,김포시,4,0,0,4,4,0,2018-06-02
462,경기,김포시,7,0,1,8,4,0,2018-07-02
463,경기,김포시,2,0,1,3,3,0,2018-08-02
464,경기,김포시,10,0,2,12,4,0,2018-09-02
465,경기,김포시,14,1,1,16,8,0,2018-10-02
466,경기,김포시,4,1,0,5,4,0,2018-11-02
467,경기,김포시,5,1,0,6,3,0,2018-12-02
468,경기,남양주시,5,0,3,8,9,1,2018-01-02
469,경기,남양주시,12,0,3,15,8,0,2018-02-02
470,경기,남양주시,6,1,0,7,6,0,2018-03-02
471,경기,남양주시,5,2,2,9,5,0,2018-04-02
472,경기,남양주시,14,0,5,19,11,0,2018-05-02
473,경기,남양주시,16,0,9,25,10,0,2018-06-02
474,경기,남양주시,16,0,7,23,12,0,2018-07-02
475,경기,남양주시,8,1,3,12,7,0,2018-08-02
476,경기,남양주시,9,7,2,18,6,0,2018-09-02
477,경기,남양주시,10,1,2,13,9,0,2018-10-02
478,경기,남양주시,9,2,4,15,13,1,2018-11-02
479,경기,남양주시,16,2,1,19,8,0,2018-12-02
480,경기,동두천시,1,0,1,2,2,0,2018-01-02
481,경기,동두천시,1,0,0,1,1,0,2018-02-02
482,경기,동두천시,0,0,2,2,2,0,2018-03-02
483,경기,동두천시,0,1,1,2,2,0,2018-04-02
484,경기,동두천시,2,0,0,2,1,0,2018-05-02
485,경기,동두천시,0,0,1,1,1,0,2018-06-02
486,경기,동두천시,1,0,1,2,1,0,2018-07-02
487,경기,동두천시,0,0,0,0,1,1,2018-08-02
488,경기,동두천시,2,2,0,4,1,0,2018-09-02
489,경기,동두천시,1,0,0,1,1,0,2018-10-02
490,경기,동두천시,1,0,0,1,1,0,2018-11-02
491,경기,동두천시,0,0,0,0,0,0,2018-12-02
492,경기,부천시,15,1,4,20,10,0,2018-01-02
493,경기,부천시,14,1,0,15,10,0,2018-02-02
494,경기,부천시,3,2,3,8,8,0,2018-03-02
495,경기,부천시,9,1,2,12,8,0,2018-04-02
496,경기,부천시,12,0,1,13,9,0,2018-05-02
497,경기,부천시,12,0,2,14,11,0,2018-06-02
498,경기,부천시,12,0,4,16,13,1,2018-07-02
499,경기,부천시,0,0,2,2,2,0,2018-08-02
500,경기,부천시,6,0,1,7,5,0,2018-09-02
501,경기,부천시,15,0,3,18,16,0,2018-10-02
502,경기,부천시,18,2,4,24,19,0,2018-11-02
503,경기,부천시,14,0,0,14,6,0,2018-12-02
504,경기,성남시,8,1,3,12,10,0,2018-01-02
505,경기,성남시,12,2,3,17,11,0,2018-02-02
506,경기,성남시,5,0,1,6,5,0,2018-03-02
507,경기,성남시,9,0,5,14,11,0,2018-04-02
508,경기,성남시,17,0,6,23,14,0,2018-05-02
509,경기,성남시,13,3,4,20,14,0,2018-06-02
510,경기,성남시,17,3,4,24,15,0,2018-07-02
511,경기,성남시,3,0,2,5,5,1,2018-08-02
512,경기,성남시,4,1,4,9,7,0,2018-09-02
513,경기,성남시,5,1,5,11,6,0,2018-10-02
514,경기,성남시,26,3,4,33,16,0,2018-11-02
515,경기,성남시,4,1,3,8,6,0,2018-12-02
516,경기,수원시,12,0,6,18,12,0,2018-01-02
517,경기,수원시,9,2,2,13,10,0,2018-02-02
518,경기,수원시,14,2,0,16,12,0,2018-03-02
519,경기,수원시,11,0,2,13,10,0,2018-04-02
520,경기,수원시,11,1,3,15,13,0,2018-05-02
521,경기,수원시,9,1,7,17,18,1,2018-06-02
522,경기,수원시,15,1,6,22,15,0,2018-07-02
523,경기,수원시,9,1,6,16,13,0,2018-08-02
524,경기,수원시,10,1,2,13,12,0,2018-09-02
525,경기,수원시,14,3,9,26,16,0,2018-10-02
526,경기,수원시,15,1,4,20,15,0,2018-11-02
527,경기,수원시,8,2,3,13,9,0,2018-12-02
528,경기,시흥시,2,0,0,2,2,0,2018-01-02
529,경기,시흥시,7,2,1,10,6,0,2018-02-02
530,경기,시흥시,3,0,3,6,6,0,2018-03-02
531,경기,시흥시,4,0,0,4,4,0,2018-04-02
532,경기,시흥시,4,0,3,7,5,0,2018-05-02
533,경기,시흥시,8,1,1,10,4,0,2018-06-02
534,경기,시흥시,7,0,1,8,7,0,2018-07-02
535,경기,시흥시,5,1,2,8,5,0,2018-08-02
536,경기,시흥시,19,0,1,20,10,0,2018-09-02
537,경기,시흥시,13,0,2,15,11,0,2018-10-02
538,경기,시흥시,5,1,6,12,8,0,2018-11-02
539,경기,시흥시,8,1,1,10,8,0,2018-12-02
540,경기,안산시,5,2,2,9,5,0,2018-01-02
541,경기,안산시,20,0,5,25,16,0,2018-02-02
542,경기,안산시,24,0,2,26,15,0,2018-03-02
543,경기,안산시,6,0,8,14,7,1,2018-04-02
544,경기,안산시,10,0,2,12,8,0,2018-05-02
545,경기,안산시,7,0,4,11,9,0,2018-06-02
546,경기,안산시,12,0,3,15,11,0,2018-07-02
547,경기,안산시,12,1,2,15,9,0,2018-08-02
548,경기,안산시,11,0,3,14,9,0,2018-09-02
549,경기,안산시,9,0,4,13,9,0,2018-10-02
550,경기,안산시,15,1,5,21,15,0,2018-11-02
551,경기,안산시,13,0,2,15,7,0,2018-12-02
552,경기,안성시,1,0,1,2,2,0,2018-01-02
553,경기,안성시,2,0,0,2,2,0,2018-02-02
554,경기,안성시,2,1,0,3,2,0,2018-03-02
555,경기,안성시,6,0,0,6,2,0,2018-04-02
556,경기,안성시,0,0,0,0,0,0,2018-05-02
557,경기,안성시,9,1,3,13,5,0,2018-06-02
558,경기,안성시,3,3,0,6,3,0,2018-07-02
559,경기,안성시,4,0,0,4,3,0,2018-08-02
560,경기,안성시,4,0,0,4,3,0,2018-09-02
561,경기,안성시,4,0,1,5,3,0,2018-10-02
562,경기,안성시,7,1,3,11,7,0,2018-11-02
563,경기,안성시,4,0,2,6,3,0,2018-12-02
564,경기,안양시,0,0,0,0,0,0,2018-01-02
565,경기,안양시,4,0,3,7,7,0,2018-02-02
566,경기,안양시,5,0,0,5,3,0,2018-03-02
567,경기,안양시,1,1,2,4,4,0,2018-04-02
568,경기,안양시,7,0,3,10,6,0,2018-05-02
569,경기,안양시,2,1,0,3,3,0,2018-06-02
570,경기,안양시,2,1,4,7,3,0,2018-07-02
571,경기,안양시,0,0,0,0,0,0,2018-08-02
572,경기,안양시,3,1,2,6,4,0,2018-09-02
573,경기,안양시,5,0,0,5,4,0,2018-10-02
574,경기,안양시,5,0,1,6,5,0,2018-11-02
575,경기,안양시,1,0,1,2,2,0,2018-12-02
576,경기,양주시,0,1,0,1,1,0,2018-01-02
577,경기,양주시,2,0,1,3,3,0,2018-02-02
578,경기,양주시,5,0,0,5,3,0,2018-03-02
579,경기,양주시,1,0,0,1,1,0,2018-04-02
580,경기,양주시,3,0,2,5,4,0,2018-05-02
581,경기,양주시,0,0,1,1,1,0,2018-06-02
582,경기,양주시,5,0,2,7,5,0,2018-07-02
583,경기,양주시,7,0,0,7,3,0,2018-08-02
584,경기,양주시,2,0,0,2,1,0,2018-09-02
585,경기,양주시,2,0,1,3,3,0,2018-10-02
586,경기,양주시,3,0,2,5,4,0,2018-11-02
587,경기,양주시,2,0,0,2,2,0,2018-12-02
588,경기,양평군,0,0,0,0,0,0,2018-01-02
589,경기,양평군,2,0,0,2,2,0,2018-02-02
590,경기,양평군,1,0,0,1,1,0,2018-03-02
591,경기,양평군,0,0,0,0,0,0,2018-04-02
592,경기,양평군,0,0,0,0,0,0,2018-05-02
593,경기,양평군,0,0,0,0,0,0,2018-06-02
594,경기,양평군,1,0,0,1,1,0,2018-07-02
595,경기,양평군,0,0,1,1,1,0,2018-08-02
596,경기,양평군,0,0,0,0,0,0,2018-09-02
597,경기,양평군,1,0,1,2,2,0,2018-10-02
598,경기,양평군,1,1,1,3,2,0,2018-11-02
599,경기,양평군,0,0,0,0,0,0,2018-12-02
600,경기,여주시,0,0,0,0,0,0,2018-01-02
601,경기,여주시,1,0,0,1,1,0,2018-02-02
602,경기,여주시,4,0,0,4,1,0,2018-03-02
603,경기,여주시,1,0,0,1,1,0,2018-04-02
604,경기,여주시,1,0,1,2,2,0,2018-05-02
605,경기,여주시,0,0,1,1,1,0,2018-06-02
606,경기,여주시,2,1,1,4,4,0,2018-07-02
607,경기,여주시,2,0,1,3,3,0,2018-08-02
608,경기,여주시,2,0,1,3,2,0,2018-09-02
609,경기,여주시,0,0,0,0,0,0,2018-10-02
610,경기,여주시,0,0,0,0,0,0,2018-11-02
611,경기,여주시,2,0,1,3,2,0,2018-12-02
612,경기,연천군,5,0,0,5,2,0,2018-01-02
613,경기,연천군,0,0,0,0,0,0,2018-02-02
614,경기,연천군,0,0,1,1,1,0,2018-03-02
615,경기,연천군,1,0,0,1,1,0,2018-04-02
616,경기,연천군,0,0,2,2,1,0,2018-05-02
617,경기,연천군,2,0,0,2,1,0,2018-06-02
618,경기,연천군,4,14,3,21,2,0,2018-07-02
619,경기,연천군,0,0,0,0,0,0,2018-08-02
620,경기,연천군,1,0,0,1,1,0,2018-09-02
621,경기,연천군,0,0,0,0,0,0,2018-10-02
622,경기,연천군,0,0,0,0,0,0,2018-11-02
623,경기,연천군,3,0,0,3,2,0,2018-12-02
624,경기,오산시,0,0,0,0,0,0,2018-01-02
625,경기,오산시,3,0,0,3,2,0,2018-02-02
626,경기,오산시,0,0,2,2,2,0,2018-03-02
627,경기,오산시,2,0,0,2,1,0,2018-04-02
628,경기,오산시,2,0,0,2,1,0,2018-05-02
629,경기,오산시,2,0,2,4,4,0,2018-06-02
630,경기,오산시,8,0,0,8,4,0,2018-07-02
631,경기,오산시,2,0,0,2,2,0,2018-08-02
632,경기,오산시,3,0,2,5,4,0,2018-09-02
633,경기,오산시,2,0,0,2,2,0,2018-10-02
634,경기,오산시,7,0,1,8,5,0,2018-11-02
635,경기,오산시,0,0,0,0,0,0,2018-12-02
636,경기,용인시,13,1,1,15,9,0,2018-01-02
637,경기,용인시,3,3,5,11,10,0,2018-02-02
638,경기,용인시,6,1,6,13,11,0,2018-03-02
639,경기,용인시,5,0,1,6,5,0,2018-04-02
640,경기,용인시,19,3,3,25,18,0,2018-05-02
641,경기,용인시,10,4,8,22,12,0,2018-06-02
642,경기,용인시,4,0,0,4,4,0,2018-07-02
643,경기,용인시,7,1,4,12,11,0,2018-08-02
644,경기,용인시,7,0,1,8,4,0,2018-09-02
645,경기,용인시,5,3,3,11,4,0,2018-10-02
646,경기,용인시,9,3,3,15,11,1,2018-11-02
647,경기,용인시,6,2,4,12,8,0,2018-12-02
648,경기,의왕시,1,0,0,1,1,0,2018-01-02
649,경기,의왕시,5,0,2,7,2,0,2018-02-02
650,경기,의왕시,0,0,1,1,1,0,2018-03-02
651,경기,의왕시,1,0,0,1,1,0,2018-04-02
652,경기,의왕시,0,0,0,0,0,0,2018-05-02
653,경기,의왕시,0,0,0,0,0,0,2018-06-02
654,경기,의왕시,1,0,0,1,1,0,2018-07-02
655,경기,의왕시,1,0,1,2,1,0,2018-08-02
656,경기,의왕시,0,0,1,1,1,0,2018-09-02
657,경기,의왕시,2,0,0,2,2,0,2018-10-02
658,경기,의왕시,0,0,0,0,0,0,2018-11-02
659,경기,의왕시,0,0,0,0,0,0,2018-12-02
660,경기,의정부시,2,0,2,4,4,0,2018-01-02
661,경기,의정부시,7,1,1,9,8,0,2018-02-02
662,경기,의정부시,4,3,3,10,6,0,2018-03-02
663,경기,의정부시,0,0,0,0,0,0,2018-04-02
664,경기,의정부시,2,0,3,5,4,0,2018-05-02
665,경기,의정부시,1,0,0,1,1,0,2018-06-02
666,경기,의정부시,10,3,0,13,5,0,2018-07-02
667,경기,의정부시,1,0,0,1,1,0,2018-08-02
668,경기,의정부시,1,0,1,2,2,0,2018-09-02
669,경기,의정부시,4,1,2,7,5,0,2018-10-02
670,경기,의정부시,9,2,1,12,8,0,2018-11-02
671,경기,의정부시,1,1,0,2,2,0,2018-12-02
672,경기,이천시,3,0,0,3,2,0,2018-01-02
673,경기,이천시,3,0,1,4,4,0,2018-02-02
674,경기,이천시,0,1,0,1,1,0,2018-03-02
675,경기,이천시,5,0,0,5,3,0,2018-04-02
676,경기,이천시,0,0,0,0,0,0,2018-05-02
677,경기,이천시,5,0,1,6,4,0,2018-06-02
678,경기,이천시,3,0,0,3,2,2,2018-07-02
679,경기,이천시,7,0,4,11,7,0,2018-08-02
680,경기,이천시,5,2,1,8,6,0,2018-09-02
681,경기,이천시,0,0,1,1,2,1,2018-10-02
682,경기,이천시,5,0,1,6,5,0,2018-11-02
683,경기,이천시,4,0,1,5,4,0,2018-12-02
684,경기,파주시,1,0,0,1,1,0,2018-01-02
685,경기,파주시,6,0,3,9,8,0,2018-02-02
686,경기,파주시,12,0,6,18,10,0,2018-03-02
687,경기,파주시,0,0,0,0,1,1,2018-04-02
688,경기,파주시,7,0,4,11,5,0,2018-05-02
689,경기,파주시,2,2,0,4,4,0,2018-06-02
690,경기,파주시,8,0,1,9,5,0,2018-07-02
691,경기,파주시,7,0,0,7,2,0,2018-08-02
692,경기,파주시,2,0,0,2,2,0,2018-09-02
693,경기,파주시,1,0,0,1,2,1,2018-10-02
694,경기,파주시,8,1,1,10,7,0,2018-11-02
695,경기,파주시,3,1,3,7,5,0,2018-12-02
696,경기,평택시,9,2,0,11,6,1,2018-01-02
697,경기,평택시,10,1,6,17,10,0,2018-02-02
698,경기,평택시,9,0,3,12,7,0,2018-03-02
699,경기,평택시,18,1,5,24,14,0,2018-04-02
700,경기,평택시,7,1,4,12,8,0,2018-05-02
701,경기,평택시,8,2,2,12,8,0,2018-06-02
702,경기,평택시,11,0,3,14,10,0,2018-07-02
703,경기,평택시,8,0,0,8,5,0,2018-08-02
704,경기,평택시,3,0,0,3,4,1,2018-09-02
705,경기,평택시,10,3,0,13,9,1,2018-10-02
706,경기,평택시,15,1,3,19,9,0,2018-11-02
707,경기,평택시,5,2,2,9,4,0,2018-12-02
708,경기,포천시,1,1,0,2,1,0,2018-01-02
709,경기,포천시,3,2,1,6,5,0,2018-02-02
710,경기,포천시,5,0,0,5,2,0,2018-03-02
711,경기,포천시,3,0,4,7,5,0,2018-04-02
712,경기,포천시,0,0,0,0,0,0,2018-05-02
713,경기,포천시,4,1,0,5,3,0,2018-06-02
714,경기,포천시,4,1,0,5,5,0,2018-07-02
715,경기,포천시,8,0,1,9,2,0,2018-08-02
716,경기,포천시,3,0,0,3,2,0,2018-09-02
717,경기,포천시,8,1,0,9,4,0,2018-10-02
718,경기,포천시,6,0,1,7,5,0,2018-11-02
719,경기,포천시,0,0,0,0,0,0,2018-12-02
720,경기,하남시,5,0,0,5,2,0,2018-01-02
721,경기,하남시,2,0,1,3,3,0,2018-02-02
722,경기,하남시,4,0,2,6,4,0,2018-03-02
723,경기,하남시,1,0,0,1,1,0,2018-04-02
724,경기,하남시,6,0,1,7,7,1,2018-05-02
725,경기,하남시,3,0,0,3,2,0,2018-06-02
726,경기,하남시,1,0,0,1,2,1,2018-07-02
727,경기,하남시,7,1,2,10,5,0,2018-08-02
728,경기,하남시,4,1,3,8,5,0,2018-09-02
729,경기,하남시,1,0,1,2,2,0,2018-10-02
730,경기,하남시,5,2,2,9,5,0,2018-11-02
731,경기,하남시,6,0,1,7,3,0,2018-12-02
732,경기,화성시,10,1,2,13,7,0,2018-01-02
733,경기,화성시,3,0,1,4,2,0,2018-02-02
734,경기,화성시,1,0,1,2,2,0,2018-03-02
735,경기,화성시,27,1,5,33,12,3,2018-04-02
736,경기,화성시,4,0,2,6,6,1,2018-05-02
737,경기,화성시,8,1,6,15,10,0,2018-06-02
738,경기,화성시,13,0,1,14,9,0,2018-07-02
739,경기,화성시,8,0,1,9,6,1,2018-08-02
740,경기,화성시,7,0,5,12,8,0,2018-09-02
741,경기,화성시,12,0,1,13,10,1,2018-10-02
742,경기,화성시,10,0,3,13,13,1,2018-11-02
743,경기,화성시,15,0,0,15,7,0,2018-12-02
744,경기,가평군,0,0,0,0,0,0,2018-01-03
745,경기,가평군,0,0,0,0,1,1,2018-02-03
746,경기,가평군,0,0,0,0,0,0,2018-03-03
747,경기,가평군,1,0,0,1,1,0,2018-04-03
748,경기,가평군,0,0,0,0,0,0,2018-05-03
749,경기,가평군,0,0,0,0,0,0,2018-06-03
750,경기,가평군,2,0,0,2,2,0,2018-07-03
751,경기,가평군,7,0,0,7,3,0,2018-08-03
752,경기,가평군,0,0,0,0,0,0,2018-09-03
753,경기,가평군,0,0,0,0,0,0,2018-10-03
754,경기,가평군,3,0,0,3,1,0,2018-11-03
755,경기,가평군,0,0,0,0,0,0,2018-12-03
756,경기,고양시,15,2,2,19,17,1,2018-01-03
757,경기,고양시,40,1,4,45,27,0,2018-02-03
758,경기,고양시,6,1,0,7,4,0,2018-03-03
759,경기,고양시,10,0,3,13,8,0,2018-04-03
760,경기,고양시,10,0,3,13,13,0,2018-05-03
761,경기,고양시,12,0,4,16,12,0,2018-06-03
762,경기,고양시,6,1,3,10,8,0,2018-07-03
763,경기,고양시,15,2,5,22,13,0,2018-08-03
764,경기,고양시,6,2,9,17,10,0,2018-09-03
765,경기,고양시,3,1,5,9,10,1,2018-10-03
766,경기,고양시,9,0,2,11,9,1,2018-11-03
767,경기,고양시,10,1,4,15,11,1,2018-12-03
768,경기,과천시,3,0,0,3,2,0,2018-01-03
769,경기,과천시,2,0,0,2,1,0,2018-02-03
770,경기,과천시,0,0,0,0,0,0,2018-03-03
771,경기,과천시,0,0,0,0,0,0,2018-04-03
772,경기,과천시,1,0,0,1,1,0,2018-05-03
773,경기,과천시,4,0,0,4,1,0,2018-06-03
774,경기,과천시,0,0,0,0,0,0,2018-07-03
775,경기,과천시,5,0,0,5,3,0,2018-08-03
776,경기,과천시,0,0,1,1,1,0,2018-09-03
777,경기,과천시,0,1,0,1,1,0,2018-10-03
778,경기,과천시,0,0,1,1,1,0,2018-11-03
779,경기,과천시,0,0,0,0,0,0,2018-12-03
780,경기,광명시,0,1,0,1,1,0,2018-01-03
781,경기,광명시,5,0,0,5,4,0,2018-02-03
782,경기,광명시,5,3,0,8,4,0,2018-03-03
783,경기,광명시,2,0,2,4,3,0,2018-04-03
784,경기,광명시,1,0,0,1,1,0,2018-05-03
785,경기,광명시,5,0,3,8,4,0,2018-06-03
786,경기,광명시,1,0,0,1,1,0,2018-07-03
787,경기,광명시,3,0,1,4,2,0,2018-08-03
788,경기,광명시,2,0,0,2,2,0,2018-09-03
789,경기,광명시,3,1,1,5,5,0,2018-10-03
790,경기,광명시,2,1,1,4,4,0,2018-11-03
791,경기,광명시,5,0,2,7,6,0,2018-12-03
792,경기,광주시,1,3,0,4,2,0,2018-01-03
793,경기,광주시,17,7,1,25,12,0,2018-02-03
794,경기,광주시,0,1,0,1,1,0,2018-03-03
795,경기,광주시,3,0,3,6,5,0,2018-04-03
796,경기,광주시,7,0,3,10,7,0,2018-05-03
797,경기,광주시,5,0,5,10,4,0,2018-06-03
798,경기,광주시,8,0,0,8,6,1,2018-07-03
799,경기,광주시,3,1,0,4,3,0,2018-08-03
800,경기,광주시,15,1,0,16,10,0,2018-09-03
801,경기,광주시,4,0,1,5,5,0,2018-10-03
802,경기,광주시,8,0,0,8,6,0,2018-11-03
803,경기,광주시,10,1,1,12,7,0,2018-12-03
804,경기,구리시,1,0,0,1,1,0,2018-01-03
805,경기,구리시,5,0,0,5,2,0,2018-02-03
806,경기,구리시,3,0,0,3,2,0,2018-03-03
807,경기,구리시,1,0,0,1,1,0,2018-04-03
808,경기,구리시,1,0,1,2,2,0,2018-05-03
809,경기,구리시,3,0,0,3,3,0,2018-06-03
810,경기,구리시,5,0,0,5,3,0,2018-07-03
811,경기,구리시,0,0,1,1,1,0,2018-08-03
812,경기,구리시,2,0,1,3,3,0,2018-09-03
813,경기,구리시,2,0,1,3,3,0,2018-10-03
814,경기,구리시,2,0,0,2,2,0,2018-11-03
815,경기,구리시,2,0,2,4,4,0,2018-12-03
816,경기,군포시,1,0,0,1,1,0,2018-01-03
817,경기,군포시,7,0,4,11,6,0,2018-02-03
818,경기,군포시,0,0,0,0,0,0,2018-03-03
819,경기,군포시,0,0,0,0,0,0,2018-04-03
820,경기,군포시,2,0,0,2,2,0,2018-05-03
821,경기,군포시,0,0,2,2,2,0,2018-06-03
822,경기,군포시,0,0,1,1,1,0,2018-07-03
823,경기,군포시,2,0,0,2,2,0,2018-08-03
824,경기,군포시,3,1,1,5,3,0,2018-09-03
825,경기,군포시,3,0,0,3,2,0,2018-10-03
826,경기,군포시,1,0,0,1,1,0,2018-11-03
827,경기,군포시,1,0,0,1,1,0,2018-12-03
828,경기,김포시,3,0,0,3,2,0,2018-01-03
829,경기,김포시,11,0,0,11,6,0,2018-02-03
830,경기,김포시,5,1,0,6,5,0,2018-03-03
831,경기,김포시,7,0,1,8,5,0,2018-04-03
832,경기,김포시,2,0,0,2,2,0,2018-05-03
833,경기,김포시,5,0,2,7,5,0,2018-06-03
834,경기,김포시,5,0,3,8,7,0,2018-07-03
835,경기,김포시,2,0,2,4,4,0,2018-08-03
836,경기,김포시,4,0,1,5,4,0,2018-09-03
837,경기,김포시,6,1,2,9,6,0,2018-10-03
838,경기,김포시,9,2,3,14,6,0,2018-11-03
839,경기,김포시,4,0,0,4,3,0,2018-12-03
840,경기,남양주시,5,2,1,8,3,0,2018-01-03
841,경기,남양주시,20,0,3,23,12,0,2018-02-03
842,경기,남양주시,7,0,0,7,7,0,2018-03-03
843,경기,남양주시,11,0,2,13,9,0,2018-04-03
844,경기,남양주시,11,3,3,17,10,0,2018-05-03
845,경기,남양주시,11,2,1,14,5,0,2018-06-03
846,경기,남양주시,5,1,3,9,6,0,2018-07-03
847,경기,남양주시,9,2,0,11,6,0,2018-08-03
848,경기,남양주시,4,1,0,5,4,0,2018-09-03
849,경기,남양주시,6,2,0,8,6,0,2018-10-03
850,경기,남양주시,15,2,5,22,15,0,2018-11-03
851,경기,남양주시,3,4,1,8,6,1,2018-12-03
852,경기,동두천시,0,1,0,1,1,0,2018-01-03
853,경기,동두천시,0,0,1,1,1,0,2018-02-03
854,경기,동두천시,2,0,0,2,2,0,2018-03-03
855,경기,동두천시,2,0,1,3,3,0,2018-04-03
856,경기,동두천시,3,0,0,3,2,0,2018-05-03
857,경기,동두천시,2,1,1,4,4,0,2018-06-03
858,경기,동두천시,5,0,0,5,1,0,2018-07-03
859,경기,동두천시,0,0,0,0,0,0,2018-08-03
860,경기,동두천시,0,0,0,0,0,0,2018-09-03
861,경기,동두천시,0,0,0,0,0,0,2018-10-03
862,경기,동두천시,7,0,0,7,4,0,2018-11-03
863,경기,동두천시,0,0,2,2,2,0,2018-12-03
864,경기,부천시,9,0,4,13,11,0,2018-01-03
865,경기,부천시,23,2,3,28,11,0,2018-02-03
866,경기,부천시,7,0,0,7,6,0,2018-03-03
867,경기,부천시,3,0,1,4,3,0,2018-04-03
868,경기,부천시,13,1,4,18,14,0,2018-05-03
869,경기,부천시,9,1,0,10,9,0,2018-06-03
870,경기,부천시,5,2,2,9,8,0,2018-07-03
871,경기,부천시,8,0,1,9,7,0,2018-08-03
872,경기,부천시,17,1,2,20,15,0,2018-09-03
873,경기,부천시,8,0,2,10,8,0,2018-10-03
874,경기,부천시,10,1,1,12,10,0,2018-11-03
875,경기,부천시,11,0,0,11,9,0,2018-12-03
876,경기,성남시,4,0,5,9,9,0,2018-01-03
877,경기,성남시,30,1,12,43,24,0,2018-02-03
878,경기,성남시,11,0,2,13,6,0,2018-03-03
879,경기,성남시,14,0,6,20,13,0,2018-04-03
880,경기,성남시,7,3,3,13,9,0,2018-05-03
881,경기,성남시,7,0,3,10,4,0,2018-06-03
882,경기,성남시,6,3,1,10,8,0,2018-07-03
883,경기,성남시,14,3,4,21,15,0,2018-08-03
884,경기,성남시,14,0,2,16,12,0,2018-09-03
885,경기,성남시,22,1,6,29,19,1,2018-10-03
886,경기,성남시,15,0,4,19,14,0,2018-11-03
887,경기,성남시,8,0,0,8,7,0,2018-12-03
888,경기,수원시,3,0,2,5,5,0,2018-01-03
889,경기,수원시,11,3,5,19,15,0,2018-02-03
890,경기,수원시,14,1,2,17,12,0,2018-03-03
891,경기,수원시,17,1,4,22,16,0,2018-04-03
892,경기,수원시,25,0,1,26,18,0,2018-05-03
893,경기,수원시,11,0,3,14,10,0,2018-06-03
894,경기,수원시,6,0,1,7,5,0,2018-07-03
895,경기,수원시,7,1,1,9,6,0,2018-08-03
896,경기,수원시,16,1,4,21,14,0,2018-09-03
897,경기,수원시,10,1,4,15,14,1,2018-10-03
898,경기,수원시,19,0,3,22,18,0,2018-11-03
899,경기,수원시,13,1,3,17,11,0,2018-12-03
900,경기,시흥시,4,0,1,5,5,0,2018-01-03
901,경기,시흥시,17,0,1,18,12,0,2018-02-03
902,경기,시흥시,5,2,2,9,9,0,2018-03-03
903,경기,시흥시,5,0,0,5,4,0,2018-04-03
904,경기,시흥시,2,0,4,6,5,0,2018-05-03
905,경기,시흥시,6,1,0,7,5,0,2018-06-03
906,경기,시흥시,8,3,4,15,9,0,2018-07-03
907,경기,시흥시,10,2,1,13,8,0,2018-08-03
908,경기,시흥시,4,0,2,6,5,0,2018-09-03
909,경기,시흥시,8,0,4,12,6,0,2018-10-03
910,경기,시흥시,13,0,3,16,9,0,2018-11-03
911,경기,시흥시,18,5,3,26,11,0,2018-12-03
912,경기,안산시,11,1,3,15,11,0,2018-01-03
913,경기,안산시,21,3,8,32,26,1,2018-02-03
914,경기,안산시,11,1,2,14,9,0,2018-03-03
915,경기,안산시,7,1,1,9,8,0,2018-04-03
916,경기,안산시,11,1,4,16,12,0,2018-05-03
917,경기,안산시,8,0,1,9,5,0,2018-06-03
918,경기,안산시,10,0,3,13,10,0,2018-07-03
919,경기,안산시,4,0,1,5,4,0,2018-08-03
920,경기,안산시,15,2,3,20,12,0,2018-09-03
921,경기,안산시,15,2,4,21,9,0,2018-10-03
922,경기,안산시,12,0,4,16,12,0,2018-11-03
923,경기,안산시,12,2,2,16,12,0,2018-12-03
924,경기,안성시,1,1,0,2,2,0,2018-01-03
925,경기,안성시,4,0,0,4,1,0,2018-02-03
926,경기,안성시,0,0,2,2,1,0,2018-03-03
927,경기,안성시,6,0,0,6,3,0,2018-04-03
928,경기,안성시,1,0,1,2,2,0,2018-05-03
929,경기,안성시,1,0,1,2,2,0,2018-06-03
930,경기,안성시,1,0,0,1,1,0,2018-07-03
931,경기,안성시,1,0,0,1,1,0,2018-08-03
932,경기,안성시,3,0,0,3,3,0,2018-09-03
933,경기,안성시,6,0,1,7,4,0,2018-10-03
934,경기,안성시,5,0,0,5,3,0,2018-11-03
935,경기,안성시,0,0,0,0,0,0,2018-12-03
936,경기,안양시,5,0,1,6,4,0,2018-01-03
937,경기,안양시,5,0,0,5,4,0,2018-02-03
938,경기,안양시,7,1,1,9,5,0,2018-03-03
939,경기,안양시,5,0,2,7,4,0,2018-04-03
940,경기,안양시,2,0,3,5,4,0,2018-05-03
941,경기,안양시,2,1,0,3,2,0,2018-06-03
942,경기,안양시,2,0,2,4,5,1,2018-07-03
943,경기,안양시,3,1,0,4,2,0,2018-08-03
944,경기,안양시,15,3,3,21,7,0,2018-09-03
945,경기,안양시,4,1,1,6,5,0,2018-10-03
946,경기,안양시,4,0,2,6,5,0,2018-11-03
947,경기,안양시,3,0,2,5,4,0,2018-12-03
948,경기,양주시,0,0,0,0,0,0,2018-01-03
949,경기,양주시,3,0,1,4,3,0,2018-02-03
950,경기,양주시,2,0,1,3,2,0,2018-03-03
951,경기,양주시,1,0,2,3,3,0,2018-04-03
952,경기,양주시,5,0,0,5,3,0,2018-05-03
953,경기,양주시,3,0,0,3,2,0,2018-06-03
954,경기,양주시,0,0,1,1,1,0,2018-07-03
955,경기,양주시,1,0,0,1,1,0,2018-08-03
956,경기,양주시,0,0,0,0,0,0,2018-09-03
957,경기,양주시,0,0,0,0,0,0,2018-10-03
958,경기,양주시,2,0,0,2,1,0,2018-11-03
959,경기,양주시,6,0,0,6,3,0,2018-12-03
960,경기,양평군,2,5,0,7,2,0,2018-01-03
961,경기,양평군,3,1,1,5,3,0,2018-02-03
962,경기,양평군,0,0,0,0,0,0,2018-03-03
963,경기,양평군,0,0,1,1,1,0,2018-04-03
964,경기,양평군,2,0,1,3,1,0,2018-05-03
965,경기,양평군,4,0,0,4,2,0,2018-06-03
966,경기,양평군,4,0,0,4,3,0,2018-07-03
967,경기,양평군,5,0,0,5,1,0,2018-08-03
968,경기,양평군,4,1,2,7,3,1,2018-09-03
969,경기,양평군,3,0,1,4,4,0,2018-10-03
970,경기,양평군,0,0,3,3,3,0,2018-11-03
971,경기,양평군,1,0,0,1,1,0,2018-12-03
972,경기,여주시,5,0,0,5,2,0,2018-01-03
973,경기,여주시,0,0,1,1,1,0,2018-02-03
974,경기,여주시,0,0,0,0,0,0,2018-03-03
975,경기,여주시,0,0,1,1,1,0,2018-04-03
976,경기,여주시,0,0,0,0,0,0,2018-05-03
977,경기,여주시,0,0,0,0,0,0,2018-06-03
978,경기,여주시,2,0,1,3,1,0,2018-07-03
979,경기,여주시,1,1,1,3,2,0,2018-08-03
980,경기,여주시,1,0,0,1,1,0,2018-09-03
981,경기,여주시,2,2,5,9,4,0,2018-10-03
982,경기,여주시,6,0,3,9,1,0,2018-11-03
983,경기,여주시,2,2,0,4,3,0,2018-12-03
984,경기,연천군,0,0,0,0,0,0,2018-01-03
985,경기,연천군,0,0,0,0,0,0,2018-02-03
986,경기,연천군,0,0,0,0,0,0,2018-03-03
987,경기,연천군,1,0,0,1,1,0,2018-04-03
988,경기,연천군,0,0,0,0,0,0,2018-05-03
989,경기,연천군,0,1,0,1,1,0,2018-06-03
990,경기,연천군,0,0,0,0,0,0,2018-07-03
991,경기,연천군,2,1,0,3,1,0,2018-08-03
992,경기,연천군,0,0,0,0,0,0,2018-09-03
993,경기,연천군,0,0,0,0,0,0,2018-10-03
994,경기,연천군,0,0,0,0,0,0,2018-11-03
995,경기,연천군,2,0,0,2,2,1,2018-12-03
996,경기,오산시,0,0,1,1,1,0,2018-01-03
997,경기,오산시,0,0,1,1,1,0,2018-02-03
998,경기,오산시,1,0,0,1,1,0,2018-03-03
999,경기,오산시,3,0,1,4,4,0,2018-04-03
1000,경기,오산시,2,0,1,3,2,0,2018-05-03
1001,경기,오산시,1,0,1,2,2,0,2018-06-03
1002,경기,오산시,3,0,1,4,2,0,2018-07-03
1003,경기,오산시,1,1,2,4,3,0,2018-08-03
1004,경기,오산시,2,0,0,2,1,0,2018-09-03
1005,경기,오산시,6,0,2,8,5,0,2018-10-03
1006,경기,오산시,0,0,0,0,0,0,2018-11-03
1007,경기,오산시,7,2,1,10,7,0,2018-12-03
1008,경기,용인시,7,0,1,8,7,0,2018-01-03
1009,경기,용인시,13,1,11,25,15,1,2018-02-03
1010,경기,용인시,9,3,1,13,7,1,2018-03-03
1011,경기,용인시,9,1,3,13,10,0,2018-04-03
1012,경기,용인시,9,2,2,13,6,0,2018-05-03
1013,경기,용인시,1,2,1,4,3,0,2018-06-03
1014,경기,용인시,5,1,2,8,8,2,2018-07-03
1015,경기,용인시,16,2,1,19,11,1,2018-08-03
1016,경기,용인시,4,1,3,8,7,0,2018-09-03
1017,경기,용인시,2,0,6,8,6,0,2018-10-03
1018,경기,용인시,11,1,3,15,7,0,2018-11-03
1019,경기,용인시,14,4,3,21,14,0,2018-12-03
1020,경기,의왕시,0,0,0,0,0,0,2018-01-03
1021,경기,의왕시,6,0,2,8,3,0,2018-02-03
1022,경기,의왕시,0,0,0,0,0,0,2018-03-03
1023,경기,의왕시,0,0,0,0,0,0,2018-04-03
1024,경기,의왕시,1,0,3,4,3,0,2018-05-03
1025,경기,의왕시,0,0,0,0,0,0,2018-06-03
1026,경기,의왕시,0,0,0,0,0,0,2018-07-03
1027,경기,의왕시,1,0,0,1,2,1,2018-08-03
1028,경기,의왕시,0,0,0,0,0,0,2018-09-03
1029,경기,의왕시,2,0,0,2,2,0,2018-10-03
1030,경기,의왕시,3,4,0,7,1,0,2018-11-03
1031,경기,의왕시,2,0,0,2,2,0,2018-12-03
1032,경기,의정부시,7,0,3,10,7,0,2018-01-03
1033,경기,의정부시,9,1,2,12,8,0,2018-02-03
1034,경기,의정부시,1,2,0,3,2,0,2018-03-03
1035,경기,의정부시,4,0,0,4,4,0,2018-04-03
1036,경기,의정부시,4,1,1,6,6,0,2018-05-03
1037,경기,의정부시,4,0,3,7,6,0,2018-06-03
1038,경기,의정부시,4,0,1,5,5,0,2018-07-03
1039,경기,의정부시,6,4,0,10,6,0,2018-08-03
1040,경기,의정부시,5,2,0,7,5,0,2018-09-03
1041,경기,의정부시,10,6,2,18,7,0,2018-10-03
1042,경기,의정부시,4,0,2,6,4,0,2018-11-03
1043,경기,의정부시,4,2,0,6,4,0,2018-12-03
1044,경기,이천시,4,0,1,5,2,0,2018-01-03
1045,경기,이천시,6,0,5,11,4,0,2018-02-03
1046,경기,이천시,0,1,1,2,1,0,2018-03-03
1047,경기,이천시,7,1,1,9,7,0,2018-04-03
1048,경기,이천시,5,1,1,7,3,0,2018-05-03
1049,경기,이천시,3,0,0,3,2,0,2018-06-03
1050,경기,이천시,4,0,0,4,3,0,2018-07-03
1051,경기,이천시,2,0,0,2,2,0,2018-08-03
1052,경기,이천시,4,0,0,4,3,0,2018-09-03
1053,경기,이천시,1,0,0,1,1,0,2018-10-03
1054,경기,이천시,1,0,0,1,1,0,2018-11-03
1055,경기,이천시,4,0,0,4,2,0,2018-12-03
1056,경기,파주시,4,0,1,5,5,0,2018-01-03
1057,경기,파주시,7,0,5,12,10,0,2018-02-03
1058,경기,파주시,5,0,1,6,3,0,2018-03-03
1059,경기,파주시,7,0,1,8,6,0,2018-04-03
1060,경기,파주시,5,0,0,5,2,0,2018-05-03
1061,경기,파주시,12,1,0,13,5,0,2018-06-03
1062,경기,파주시,3,0,0,3,3,0,2018-07-03
1063,경기,파주시,8,0,1,9,6,1,2018-08-03
1064,경기,파주시,4,0,1,5,4,0,2018-09-03
1065,경기,파주시,5,0,2,7,6,0,2018-10-03
1066,경기,파주시,10,0,0,10,5,0,2018-11-03
1067,경기,파주시,7,0,1,8,5,1,2018-12-03
1068,경기,평택시,17,1,4,22,10,0,2018-01-03
1069,경기,평택시,14,0,1,15,9,0,2018-02-03
1070,경기,평택시,5,0,0,5,4,0,2018-03-03
1071,경기,평택시,7,3,4,14,10,1,2018-04-03
1072,경기,평택시,1,0,2,3,3,0,2018-05-03
1073,경기,평택시,7,2,1,10,5,0,2018-06-03
1074,경기,평택시,12,1,1,14,10,0,2018-07-03
1075,경기,평택시,30,0,1,31,9,0,2018-08-03
1076,경기,평택시,11,1,1,13,10,0,2018-09-03
1077,경기,평택시,5,0,1,6,4,0,2018-10-03
1078,경기,평택시,16,0,1,17,7,0,2018-11-03
1079,경기,평택시,17,2,4,23,13,0,2018-12-03
1080,경기,포천시,0,0,0,0,0,0,2018-01-03
1081,경기,포천시,1,0,0,1,1,0,2018-02-03
1082,경기,포천시,0,0,0,0,0,0,2018-03-03
1083,경기,포천시,4,0,1,5,2,0,2018-04-03
1084,경기,포천시,0,0,1,1,1,0,2018-05-03
1085,경기,포천시,0,2,1,3,2,0,2018-06-03
1086,경기,포천시,1,0,0,1,1,0,2018-07-03
1087,경기,포천시,0,0,0,0,0,0,2018-08-03
1088,경기,포천시,5,0,2,7,4,0,2018-09-03
1089,경기,포천시,3,1,1,5,3,0,2018-10-03
1090,경기,포천시,8,2,3,13,6,0,2018-11-03
1091,경기,포천시,0,0,0,0,0,0,2018-12-03
1092,경기,하남시,1,0,0,1,1,0,2018-01-03
1093,경기,하남시,2,0,0,2,2,0,2018-02-03
1094,경기,하남시,11,0,1,12,5,0,2018-03-03
1095,경기,하남시,1,0,1,2,2,0,2018-04-03
1096,경기,하남시,3,0,2,5,3,0,2018-05-03
1097,경기,하남시,1,0,0,1,1,0,2018-06-03
1098,경기,하남시,1,0,0,1,1,0,2018-07-03
1099,경기,하남시,4,1,0,5,2,0,2018-08-03
1100,경기,하남시,4,0,2,6,4,0,2018-09-03
1101,경기,하남시,3,0,1,4,4,0,2018-10-03
1102,경기,하남시,0,1,1,2,2,0,2018-11-03
1103,경기,하남시,2,0,0,2,2,0,2018-12-03
1104,경기,화성시,3,0,4,7,5,0,2018-01-03
1105,경기,화성시,3,0,0,3,3,0,2018-02-03
1106,경기,화성시,12,0,2,14,4,0,2018-03-03
1107,경기,화성시,4,1,3,8,6,0,2018-04-03
1108,경기,화성시,4,0,1,5,4,0,2018-05-03
1109,경기,화성시,4,1,3,8,5,0,2018-06-03
1110,경기,화성시,16,0,4,20,11,0,2018-07-03
1111,경기,화성시,6,0,0,6,5,1,2018-08-03
1112,경기,화성시,16,0,4,20,10,1,2018-09-03
1113,경기,화성시,8,0,2,10,7,0,2018-10-03
1114,경기,화성시,8,3,10,21,7,0,2018-11-03
1115,경기,화성시,10,0,1,11,5,0,2018-12-03
1116,경기,가평군,2,0,0,2,1,0,2018-01-04
1117,경기,가평군,0,0,0,0,0,0,2018-02-04
1118,경기,가평군,0,0,0,0,0,0,2018-03-04
1119,경기,가평군,0,0,0,0,0,0,2018-04-04
1120,경기,가평군,0,0,0,0,0,0,2018-05-04
1121,경기,가평군,0,0,0,0,0,0,2018-06-04
1122,경기,가평군,0,1,1,2,2,0,2018-07-04
1123,경기,가평군,5,0,0,5,2,0,2018-08-04
1124,경기,가평군,0,0,0,0,0,0,2018-09-04
1125,경기,가평군,0,0,0,0,0,0,2018-10-04
1126,경기,가평군,1,0,0,1,1,0,2018-11-04
1127,경기,가평군,2,1,0,3,3,0,2018-12-04
1128,경기,고양시,10,3,2,15,14,1,2018-01-04
1129,경기,고양시,29,3,7,39,21,0,2018-02-04
1130,경기,고양시,7,0,3,10,6,0,2018-03-04
1131,경기,고양시,10,2,5,17,8,0,2018-04-04
1132,경기,고양시,7,3,5,15,12,0,2018-05-04
1133,경기,고양시,16,1,3,20,13,0,2018-06-04
1134,경기,고양시,10,2,1,13,11,0,2018-07-04
1135,경기,고양시,23,5,3,31,12,0,2018-08-04
1136,경기,고양시,11,0,2,13,8,0,2018-09-04
1137,경기,고양시,11,2,3,16,10,0,2018-10-04
1138,경기,고양시,15,4,6,25,13,0,2018-11-04
1139,경기,고양시,5,1,2,8,8,0,2018-12-04
1140,경기,과천시,0,0,0,0,0,0,2018-01-04
1141,경기,과천시,0,0,0,0,0,0,2018-02-04
1142,경기,과천시,1,1,0,2,1,0,2018-03-04
1143,경기,과천시,2,0,0,2,2,0,2018-04-04
1144,경기,과천시,0,0,0,0,0,0,2018-05-04
1145,경기,과천시,0,0,0,0,0,0,2018-06-04
1146,경기,과천시,0,0,0,0,0,0,2018-07-04
1147,경기,과천시,1,0,0,1,1,0,2018-08-04
1148,경기,과천시,0,0,1,1,1,0,2018-09-04
1149,경기,과천시,0,0,0,0,0,0,2018-10-04
1150,경기,과천시,0,0,0,0,0,0,2018-11-04
1151,경기,과천시,0,0,0,0,0,0,2018-12-04
1152,경기,광명시,3,0,0,3,2,0,2018-01-04
1153,경기,광명시,1,0,2,3,1,0,2018-02-04
1154,경기,광명시,3,0,0,3,1,0,2018-03-04
1155,경기,광명시,1,0,2,3,3,0,2018-04-04
1156,경기,광명시,3,1,0,4,2,0,2018-05-04
1157,경기,광명시,1,0,1,2,2,0,2018-06-04
1158,경기,광명시,0,1,1,2,2,0,2018-07-04
1159,경기,광명시,9,0,0,9,3,0,2018-08-04
1160,경기,광명시,5,0,1,6,5,0,2018-09-04
1161,경기,광명시,0,0,1,1,1,0,2018-10-04
1162,경기,광명시,2,2,2,6,5,0,2018-11-04
1163,경기,광명시,3,0,0,3,3,0,2018-12-04
1164,경기,광주시,6,0,2,8,5,0,2018-01-04
1165,경기,광주시,3,0,0,3,3,0,2018-02-04
1166,경기,광주시,2,0,0,2,2,0,2018-03-04
1167,경기,광주시,1,0,0,1,1,0,2018-04-04
1168,경기,광주시,12,1,2,15,11,0,2018-05-04
1169,경기,광주시,4,0,4,8,6,0,2018-06-04
1170,경기,광주시,1,0,0,1,1,0,2018-07-04
1171,경기,광주시,9,0,1,10,6,0,2018-08-04
1172,경기,광주시,3,0,0,3,3,0,2018-09-04
1173,경기,광주시,3,0,1,4,4,0,2018-10-04
1174,경기,광주시,11,0,2,13,7,0,2018-11-04
1175,경기,광주시,3,0,0,3,3,0,2018-12-04
1176,경기,구리시,2,0,0,2,1,0,2018-01-04
1177,경기,구리시,2,0,0,2,1,0,2018-02-04
1178,경기,구리시,0,0,0,0,0,0,2018-03-04
1179,경기,구리시,3,1,1,5,5,0,2018-04-04
1180,경기,구리시,2,1,0,3,2,0,2018-05-04
1181,경기,구리시,3,0,2,5,3,0,2018-06-04
1182,경기,구리시,3,0,0,3,2,0,2018-07-04
1183,경기,구리시,1,0,0,1,1,0,2018-08-04
1184,경기,구리시,0,0,3,3,2,0,2018-09-04
1185,경기,구리시,1,1,0,2,2,0,2018-10-04
1186,경기,구리시,0,0,0,0,0,0,2018-11-04
1187,경기,구리시,1,0,0,1,1,0,2018-12-04
1188,경기,군포시,0,0,0,0,0,0,2018-01-04
1189,경기,군포시,8,1,1,10,4,1,2018-02-04
1190,경기,군포시,0,0,1,1,1,0,2018-03-04
1191,경기,군포시,0,1,0,1,1,0,2018-04-04
1192,경기,군포시,1,1,0,2,2,0,2018-05-04
1193,경기,군포시,1,1,0,2,2,0,2018-06-04
1194,경기,군포시,0,0,0,0,0,0,2018-07-04
1195,경기,군포시,0,0,1,1,1,0,2018-08-04
1196,경기,군포시,5,1,0,6,3,0,2018-09-04
1197,경기,군포시,0,0,0,0,0,0,2018-10-04
1198,경기,군포시,4,0,0,4,1,0,2018-11-04
1199,경기,군포시,2,0,3,5,3,0,2018-12-04
1200,경기,김포시,4,0,0,4,2,0,2018-01-04
1201,경기,김포시,14,0,0,14,6,0,2018-02-04
1202,경기,김포시,1,0,2,3,3,0,2018-03-04
1203,경기,김포시,4,1,2,7,7,0,2018-04-04
1204,경기,김포시,5,0,1,6,3,0,2018-05-04
1205,경기,김포시,2,1,0,3,3,0,2018-06-04
1206,경기,김포시,15,2,4,21,9,0,2018-07-04
1207,경기,김포시,3,0,0,3,3,0,2018-08-04
1208,경기,김포시,12,2,6,20,12,0,2018-09-04
1209,경기,김포시,9,2,4,15,9,1,2018-10-04
1210,경기,김포시,0,0,2,2,2,0,2018-11-04
1211,경기,김포시,3,1,5,9,5,0,2018-12-04
1212,경기,남양주시,3,1,0,4,3,0,2018-01-04
1213,경기,남양주시,3,1,2,6,5,0,2018-02-04
1214,경기,남양주시,2,0,0,2,1,0,2018-03-04
1215,경기,남양주시,8,2,0,10,7,0,2018-04-04
1216,경기,남양주시,11,0,2,13,10,0,2018-05-04
1217,경기,남양주시,5,1,1,7,5,0,2018-06-04
1218,경기,남양주시,5,0,3,8,5,0,2018-07-04
1219,경기,남양주시,14,3,1,18,5,0,2018-08-04
1220,경기,남양주시,5,0,0,5,5,0,2018-09-04
1221,경기,남양주시,14,0,4,18,15,0,2018-10-04
1222,경기,남양주시,5,0,0,5,3,0,2018-11-04
1223,경기,남양주시,5,0,2,7,4,0,2018-12-04
1224,경기,동두천시,0,0,0,0,0,0,2018-01-04
1225,경기,동두천시,0,0,0,0,0,0,2018-02-04
1226,경기,동두천시,0,0,0,0,0,0,2018-03-04
1227,경기,동두천시,0,0,0,0,0,0,2018-04-04
1228,경기,동두천시,4,0,1,5,2,0,2018-05-04
1229,경기,동두천시,2,0,2,4,3,1,2018-06-04
1230,경기,동두천시,3,0,0,3,1,0,2018-07-04
1231,경기,동두천시,1,0,1,2,2,0,2018-08-04
1232,경기,동두천시,0,0,0,0,0,0,2018-09-04
1233,경기,동두천시,2,0,0,2,2,0,2018-10-04
1234,경기,동두천시,0,0,0,0,0,0,2018-11-04
1235,경기,동두천시,3,0,0,3,3,0,2018-12-04
1236,경기,부천시,9,0,4,13,9,0,2018-01-04
1237,경기,부천시,13,2,4,19,11,0,2018-02-04
1238,경기,부천시,7,1,1,9,7,0,2018-03-04
1239,경기,부천시,7,1,3,11,10,0,2018-04-04
1240,경기,부천시,8,4,2,14,7,0,2018-05-04
1241,경기,부천시,11,0,4,15,12,0,2018-06-04
1242,경기,부천시,12,1,3,16,10,0,2018-07-04
1243,경기,부천시,23,4,2,29,16,0,2018-08-04
1244,경기,부천시,7,1,2,10,9,0,2018-09-04
1245,경기,부천시,11,1,2,14,11,0,2018-10-04
1246,경기,부천시,17,1,2,20,13,0,2018-11-04
1247,경기,부천시,8,1,3,12,8,0,2018-12-04
1248,경기,성남시,7,1,2,10,8,0,2018-01-04
1249,경기,성남시,19,1,5,25,17,0,2018-02-04
1250,경기,성남시,12,1,5,18,12,1,2018-03-04
1251,경기,성남시,7,1,3,11,8,0,2018-04-04
1252,경기,성남시,9,0,5,14,11,0,2018-05-04
1253,경기,성남시,6,0,2,8,6,0,2018-06-04
1254,경기,성남시,11,2,1,14,9,0,2018-07-04
1255,경기,성남시,2,1,0,3,3,0,2018-08-04
1256,경기,성남시,10,1,4,15,9,0,2018-09-04
1257,경기,성남시,16,2,5,23,13,0,2018-10-04
1258,경기,성남시,6,0,3,9,8,0,2018-11-04
1259,경기,성남시,12,2,2,16,13,0,2018-12-04
1260,경기,수원시,9,2,4,15,14,0,2018-01-04
1261,경기,수원시,25,1,5,31,19,1,2018-02-04
1262,경기,수원시,4,0,5,9,7,0,2018-03-04
1263,경기,수원시,11,3,4,18,14,0,2018-04-04
1264,경기,수원시,18,2,12,32,17,0,2018-05-04
1265,경기,수원시,12,1,5,18,11,0,2018-06-04
1266,경기,수원시,11,0,5,16,11,0,2018-07-04
1267,경기,수원시,15,2,3,20,10,0,2018-08-04
1268,경기,수원시,14,1,3,18,13,0,2018-09-04
1269,경기,수원시,10,5,7,22,12,0,2018-10-04
1270,경기,수원시,27,1,6,34,19,0,2018-11-04
1271,경기,수원시,9,1,4,14,11,0,2018-12-04
1272,경기,시흥시,5,1,0,6,5,0,2018-01-04
1273,경기,시흥시,8,2,5,15,7,0,2018-02-04
1274,경기,시흥시,4,2,1,7,4,0,2018-03-04
1275,경기,시흥시,3,0,3,6,5,0,2018-04-04
1276,경기,시흥시,4,0,2,6,3,0,2018-05-04
1277,경기,시흥시,3,0,0,3,3,0,2018-06-04
1278,경기,시흥시,4,1,1,6,3,0,2018-07-04
1279,경기,시흥시,7,0,0,7,5,0,2018-08-04
1280,경기,시흥시,6,0,1,7,7,1,2018-09-04
1281,경기,시흥시,9,4,2,15,7,0,2018-10-04
1282,경기,시흥시,5,3,2,10,6,0,2018-11-04
1283,경기,시흥시,6,0,4,10,7,0,2018-12-04
1284,경기,안산시,1,0,0,1,1,1,2018-01-04
1285,경기,안산시,19,1,3,23,14,0,2018-02-04
1286,경기,안산시,13,0,3,16,11,0,2018-03-04
1287,경기,안산시,14,0,6,20,9,0,2018-04-04
1288,경기,안산시,12,0,2,14,13,0,2018-05-04
1289,경기,안산시,4,0,0,4,4,0,2018-06-04
1290,경기,안산시,9,1,5,15,11,1,2018-07-04
1291,경기,안산시,4,1,3,8,6,0,2018-08-04
1292,경기,안산시,6,1,1,8,6,0,2018-09-04
1293,경기,안산시,12,0,2,14,11,0,2018-10-04
1294,경기,안산시,16,0,2,18,11,0,2018-11-04
1295,경기,안산시,12,5,1,18,10,0,2018-12-04
1296,경기,안성시,4,0,0,4,4,0,2018-01-04
1297,경기,안성시,7,0,1,8,4,0,2018-02-04
1298,경기,안성시,0,0,0,0,0,0,2018-03-04
1299,경기,안성시,2,0,3,5,4,0,2018-04-04
1300,경기,안성시,7,0,1,8,6,0,2018-05-04
1301,경기,안성시,8,1,2,11,5,0,2018-06-04
1302,경기,안성시,0,0,0,0,0,0,2018-07-04
1303,경기,안성시,0,0,0,0,0,0,2018-08-04
1304,경기,안성시,6,0,1,7,4,0,2018-09-04
1305,경기,안성시,7,1,1,9,4,0,2018-10-04
1306,경기,안성시,9,0,5,14,6,0,2018-11-04
1307,경기,안성시,0,0,0,0,0,0,2018-12-04
1308,경기,안양시,0,1,3,4,3,0,2018-01-04
1309,경기,안양시,1,1,0,2,1,0,2018-02-04
1310,경기,안양시,3,0,0,3,3,0,2018-03-04
1311,경기,안양시,13,0,0,13,9,0,2018-04-04
1312,경기,안양시,5,0,1,6,4,0,2018-05-04
1313,경기,안양시,0,0,1,1,1,0,2018-06-04
1314,경기,안양시,2,0,1,3,3,0,2018-07-04
1315,경기,안양시,14,3,1,18,6,0,2018-08-04
1316,경기,안양시,10,0,2,12,6,0,2018-09-04
1317,경기,안양시,6,0,2,8,7,0,2018-10-04
1318,경기,안양시,0,0,0,0,0,0,2018-11-04
1319,경기,안양시,0,0,3,3,3,0,2018-12-04
1320,경기,양주시,3,0,0,3,2,0,2018-01-04
1321,경기,양주시,2,0,3,5,2,0,2018-02-04
1322,경기,양주시,1,0,1,2,2,0,2018-03-04
1323,경기,양주시,5,0,0,5,4,0,2018-04-04
1324,경기,양주시,0,0,0,0,0,0,2018-05-04
1325,경기,양주시,10,0,0,10,8,0,2018-06-04
1326,경기,양주시,2,0,1,3,2,0,2018-07-04
1327,경기,양주시,1,0,1,2,2,0,2018-08-04
1328,경기,양주시,3,0,2,5,3,0,2018-09-04
1329,경기,양주시,5,0,0,5,4,0,2018-10-04
1330,경기,양주시,6,0,1,7,4,0,2018-11-04
1331,경기,양주시,3,1,1,5,3,0,2018-12-04
1332,경기,양평군,0,0,0,0,0,0,2018-01-04
1333,경기,양평군,0,0,3,3,2,0,2018-02-04
1334,경기,양평군,0,0,0,0,0,0,2018-03-04
1335,경기,양평군,1,0,1,2,1,0,2018-04-04
1336,경기,양평군,3,0,1,4,3,0,2018-05-04
1337,경기,양평군,0,0,0,0,0,0,2018-06-04
1338,경기,양평군,2,0,1,3,3,0,2018-07-04
1339,경기,양평군,0,0,0,0,0,0,2018-08-04
1340,경기,양평군,0,0,0,0,0,0,2018-09-04
1341,경기,양평군,2,0,0,2,1,0,2018-10-04
1342,경기,양평군,1,0,1,2,2,0,2018-11-04
1343,경기,양평군,0,0,0,0,0,0,2018-12-04
1344,경기,여주시,1,1,1,3,1,0,2018-01-04
1345,경기,여주시,0,0,0,0,0,0,2018-02-04
1346,경기,여주시,8,0,0,8,2,0,2018-03-04
1347,경기,여주시,0,1,2,3,3,0,2018-04-04
1348,경기,여주시,0,1,0,1,1,0,2018-05-04
1349,경기,여주시,4,0,0,4,3,0,2018-06-04
1350,경기,여주시,2,0,1,3,2,0,2018-07-04
1351,경기,여주시,0,0,0,0,0,0,2018-08-04
1352,경기,여주시,1,0,0,1,1,0,2018-09-04
1353,경기,여주시,2,0,1,3,2,0,2018-10-04
1354,경기,여주시,0,0,0,0,0,0,2018-11-04
1355,경기,여주시,0,0,0,0,0,0,2018-12-04
1356,경기,연천군,0,0,0,0,0,0,2018-01-04
1357,경기,연천군,0,0,0,0,0,0,2018-02-04
1358,경기,연천군,0,0,0,0,0,0,2018-03-04
1359,경기,연천군,0,0,0,0,0,0,2018-04-04
1360,경기,연천군,1,0,0,1,1,0,2018-05-04
1361,경기,연천군,0,0,0,0,0,0,2018-06-04
1362,경기,연천군,0,0,0,0,0,0,2018-07-04
1363,경기,연천군,0,0,0,0,0,0,2018-08-04
1364,경기,연천군,1,0,0,1,1,0,2018-09-04
1365,경기,연천군,0,0,0,0,0,0,2018-10-04
1366,경기,연천군,0,0,1,1,1,0,2018-11-04
1367,경기,연천군,0,0,0,0,0,0,2018-12-04
1368,경기,오산시,1,0,1,2,2,0,2018-01-04
1369,경기,오산시,2,0,1,3,1,0,2018-02-04
1370,경기,오산시,1,0,2,3,3,0,2018-03-04
1371,경기,오산시,1,0,3,4,4,0,2018-04-04
1372,경기,오산시,1,0,1,2,2,0,2018-05-04
1373,경기,오산시,5,0,2,7,5,0,2018-06-04
1374,경기,오산시,1,1,1,3,2,0,2018-07-04
1375,경기,오산시,2,0,0,2,1,0,2018-08-04
1376,경기,오산시,3,0,0,3,3,0,2018-09-04
1377,경기,오산시,3,0,0,3,3,0,2018-10-04
1378,경기,오산시,1,0,0,1,1,0,2018-11-04
1379,경기,오산시,9,2,1,12,4,0,2018-12-04
1380,경기,용인시,2,1,3,6,5,0,2018-01-04
1381,경기,용인시,15,8,4,27,9,0,2018-02-04
1382,경기,용인시,5,0,3,8,5,0,2018-03-04
1383,경기,용인시,18,1,5,24,17,1,2018-04-04
1384,경기,용인시,12,1,5,18,11,0,2018-05-04
1385,경기,용인시,8,1,6,15,9,0,2018-06-04
1386,경기,용인시,9,0,8,17,12,1,2018-07-04
1387,경기,용인시,22,2,7,31,8,0,2018-08-04
1388,경기,용인시,6,0,1,7,5,0,2018-09-04
1389,경기,용인시,5,1,7,13,10,0,2018-10-04
1390,경기,용인시,20,2,0,22,14,0,2018-11-04
1391,경기,용인시,7,5,0,12,6,0,2018-12-04
1392,경기,의왕시,1,0,1,2,1,0,2018-01-04
1393,경기,의왕시,4,0,2,6,2,0,2018-02-04
1394,경기,의왕시,0,1,0,1,1,0,2018-03-04
1395,경기,의왕시,0,0,0,0,0,0,2018-04-04
1396,경기,의왕시,0,0,0,0,0,0,2018-05-04
1397,경기,의왕시,1,0,0,1,1,0,2018-06-04
1398,경기,의왕시,6,0,1,7,1,0,2018-07-04
1399,경기,의왕시,3,0,2,5,2,0,2018-08-04
1400,경기,의왕시,0,0,1,1,1,0,2018-09-04
1401,경기,의왕시,0,0,1,1,1,0,2018-10-04
1402,경기,의왕시,0,0,0,0,0,0,2018-11-04
1403,경기,의왕시,1,0,0,1,1,0,2018-12-04
1404,경기,의정부시,6,0,3,9,7,0,2018-01-04
1405,경기,의정부시,6,1,1,8,4,0,2018-02-04
1406,경기,의정부시,2,0,0,2,2,0,2018-03-04
1407,경기,의정부시,2,0,2,4,3,0,2018-04-04
1408,경기,의정부시,3,2,1,6,5,0,2018-05-04
1409,경기,의정부시,2,0,1,3,2,0,2018-06-04
1410,경기,의정부시,3,0,3,6,5,0,2018-07-04
1411,경기,의정부시,1,0,0,1,1,0,2018-08-04
1412,경기,의정부시,5,0,3,8,7,0,2018-09-04
1413,경기,의정부시,3,0,2,5,5,0,2018-10-04
1414,경기,의정부시,0,0,0,0,0,0,2018-11-04
1415,경기,의정부시,5,5,2,12,10,0,2018-12-04
1416,경기,이천시,2,0,0,2,1,0,2018-01-04
1417,경기,이천시,1,0,0,1,1,0,2018-02-04
1418,경기,이천시,1,0,0,1,1,0,2018-03-04
1419,경기,이천시,2,0,1,3,4,1,2018-04-04
1420,경기,이천시,1,0,0,1,1,0,2018-05-04
1421,경기,이천시,4,0,3,7,5,0,2018-06-04
1422,경기,이천시,6,0,0,6,5,0,2018-07-04
1423,경기,이천시,1,0,1,2,2,0,2018-08-04
1424,경기,이천시,1,0,1,2,2,0,2018-09-04
1425,경기,이천시,0,0,0,0,0,0,2018-10-04
1426,경기,이천시,7,0,0,7,3,0,2018-11-04
1427,경기,이천시,3,0,0,3,3,0,2018-12-04
1428,경기,파주시,6,0,0,6,4,0,2018-01-04
1429,경기,파주시,9,3,2,14,4,0,2018-02-04
1430,경기,파주시,1,0,1,2,2,0,2018-03-04
1431,경기,파주시,3,2,4,9,7,0,2018-04-04
1432,경기,파주시,2,0,0,2,2,0,2018-05-04
1433,경기,파주시,3,2,1,6,5,0,2018-06-04
1434,경기,파주시,8,0,2,10,6,0,2018-07-04
1435,경기,파주시,6,0,4,10,6,0,2018-08-04
1436,경기,파주시,3,0,0,3,3,0,2018-09-04
1437,경기,파주시,1,0,1,2,2,0,2018-10-04
1438,경기,파주시,2,0,2,4,3,0,2018-11-04
1439,경기,파주시,2,0,0,2,2,0,2018-12-04
1440,경기,평택시,8,0,2,10,8,0,2018-01-04
1441,경기,평택시,11,1,2,14,8,0,2018-02-04
1442,경기,평택시,9,0,1,10,6,0,2018-03-04
1443,경기,평택시,5,0,2,7,6,0,2018-04-04
1444,경기,평택시,22,2,4,28,16,1,2018-05-04
1445,경기,평택시,10,1,6,17,11,0,2018-06-04
1446,경기,평택시,15,4,3,22,13,0,2018-07-04
1447,경기,평택시,11,1,4,16,9,0,2018-08-04
1448,경기,평택시,9,0,2,11,9,0,2018-09-04
1449,경기,평택시,11,0,3,14,11,0,2018-10-04
1450,경기,평택시,7,4,2,13,9,0,2018-11-04
1451,경기,평택시,10,0,3,13,11,1,2018-12-04
1452,경기,포천시,0,0,0,0,0,0,2018-01-04
1453,경기,포천시,1,0,1,2,1,0,2018-02-04
1454,경기,포천시,0,0,1,1,1,0,2018-03-04
1455,경기,포천시,5,5,3,13,3,0,2018-04-04
1456,경기,포천시,0,0,0,0,0,0,2018-05-04
1457,경기,포천시,3,2,1,6,4,0,2018-06-04
1458,경기,포천시,3,0,0,3,2,0,2018-07-04
1459,경기,포천시,4,10,1,15,5,0,2018-08-04
1460,경기,포천시,0,0,0,0,0,0,2018-09-04
1461,경기,포천시,5,1,1,7,3,0,2018-10-04
1462,경기,포천시,3,1,0,4,2,0,2018-11-04
1463,경기,포천시,1,0,0,1,1,0,2018-12-04
1464,경기,하남시,5,1,0,6,4,0,2018-01-04
1465,경기,하남시,1,2,2,5,3,0,2018-02-04
1466,경기,하남시,0,4,0,4,1,0,2018-03-04
1467,경기,하남시,0,0,1,1,1,0,2018-04-04
1468,경기,하남시,5,0,2,7,4,1,2018-05-04
1469,경기,하남시,2,2,1,5,4,0,2018-06-04
1470,경기,하남시,0,0,0,0,0,0,2018-07-04
1471,경기,하남시,4,1,0,5,3,0,2018-08-04
1472,경기,하남시,0,0,3,3,2,0,2018-09-04
1473,경기,하남시,2,0,0,2,2,0,2018-10-04
1474,경기,하남시,0,1,1,2,2,0,2018-11-04
1475,경기,하남시,0,0,1,1,1,0,2018-12-04
1476,경기,화성시,10,0,1,11,8,0,2018-01-04
1477,경기,화성시,4,0,2,6,5,0,2018-02-04
1478,경기,화성시,2,0,2,4,1,0,2018-03-04
1479,경기,화성시,9,0,3,12,10,0,2018-04-04
1480,경기,화성시,6,0,3,9,9,0,2018-05-04
1481,경기,화성시,3,2,4,9,7,0,2018-06-04
1482,경기,화성시,3,0,2,5,4,0,2018-07-04
1483,경기,화성시,3,0,0,3,3,0,2018-08-04
1484,경기,화성시,3,0,4,7,6,0,2018-09-04
1485,경기,화성시,15,1,4,20,10,0,2018-10-04
1486,경기,화성시,2,0,1,3,3,0,2018-11-04
1487,경기,화성시,7,1,3,11,8,0,2018-12-04
1488,경기,가평군,1,2,0,3,1,0,2018-01-05
1489,경기,가평군,0,0,0,0,0,0,2018-02-05
1490,경기,가평군,0,0,0,0,0,0,2018-03-05
1491,경기,가평군,0,0,0,0,0,0,2018-04-05
1492,경기,가평군,2,0,1,3,2,0,2018-05-05
1493,경기,가평군,1,0,0,1,1,0,2018-06-05
1494,경기,가평군,1,0,0,1,2,1,2018-07-05
1495,경기,가평군,0,0,1,1,1,0,2018-08-05
1496,경기,가평군,0,0,0,0,0,0,2018-09-05
1497,경기,가평군,0,0,0,0,0,0,2018-10-05
1498,경기,가평군,0,1,0,1,1,0,2018-11-05
1499,경기,가평군,0,0,0,0,0,0,2018-12-05
1500,경기,고양시,14,2,8,24,16,0,2018-01-05
1501,경기,고양시,45,2,8,55,30,0,2018-02-05
1502,경기,고양시,11,3,4,18,11,0,2018-03-05
1503,경기,고양시,18,2,3,23,17,0,2018-04-05
1504,경기,고양시,4,4,1,9,5,0,2018-05-05
1505,경기,고양시,10,0,0,10,9,0,2018-06-05
1506,경기,고양시,12,1,1,14,8,0,2018-07-05
1507,경기,고양시,14,0,4,18,13,0,2018-08-05
1508,경기,고양시,11,0,5,16,12,0,2018-09-05
1509,경기,고양시,14,1,6,21,15,0,2018-10-05
1510,경기,고양시,13,2,4,19,11,0,2018-11-05
1511,경기,고양시,10,2,4,16,8,0,2018-12-05
1512,경기,과천시,0,0,0,0,0,0,2018-01-05
1513,경기,과천시,1,0,0,1,1,0,2018-02-05
1514,경기,과천시,0,0,0,0,0,0,2018-03-05
1515,경기,과천시,2,2,0,4,2,0,2018-04-05
1516,경기,과천시,1,1,0,2,2,0,2018-05-05
1517,경기,과천시,0,0,0,0,0,0,2018-06-05
1518,경기,과천시,0,0,0,0,0,0,2018-07-05
1519,경기,과천시,0,0,0,0,0,0,2018-08-05
1520,경기,과천시,0,0,0,0,0,0,2018-09-05
1521,경기,과천시,0,0,0,0,0,0,2018-10-05
1522,경기,과천시,0,0,0,0,0,0,2018-11-05
1523,경기,과천시,0,0,2,2,1,0,2018-12-05
1524,경기,광명시,3,1,0,4,3,0,2018-01-05
1525,경기,광명시,1,0,1,2,3,1,2018-02-05
1526,경기,광명시,0,0,0,0,0,0,2018-03-05
1527,경기,광명시,1,1,0,2,2,0,2018-04-05
1528,경기,광명시,1,4,1,6,3,0,2018-05-05
1529,경기,광명시,2,1,2,5,5,0,2018-06-05
1530,경기,광명시,3,2,0,5,3,0,2018-07-05
1531,경기,광명시,1,1,0,2,2,0,2018-08-05
1532,경기,광명시,2,1,1,4,4,0,2018-09-05
1533,경기,광명시,10,4,0,14,7,0,2018-10-05
1534,경기,광명시,4,0,1,5,4,0,2018-11-05
1535,경기,광명시,5,2,0,7,5,0,2018-12-05
1536,경기,광주시,4,0,0,4,3,0,2018-01-05
1537,경기,광주시,5,0,1,6,4,0,2018-02-05
1538,경기,광주시,5,0,0,5,3,0,2018-03-05
1539,경기,광주시,11,0,1,12,6,0,2018-04-05
1540,경기,광주시,9,1,1,11,7,0,2018-05-05
1541,경기,광주시,1,0,1,2,2,0,2018-06-05
1542,경기,광주시,1,0,0,1,1,0,2018-07-05
1543,경기,광주시,4,1,2,7,2,0,2018-08-05
1544,경기,광주시,2,0,3,5,3,0,2018-09-05
1545,경기,광주시,6,0,4,10,7,0,2018-10-05
1546,경기,광주시,4,0,1,5,4,0,2018-11-05
1547,경기,광주시,7,0,0,7,5,0,2018-12-05
1548,경기,구리시,4,0,0,4,4,0,2018-01-05
1549,경기,구리시,1,0,0,1,1,0,2018-02-05
1550,경기,구리시,3,0,0,3,2,0,2018-03-05
1551,경기,구리시,0,1,0,1,1,0,2018-04-05
1552,경기,구리시,1,0,0,1,1,0,2018-05-05
1553,경기,구리시,0,0,0,0,0,0,2018-06-05
1554,경기,구리시,2,0,1,3,3,0,2018-07-05
1555,경기,구리시,0,0,0,0,0,0,2018-08-05
1556,경기,구리시,2,0,0,2,1,0,2018-09-05
1557,경기,구리시,4,0,1,5,3,0,2018-10-05
1558,경기,구리시,0,0,1,1,1,0,2018-11-05
1559,경기,구리시,2,0,0,2,1,0,2018-12-05
1560,경기,군포시,0,0,0,0,0,0,2018-01-05
1561,경기,군포시,1,0,4,5,4,0,2018-02-05
1562,경기,군포시,0,0,0,0,0,0,2018-03-05
1563,경기,군포시,1,0,0,1,1,0,2018-04-05
1564,경기,군포시,1,0,0,1,1,0,2018-05-05
1565,경기,군포시,4,0,0,4,3,0,2018-06-05
1566,경기,군포시,1,0,0,1,1,0,2018-07-05
1567,경기,군포시,1,1,0,2,1,0,2018-08-05
1568,경기,군포시,1,0,1,2,2,0,2018-09-05
1569,경기,군포시,3,1,0,4,4,0,2018-10-05
1570,경기,군포시,1,1,2,4,4,0,2018-11-05
1571,경기,군포시,4,0,0,4,4,0,2018-12-05
1572,경기,김포시,4,0,1,5,4,0,2018-01-05
1573,경기,김포시,3,0,1,4,2,0,2018-02-05
1574,경기,김포시,3,0,2,5,5,0,2018-03-05
1575,경기,김포시,3,1,3,7,8,1,2018-04-05
1576,경기,김포시,5,5,1,11,7,0,2018-05-05
1577,경기,김포시,9,0,3,12,9,0,2018-06-05
1578,경기,김포시,3,0,0,3,3,0,2018-07-05
1579,경기,김포시,4,2,3,9,5,0,2018-08-05
1580,경기,김포시,7,0,3,10,8,1,2018-09-05
1581,경기,김포시,6,5,4,15,9,0,2018-10-05
1582,경기,김포시,14,2,3,19,12,0,2018-11-05
1583,경기,김포시,2,0,1,3,3,0,2018-12-05
1584,경기,남양주시,16,0,3,19,5,0,2018-01-05
1585,경기,남양주시,11,1,4,16,10,0,2018-02-05
1586,경기,남양주시,5,0,0,5,3,0,2018-03-05
1587,경기,남양주시,12,0,1,13,9,0,2018-04-05
1588,경기,남양주시,7,0,0,7,6,1,2018-05-05
1589,경기,남양주시,11,1,1,13,6,0,2018-06-05
1590,경기,남양주시,12,3,2,17,9,0,2018-07-05
1591,경기,남양주시,6,0,0,6,3,0,2018-08-05
1592,경기,남양주시,5,0,2,7,7,0,2018-09-05
1593,경기,남양주시,12,0,8,20,12,0,2018-10-05
1594,경기,남양주시,7,0,4,11,6,0,2018-11-05
1595,경기,남양주시,5,1,1,7,6,1,2018-12-05
1596,경기,동두천시,0,0,1,1,1,0,2018-01-05
1597,경기,동두천시,2,0,1,3,3,0,2018-02-05
1598,경기,동두천시,0,0,0,0,0,0,2018-03-05
1599,경기,동두천시,3,0,0,3,1,0,2018-04-05
1600,경기,동두천시,2,0,0,2,1,0,2018-05-05
1601,경기,동두천시,4,0,1,5,3,0,2018-06-05
1602,경기,동두천시,0,0,1,1,1,0,2018-07-05
1603,경기,동두천시,1,0,0,1,1,0,2018-08-05
1604,경기,동두천시,0,0,0,0,0,0,2018-09-05
1605,경기,동두천시,1,0,0,1,1,0,2018-10-05
1606,경기,동두천시,1,0,0,1,1,0,2018-11-05
1607,경기,동두천시,3,0,0,3,2,0,2018-12-05
1608,경기,부천시,12,0,1,13,7,0,2018-01-05
1609,경기,부천시,4,0,2,6,4,0,2018-02-05
1610,경기,부천시,12,0,1,13,11,0,2018-03-05
1611,경기,부천시,19,1,2,22,17,0,2018-04-05
1612,경기,부천시,7,1,1,9,8,0,2018-05-05
1613,경기,부천시,6,2,3,11,10,0,2018-06-05
1614,경기,부천시,4,0,4,8,7,0,2018-07-05
1615,경기,부천시,12,3,1,16,9,0,2018-08-05
1616,경기,부천시,15,2,1,18,10,0,2018-09-05
1617,경기,부천시,4,1,2,7,7,0,2018-10-05
1618,경기,부천시,4,1,1,6,6,0,2018-11-05
1619,경기,부천시,16,1,1,18,12,0,2018-12-05
1620,경기,성남시,17,1,5,23,18,0,2018-01-05
1621,경기,성남시,9,3,5,17,15,0,2018-02-05
1622,경기,성남시,7,0,1,8,7,0,2018-03-05
1623,경기,성남시,12,1,4,17,11,0,2018-04-05
1624,경기,성남시,16,3,1,20,9,0,2018-05-05
1625,경기,성남시,8,2,4,14,8,0,2018-06-05
1626,경기,성남시,17,3,0,20,13,0,2018-07-05
1627,경기,성남시,10,0,2,12,10,0,2018-08-05
1628,경기,성남시,7,1,4,12,11,0,2018-09-05
1629,경기,성남시,8,1,2,11,11,0,2018-10-05
1630,경기,성남시,4,0,1,5,3,0,2018-11-05
1631,경기,성남시,4,0,4,8,7,0,2018-12-05
1632,경기,수원시,13,1,3,17,13,0,2018-01-05
1633,경기,수원시,14,3,4,21,17,0,2018-02-05
1634,경기,수원시,16,1,2,19,15,0,2018-03-05
1635,경기,수원시,16,1,5,22,22,0,2018-04-05
1636,경기,수원시,30,1,5,36,21,0,2018-05-05
1637,경기,수원시,16,5,3,24,18,0,2018-06-05
1638,경기,수원시,14,4,4,22,14,0,2018-07-05
1639,경기,수원시,11,5,3,19,9,0,2018-08-05
1640,경기,수원시,13,1,3,17,11,0,2018-09-05
1641,경기,수원시,16,3,4,23,20,1,2018-10-05
1642,경기,수원시,16,1,3,20,15,0,2018-11-05
1643,경기,수원시,6,0,5,11,9,0,2018-12-05
1644,경기,시흥시,3,0,1,4,3,0,2018-01-05
1645,경기,시흥시,11,0,3,14,7,0,2018-02-05
1646,경기,시흥시,7,0,4,11,9,0,2018-03-05
1647,경기,시흥시,18,0,2,20,11,0,2018-04-05
1648,경기,시흥시,8,0,1,9,5,0,2018-05-05
1649,경기,시흥시,9,1,1,11,8,0,2018-06-05
1650,경기,시흥시,5,0,2,7,5,0,2018-07-05
1651,경기,시흥시,9,0,2,11,7,0,2018-08-05
1652,경기,시흥시,12,1,3,16,11,0,2018-09-05
1653,경기,시흥시,12,0,5,17,12,0,2018-10-05
1654,경기,시흥시,11,0,2,13,12,0,2018-11-05
1655,경기,시흥시,8,0,4,12,7,0,2018-12-05
1656,경기,안산시,19,0,3,22,17,0,2018-01-05
1657,경기,안산시,14,0,5,19,15,0,2018-02-05
1658,경기,안산시,14,0,0,14,10,0,2018-03-05
1659,경기,안산시,5,0,2,7,7,0,2018-04-05
1660,경기,안산시,12,0,5,17,13,0,2018-05-05
1661,경기,안산시,11,1,5,17,13,0,2018-06-05
1662,경기,안산시,8,1,7,16,13,0,2018-07-05
1663,경기,안산시,13,0,2,15,9,1,2018-08-05
1664,경기,안산시,7,0,3,10,9,0,2018-09-05
1665,경기,안산시,18,1,3,22,11,0,2018-10-05
1666,경기,안산시,21,0,3,24,15,0,2018-11-05
1667,경기,안산시,13,3,2,18,13,0,2018-12-05
1668,경기,안성시,1,0,1,2,2,0,2018-01-05
1669,경기,안성시,1,0,0,1,1,0,2018-02-05
1670,경기,안성시,1,0,0,1,1,0,2018-03-05
1671,경기,안성시,1,0,0,1,1,0,2018-04-05
1672,경기,안성시,1,1,1,3,2,0,2018-05-05
1673,경기,안성시,3,1,1,5,5,0,2018-06-05
1674,경기,안성시,1,0,0,1,1,0,2018-07-05
1675,경기,안성시,1,0,0,1,1,0,2018-08-05
1676,경기,안성시,3,0,0,3,3,0,2018-09-05
1677,경기,안성시,6,0,1,7,4,0,2018-10-05
1678,경기,안성시,4,0,0,4,3,0,2018-11-05
1679,경기,안성시,2,0,0,2,1,0,2018-12-05
1680,경기,안양시,1,0,1,2,2,0,2018-01-05
1681,경기,안양시,0,0,1,1,1,0,2018-02-05
1682,경기,안양시,10,0,1,11,5,0,2018-03-05
1683,경기,안양시,1,0,0,1,1,0,2018-04-05
1684,경기,안양시,3,0,1,4,3,1,2018-05-05
1685,경기,안양시,3,1,3,7,6,0,2018-06-05
1686,경기,안양시,5,0,2,7,5,0,2018-07-05
1687,경기,안양시,2,1,1,4,4,0,2018-08-05
1688,경기,안양시,4,0,1,5,3,0,2018-09-05
1689,경기,안양시,13,0,2,15,11,0,2018-10-05
1690,경기,안양시,4,1,3,8,9,1,2018-11-05
1691,경기,안양시,2,0,1,3,2,0,2018-12-05
1692,경기,양주시,1,0,0,1,1,0,2018-01-05
1693,경기,양주시,1,0,2,3,3,0,2018-02-05
1694,경기,양주시,1,3,0,4,3,0,2018-03-05
1695,경기,양주시,6,0,0,6,2,0,2018-04-05
1696,경기,양주시,8,1,6,15,6,0,2018-05-05
1697,경기,양주시,1,0,0,1,1,0,2018-06-05
1698,경기,양주시,4,0,4,8,5,0,2018-07-05
1699,경기,양주시,3,2,0,5,1,0,2018-08-05
1700,경기,양주시,6,0,1,7,3,0,2018-09-05
1701,경기,양주시,6,0,1,7,5,0,2018-10-05
1702,경기,양주시,0,1,1,2,2,0,2018-11-05
1703,경기,양주시,7,0,1,8,5,0,2018-12-05
1704,경기,양평군,0,0,1,1,1,0,2018-01-05
1705,경기,양평군,0,0,0,0,0,0,2018-02-05
1706,경기,양평군,0,0,0,0,0,0,2018-03-05
1707,경기,양평군,0,0,1,1,1,0,2018-04-05
1708,경기,양평군,1,0,2,3,3,0,2018-05-05
1709,경기,양평군,4,0,0,4,3,0,2018-06-05
1710,경기,양평군,1,0,0,1,1,0,2018-07-05
1711,경기,양평군,2,0,0,2,1,0,2018-08-05
1712,경기,양평군,1,0,1,2,2,0,2018-09-05
1713,경기,양평군,2,0,1,3,2,0,2018-10-05
1714,경기,양평군,0,0,0,0,0,0,2018-11-05
1715,경기,양평군,0,0,0,0,0,0,2018-12-05
1716,경기,여주시,0,0,1,1,1,0,2018-01-05
1717,경기,여주시,3,0,0,3,3,0,2018-02-05
1718,경기,여주시,0,0,0,0,0,0,2018-03-05
1719,경기,여주시,4,0,1,5,3,0,2018-04-05
1720,경기,여주시,0,0,1,1,1,0,2018-05-05
1721,경기,여주시,3,0,1,4,2,0,2018-06-05
1722,경기,여주시,0,0,0,0,0,0,2018-07-05
1723,경기,여주시,4,0,0,4,3,0,2018-08-05
1724,경기,여주시,0,0,0,0,0,0,2018-09-05
1725,경기,여주시,8,0,0,8,8,0,2018-10-05
1726,경기,여주시,2,0,0,2,1,0,2018-11-05
1727,경기,여주시,1,0,0,1,1,0,2018-12-05
1728,경기,연천군,0,0,0,0,0,0,2018-01-05
1729,경기,연천군,3,1,0,4,1,0,2018-02-05
1730,경기,연천군,0,1,0,1,1,0,2018-03-05
1731,경기,연천군,1,0,0,1,1,0,2018-04-05
1732,경기,연천군,1,0,0,1,1,0,2018-05-05
1733,경기,연천군,1,0,0,1,1,0,2018-06-05
1734,경기,연천군,0,0,0,0,0,0,2018-07-05
1735,경기,연천군,5,0,1,6,2,0,2018-08-05
1736,경기,연천군,0,0,0,0,0,0,2018-09-05
1737,경기,연천군,4,0,0,4,2,0,2018-10-05
1738,경기,연천군,0,0,0,0,0,0,2018-11-05
1739,경기,연천군,0,0,0,0,0,0,2018-12-05
1740,경기,오산시,3,0,0,3,2,0,2018-01-05
1741,경기,오산시,1,0,0,1,1,0,2018-02-05
1742,경기,오산시,1,0,0,1,1,0,2018-03-05
1743,경기,오산시,6,0,1,7,3,0,2018-04-05
1744,경기,오산시,4,0,2,6,5,0,2018-05-05
1745,경기,오산시,2,0,0,2,2,0,2018-06-05
1746,경기,오산시,2,0,0,2,2,0,2018-07-05
1747,경기,오산시,3,1,0,4,3,0,2018-08-05
1748,경기,오산시,5,0,1,6,3,0,2018-09-05
1749,경기,오산시,12,1,2,15,8,0,2018-10-05
1750,경기,오산시,0,0,0,0,0,0,2018-11-05
1751,경기,오산시,1,0,3,4,2,0,2018-12-05
1752,경기,용인시,13,1,2,16,10,0,2018-01-05
1753,경기,용인시,16,2,8,26,15,0,2018-02-05
1754,경기,용인시,3,1,6,10,7,0,2018-03-05
1755,경기,용인시,10,1,8,19,12,0,2018-04-05
1756,경기,용인시,11,2,5,18,9,1,2018-05-05
1757,경기,용인시,10,1,1,12,9,1,2018-06-05
1758,경기,용인시,7,2,6,15,9,0,2018-07-05
1759,경기,용인시,4,0,1,5,3,0,2018-08-05
1760,경기,용인시,19,0,2,21,12,0,2018-09-05
1761,경기,용인시,16,6,5,27,16,0,2018-10-05
1762,경기,용인시,2,1,2,5,5,0,2018-11-05
1763,경기,용인시,11,1,5,17,10,0,2018-12-05
1764,경기,의왕시,0,0,0,0,0,0,2018-01-05
1765,경기,의왕시,0,1,0,1,1,0,2018-02-05
1766,경기,의왕시,1,0,1,2,2,0,2018-03-05
1767,경기,의왕시,7,1,1,9,3,0,2018-04-05
1768,경기,의왕시,5,0,4,9,4,0,2018-05-05
1769,경기,의왕시,1,0,1,2,2,0,2018-06-05
1770,경기,의왕시,0,0,0,0,0,0,2018-07-05
1771,경기,의왕시,0,0,2,2,1,0,2018-08-05
1772,경기,의왕시,1,0,0,1,1,0,2018-09-05
1773,경기,의왕시,2,0,0,2,1,0,2018-10-05
1774,경기,의왕시,0,0,1,1,1,0,2018-11-05
1775,경기,의왕시,2,0,1,3,3,0,2018-12-05
1776,경기,의정부시,6,2,0,8,5,0,2018-01-05
1777,경기,의정부시,8,3,1,12,8,0,2018-02-05
1778,경기,의정부시,0,0,1,1,1,0,2018-03-05
1779,경기,의정부시,6,0,1,7,5,0,2018-04-05
1780,경기,의정부시,1,0,1,2,2,0,2018-05-05
1781,경기,의정부시,1,0,1,2,2,0,2018-06-05
1782,경기,의정부시,10,1,2,13,9,0,2018-07-05
1783,경기,의정부시,1,2,2,5,5,0,2018-08-05
1784,경기,의정부시,6,0,1,7,4,0,2018-09-05
1785,경기,의정부시,11,0,1,12,7,0,2018-10-05
1786,경기,의정부시,7,0,1,8,6,0,2018-11-05
1787,경기,의정부시,5,0,1,6,6,0,2018-12-05
1788,경기,이천시,0,0,1,1,1,0,2018-01-05
1789,경기,이천시,0,0,1,1,1,0,2018-02-05
1790,경기,이천시,7,0,0,7,3,0,2018-03-05
1791,경기,이천시,4,0,2,6,4,0,2018-04-05
1792,경기,이천시,7,4,0,11,5,0,2018-05-05
1793,경기,이천시,5,0,0,5,2,0,2018-06-05
1794,경기,이천시,6,1,1,8,7,0,2018-07-05
1795,경기,이천시,5,1,0,6,2,0,2018-08-05
1796,경기,이천시,1,0,2,3,3,0,2018-09-05
1797,경기,이천시,2,0,1,3,3,0,2018-10-05
1798,경기,이천시,3,0,2,5,3,0,2018-11-05
1799,경기,이천시,3,0,1,4,4,0,2018-12-05
1800,경기,파주시,12,0,1,13,4,0,2018-01-05
1801,경기,파주시,12,0,1,13,11,1,2018-02-05
1802,경기,파주시,4,0,1,5,3,0,2018-03-05
1803,경기,파주시,7,1,0,8,6,0,2018-04-05
1804,경기,파주시,2,0,1,3,3,0,2018-05-05
1805,경기,파주시,5,0,2,7,4,0,2018-06-05
1806,경기,파주시,10,0,2,12,7,0,2018-07-05
1807,경기,파주시,6,1,2,9,7,0,2018-08-05
1808,경기,파주시,7,0,2,9,7,0,2018-09-05
1809,경기,파주시,6,0,5,11,10,0,2018-10-05
1810,경기,파주시,6,1,1,8,7,0,2018-11-05
1811,경기,파주시,11,0,2,13,6,0,2018-12-05
1812,경기,평택시,5,2,3,10,10,0,2018-01-05
1813,경기,평택시,9,0,5,14,9,0,2018-02-05
1814,경기,평택시,4,1,3,8,6,0,2018-03-05
1815,경기,평택시,7,0,4,11,7,0,2018-04-05
1816,경기,평택시,15,4,1,20,12,0,2018-05-05
1817,경기,평택시,7,3,4,14,8,0,2018-06-05
1818,경기,평택시,15,3,6,24,12,0,2018-07-05
1819,경기,평택시,5,1,2,8,5,0,2018-08-05
1820,경기,평택시,17,2,5,24,12,0,2018-09-05
1821,경기,평택시,9,3,5,17,14,0,2018-10-05
1822,경기,평택시,11,1,3,15,12,0,2018-11-05
1823,경기,평택시,11,1,3,15,10,1,2018-12-05
1824,경기,포천시,0,0,0,0,0,0,2018-01-05
1825,경기,포천시,2,0,1,3,2,0,2018-02-05
1826,경기,포천시,3,0,0,3,3,0,2018-03-05
1827,경기,포천시,1,1,0,2,2,0,2018-04-05
1828,경기,포천시,0,2,0,2,1,0,2018-05-05
1829,경기,포천시,6,1,0,7,4,0,2018-06-05
1830,경기,포천시,5,1,1,7,6,0,2018-07-05
1831,경기,포천시,9,3,2,14,7,0,2018-08-05
1832,경기,포천시,2,2,1,5,5,0,2018-09-05
1833,경기,포천시,4,0,0,4,3,0,2018-10-05
1834,경기,포천시,3,0,1,4,1,0,2018-11-05
1835,경기,포천시,2,0,0,2,2,0,2018-12-05
1836,경기,하남시,1,0,0,1,1,0,2018-01-05
1837,경기,하남시,0,0,0,0,0,0,2018-02-05
1838,경기,하남시,1,0,2,3,3,0,2018-03-05
1839,경기,하남시,5,0,1,6,2,0,2018-04-05
1840,경기,하남시,9,4,1,14,8,0,2018-05-05
1841,경기,하남시,11,0,0,11,7,0,2018-06-05
1842,경기,하남시,3,0,0,3,1,0,2018-07-05
1843,경기,하남시,0,0,0,0,0,0,2018-08-05
1844,경기,하남시,1,0,0,1,1,0,2018-09-05
1845,경기,하남시,4,0,1,5,4,0,2018-10-05
1846,경기,하남시,3,1,0,4,4,0,2018-11-05
1847,경기,하남시,0,2,3,5,5,0,2018-12-05
1848,경기,화성시,11,0,7,18,16,1,2018-01-05
1849,경기,화성시,6,1,2,9,7,0,2018-02-05
1850,경기,화성시,6,0,1,7,4,0,2018-03-05
1851,경기,화성시,7,0,4,11,7,0,2018-04-05
1852,경기,화성시,15,1,3,19,7,0,2018-05-05
1853,경기,화성시,3,1,5,9,6,0,2018-06-05
1854,경기,화성시,10,0,1,11,7,0,2018-07-05
1855,경기,화성시,4,0,2,6,4,0,2018-08-05
1856,경기,화성시,7,0,2,9,8,0,2018-09-05
1857,경기,화성시,6,0,3,9,8,0,2018-10-05
1858,경기,화성시,28,10,3,41,15,0,2018-11-05
1859,경기,화성시,4,1,2,7,6,0,2018-12-05
1860,경기,가평군,3,0,0,3,1,0,2018-01-06
1861,경기,가평군,5,1,0,6,3,0,2018-02-06
1862,경기,가평군,4,0,0,4,3,0,2018-03-06
1863,경기,가평군,4,0,3,7,1,0,2018-04-06
1864,경기,가평군,2,0,0,2,1,0,2018-05-06
1865,경기,가평군,1,0,0,1,1,0,2018-06-06
1866,경기,가평군,0,0,0,0,0,0,2018-07-06
1867,경기,가평군,1,0,0,1,1,0,2018-08-06
1868,경기,가평군,0,0,0,0,0,0,2018-09-06
1869,경기,가평군,4,3,0,7,2,0,2018-10-06
1870,경기,가평군,0,0,0,0,0,0,2018-11-06
1871,경기,가평군,1,0,0,1,1,0,2018-12-06
1872,경기,고양시,15,2,5,22,15,0,2018-01-06
1873,경기,고양시,8,2,5,15,11,0,2018-02-06
1874,경기,고양시,6,0,1,7,6,0,2018-03-06
1875,경기,고양시,20,1,0,21,15,1,2018-04-06
1876,경기,고양시,8,0,1,9,5,0,2018-05-06
1877,경기,고양시,7,0,6,13,6,0,2018-06-06
1878,경기,고양시,3,1,1,5,5,0,2018-07-06
1879,경기,고양시,11,1,6,18,10,0,2018-08-06
1880,경기,고양시,9,3,2,14,10,0,2018-09-06
1881,경기,고양시,19,2,6,27,15,0,2018-10-06
1882,경기,고양시,6,2,5,13,9,0,2018-11-06
1883,경기,고양시,16,1,1,18,14,0,2018-12-06
1884,경기,과천시,0,0,0,0,0,0,2018-01-06
1885,경기,과천시,1,0,0,1,1,0,2018-02-06
1886,경기,과천시,1,0,0,1,1,0,2018-03-06
1887,경기,과천시,0,0,0,0,0,0,2018-04-06
1888,경기,과천시,0,0,0,0,0,0,2018-05-06
1889,경기,과천시,1,0,1,2,1,0,2018-06-06
1890,경기,과천시,0,0,0,0,0,0,2018-07-06
1891,경기,과천시,1,0,0,1,1,0,2018-08-06
1892,경기,과천시,1,0,0,1,1,0,2018-09-06
1893,경기,과천시,0,0,1,1,1,0,2018-10-06
1894,경기,과천시,0,0,0,0,0,0,2018-11-06
1895,경기,과천시,5,0,0,5,2,0,2018-12-06
1896,경기,광명시,4,1,0,5,4,0,2018-01-06
1897,경기,광명시,0,2,0,2,2,0,2018-02-06
1898,경기,광명시,1,1,1,3,3,0,2018-03-06
1899,경기,광명시,0,1,1,2,2,0,2018-04-06
1900,경기,광명시,0,2,0,2,2,0,2018-05-06
1901,경기,광명시,2,0,2,4,3,0,2018-06-06
1902,경기,광명시,1,0,1,2,2,0,2018-07-06
1903,경기,광명시,1,1,0,2,2,0,2018-08-06
1904,경기,광명시,5,1,1,7,3,0,2018-09-06
1905,경기,광명시,0,0,0,0,1,1,2018-10-06
1906,경기,광명시,5,1,1,7,5,0,2018-11-06
1907,경기,광명시,1,4,1,6,4,0,2018-12-06
1908,경기,광주시,13,1,2,16,9,0,2018-01-06
1909,경기,광주시,8,0,7,15,10,0,2018-02-06
1910,경기,광주시,8,0,2,10,6,0,2018-03-06
1911,경기,광주시,3,0,1,4,3,0,2018-04-06
1912,경기,광주시,9,0,0,9,2,0,2018-05-06
1913,경기,광주시,7,1,0,8,4,0,2018-06-06
1914,경기,광주시,1,0,2,3,3,0,2018-07-06
1915,경기,광주시,2,0,2,4,4,0,2018-08-06
1916,경기,광주시,6,1,1,8,7,0,2018-09-06
1917,경기,광주시,10,3,1,14,8,0,2018-10-06
1918,경기,광주시,8,2,1,11,6,0,2018-11-06
1919,경기,광주시,8,0,1,9,7,0,2018-12-06
1920,경기,구리시,0,0,0,0,0,0,2018-01-06
1921,경기,구리시,2,0,1,3,3,0,2018-02-06
1922,경기,구리시,4,0,0,4,2,0,2018-03-06
1923,경기,구리시,0,0,0,0,0,0,2018-04-06
1924,경기,구리시,1,0,0,1,1,0,2018-05-06
1925,경기,구리시,3,0,2,5,3,0,2018-06-06
1926,경기,구리시,1,0,0,1,1,0,2018-07-06
1927,경기,구리시,2,1,1,4,3,0,2018-08-06
1928,경기,구리시,0,0,1,1,1,0,2018-09-06
1929,경기,구리시,2,0,1,3,3,0,2018-10-06
1930,경기,구리시,1,0,0,1,1,0,2018-11-06
1931,경기,구리시,1,0,0,1,1,0,2018-12-06
1932,경기,군포시,1,0,0,1,1,0,2018-01-06
1933,경기,군포시,0,1,1,2,2,0,2018-02-06
1934,경기,군포시,0,0,0,0,0,0,2018-03-06
1935,경기,군포시,1,1,0,2,2,0,2018-04-06
1936,경기,군포시,0,0,0,0,0,0,2018-05-06
1937,경기,군포시,3,1,1,5,4,0,2018-06-06
1938,경기,군포시,1,0,0,1,1,0,2018-07-06
1939,경기,군포시,1,0,1,2,1,0,2018-08-06
1940,경기,군포시,2,0,0,2,2,0,2018-09-06
1941,경기,군포시,1,1,0,2,2,0,2018-10-06
1942,경기,군포시,0,0,0,0,0,0,2018-11-06
1943,경기,군포시,1,0,2,3,2,0,2018-12-06
1944,경기,김포시,3,0,0,3,2,0,2018-01-06
1945,경기,김포시,8,0,3,11,9,0,2018-02-06
1946,경기,김포시,3,0,0,3,2,0,2018-03-06
1947,경기,김포시,6,1,2,9,7,0,2018-04-06
1948,경기,김포시,3,0,2,5,2,0,2018-05-06
1949,경기,김포시,2,0,0,2,2,0,2018-06-06
1950,경기,김포시,7,0,0,7,6,0,2018-07-06
1951,경기,김포시,5,0,2,7,6,0,2018-08-06
1952,경기,김포시,8,0,4,12,10,0,2018-09-06
1953,경기,김포시,6,1,0,7,2,0,2018-10-06
1954,경기,김포시,2,0,0,2,2,0,2018-11-06
1955,경기,김포시,2,0,3,5,4,0,2018-12-06
1956,경기,남양주시,3,0,0,3,3,0,2018-01-06
1957,경기,남양주시,6,2,2,10,8,0,2018-02-06
1958,경기,남양주시,6,1,2,9,8,0,2018-03-06
1959,경기,남양주시,7,3,2,12,9,0,2018-04-06
1960,경기,남양주시,2,2,0,4,3,0,2018-05-06
1961,경기,남양주시,16,0,0,16,12,0,2018-06-06
1962,경기,남양주시,8,2,0,10,7,0,2018-07-06
1963,경기,남양주시,10,0,2,12,6,0,2018-08-06
1964,경기,남양주시,10,1,2,13,6,0,2018-09-06
1965,경기,남양주시,13,8,2,23,9,0,2018-10-06
1966,경기,남양주시,5,0,2,7,4,0,2018-11-06
1967,경기,남양주시,5,1,0,6,6,1,2018-12-06
1968,경기,동두천시,0,0,0,0,0,0,2018-01-06
1969,경기,동두천시,0,0,0,0,0,0,2018-02-06
1970,경기,동두천시,1,0,0,1,1,0,2018-03-06
1971,경기,동두천시,0,0,0,0,0,0,2018-04-06
1972,경기,동두천시,1,0,0,1,1,0,2018-05-06
1973,경기,동두천시,2,0,0,2,1,0,2018-06-06
1974,경기,동두천시,2,0,1,3,2,0,2018-07-06
1975,경기,동두천시,1,0,2,3,1,0,2018-08-06
1976,경기,동두천시,1,0,1,2,2,0,2018-09-06
1977,경기,동두천시,9,0,1,10,4,0,2018-10-06
1978,경기,동두천시,1,0,1,2,2,0,2018-11-06
1979,경기,동두천시,0,0,0,0,0,0,2018-12-06
1980,경기,부천시,11,0,2,13,9,0,2018-01-06
1981,경기,부천시,13,1,2,16,13,0,2018-02-06
1982,경기,부천시,16,0,3,19,11,0,2018-03-06
1983,경기,부천시,3,0,0,3,2,0,2018-04-06
1984,경기,부천시,13,3,0,16,12,0,2018-05-06
1985,경기,부천시,12,2,2,16,9,0,2018-06-06
1986,경기,부천시,2,1,3,6,6,0,2018-07-06
1987,경기,부천시,9,0,0,9,6,0,2018-08-06
1988,경기,부천시,10,0,3,13,11,0,2018-09-06
1989,경기,부천시,7,2,0,9,7,0,2018-10-06
1990,경기,부천시,8,0,3,11,11,0,2018-11-06
1991,경기,부천시,9,0,4,13,12,0,2018-12-06
1992,경기,성남시,16,1,5,22,10,0,2018-01-06
1993,경기,성남시,15,0,2,17,12,0,2018-02-06
1994,경기,성남시,5,1,2,8,6,1,2018-03-06
1995,경기,성남시,9,2,0,11,9,0,2018-04-06
1996,경기,성남시,10,0,2,12,5,0,2018-05-06
1997,경기,성남시,11,1,6,18,14,0,2018-06-06
1998,경기,성남시,8,2,3,13,9,1,2018-07-06
1999,경기,성남시,12,0,2,14,8,0,2018-08-06
2000,경기,성남시,16,1,2,19,11,0,2018-09-06
2001,경기,성남시,15,3,6,24,13,0,2018-10-06
2002,경기,성남시,8,0,2,10,8,0,2018-11-06
2003,경기,성남시,2,0,2,4,4,0,2018-12-06
2004,경기,수원시,13,0,5,18,12,0,2018-01-06
2005,경기,수원시,19,1,2,22,16,0,2018-02-06
2006,경기,수원시,17,3,2,22,14,0,2018-03-06
2007,경기,수원시,13,3,1,17,13,0,2018-04-06
2008,경기,수원시,15,2,0,17,12,0,2018-05-06
2009,경기,수원시,9,6,4,19,11,0,2018-06-06
2010,경기,수원시,15,0,3,18,17,0,2018-07-06
2011,경기,수원시,11,0,6,17,10,0,2018-08-06
2012,경기,수원시,7,2,3,12,11,0,2018-09-06
2013,경기,수원시,11,2,7,20,14,0,2018-10-06
2014,경기,수원시,15,1,2,18,13,0,2018-11-06
2015,경기,수원시,20,1,4,25,14,0,2018-12-06
2016,경기,시흥시,11,0,1,12,7,1,2018-01-06
2017,경기,시흥시,5,0,3,8,7,0,2018-02-06
2018,경기,시흥시,12,0,0,12,8,0,2018-03-06
2019,경기,시흥시,12,5,2,19,10,0,2018-04-06
2020,경기,시흥시,11,1,3,15,8,0,2018-05-06
2021,경기,시흥시,10,0,4,14,9,1,2018-06-06
2022,경기,시흥시,2,0,3,5,5,0,2018-07-06
2023,경기,시흥시,6,0,1,7,5,0,2018-08-06
2024,경기,시흥시,7,0,1,8,4,0,2018-09-06
2025,경기,시흥시,6,2,0,8,5,0,2018-10-06
2026,경기,시흥시,7,0,3,10,5,0,2018-11-06
2027,경기,시흥시,15,0,6,21,12,0,2018-12-06
2028,경기,안산시,16,0,4,20,12,1,2018-01-06
2029,경기,안산시,17,5,6,28,9,0,2018-02-06
2030,경기,안산시,6,0,0,6,4,0,2018-03-06
2031,경기,안산시,18,2,3,23,15,0,2018-04-06
2032,경기,안산시,38,1,2,41,15,0,2018-05-06
2033,경기,안산시,12,0,2,14,7,0,2018-06-06
2034,경기,안산시,16,1,3,20,12,0,2018-07-06
2035,경기,안산시,2,0,1,3,3,0,2018-08-06
2036,경기,안산시,7,0,3,10,8,0,2018-09-06
2037,경기,안산시,13,2,3,18,14,0,2018-10-06
2038,경기,안산시,7,0,1,8,7,1,2018-11-06
2039,경기,안산시,9,1,0,10,9,0,2018-12-06
2040,경기,안성시,0,0,0,0,0,0,2018-01-06
2041,경기,안성시,2,0,0,2,2,0,2018-02-06
2042,경기,안성시,2,0,1,3,2,0,2018-03-06
2043,경기,안성시,2,0,0,2,2,0,2018-04-06
2044,경기,안성시,3,0,1,4,3,0,2018-05-06
2045,경기,안성시,7,1,0,8,5,0,2018-06-06
2046,경기,안성시,1,0,0,1,2,1,2018-07-06
2047,경기,안성시,3,0,2,5,4,0,2018-08-06
2048,경기,안성시,0,0,0,0,0,0,2018-09-06
2049,경기,안성시,4,0,0,4,4,1,2018-10-06
2050,경기,안성시,4,1,1,6,3,0,2018-11-06
2051,경기,안성시,1,0,0,1,1,0,2018-12-06
2052,경기,안양시,10,0,0,10,6,0,2018-01-06
2053,경기,안양시,6,1,1,8,5,0,2018-02-06
2054,경기,안양시,7,0,2,9,4,0,2018-03-06
2055,경기,안양시,8,1,3,12,8,1,2018-04-06
2056,경기,안양시,0,0,1,1,1,0,2018-05-06
2057,경기,안양시,4,0,1,5,4,0,2018-06-06
2058,경기,안양시,4,1,1,6,4,0,2018-07-06
2059,경기,안양시,2,0,4,6,4,0,2018-08-06
2060,경기,안양시,6,0,2,8,6,0,2018-09-06
2061,경기,안양시,6,0,2,8,3,0,2018-10-06
2062,경기,안양시,2,0,2,4,4,0,2018-11-06
2063,경기,안양시,1,0,2,3,3,0,2018-12-06
2064,경기,양주시,2,1,0,3,2,0,2018-01-06
2065,경기,양주시,0,1,0,1,1,0,2018-02-06
2066,경기,양주시,1,0,0,1,1,0,2018-03-06
2067,경기,양주시,7,0,1,8,6,0,2018-04-06
2068,경기,양주시,0,1,0,1,1,0,2018-05-06
2069,경기,양주시,2,0,1,3,2,0,2018-06-06
2070,경기,양주시,2,0,0,2,2,0,2018-07-06
2071,경기,양주시,3,1,0,4,3,0,2018-08-06
2072,경기,양주시,4,0,0,4,3,0,2018-09-06
2073,경기,양주시,2,0,1,3,2,0,2018-10-06
2074,경기,양주시,0,0,0,0,0,0,2018-11-06
2075,경기,양주시,3,0,1,4,3,0,2018-12-06
2076,경기,양평군,2,0,2,4,1,0,2018-01-06
2077,경기,양평군,1,0,0,1,1,0,2018-02-06
2078,경기,양평군,0,0,0,0,0,0,2018-03-06
2079,경기,양평군,4,0,1,5,3,0,2018-04-06
2080,경기,양평군,3,0,0,3,1,0,2018-05-06
2081,경기,양평군,1,0,0,1,1,0,2018-06-06
2082,경기,양평군,1,0,0,1,1,0,2018-07-06
2083,경기,양평군,3,1,1,5,4,0,2018-08-06
2084,경기,양평군,1,0,1,2,1,0,2018-09-06
2085,경기,양평군,4,0,0,4,3,0,2018-10-06
2086,경기,양평군,3,0,3,6,4,0,2018-11-06
2087,경기,양평군,1,0,0,1,1,0,2018-12-06
2088,경기,여주시,1,1,0,2,2,0,2018-01-06
2089,경기,여주시,3,0,4,7,3,0,2018-02-06
2090,경기,여주시,0,0,0,0,0,0,2018-03-06
2091,경기,여주시,0,0,1,1,1,0,2018-04-06
2092,경기,여주시,0,0,0,0,0,0,2018-05-06
2093,경기,여주시,3,0,1,4,2,0,2018-06-06
2094,경기,여주시,0,0,0,0,0,0,2018-07-06
2095,경기,여주시,0,0,1,1,1,0,2018-08-06
2096,경기,여주시,0,2,0,2,2,1,2018-09-06
2097,경기,여주시,2,0,0,2,2,0,2018-10-06
2098,경기,여주시,1,0,0,1,1,0,2018-11-06
2099,경기,여주시,0,0,0,0,0,0,2018-12-06
2100,경기,연천군,0,0,0,0,0,0,2018-01-06
2101,경기,연천군,0,0,0,0,0,0,2018-02-06
2102,경기,연천군,0,0,0,0,0,0,2018-03-06
2103,경기,연천군,0,0,0,0,0,0,2018-04-06
2104,경기,연천군,0,0,0,0,0,0,2018-05-06
2105,경기,연천군,5,0,0,5,1,0,2018-06-06
2106,경기,연천군,0,0,0,0,0,0,2018-07-06
2107,경기,연천군,0,1,0,1,1,0,2018-08-06
2108,경기,연천군,4,1,0,5,2,0,2018-09-06
2109,경기,연천군,3,0,0,3,1,0,2018-10-06
2110,경기,연천군,0,0,0,0,0,0,2018-11-06
2111,경기,연천군,4,0,1,5,2,0,2018-12-06
2112,경기,오산시,0,0,0,0,0,0,2018-01-06
2113,경기,오산시,3,0,3,6,2,0,2018-02-06
2114,경기,오산시,1,0,0,1,1,0,2018-03-06
2115,경기,오산시,3,0,1,4,3,0,2018-04-06
2116,경기,오산시,1,1,4,6,3,0,2018-05-06
2117,경기,오산시,2,0,2,4,3,0,2018-06-06
2118,경기,오산시,5,0,0,5,4,0,2018-07-06
2119,경기,오산시,2,0,0,2,1,0,2018-08-06
2120,경기,오산시,1,0,3,4,4,0,2018-09-06
2121,경기,오산시,7,0,2,9,6,0,2018-10-06
2122,경기,오산시,1,0,2,3,3,0,2018-11-06
2123,경기,오산시,10,0,1,11,7,0,2018-12-06
2124,경기,용인시,3,3,3,9,8,0,2018-01-06
2125,경기,용인시,24,5,6,35,15,0,2018-02-06
2126,경기,용인시,8,2,1,11,6,0,2018-03-06
2127,경기,용인시,13,0,3,16,9,0,2018-04-06
2128,경기,용인시,4,3,2,9,7,0,2018-05-06
2129,경기,용인시,9,2,3,14,10,0,2018-06-06
2130,경기,용인시,9,0,0,9,8,0,2018-07-06
2131,경기,용인시,1,0,3,4,4,0,2018-08-06
2132,경기,용인시,14,2,2,18,7,0,2018-09-06
2133,경기,용인시,10,1,3,14,10,0,2018-10-06
2134,경기,용인시,10,1,3,14,9,0,2018-11-06
2135,경기,용인시,4,1,4,9,8,0,2018-12-06
2136,경기,의왕시,1,0,2,3,2,0,2018-01-06
2137,경기,의왕시,2,0,0,2,2,0,2018-02-06
2138,경기,의왕시,0,0,0,0,0,0,2018-03-06
2139,경기,의왕시,0,0,0,0,0,0,2018-04-06
2140,경기,의왕시,3,0,1,4,2,0,2018-05-06
2141,경기,의왕시,2,0,0,2,1,0,2018-06-06
2142,경기,의왕시,3,1,0,4,4,0,2018-07-06
2143,경기,의왕시,0,0,0,0,0,0,2018-08-06
2144,경기,의왕시,0,0,0,0,0,0,2018-09-06
2145,경기,의왕시,0,0,0,0,0,0,2018-10-06
2146,경기,의왕시,2,0,0,2,1,0,2018-11-06
2147,경기,의왕시,1,0,1,2,2,0,2018-12-06
2148,경기,의정부시,3,0,0,3,2,0,2018-01-06
2149,경기,의정부시,3,0,1,4,3,0,2018-02-06
2150,경기,의정부시,0,0,0,0,1,1,2018-03-06
2151,경기,의정부시,1,1,1,3,4,2,2018-04-06
2152,경기,의정부시,2,0,0,2,1,0,2018-05-06
2153,경기,의정부시,3,0,0,3,2,0,2018-06-06
2154,경기,의정부시,1,1,1,3,3,0,2018-07-06
2155,경기,의정부시,1,0,0,1,1,0,2018-08-06
2156,경기,의정부시,5,2,2,9,6,0,2018-09-06
2157,경기,의정부시,2,1,1,4,4,0,2018-10-06
2158,경기,의정부시,5,1,0,6,3,0,2018-11-06
2159,경기,의정부시,8,3,4,15,9,0,2018-12-06
2160,경기,이천시,2,0,0,2,1,0,2018-01-06
2161,경기,이천시,4,0,1,5,4,1,2018-02-06
2162,경기,이천시,9,2,1,12,2,0,2018-03-06
2163,경기,이천시,3,1,0,4,3,0,2018-04-06
2164,경기,이천시,4,2,1,7,3,0,2018-05-06
2165,경기,이천시,0,2,2,4,3,0,2018-06-06
2166,경기,이천시,1,0,0,1,1,0,2018-07-06
2167,경기,이천시,6,0,2,8,3,0,2018-08-06
2168,경기,이천시,3,1,0,4,3,0,2018-09-06
2169,경기,이천시,10,0,2,12,6,0,2018-10-06
2170,경기,이천시,5,0,1,6,5,0,2018-11-06
2171,경기,이천시,7,1,0,8,3,0,2018-12-06
2172,경기,파주시,10,0,2,12,6,0,2018-01-06
2173,경기,파주시,5,0,1,6,5,0,2018-02-06
2174,경기,파주시,2,0,3,5,3,0,2018-03-06
2175,경기,파주시,2,0,2,4,4,0,2018-04-06
2176,경기,파주시,7,0,1,8,4,0,2018-05-06
2177,경기,파주시,3,0,1,4,4,0,2018-06-06
2178,경기,파주시,4,0,0,4,1,0,2018-07-06
2179,경기,파주시,2,0,2,4,4,0,2018-08-06
2180,경기,파주시,1,2,1,4,3,0,2018-09-06
2181,경기,파주시,6,0,0,6,4,0,2018-10-06
2182,경기,파주시,6,0,1,7,6,0,2018-11-06
2183,경기,파주시,8,0,2,10,8,0,2018-12-06
2184,경기,평택시,5,2,1,8,9,1,2018-01-06
2185,경기,평택시,6,0,4,10,8,0,2018-02-06
2186,경기,평택시,16,1,6,23,11,0,2018-03-06
2187,경기,평택시,5,1,1,7,6,0,2018-04-06
2188,경기,평택시,0,0,0,0,0,0,2018-05-06
2189,경기,평택시,18,1,0,19,12,0,2018-06-06
2190,경기,평택시,6,1,5,12,9,0,2018-07-06
2191,경기,평택시,17,2,1,20,12,0,2018-08-06
2192,경기,평택시,6,2,4,12,9,0,2018-09-06
2193,경기,평택시,18,1,1,20,12,0,2018-10-06
2194,경기,평택시,15,2,4,21,13,0,2018-11-06
2195,경기,평택시,16,3,4,23,15,0,2018-12-06
2196,경기,포천시,0,6,1,7,2,0,2018-01-06
2197,경기,포천시,1,0,1,2,2,0,2018-02-06
2198,경기,포천시,3,0,0,3,2,0,2018-03-06
2199,경기,포천시,1,1,0,2,2,0,2018-04-06
2200,경기,포천시,0,0,0,0,0,0,2018-05-06
2201,경기,포천시,4,0,2,6,2,0,2018-06-06
2202,경기,포천시,3,0,2,5,3,0,2018-07-06
2203,경기,포천시,2,0,2,4,3,0,2018-08-06
2204,경기,포천시,1,0,0,1,1,0,2018-09-06
2205,경기,포천시,1,0,0,1,1,0,2018-10-06
2206,경기,포천시,2,0,1,3,3,0,2018-11-06
2207,경기,포천시,4,1,3,8,5,0,2018-12-06
2208,경기,하남시,2,0,0,2,2,0,2018-01-06
2209,경기,하남시,2,0,1,3,3,0,2018-02-06
2210,경기,하남시,2,1,1,4,2,0,2018-03-06
2211,경기,하남시,2,1,0,3,3,0,2018-04-06
2212,경기,하남시,3,2,0,5,3,0,2018-05-06
2213,경기,하남시,2,1,1,4,2,0,2018-06-06
2214,경기,하남시,1,0,1,2,2,0,2018-07-06
2215,경기,하남시,1,1,1,3,3,0,2018-08-06
2216,경기,하남시,4,1,1,6,5,0,2018-09-06
2217,경기,하남시,4,0,0,4,1,0,2018-10-06
2218,경기,하남시,2,0,0,2,1,0,2018-11-06
2219,경기,하남시,2,1,0,3,3,0,2018-12-06
2220,경기,화성시,14,1,4,19,12,1,2018-01-06
2221,경기,화성시,8,0,0,8,7,0,2018-02-06
2222,경기,화성시,1,1,4,6,6,0,2018-03-06
2223,경기,화성시,8,0,3,11,6,0,2018-04-06
2224,경기,화성시,2,0,2,4,4,1,2018-05-06
2225,경기,화성시,2,0,2,4,2,0,2018-06-06
2226,경기,화성시,12,2,2,16,12,0,2018-07-06
2227,경기,화성시,14,0,1,15,8,0,2018-08-06
2228,경기,화성시,4,1,5,10,8,0,2018-09-06
2229,경기,화성시,12,1,3,16,8,1,2018-10-06
2230,경기,화성시,5,12,0,17,5,0,2018-11-06
2231,경기,화성시,17,0,3,20,12,0,2018-12-06
2232,경기,가평군,0,0,1,1,1,0,2018-01-07
2233,경기,가평군,2,0,2,4,3,0,2018-02-07
2234,경기,가평군,0,0,0,0,0,0,2018-03-07
2235,경기,가평군,1,0,0,1,1,0,2018-04-07
2236,경기,가평군,2,0,0,2,1,0,2018-05-07
2237,경기,가평군,1,0,0,1,1,0,2018-06-07
2238,경기,가평군,0,1,1,2,2,0,2018-07-07
2239,경기,가평군,0,0,1,1,1,0,2018-08-07
2240,경기,가평군,0,0,0,0,0,0,2018-09-07
2241,경기,가평군,0,0,0,0,0,0,2018-10-07
2242,경기,가평군,0,0,0,0,0,0,2018-11-07
2243,경기,가평군,0,0,1,1,1,0,2018-12-07
2244,경기,고양시,6,1,1,8,7,0,2018-01-07
2245,경기,고양시,24,3,7,34,22,0,2018-02-07
2246,경기,고양시,3,0,1,4,4,0,2018-03-07
2247,경기,고양시,14,4,2,20,9,0,2018-04-07
2248,경기,고양시,7,1,5,13,9,0,2018-05-07
2249,경기,고양시,11,2,2,15,12,0,2018-06-07
2250,경기,고양시,8,1,4,13,10,1,2018-07-07
2251,경기,고양시,15,1,6,22,14,0,2018-08-07
2252,경기,고양시,8,2,3,13,12,0,2018-09-07
2253,경기,고양시,11,1,1,13,10,1,2018-10-07
2254,경기,고양시,20,3,3,26,13,0,2018-11-07
2255,경기,고양시,13,3,4,20,14,0,2018-12-07
2256,경기,과천시,0,0,0,0,0,0,2018-01-07
2257,경기,과천시,0,0,1,1,1,0,2018-02-07
2258,경기,과천시,4,0,0,4,2,0,2018-03-07
2259,경기,과천시,0,0,1,1,1,0,2018-04-07
2260,경기,과천시,0,0,0,0,0,0,2018-05-07
2261,경기,과천시,0,0,0,0,0,0,2018-06-07
2262,경기,과천시,1,2,0,3,2,0,2018-07-07
2263,경기,과천시,1,0,0,1,1,0,2018-08-07
2264,경기,과천시,0,0,0,0,0,0,2018-09-07
2265,경기,과천시,0,0,0,0,0,0,2018-10-07
2266,경기,과천시,0,1,0,1,1,0,2018-11-07
2267,경기,과천시,0,1,0,1,1,0,2018-12-07
2268,경기,광명시,0,0,0,0,0,0,2018-01-07
2269,경기,광명시,1,0,1,2,2,0,2018-02-07
2270,경기,광명시,2,0,2,4,4,0,2018-03-07
2271,경기,광명시,1,1,1,3,3,0,2018-04-07
2272,경기,광명시,2,1,1,4,3,0,2018-05-07
2273,경기,광명시,6,1,0,7,3,0,2018-06-07
2274,경기,광명시,6,3,2,11,5,0,2018-07-07
2275,경기,광명시,2,3,0,5,5,0,2018-08-07
2276,경기,광명시,2,0,0,2,2,0,2018-09-07
2277,경기,광명시,2,1,1,4,4,0,2018-10-07
2278,경기,광명시,4,2,3,9,8,0,2018-11-07
2279,경기,광명시,3,0,2,5,3,0,2018-12-07
2280,경기,광주시,5,2,0,7,2,0,2018-01-07
2281,경기,광주시,3,0,4,7,4,0,2018-02-07
2282,경기,광주시,2,1,6,9,4,0,2018-03-07
2283,경기,광주시,9,0,3,12,7,0,2018-04-07
2284,경기,광주시,4,1,0,5,5,0,2018-05-07
2285,경기,광주시,16,3,6,25,10,0,2018-06-07
2286,경기,광주시,4,0,0,4,3,0,2018-07-07
2287,경기,광주시,7,0,0,7,4,0,2018-08-07
2288,경기,광주시,6,0,0,6,6,0,2018-09-07
2289,경기,광주시,3,0,0,3,3,0,2018-10-07
2290,경기,광주시,27,1,3,31,6,0,2018-11-07
2291,경기,광주시,6,0,0,6,4,0,2018-12-07
2292,경기,구리시,3,0,0,3,2,0,2018-01-07
2293,경기,구리시,4,0,0,4,3,0,2018-02-07
2294,경기,구리시,0,0,0,0,0,0,2018-03-07
2295,경기,구리시,0,0,0,0,0,0,2018-04-07
2296,경기,구리시,4,0,5,9,6,0,2018-05-07
2297,경기,구리시,4,1,1,6,3,0,2018-06-07
2298,경기,구리시,10,0,3,13,6,0,2018-07-07
2299,경기,구리시,2,0,0,2,2,0,2018-08-07
2300,경기,구리시,0,0,1,1,1,0,2018-09-07
2301,경기,구리시,0,0,0,0,0,0,2018-10-07
2302,경기,구리시,2,0,0,2,2,0,2018-11-07
2303,경기,구리시,7,0,1,8,7,1,2018-12-07
2304,경기,군포시,1,0,0,1,1,0,2018-01-07
2305,경기,군포시,0,1,0,1,1,0,2018-02-07
2306,경기,군포시,1,0,0,1,1,0,2018-03-07
2307,경기,군포시,3,1,0,4,4,0,2018-04-07
2308,경기,군포시,2,1,1,4,3,0,2018-05-07
2309,경기,군포시,2,0,1,3,1,0,2018-06-07
2310,경기,군포시,1,0,2,3,2,0,2018-07-07
2311,경기,군포시,1,1,0,2,2,1,2018-08-07
2312,경기,군포시,5,3,0,8,4,0,2018-09-07
2313,경기,군포시,1,0,2,3,2,0,2018-10-07
2314,경기,군포시,1,0,1,2,2,0,2018-11-07
2315,경기,군포시,1,0,1,2,2,0,2018-12-07
2316,경기,김포시,1,0,0,1,1,0,2018-01-07
2317,경기,김포시,11,0,4,15,9,1,2018-02-07
2318,경기,김포시,5,2,0,7,3,0,2018-03-07
2319,경기,김포시,6,0,4,10,5,0,2018-04-07
2320,경기,김포시,4,0,1,5,3,0,2018-05-07
2321,경기,김포시,14,0,3,17,12,0,2018-06-07
2322,경기,김포시,5,0,2,7,4,0,2018-07-07
2323,경기,김포시,5,0,0,5,4,1,2018-08-07
2324,경기,김포시,3,1,3,7,4,0,2018-09-07
2325,경기,김포시,5,0,0,5,3,0,2018-10-07
2326,경기,김포시,7,2,2,11,6,0,2018-11-07
2327,경기,김포시,8,2,3,13,5,0,2018-12-07
2328,경기,남양주시,5,0,3,8,4,0,2018-01-07
2329,경기,남양주시,4,0,2,6,6,0,2018-02-07
2330,경기,남양주시,7,2,0,9,4,0,2018-03-07
2331,경기,남양주시,6,1,0,7,5,0,2018-04-07
2332,경기,남양주시,9,4,1,14,8,0,2018-05-07
2333,경기,남양주시,10,0,2,12,9,0,2018-06-07
2334,경기,남양주시,7,1,5,13,10,0,2018-07-07
2335,경기,남양주시,4,0,1,5,4,0,2018-08-07
2336,경기,남양주시,9,4,3,16,10,0,2018-09-07
2337,경기,남양주시,4,0,2,6,5,0,2018-10-07
2338,경기,남양주시,13,2,2,17,11,0,2018-11-07
2339,경기,남양주시,4,0,3,7,5,0,2018-12-07
2340,경기,동두천시,0,0,0,0,0,0,2018-01-07
2341,경기,동두천시,0,1,0,1,1,0,2018-02-07
2342,경기,동두천시,2,0,1,3,3,0,2018-03-07
2343,경기,동두천시,0,0,0,0,0,0,2018-04-07
2344,경기,동두천시,0,0,0,0,0,0,2018-05-07
2345,경기,동두천시,0,0,0,0,0,0,2018-06-07
2346,경기,동두천시,4,0,0,4,1,0,2018-07-07
2347,경기,동두천시,0,0,2,2,2,0,2018-08-07
2348,경기,동두천시,1,0,0,1,1,0,2018-09-07
2349,경기,동두천시,1,0,0,1,1,0,2018-10-07
2350,경기,동두천시,0,0,0,0,0,0,2018-11-07
2351,경기,동두천시,1,0,1,2,1,0,2018-12-07
2352,경기,부천시,9,1,3,13,7,0,2018-01-07
2353,경기,부천시,13,0,4,17,12,0,2018-02-07
2354,경기,부천시,16,2,2,20,9,0,2018-03-07
2355,경기,부천시,6,1,0,7,6,0,2018-04-07
2356,경기,부천시,4,0,1,5,5,0,2018-05-07
2357,경기,부천시,7,1,1,9,6,0,2018-06-07
2358,경기,부천시,7,3,3,13,9,0,2018-07-07
2359,경기,부천시,10,2,1,13,4,0,2018-08-07
2360,경기,부천시,10,0,4,14,11,0,2018-09-07
2361,경기,부천시,7,0,1,8,5,0,2018-10-07
2362,경기,부천시,3,0,5,8,8,0,2018-11-07
2363,경기,부천시,7,0,2,9,8,0,2018-12-07
2364,경기,성남시,3,1,2,6,5,0,2018-01-07
2365,경기,성남시,27,2,9,38,23,0,2018-02-07
2366,경기,성남시,14,1,7,22,10,0,2018-03-07
2367,경기,성남시,21,2,7,30,18,0,2018-04-07
2368,경기,성남시,9,1,3,13,8,0,2018-05-07
2369,경기,성남시,13,1,5,19,16,0,2018-06-07
2370,경기,성남시,10,2,8,20,12,0,2018-07-07
2371,경기,성남시,9,2,1,12,10,0,2018-08-07
2372,경기,성남시,18,1,5,24,16,0,2018-09-07
2373,경기,성남시,15,0,1,16,6,0,2018-10-07
2374,경기,성남시,11,0,1,12,11,0,2018-11-07
2375,경기,성남시,10,3,5,18,13,0,2018-12-07
2376,경기,수원시,6,2,2,10,8,0,2018-01-07
2377,경기,수원시,44,9,11,64,40,0,2018-02-07
2378,경기,수원시,7,0,4,11,9,0,2018-03-07
2379,경기,수원시,32,1,2,35,19,0,2018-04-07
2380,경기,수원시,14,1,4,19,9,0,2018-05-07
2381,경기,수원시,23,3,1,27,17,0,2018-06-07
2382,경기,수원시,16,0,2,18,12,0,2018-07-07
2383,경기,수원시,13,1,2,16,14,0,2018-08-07
2384,경기,수원시,9,2,2,13,10,0,2018-09-07
2385,경기,수원시,15,0,4,19,13,0,2018-10-07
2386,경기,수원시,11,4,2,17,11,0,2018-11-07
2387,경기,수원시,24,0,9,33,22,0,2018-12-07
2388,경기,시흥시,7,0,2,9,5,1,2018-01-07
2389,경기,시흥시,4,0,3,7,5,0,2018-02-07
2390,경기,시흥시,4,0,1,5,5,0,2018-03-07
2391,경기,시흥시,9,1,4,14,9,0,2018-04-07
2392,경기,시흥시,4,2,2,8,6,0,2018-05-07
2393,경기,시흥시,7,0,8,15,8,0,2018-06-07
2394,경기,시흥시,10,1,2,13,9,0,2018-07-07
2395,경기,시흥시,8,0,2,10,6,2,2018-08-07
2396,경기,시흥시,10,3,0,13,8,0,2018-09-07
2397,경기,시흥시,6,0,0,6,5,0,2018-10-07
2398,경기,시흥시,2,0,3,5,3,0,2018-11-07
2399,경기,시흥시,13,1,2,16,10,0,2018-12-07
2400,경기,안산시,14,0,0,14,7,0,2018-01-07
2401,경기,안산시,16,8,5,29,17,0,2018-02-07
2402,경기,안산시,6,0,2,8,6,1,2018-03-07
2403,경기,안산시,15,2,5,22,17,0,2018-04-07
2404,경기,안산시,13,0,2,15,10,0,2018-05-07
2405,경기,안산시,8,1,2,11,9,0,2018-06-07
2406,경기,안산시,19,0,2,21,11,0,2018-07-07
2407,경기,안산시,9,1,5,15,14,1,2018-08-07
2408,경기,안산시,16,3,2,21,18,1,2018-09-07
2409,경기,안산시,24,3,5,32,17,0,2018-10-07
2410,경기,안산시,23,0,9,32,16,0,2018-11-07
2411,경기,안산시,16,1,3,20,15,0,2018-12-07
2412,경기,안성시,7,0,0,7,3,0,2018-01-07
2413,경기,안성시,2,0,3,5,3,0,2018-02-07
2414,경기,안성시,7,0,1,8,3,0,2018-03-07
2415,경기,안성시,4,0,0,4,2,0,2018-04-07
2416,경기,안성시,8,0,1,9,4,0,2018-05-07
2417,경기,안성시,3,0,1,4,4,0,2018-06-07
2418,경기,안성시,4,0,0,4,4,0,2018-07-07
2419,경기,안성시,3,0,3,6,6,0,2018-08-07
2420,경기,안성시,5,0,0,5,3,0,2018-09-07
2421,경기,안성시,4,7,1,12,4,0,2018-10-07
2422,경기,안성시,10,0,3,13,12,0,2018-11-07
2423,경기,안성시,0,0,3,3,2,0,2018-12-07
2424,경기,안양시,4,0,0,4,2,0,2018-01-07
2425,경기,안양시,5,1,1,7,6,0,2018-02-07
2426,경기,안양시,1,0,3,4,4,0,2018-03-07
2427,경기,안양시,3,0,0,3,3,0,2018-04-07
2428,경기,안양시,3,0,0,3,2,0,2018-05-07
2429,경기,안양시,2,0,2,4,4,0,2018-06-07
2430,경기,안양시,21,1,5,27,10,0,2018-07-07
2431,경기,안양시,3,0,1,4,3,0,2018-08-07
2432,경기,안양시,10,2,6,18,14,0,2018-09-07
2433,경기,안양시,3,0,1,4,3,0,2018-10-07
2434,경기,안양시,3,0,1,4,4,0,2018-11-07
2435,경기,안양시,6,2,1,9,6,0,2018-12-07
2436,경기,양주시,2,0,0,2,2,0,2018-01-07
2437,경기,양주시,1,0,1,2,2,0,2018-02-07
2438,경기,양주시,3,0,0,3,3,0,2018-03-07
2439,경기,양주시,11,1,0,12,8,0,2018-04-07
2440,경기,양주시,1,0,1,2,2,0,2018-05-07
2441,경기,양주시,1,0,0,1,1,0,2018-06-07
2442,경기,양주시,4,0,0,4,3,0,2018-07-07
2443,경기,양주시,1,0,0,1,1,0,2018-08-07
2444,경기,양주시,2,0,3,5,3,0,2018-09-07
2445,경기,양주시,4,0,1,5,4,1,2018-10-07
2446,경기,양주시,4,0,1,5,3,0,2018-11-07
2447,경기,양주시,1,0,0,1,1,0,2018-12-07
2448,경기,양평군,0,0,1,1,1,0,2018-01-07
2449,경기,양평군,1,0,2,3,2,0,2018-02-07
2450,경기,양평군,0,0,0,0,0,0,2018-03-07
2451,경기,양평군,5,0,2,7,3,0,2018-04-07
2452,경기,양평군,0,0,1,1,1,0,2018-05-07
2453,경기,양평군,0,0,0,0,0,0,2018-06-07
2454,경기,양평군,1,0,0,1,1,0,2018-07-07
2455,경기,양평군,1,0,2,3,1,0,2018-08-07
2456,경기,양평군,1,0,0,1,1,0,2018-09-07
2457,경기,양평군,1,0,0,1,1,0,2018-10-07
2458,경기,양평군,1,0,3,4,1,0,2018-11-07
2459,경기,양평군,1,0,0,1,1,0,2018-12-07
2460,경기,여주시,0,0,0,0,0,0,2018-01-07
2461,경기,여주시,0,0,0,0,0,0,2018-02-07
2462,경기,여주시,0,0,1,1,1,0,2018-03-07
2463,경기,여주시,2,0,1,3,1,0,2018-04-07
2464,경기,여주시,0,0,0,0,0,0,2018-05-07
2465,경기,여주시,0,0,2,2,2,1,2018-06-07
2466,경기,여주시,2,0,1,3,3,0,2018-07-07
2467,경기,여주시,1,0,0,1,1,0,2018-08-07
2468,경기,여주시,2,0,0,2,1,0,2018-09-07
2469,경기,여주시,3,0,0,3,1,0,2018-10-07
2470,경기,여주시,1,0,0,1,1,0,2018-11-07
2471,경기,여주시,4,0,0,4,2,0,2018-12-07
2472,경기,연천군,0,0,0,0,0,0,2018-01-07
2473,경기,연천군,0,1,0,1,1,0,2018-02-07
2474,경기,연천군,0,0,0,0,0,0,2018-03-07
2475,경기,연천군,0,0,0,0,0,0,2018-04-07
2476,경기,연천군,0,0,1,1,1,1,2018-05-07
2477,경기,연천군,0,0,0,0,0,0,2018-06-07
2478,경기,연천군,0,0,0,0,0,0,2018-07-07
2479,경기,연천군,0,0,1,1,1,0,2018-08-07
2480,경기,연천군,1,0,1,2,2,0,2018-09-07
2481,경기,연천군,0,0,0,0,0,0,2018-10-07
2482,경기,연천군,0,0,0,0,0,0,2018-11-07
2483,경기,연천군,0,0,0,0,0,0,2018-12-07
2484,경기,오산시,0,0,0,0,0,0,2018-01-07
2485,경기,오산시,3,1,1,5,4,0,2018-02-07
2486,경기,오산시,3,0,0,3,3,0,2018-03-07
2487,경기,오산시,1,2,1,4,3,0,2018-04-07
2488,경기,오산시,1,0,1,2,2,0,2018-05-07
2489,경기,오산시,1,0,2,3,3,0,2018-06-07
2490,경기,오산시,1,0,1,2,2,1,2018-07-07
2491,경기,오산시,2,0,0,2,2,0,2018-08-07
2492,경기,오산시,4,3,2,9,6,0,2018-09-07
2493,경기,오산시,6,0,1,7,5,0,2018-10-07
2494,경기,오산시,3,0,1,4,3,0,2018-11-07
2495,경기,오산시,6,0,0,6,3,0,2018-12-07
2496,경기,용인시,2,2,1,5,4,0,2018-01-07
2497,경기,용인시,11,2,1,14,11,0,2018-02-07
2498,경기,용인시,3,1,3,7,5,0,2018-03-07
2499,경기,용인시,15,4,3,22,15,0,2018-04-07
2500,경기,용인시,11,0,2,13,7,0,2018-05-07
2501,경기,용인시,8,0,1,9,6,0,2018-06-07
2502,경기,용인시,14,2,4,20,10,0,2018-07-07
2503,경기,용인시,9,1,1,11,6,0,2018-08-07
2504,경기,용인시,10,1,3,14,10,0,2018-09-07
2505,경기,용인시,1,0,0,1,1,0,2018-10-07
2506,경기,용인시,4,3,3,10,9,0,2018-11-07
2507,경기,용인시,11,6,10,27,17,0,2018-12-07
2508,경기,의왕시,0,0,0,0,0,0,2018-01-07
2509,경기,의왕시,1,0,0,1,1,0,2018-02-07
2510,경기,의왕시,1,0,0,1,1,0,2018-03-07
2511,경기,의왕시,0,0,0,0,0,0,2018-04-07
2512,경기,의왕시,1,1,0,2,2,0,2018-05-07
2513,경기,의왕시,2,0,0,2,2,0,2018-06-07
2514,경기,의왕시,4,0,1,5,2,0,2018-07-07
2515,경기,의왕시,5,0,0,5,2,0,2018-08-07
2516,경기,의왕시,1,0,0,1,2,1,2018-09-07
2517,경기,의왕시,2,0,0,2,2,0,2018-10-07
2518,경기,의왕시,0,1,0,1,1,0,2018-11-07
2519,경기,의왕시,0,0,0,0,0,0,2018-12-07
2520,경기,의정부시,11,0,5,16,4,0,2018-01-07
2521,경기,의정부시,3,0,1,4,3,0,2018-02-07
2522,경기,의정부시,5,0,1,6,5,0,2018-03-07
2523,경기,의정부시,8,2,5,15,10,0,2018-04-07
2524,경기,의정부시,13,4,1,18,7,0,2018-05-07
2525,경기,의정부시,1,1,2,4,3,0,2018-06-07
2526,경기,의정부시,2,1,1,4,3,0,2018-07-07
2527,경기,의정부시,5,0,1,6,4,0,2018-08-07
2528,경기,의정부시,5,1,2,8,7,0,2018-09-07
2529,경기,의정부시,0,1,0,1,1,0,2018-10-07
2530,경기,의정부시,5,2,0,7,5,0,2018-11-07
2531,경기,의정부시,4,1,0,5,5,0,2018-12-07
2532,경기,이천시,1,0,0,1,1,0,2018-01-07
2533,경기,이천시,1,1,2,4,3,0,2018-02-07
2534,경기,이천시,0,0,0,0,0,0,2018-03-07
2535,경기,이천시,1,0,3,4,3,0,2018-04-07
2536,경기,이천시,5,1,0,6,4,0,2018-05-07
2537,경기,이천시,3,0,2,5,5,0,2018-06-07
2538,경기,이천시,6,0,2,8,3,0,2018-07-07
2539,경기,이천시,4,0,2,6,3,0,2018-08-07
2540,경기,이천시,4,0,1,5,5,0,2018-09-07
2541,경기,이천시,0,0,0,0,0,0,2018-10-07
2542,경기,이천시,4,0,2,6,3,0,2018-11-07
2543,경기,이천시,1,0,1,2,2,0,2018-12-07
2544,경기,파주시,2,0,2,4,2,0,2018-01-07
2545,경기,파주시,9,5,4,18,10,0,2018-02-07
2546,경기,파주시,5,0,4,9,6,0,2018-03-07
2547,경기,파주시,0,0,0,0,0,0,2018-04-07
2548,경기,파주시,4,0,4,8,4,0,2018-05-07
2549,경기,파주시,1,1,1,3,2,0,2018-06-07
2550,경기,파주시,5,0,1,6,4,0,2018-07-07
2551,경기,파주시,4,2,5,11,7,0,2018-08-07
2552,경기,파주시,2,0,1,3,2,0,2018-09-07
2553,경기,파주시,8,1,3,12,6,0,2018-10-07
2554,경기,파주시,10,0,5,15,9,0,2018-11-07
2555,경기,파주시,6,0,0,6,3,0,2018-12-07
2556,경기,평택시,6,0,1,7,5,0,2018-01-07
2557,경기,평택시,15,0,2,17,9,0,2018-02-07
2558,경기,평택시,11,1,1,13,8,0,2018-03-07
2559,경기,평택시,19,3,8,30,14,2,2018-04-07
2560,경기,평택시,6,3,3,12,6,0,2018-05-07
2561,경기,평택시,7,0,2,9,7,0,2018-06-07
2562,경기,평택시,13,2,2,17,7,0,2018-07-07
2563,경기,평택시,8,3,0,11,7,0,2018-08-07
2564,경기,평택시,8,0,3,11,9,0,2018-09-07
2565,경기,평택시,8,0,3,11,8,0,2018-10-07
2566,경기,평택시,8,1,2,11,6,0,2018-11-07
2567,경기,평택시,13,1,2,16,12,0,2018-12-07
2568,경기,포천시,1,0,0,1,1,0,2018-01-07
2569,경기,포천시,2,0,1,3,3,0,2018-02-07
2570,경기,포천시,0,0,0,0,0,0,2018-03-07
2571,경기,포천시,2,0,1,3,2,0,2018-04-07
2572,경기,포천시,2,0,2,4,3,0,2018-05-07
2573,경기,포천시,1,1,1,3,3,0,2018-06-07
2574,경기,포천시,3,5,2,10,5,0,2018-07-07
2575,경기,포천시,0,0,0,0,0,0,2018-08-07
2576,경기,포천시,1,0,1,2,2,0,2018-09-07
2577,경기,포천시,6,0,0,6,5,0,2018-10-07
2578,경기,포천시,2,0,0,2,1,0,2018-11-07
2579,경기,포천시,0,3,1,4,2,0,2018-12-07
2580,경기,하남시,1,0,0,1,1,0,2018-01-07
2581,경기,하남시,2,1,0,3,3,0,2018-02-07
2582,경기,하남시,0,0,0,0,0,0,2018-03-07
2583,경기,하남시,4,1,0,5,2,0,2018-04-07
2584,경기,하남시,2,2,2,6,4,0,2018-05-07
2585,경기,하남시,4,0,0,4,3,0,2018-06-07
2586,경기,하남시,3,0,0,3,2,0,2018-07-07
2587,경기,하남시,2,1,0,3,3,0,2018-08-07
2588,경기,하남시,5,0,1,6,5,0,2018-09-07
2589,경기,하남시,6,0,2,8,5,0,2018-10-07
2590,경기,하남시,4,0,3,7,2,0,2018-11-07
2591,경기,하남시,8,1,1,10,6,0,2018-12-07
2592,경기,화성시,8,0,1,9,6,0,2018-01-07
2593,경기,화성시,11,0,5,16,10,0,2018-02-07
2594,경기,화성시,5,0,3,8,9,2,2018-03-07
2595,경기,화성시,6,0,1,7,5,0,2018-04-07
2596,경기,화성시,12,0,0,12,5,0,2018-05-07
2597,경기,화성시,12,1,2,15,10,0,2018-06-07
2598,경기,화성시,2,1,1,4,4,0,2018-07-07
2599,경기,화성시,12,0,1,13,6,0,2018-08-07
2600,경기,화성시,15,0,7,22,15,0,2018-09-07
2601,경기,화성시,4,0,1,5,4,0,2018-10-07
2602,경기,화성시,15,0,4,19,12,0,2018-11-07
2603,경기,화성시,13,1,4,18,13,0,2018-12-07
2604,경기,가평군,0,0,0,0,0,0,2018-01-08
2605,경기,가평군,0,0,0,0,0,0,2018-02-08
2606,경기,가평군,1,0,0,1,1,0,2018-03-08
2607,경기,가평군,0,0,0,0,0,0,2018-04-08
2608,경기,가평군,5,0,1,6,5,0,2018-05-08
2609,경기,가평군,0,0,0,0,0,0,2018-06-08
2610,경기,가평군,0,0,0,0,0,0,2018-07-08
2611,경기,가평군,2,0,0,2,1,0,2018-08-08
2612,경기,가평군,4,0,0,4,2,0,2018-09-08
2613,경기,가평군,0,0,0,0,0,0,2018-10-08
2614,경기,가평군,2,0,0,2,2,0,2018-11-08
2615,경기,가평군,0,0,0,0,0,0,2018-12-08
2616,경기,고양시,10,0,1,11,8,0,2018-01-08
2617,경기,고양시,16,0,6,22,17,0,2018-02-08
2618,경기,고양시,10,0,1,11,8,0,2018-03-08
2619,경기,고양시,11,2,4,17,8,0,2018-04-08
2620,경기,고양시,19,4,4,27,14,0,2018-05-08
2621,경기,고양시,20,2,2,24,11,1,2018-06-08
2622,경기,고양시,4,2,1,7,6,0,2018-07-08
2623,경기,고양시,19,0,7,26,11,0,2018-08-08
2624,경기,고양시,17,4,5,26,13,0,2018-09-08
2625,경기,고양시,11,1,3,15,11,0,2018-10-08
2626,경기,고양시,12,2,5,19,14,0,2018-11-08
2627,경기,고양시,11,1,2,14,10,0,2018-12-08
2628,경기,과천시,2,0,0,2,1,0,2018-01-08
2629,경기,과천시,0,0,1,1,1,0,2018-02-08
2630,경기,과천시,1,0,0,1,1,0,2018-03-08
2631,경기,과천시,4,0,0,4,2,0,2018-04-08
2632,경기,과천시,0,0,0,0,0,0,2018-05-08
2633,경기,과천시,1,0,0,1,1,0,2018-06-08
2634,경기,과천시,4,3,1,8,3,0,2018-07-08
2635,경기,과천시,0,0,0,0,0,0,2018-08-08
2636,경기,과천시,4,0,0,4,2,0,2018-09-08
2637,경기,과천시,0,0,0,0,0,0,2018-10-08
2638,경기,과천시,2,0,0,2,2,0,2018-11-08
2639,경기,과천시,0,0,0,0,0,0,2018-12-08
2640,경기,광명시,1,0,2,3,3,0,2018-01-08
2641,경기,광명시,2,0,0,2,1,0,2018-02-08
2642,경기,광명시,0,0,0,0,0,0,2018-03-08
2643,경기,광명시,1,3,1,5,2,0,2018-04-08
2644,경기,광명시,1,1,2,4,4,0,2018-05-08
2645,경기,광명시,0,1,1,2,2,0,2018-06-08
2646,경기,광명시,0,1,1,2,2,0,2018-07-08
2647,경기,광명시,3,0,1,4,3,0,2018-08-08
2648,경기,광명시,1,3,1,5,2,0,2018-09-08
2649,경기,광명시,3,1,0,4,4,0,2018-10-08
2650,경기,광명시,1,1,1,3,3,0,2018-11-08
2651,경기,광명시,1,0,0,1,1,0,2018-12-08
2652,경기,광주시,3,0,0,3,3,0,2018-01-08
2653,경기,광주시,7,0,7,14,8,0,2018-02-08
2654,경기,광주시,2,0,2,4,3,0,2018-03-08
2655,경기,광주시,5,0,0,5,3,0,2018-04-08
2656,경기,광주시,4,0,1,5,4,0,2018-05-08
2657,경기,광주시,1,0,0,1,1,0,2018-06-08
2658,경기,광주시,7,0,0,7,3,0,2018-07-08
2659,경기,광주시,9,0,0,9,8,1,2018-08-08
2660,경기,광주시,9,1,0,10,5,0,2018-09-08
2661,경기,광주시,5,1,3,9,8,0,2018-10-08
2662,경기,광주시,11,2,2,15,10,0,2018-11-08
2663,경기,광주시,6,0,3,9,6,0,2018-12-08
2664,경기,구리시,0,0,0,0,0,0,2018-01-08
2665,경기,구리시,6,0,4,10,3,0,2018-02-08
2666,경기,구리시,4,0,0,4,4,0,2018-03-08
2667,경기,구리시,0,0,1,1,1,0,2018-04-08
2668,경기,구리시,4,2,0,6,3,0,2018-05-08
2669,경기,구리시,0,0,1,1,1,0,2018-06-08
2670,경기,구리시,2,1,0,3,2,0,2018-07-08
2671,경기,구리시,2,0,0,2,1,0,2018-08-08
2672,경기,구리시,5,0,2,7,6,0,2018-09-08
2673,경기,구리시,0,0,0,0,0,0,2018-10-08
2674,경기,구리시,4,0,0,4,2,0,2018-11-08
2675,경기,구리시,6,0,0,6,3,0,2018-12-08
2676,경기,군포시,0,0,0,0,0,0,2018-01-08
2677,경기,군포시,1,0,0,1,1,0,2018-02-08
2678,경기,군포시,1,0,0,1,1,0,2018-03-08
2679,경기,군포시,0,0,1,1,1,0,2018-04-08
2680,경기,군포시,0,0,0,0,0,0,2018-05-08
2681,경기,군포시,1,0,0,1,1,0,2018-06-08
2682,경기,군포시,3,1,0,4,1,0,2018-07-08
2683,경기,군포시,0,1,0,1,1,0,2018-08-08
2684,경기,군포시,1,0,0,1,1,0,2018-09-08
2685,경기,군포시,0,0,1,1,1,0,2018-10-08
2686,경기,군포시,6,0,1,7,5,0,2018-11-08
2687,경기,군포시,1,1,1,3,2,0,2018-12-08
2688,경기,김포시,9,1,5,15,6,0,2018-01-08
2689,경기,김포시,8,1,1,10,8,0,2018-02-08
2690,경기,김포시,3,0,1,4,3,0,2018-03-08
2691,경기,김포시,2,0,0,2,1,0,2018-04-08
2692,경기,김포시,3,0,1,4,3,0,2018-05-08
2693,경기,김포시,6,0,0,6,5,0,2018-06-08
2694,경기,김포시,1,0,0,1,1,0,2018-07-08
2695,경기,김포시,4,0,7,11,8,0,2018-08-08
2696,경기,김포시,2,0,0,2,3,1,2018-09-08
2697,경기,김포시,4,1,3,8,6,0,2018-10-08
2698,경기,김포시,11,0,1,12,9,0,2018-11-08
2699,경기,김포시,7,4,1,12,5,0,2018-12-08
2700,경기,남양주시,7,1,3,11,7,0,2018-01-08
2701,경기,남양주시,7,2,0,9,6,0,2018-02-08
2702,경기,남양주시,7,0,0,7,3,0,2018-03-08
2703,경기,남양주시,5,2,3,10,8,0,2018-04-08
2704,경기,남양주시,1,1,1,3,3,0,2018-05-08
2705,경기,남양주시,4,0,0,4,3,0,2018-06-08
2706,경기,남양주시,9,0,1,10,6,0,2018-07-08
2707,경기,남양주시,10,4,2,16,9,0,2018-08-08
2708,경기,남양주시,5,0,1,6,4,0,2018-09-08
2709,경기,남양주시,4,1,1,6,6,0,2018-10-08
2710,경기,남양주시,13,2,6,21,11,0,2018-11-08
2711,경기,남양주시,17,0,2,19,6,0,2018-12-08
2712,경기,동두천시,1,0,2,3,2,0,2018-01-08
2713,경기,동두천시,1,0,2,3,3,0,2018-02-08
2714,경기,동두천시,1,0,0,1,1,0,2018-03-08
2715,경기,동두천시,2,0,0,2,1,0,2018-04-08
2716,경기,동두천시,0,0,0,0,0,0,2018-05-08
2717,경기,동두천시,0,0,0,0,0,0,2018-06-08
2718,경기,동두천시,0,0,1,1,1,0,2018-07-08
2719,경기,동두천시,0,0,1,1,1,0,2018-08-08
2720,경기,동두천시,1,0,2,3,3,0,2018-09-08
2721,경기,동두천시,0,0,0,0,0,0,2018-10-08
2722,경기,동두천시,1,0,0,1,1,0,2018-11-08
2723,경기,동두천시,1,0,1,2,1,0,2018-12-08
2724,경기,부천시,3,0,3,6,5,0,2018-01-08
2725,경기,부천시,6,1,2,9,7,0,2018-02-08
2726,경기,부천시,6,0,3,9,6,0,2018-03-08
2727,경기,부천시,9,1,1,11,8,0,2018-04-08
2728,경기,부천시,6,0,2,8,7,0,2018-05-08
2729,경기,부천시,23,1,3,27,12,0,2018-06-08
2730,경기,부천시,11,0,1,12,6,0,2018-07-08
2731,경기,부천시,12,1,1,14,9,0,2018-08-08
2732,경기,부천시,12,0,1,13,8,0,2018-09-08
2733,경기,부천시,11,2,2,15,14,0,2018-10-08
2734,경기,부천시,20,0,2,22,19,0,2018-11-08
2735,경기,부천시,11,0,3,14,9,0,2018-12-08
2736,경기,성남시,17,1,2,20,11,0,2018-01-08
2737,경기,성남시,15,2,4,21,16,0,2018-02-08
2738,경기,성남시,11,2,1,14,9,0,2018-03-08
2739,경기,성남시,23,3,5,31,16,0,2018-04-08
2740,경기,성남시,6,1,10,17,13,0,2018-05-08
2741,경기,성남시,9,1,2,12,7,0,2018-06-08
2742,경기,성남시,2,4,3,9,6,0,2018-07-08
2743,경기,성남시,5,0,3,8,7,0,2018-08-08
2744,경기,성남시,13,0,7,20,7,0,2018-09-08
2745,경기,성남시,6,0,1,7,6,0,2018-10-08
2746,경기,성남시,16,0,4,20,15,1,2018-11-08
2747,경기,성남시,18,2,2,22,11,0,2018-12-08
2748,경기,수원시,15,1,2,18,9,0,2018-01-08
2749,경기,수원시,21,3,6,30,22,0,2018-02-08
2750,경기,수원시,12,0,2,14,14,0,2018-03-08
2751,경기,수원시,9,0,4,13,10,0,2018-04-08
2752,경기,수원시,24,3,8,35,20,0,2018-05-08
2753,경기,수원시,11,11,4,26,13,1,2018-06-08
2754,경기,수원시,15,1,5,21,13,0,2018-07-08
2755,경기,수원시,14,0,6,20,18,0,2018-08-08
2756,경기,수원시,10,3,5,18,16,0,2018-09-08
2757,경기,수원시,24,2,3,29,20,1,2018-10-08
2758,경기,수원시,23,1,4,28,22,1,2018-11-08
2759,경기,수원시,17,1,5,23,15,0,2018-12-08
2760,경기,시흥시,1,0,3,4,4,0,2018-01-08
2761,경기,시흥시,13,0,0,13,9,0,2018-02-08
2762,경기,시흥시,9,2,2,13,11,0,2018-03-08
2763,경기,시흥시,3,0,1,4,4,0,2018-04-08
2764,경기,시흥시,11,0,0,11,6,0,2018-05-08
2765,경기,시흥시,2,2,3,7,7,0,2018-06-08
2766,경기,시흥시,6,0,1,7,4,0,2018-07-08
2767,경기,시흥시,3,0,0,3,2,0,2018-08-08
2768,경기,시흥시,15,2,4,21,13,0,2018-09-08
2769,경기,시흥시,6,0,3,9,6,0,2018-10-08
2770,경기,시흥시,12,0,4,16,12,0,2018-11-08
2771,경기,시흥시,8,0,2,10,9,0,2018-12-08
2772,경기,안산시,16,1,7,24,16,0,2018-01-08
2773,경기,안산시,18,0,7,25,17,0,2018-02-08
2774,경기,안산시,8,0,2,10,7,0,2018-03-08
2775,경기,안산시,6,1,5,12,10,1,2018-04-08
2776,경기,안산시,5,0,3,8,7,0,2018-05-08
2777,경기,안산시,7,0,1,8,6,0,2018-06-08
2778,경기,안산시,8,1,1,10,8,1,2018-07-08
2779,경기,안산시,9,1,0,10,7,0,2018-08-08
2780,경기,안산시,11,1,6,18,12,0,2018-09-08
2781,경기,안산시,12,0,4,16,11,0,2018-10-08
2782,경기,안산시,20,0,2,22,15,0,2018-11-08
2783,경기,안산시,16,4,1,21,15,1,2018-12-08
2784,경기,안성시,2,0,4,6,3,0,2018-01-08
2785,경기,안성시,0,1,1,2,2,0,2018-02-08
2786,경기,안성시,0,0,1,1,1,0,2018-03-08
2787,경기,안성시,0,0,3,3,1,0,2018-04-08
2788,경기,안성시,1,0,1,2,2,0,2018-05-08
2789,경기,안성시,0,0,1,1,1,0,2018-06-08
2790,경기,안성시,1,1,0,2,1,0,2018-07-08
2791,경기,안성시,3,1,3,7,4,0,2018-08-08
2792,경기,안성시,8,1,2,11,3,0,2018-09-08
2793,경기,안성시,2,0,2,4,2,0,2018-10-08
2794,경기,안성시,1,0,0,1,1,0,2018-11-08
2795,경기,안성시,6,2,1,9,3,0,2018-12-08
2796,경기,안양시,3,0,1,4,4,0,2018-01-08
2797,경기,안양시,8,0,3,11,9,1,2018-02-08
2798,경기,안양시,9,0,2,11,5,0,2018-03-08
2799,경기,안양시,3,0,3,6,4,0,2018-04-08
2800,경기,안양시,2,0,0,2,2,0,2018-05-08
2801,경기,안양시,5,0,4,9,8,0,2018-06-08
2802,경기,안양시,2,1,1,4,2,0,2018-07-08
2803,경기,안양시,4,1,0,5,4,0,2018-08-08
2804,경기,안양시,3,0,0,3,2,0,2018-09-08
2805,경기,안양시,4,1,0,5,3,0,2018-10-08
2806,경기,안양시,6,0,3,9,7,0,2018-11-08
2807,경기,안양시,8,1,1,10,8,0,2018-12-08
2808,경기,양주시,2,1,0,3,3,0,2018-01-08
2809,경기,양주시,3,0,0,3,3,0,2018-02-08
2810,경기,양주시,1,0,0,1,1,0,2018-03-08
2811,경기,양주시,5,0,0,5,2,0,2018-04-08
2812,경기,양주시,7,0,0,7,5,0,2018-05-08
2813,경기,양주시,6,0,0,6,2,0,2018-06-08
2814,경기,양주시,8,0,1,9,4,1,2018-07-08
2815,경기,양주시,12,0,7,19,4,2,2018-08-08
2816,경기,양주시,4,1,2,7,5,0,2018-09-08
2817,경기,양주시,5,0,1,6,4,0,2018-10-08
2818,경기,양주시,8,0,1,9,5,0,2018-11-08
2819,경기,양주시,3,0,0,3,3,0,2018-12-08
2820,경기,양평군,1,0,0,1,1,0,2018-01-08
2821,경기,양평군,0,1,0,1,1,0,2018-02-08
2822,경기,양평군,0,0,0,0,0,0,2018-03-08
2823,경기,양평군,0,2,0,2,2,0,2018-04-08
2824,경기,양평군,0,0,0,0,0,0,2018-05-08
2825,경기,양평군,1,1,0,2,2,0,2018-06-08
2826,경기,양평군,0,0,3,3,2,2,2018-07-08
2827,경기,양평군,3,0,0,3,2,0,2018-08-08
2828,경기,양평군,3,0,0,3,2,0,2018-09-08
2829,경기,양평군,3,0,3,6,3,0,2018-10-08
2830,경기,양평군,0,0,0,0,0,0,2018-11-08
2831,경기,양평군,1,0,0,1,1,0,2018-12-08
2832,경기,여주시,0,0,1,1,1,0,2018-01-08
2833,경기,여주시,0,0,0,0,0,0,2018-02-08
2834,경기,여주시,1,0,0,1,1,0,2018-03-08
2835,경기,여주시,3,0,1,4,2,0,2018-04-08
2836,경기,여주시,0,0,0,0,0,0,2018-05-08
2837,경기,여주시,1,0,0,1,1,0,2018-06-08
2838,경기,여주시,2,0,1,3,1,0,2018-07-08
2839,경기,여주시,2,0,0,2,1,0,2018-08-08
2840,경기,여주시,4,0,3,7,4,0,2018-09-08
2841,경기,여주시,4,0,1,5,2,0,2018-10-08
2842,경기,여주시,6,2,0,8,3,0,2018-11-08
2843,경기,여주시,1,0,0,1,1,0,2018-12-08
2844,경기,연천군,1,0,0,1,1,0,2018-01-08
2845,경기,연천군,1,0,0,1,1,0,2018-02-08
2846,경기,연천군,0,0,0,0,0,0,2018-03-08
2847,경기,연천군,1,0,1,2,1,0,2018-04-08
2848,경기,연천군,0,0,1,1,1,0,2018-05-08
2849,경기,연천군,0,0,0,0,0,0,2018-06-08
2850,경기,연천군,0,1,0,1,1,0,2018-07-08
2851,경기,연천군,0,0,0,0,0,0,2018-08-08
2852,경기,연천군,0,0,0,0,0,0,2018-09-08
2853,경기,연천군,0,0,0,0,0,0,2018-10-08
2854,경기,연천군,0,0,0,0,0,0,2018-11-08
2855,경기,연천군,2,0,0,2,1,0,2018-12-08
2856,경기,오산시,3,0,1,4,3,0,2018-01-08
2857,경기,오산시,1,0,1,2,2,0,2018-02-08
2858,경기,오산시,2,1,1,4,3,0,2018-03-08
2859,경기,오산시,1,0,2,3,1,0,2018-04-08
2860,경기,오산시,3,0,1,4,2,0,2018-05-08
2861,경기,오산시,2,0,5,7,5,0,2018-06-08
2862,경기,오산시,5,0,1,6,2,0,2018-07-08
2863,경기,오산시,3,0,0,3,3,0,2018-08-08
2864,경기,오산시,2,1,2,5,3,0,2018-09-08
2865,경기,오산시,5,0,2,7,5,0,2018-10-08
2866,경기,오산시,1,0,3,4,4,0,2018-11-08
2867,경기,오산시,6,0,2,8,4,0,2018-12-08
2868,경기,용인시,6,1,1,8,7,0,2018-01-08
2869,경기,용인시,8,2,10,20,13,0,2018-02-08
2870,경기,용인시,5,1,1,7,7,0,2018-03-08
2871,경기,용인시,9,1,1,11,7,0,2018-04-08
2872,경기,용인시,7,1,3,11,6,0,2018-05-08
2873,경기,용인시,5,2,6,13,9,0,2018-06-08
2874,경기,용인시,1,0,2,3,3,0,2018-07-08
2875,경기,용인시,9,1,0,10,8,0,2018-08-08
2876,경기,용인시,3,2,3,8,6,0,2018-09-08
2877,경기,용인시,12,2,10,24,18,0,2018-10-08
2878,경기,용인시,13,2,5,20,14,0,2018-11-08
2879,경기,용인시,7,0,1,8,6,0,2018-12-08
2880,경기,의왕시,1,0,0,1,1,0,2018-01-08
2881,경기,의왕시,1,0,0,1,1,0,2018-02-08
2882,경기,의왕시,3,0,0,3,2,0,2018-03-08
2883,경기,의왕시,0,0,0,0,0,0,2018-04-08
2884,경기,의왕시,2,0,0,2,1,0,2018-05-08
2885,경기,의왕시,1,0,1,2,2,0,2018-06-08
2886,경기,의왕시,1,0,0,1,1,0,2018-07-08
2887,경기,의왕시,0,0,0,0,0,0,2018-08-08
2888,경기,의왕시,1,0,0,1,1,0,2018-09-08
2889,경기,의왕시,0,0,3,3,2,0,2018-10-08
2890,경기,의왕시,2,0,2,4,3,0,2018-11-08
2891,경기,의왕시,0,0,0,0,0,0,2018-12-08
2892,경기,의정부시,6,0,1,7,4,0,2018-01-08
2893,경기,의정부시,5,2,2,9,6,0,2018-02-08
2894,경기,의정부시,3,0,0,3,2,0,2018-03-08
2895,경기,의정부시,6,1,2,9,5,0,2018-04-08
2896,경기,의정부시,2,0,2,4,4,0,2018-05-08
2897,경기,의정부시,6,0,1,7,4,0,2018-06-08
2898,경기,의정부시,0,0,2,2,2,0,2018-07-08
2899,경기,의정부시,2,1,0,3,2,0,2018-08-08
2900,경기,의정부시,4,2,1,7,4,0,2018-09-08
2901,경기,의정부시,5,1,3,9,7,0,2018-10-08
2902,경기,의정부시,13,1,3,17,12,0,2018-11-08
2903,경기,의정부시,6,1,1,8,7,0,2018-12-08
2904,경기,이천시,0,0,1,1,1,1,2018-01-08
2905,경기,이천시,3,0,3,6,3,0,2018-02-08
2906,경기,이천시,1,0,2,3,2,0,2018-03-08
2907,경기,이천시,3,0,0,3,1,0,2018-04-08
2908,경기,이천시,3,0,4,7,4,0,2018-05-08
2909,경기,이천시,1,0,0,1,1,0,2018-06-08
2910,경기,이천시,0,0,1,1,1,0,2018-07-08
2911,경기,이천시,3,0,0,3,3,0,2018-08-08
2912,경기,이천시,3,0,5,8,5,0,2018-09-08
2913,경기,이천시,3,0,1,4,3,0,2018-10-08
2914,경기,이천시,3,0,1,4,2,0,2018-11-08
2915,경기,이천시,2,0,0,2,2,0,2018-12-08
2916,경기,파주시,7,1,2,10,7,0,2018-01-08
2917,경기,파주시,21,1,9,31,15,0,2018-02-08
2918,경기,파주시,5,0,3,8,6,0,2018-03-08
2919,경기,파주시,5,0,3,8,3,0,2018-04-08
2920,경기,파주시,10,1,1,12,6,0,2018-05-08
2921,경기,파주시,4,0,3,7,6,0,2018-06-08
2922,경기,파주시,5,0,2,7,6,0,2018-07-08
2923,경기,파주시,3,0,0,3,3,0,2018-08-08
2924,경기,파주시,5,0,1,6,3,0,2018-09-08
2925,경기,파주시,5,1,0,6,3,0,2018-10-08
2926,경기,파주시,12,1,5,18,10,2,2018-11-08
2927,경기,파주시,0,4,0,4,1,0,2018-12-08
2928,경기,평택시,11,0,5,16,12,0,2018-01-08
2929,경기,평택시,17,0,3,20,9,0,2018-02-08
2930,경기,평택시,16,1,3,20,8,0,2018-03-08
2931,경기,평택시,12,2,3,17,8,0,2018-04-08
2932,경기,평택시,12,4,3,19,12,0,2018-05-08
2933,경기,평택시,10,3,4,17,11,0,2018-06-08
2934,경기,평택시,4,1,1,6,5,0,2018-07-08
2935,경기,평택시,5,0,0,5,4,0,2018-08-08
2936,경기,평택시,13,2,6,21,13,0,2018-09-08
2937,경기,평택시,15,4,5,24,17,1,2018-10-08
2938,경기,평택시,13,1,1,15,12,0,2018-11-08
2939,경기,평택시,14,3,1,18,11,0,2018-12-08
2940,경기,포천시,3,0,0,3,1,0,2018-01-08
2941,경기,포천시,0,0,1,1,1,0,2018-02-08
2942,경기,포천시,0,0,0,0,0,0,2018-03-08
2943,경기,포천시,1,0,1,2,2,0,2018-04-08
2944,경기,포천시,3,4,0,7,2,0,2018-05-08
2945,경기,포천시,3,0,1,4,4,1,2018-06-08
2946,경기,포천시,1,0,0,1,1,0,2018-07-08
2947,경기,포천시,3,0,2,5,3,0,2018-08-08
2948,경기,포천시,3,0,1,4,2,0,2018-09-08
2949,경기,포천시,1,1,0,2,1,0,2018-10-08
2950,경기,포천시,1,0,4,5,2,0,2018-11-08
2951,경기,포천시,0,0,0,0,0,0,2018-12-08
2952,경기,하남시,3,1,1,5,4,0,2018-01-08
2953,경기,하남시,9,0,0,9,5,0,2018-02-08
2954,경기,하남시,1,0,2,3,3,0,2018-03-08
2955,경기,하남시,1,0,0,1,1,0,2018-04-08
2956,경기,하남시,3,0,0,3,2,0,2018-05-08
2957,경기,하남시,1,1,2,4,4,0,2018-06-08
2958,경기,하남시,3,0,1,4,3,0,2018-07-08
2959,경기,하남시,0,0,1,1,1,0,2018-08-08
2960,경기,하남시,2,1,0,3,2,0,2018-09-08
2961,경기,하남시,2,1,0,3,3,0,2018-10-08
2962,경기,하남시,14,1,4,19,12,0,2018-11-08
2963,경기,하남시,3,1,1,5,4,0,2018-12-08
2964,경기,화성시,10,0,0,10,6,0,2018-01-08
2965,경기,화성시,17,2,2,21,14,0,2018-02-08
2966,경기,화성시,4,0,2,6,6,0,2018-03-08
2967,경기,화성시,7,0,1,8,6,0,2018-04-08
2968,경기,화성시,4,0,2,6,4,0,2018-05-08
2969,경기,화성시,11,1,2,14,9,0,2018-06-08
2970,경기,화성시,7,4,5,16,8,0,2018-07-08
2971,경기,화성시,35,1,9,45,15,0,2018-08-08
2972,경기,화성시,7,2,0,9,6,0,2018-09-08
2973,경기,화성시,4,0,2,6,6,0,2018-10-08
2974,경기,화성시,12,3,4,19,14,0,2018-11-08
2975,경기,화성시,14,1,1,16,6,0,2018-12-08
2976,경기,가평군,2,0,0,2,1,0,2018-01-09
2977,경기,가평군,0,0,0,0,0,0,2018-02-09
2978,경기,가평군,0,0,0,0,0,0,2018-03-09
2979,경기,가평군,3,2,2,7,5,1,2018-04-09
2980,경기,가평군,0,0,1,1,1,0,2018-05-09
2981,경기,가평군,2,1,1,4,1,0,2018-06-09
2982,경기,가평군,5,0,3,8,4,0,2018-07-09
2983,경기,가평군,0,0,1,1,1,0,2018-08-09
2984,경기,가평군,1,0,0,1,1,0,2018-09-09
2985,경기,가평군,1,0,0,1,1,0,2018-10-09
2986,경기,가평군,0,0,1,1,1,0,2018-11-09
2987,경기,가평군,1,2,0,3,2,0,2018-12-09
2988,경기,고양시,7,2,3,12,8,0,2018-01-09
2989,경기,고양시,13,3,3,19,17,0,2018-02-09
2990,경기,고양시,3,1,3,7,6,0,2018-03-09
2991,경기,고양시,6,2,1,9,7,0,2018-04-09
2992,경기,고양시,10,2,6,18,15,0,2018-05-09
2993,경기,고양시,15,1,2,18,13,0,2018-06-09
2994,경기,고양시,11,0,1,12,9,0,2018-07-09
2995,경기,고양시,12,1,9,22,14,1,2018-08-09
2996,경기,고양시,13,4,2,19,11,2,2018-09-09
2997,경기,고양시,15,0,0,15,8,0,2018-10-09
2998,경기,고양시,7,1,2,10,8,0,2018-11-09
2999,경기,고양시,7,0,2,9,5,0,2018-12-09
3000,경기,과천시,0,0,0,0,0,0,2018-01-09
3001,경기,과천시,1,0,0,1,1,0,2018-02-09
3002,경기,과천시,0,0,0,0,0,0,2018-03-09
3003,경기,과천시,1,0,1,2,1,0,2018-04-09
3004,경기,과천시,1,0,0,1,1,0,2018-05-09
3005,경기,과천시,0,0,0,0,0,0,2018-06-09
3006,경기,과천시,1,0,0,1,1,0,2018-07-09
3007,경기,과천시,1,0,0,1,1,0,2018-08-09
3008,경기,과천시,0,0,0,0,0,0,2018-09-09
3009,경기,과천시,0,0,0,0,0,0,2018-10-09
3010,경기,과천시,2,1,0,3,2,0,2018-11-09
3011,경기,과천시,0,0,0,0,0,0,2018-12-09
3012,경기,광명시,3,0,0,3,3,0,2018-01-09
3013,경기,광명시,4,4,0,8,6,0,2018-02-09
3014,경기,광명시,15,1,1,17,7,0,2018-03-09
3015,경기,광명시,6,0,0,6,4,0,2018-04-09
3016,경기,광명시,0,0,0,0,0,0,2018-05-09
3017,경기,광명시,5,2,0,7,3,0,2018-06-09
3018,경기,광명시,0,1,1,2,2,0,2018-07-09
3019,경기,광명시,1,1,0,2,2,0,2018-08-09
3020,경기,광명시,1,0,0,1,1,0,2018-09-09
3021,경기,광명시,0,0,0,0,0,0,2018-10-09
3022,경기,광명시,0,0,1,1,1,0,2018-11-09
3023,경기,광명시,2,2,0,4,3,0,2018-12-09
3024,경기,광주시,2,2,2,6,3,0,2018-01-09
3025,경기,광주시,5,0,4,9,6,0,2018-02-09
3026,경기,광주시,0,0,1,1,1,0,2018-03-09
3027,경기,광주시,4,0,1,5,4,0,2018-04-09
3028,경기,광주시,5,1,2,8,6,0,2018-05-09
3029,경기,광주시,1,0,2,3,3,0,2018-06-09
3030,경기,광주시,6,0,1,7,7,0,2018-07-09
3031,경기,광주시,11,1,0,12,5,0,2018-08-09
3032,경기,광주시,2,0,1,3,3,0,2018-09-09
3033,경기,광주시,3,4,0,7,2,0,2018-10-09
3034,경기,광주시,5,0,1,6,6,0,2018-11-09
3035,경기,광주시,3,1,0,4,3,0,2018-12-09
3036,경기,구리시,0,0,1,1,1,0,2018-01-09
3037,경기,구리시,2,0,0,2,1,0,2018-02-09
3038,경기,구리시,0,0,0,0,0,0,2018-03-09
3039,경기,구리시,4,0,1,5,4,0,2018-04-09
3040,경기,구리시,2,0,3,5,3,0,2018-05-09
3041,경기,구리시,2,0,0,2,2,0,2018-06-09
3042,경기,구리시,1,0,0,1,1,0,2018-07-09
3043,경기,구리시,1,0,0,1,1,0,2018-08-09
3044,경기,구리시,3,0,0,3,1,0,2018-09-09
3045,경기,구리시,2,0,0,2,2,0,2018-10-09
3046,경기,구리시,5,3,3,11,8,0,2018-11-09
3047,경기,구리시,2,1,0,3,2,0,2018-12-09
3048,경기,군포시,0,0,0,0,0,0,2018-01-09
3049,경기,군포시,0,0,0,0,0,0,2018-02-09
3050,경기,군포시,0,2,1,3,2,0,2018-03-09
3051,경기,군포시,1,0,0,1,1,0,2018-04-09
3052,경기,군포시,1,1,0,2,2,0,2018-05-09
3053,경기,군포시,1,0,1,2,2,0,2018-06-09
3054,경기,군포시,2,1,0,3,3,0,2018-07-09
3055,경기,군포시,0,0,0,0,1,1,2018-08-09
3056,경기,군포시,4,1,1,6,4,0,2018-09-09
3057,경기,군포시,1,0,1,2,2,0,2018-10-09
3058,경기,군포시,1,0,0,1,1,0,2018-11-09
3059,경기,군포시,1,0,0,1,1,0,2018-12-09
3060,경기,김포시,1,2,2,5,4,0,2018-01-09
3061,경기,김포시,4,0,1,5,3,0,2018-02-09
3062,경기,김포시,0,0,3,3,3,0,2018-03-09
3063,경기,김포시,10,0,0,10,4,0,2018-04-09
3064,경기,김포시,3,0,1,4,3,0,2018-05-09
3065,경기,김포시,6,0,4,10,5,0,2018-06-09
3066,경기,김포시,6,1,0,7,6,0,2018-07-09
3067,경기,김포시,9,1,4,14,9,0,2018-08-09
3068,경기,김포시,7,0,2,9,6,0,2018-09-09
3069,경기,김포시,8,0,1,9,5,0,2018-10-09
3070,경기,김포시,12,2,2,16,13,0,2018-11-09
3071,경기,김포시,7,2,0,9,6,0,2018-12-09
3072,경기,남양주시,5,0,4,9,7,0,2018-01-09
3073,경기,남양주시,18,1,2,21,15,0,2018-02-09
3074,경기,남양주시,6,1,3,10,6,0,2018-03-09
3075,경기,남양주시,12,1,2,15,10,0,2018-04-09
3076,경기,남양주시,5,1,5,11,10,0,2018-05-09
3077,경기,남양주시,14,1,4,19,9,1,2018-06-09
3078,경기,남양주시,8,1,2,11,4,0,2018-07-09
3079,경기,남양주시,20,2,6,28,10,0,2018-08-09
3080,경기,남양주시,16,4,2,22,11,1,2018-09-09
3081,경기,남양주시,5,1,1,7,4,0,2018-10-09
3082,경기,남양주시,8,0,1,9,7,0,2018-11-09
3083,경기,남양주시,4,0,0,4,2,0,2018-12-09
3084,경기,동두천시,0,0,1,1,1,0,2018-01-09
3085,경기,동두천시,0,0,0,0,0,0,2018-02-09
3086,경기,동두천시,0,0,0,0,0,0,2018-03-09
3087,경기,동두천시,0,0,0,0,0,0,2018-04-09
3088,경기,동두천시,0,0,0,0,0,0,2018-05-09
3089,경기,동두천시,6,0,0,6,2,0,2018-06-09
3090,경기,동두천시,1,0,0,1,1,0,2018-07-09
3091,경기,동두천시,0,0,0,0,0,0,2018-08-09
3092,경기,동두천시,2,0,0,2,2,0,2018-09-09
3093,경기,동두천시,0,0,0,0,0,0,2018-10-09
3094,경기,동두천시,2,0,1,3,1,0,2018-11-09
3095,경기,동두천시,0,0,0,0,0,0,2018-12-09
3096,경기,부천시,9,2,2,13,6,0,2018-01-09
3097,경기,부천시,12,1,2,15,10,0,2018-02-09
3098,경기,부천시,13,2,8,23,7,0,2018-03-09
3099,경기,부천시,5,0,3,8,7,0,2018-04-09
3100,경기,부천시,5,2,2,9,7,0,2018-05-09
3101,경기,부천시,7,0,0,7,7,0,2018-06-09
3102,경기,부천시,11,2,0,13,10,0,2018-07-09
3103,경기,부천시,12,0,0,12,8,0,2018-08-09
3104,경기,부천시,10,1,1,12,10,1,2018-09-09
3105,경기,부천시,3,0,5,8,6,0,2018-10-09
3106,경기,부천시,15,2,3,20,12,0,2018-11-09
3107,경기,부천시,5,0,3,8,5,0,2018-12-09
3108,경기,성남시,24,3,6,33,17,0,2018-01-09
3109,경기,성남시,17,2,8,27,15,0,2018-02-09
3110,경기,성남시,6,1,1,8,5,0,2018-03-09
3111,경기,성남시,2,1,5,8,6,0,2018-04-09
3112,경기,성남시,4,0,2,6,5,0,2018-05-09
3113,경기,성남시,5,0,7,12,10,0,2018-06-09
3114,경기,성남시,7,1,1,9,7,0,2018-07-09
3115,경기,성남시,8,3,2,13,6,0,2018-08-09
3116,경기,성남시,14,2,7,23,12,0,2018-09-09
3117,경기,성남시,9,2,2,13,11,0,2018-10-09
3118,경기,성남시,21,2,12,35,18,0,2018-11-09
3119,경기,성남시,8,2,2,12,7,0,2018-12-09
3120,경기,수원시,9,0,3,12,10,0,2018-01-09
3121,경기,수원시,33,8,6,47,30,0,2018-02-09
3122,경기,수원시,6,0,4,10,9,0,2018-03-09
3123,경기,수원시,7,0,1,8,8,0,2018-04-09
3124,경기,수원시,23,2,6,31,20,0,2018-05-09
3125,경기,수원시,16,4,6,26,19,0,2018-06-09
3126,경기,수원시,17,5,7,29,22,0,2018-07-09
3127,경기,수원시,6,4,1,11,11,1,2018-08-09
3128,경기,수원시,11,3,4,18,9,0,2018-09-09
3129,경기,수원시,11,0,2,13,11,1,2018-10-09
3130,경기,수원시,13,1,4,18,13,0,2018-11-09
3131,경기,수원시,13,6,4,23,15,1,2018-12-09
3132,경기,시흥시,1,0,1,2,2,0,2018-01-09
3133,경기,시흥시,5,1,2,8,5,1,2018-02-09
3134,경기,시흥시,5,3,2,10,7,0,2018-03-09
3135,경기,시흥시,9,1,3,13,11,1,2018-04-09
3136,경기,시흥시,6,0,1,7,4,0,2018-05-09
3137,경기,시흥시,5,1,1,7,8,1,2018-06-09
3138,경기,시흥시,5,0,0,5,4,0,2018-07-09
3139,경기,시흥시,6,5,3,14,11,1,2018-08-09
3140,경기,시흥시,5,1,3,9,6,0,2018-09-09
3141,경기,시흥시,1,0,0,1,1,0,2018-10-09
3142,경기,시흥시,4,0,3,7,6,0,2018-11-09
3143,경기,시흥시,1,0,0,1,1,0,2018-12-09
3144,경기,안산시,25,0,9,34,21,0,2018-01-09
3145,경기,안산시,11,2,1,14,11,0,2018-02-09
3146,경기,안산시,7,0,0,7,6,0,2018-03-09
3147,경기,안산시,11,0,6,17,13,1,2018-04-09
3148,경기,안산시,10,1,3,14,8,1,2018-05-09
3149,경기,안산시,9,0,1,10,8,0,2018-06-09
3150,경기,안산시,6,1,5,12,9,0,2018-07-09
3151,경기,안산시,7,0,3,10,7,0,2018-08-09
3152,경기,안산시,9,0,6,15,8,0,2018-09-09
3153,경기,안산시,6,0,1,7,6,0,2018-10-09
3154,경기,안산시,12,0,5,17,14,0,2018-11-09
3155,경기,안산시,2,0,1,3,3,0,2018-12-09
3156,경기,안성시,3,1,3,7,2,0,2018-01-09
3157,경기,안성시,0,0,2,2,2,0,2018-02-09
3158,경기,안성시,5,0,4,9,4,0,2018-03-09
3159,경기,안성시,3,0,0,3,2,0,2018-04-09
3160,경기,안성시,1,1,0,2,1,0,2018-05-09
3161,경기,안성시,2,0,1,3,3,0,2018-06-09
3162,경기,안성시,5,0,0,5,2,0,2018-07-09
3163,경기,안성시,0,0,0,0,0,0,2018-08-09
3164,경기,안성시,0,0,0,0,0,0,2018-09-09
3165,경기,안성시,1,0,0,1,1,0,2018-10-09
3166,경기,안성시,0,1,1,2,2,0,2018-11-09
3167,경기,안성시,4,0,1,5,4,0,2018-12-09
3168,경기,안양시,10,0,1,11,7,0,2018-01-09
3169,경기,안양시,5,0,3,8,6,0,2018-02-09
3170,경기,안양시,4,0,1,5,6,1,2018-03-09
3171,경기,안양시,2,0,2,4,4,0,2018-04-09
3172,경기,안양시,4,0,0,4,3,0,2018-05-09
3173,경기,안양시,8,1,3,12,6,0,2018-06-09
3174,경기,안양시,2,0,2,4,3,0,2018-07-09
3175,경기,안양시,3,0,0,3,3,0,2018-08-09
3176,경기,안양시,0,0,2,2,2,0,2018-09-09
3177,경기,안양시,2,0,4,6,5,0,2018-10-09
3178,경기,안양시,5,1,1,7,5,0,2018-11-09
3179,경기,안양시,8,0,2,10,6,0,2018-12-09
3180,경기,양주시,2,0,1,3,4,1,2018-01-09
3181,경기,양주시,3,0,1,4,3,0,2018-02-09
3182,경기,양주시,2,0,0,2,2,0,2018-03-09
3183,경기,양주시,5,0,2,7,6,0,2018-04-09
3184,경기,양주시,4,0,0,4,3,0,2018-05-09
3185,경기,양주시,12,0,3,15,6,0,2018-06-09
3186,경기,양주시,4,0,4,8,5,0,2018-07-09
3187,경기,양주시,1,0,0,1,1,0,2018-08-09
3188,경기,양주시,4,0,3,7,5,0,2018-09-09
3189,경기,양주시,2,0,3,5,4,0,2018-10-09
3190,경기,양주시,2,0,1,3,3,0,2018-11-09
3191,경기,양주시,0,0,3,3,2,0,2018-12-09
3192,경기,양평군,0,0,0,0,0,0,2018-01-09
3193,경기,양평군,5,0,2,7,1,0,2018-02-09
3194,경기,양평군,0,0,0,0,0,0,2018-03-09
3195,경기,양평군,3,1,0,4,1,0,2018-04-09
3196,경기,양평군,2,0,0,2,2,0,2018-05-09
3197,경기,양평군,1,0,1,2,2,0,2018-06-09
3198,경기,양평군,4,0,1,5,4,0,2018-07-09
3199,경기,양평군,1,0,1,2,1,0,2018-08-09
3200,경기,양평군,0,0,0,0,0,0,2018-09-09
3201,경기,양평군,1,0,3,4,3,0,2018-10-09
3202,경기,양평군,0,2,0,2,1,0,2018-11-09
3203,경기,양평군,1,0,0,1,1,0,2018-12-09
3204,경기,여주시,1,0,0,1,2,1,2018-01-09
3205,경기,여주시,6,0,1,7,2,0,2018-02-09
3206,경기,여주시,0,0,0,0,0,0,2018-03-09
3207,경기,여주시,5,0,0,5,1,0,2018-04-09
3208,경기,여주시,0,0,0,0,0,0,2018-05-09
3209,경기,여주시,0,0,0,0,0,0,2018-06-09
3210,경기,여주시,0,0,0,0,0,0,2018-07-09
3211,경기,여주시,0,0,0,0,0,0,2018-08-09
3212,경기,여주시,0,0,1,1,1,0,2018-09-09
3213,경기,여주시,0,0,0,0,0,0,2018-10-09
3214,경기,여주시,7,3,2,12,5,0,2018-11-09
3215,경기,여주시,3,0,0,3,2,0,2018-12-09
3216,경기,연천군,2,0,0,2,1,0,2018-01-09
3217,경기,연천군,1,0,0,1,1,0,2018-02-09
3218,경기,연천군,2,0,0,2,2,0,2018-03-09
3219,경기,연천군,0,0,0,0,0,0,2018-04-09
3220,경기,연천군,0,0,0,0,0,0,2018-05-09
3221,경기,연천군,0,0,0,0,0,0,2018-06-09
3222,경기,연천군,0,0,0,0,0,0,2018-07-09
3223,경기,연천군,0,0,0,0,0,0,2018-08-09
3224,경기,연천군,0,0,0,0,0,0,2018-09-09
3225,경기,연천군,1,0,0,1,1,0,2018-10-09
3226,경기,연천군,0,0,0,0,0,0,2018-11-09
3227,경기,연천군,0,0,0,0,0,0,2018-12-09
3228,경기,오산시,5,2,4,11,6,0,2018-01-09
3229,경기,오산시,4,1,0,5,4,0,2018-02-09
3230,경기,오산시,2,1,0,3,3,0,2018-03-09
3231,경기,오산시,0,0,0,0,0,0,2018-04-09
3232,경기,오산시,2,0,1,3,2,0,2018-05-09
3233,경기,오산시,1,1,3,5,2,0,2018-06-09
3234,경기,오산시,7,1,1,9,5,0,2018-07-09
3235,경기,오산시,1,0,0,1,1,0,2018-08-09
3236,경기,오산시,3,0,0,3,3,0,2018-09-09
3237,경기,오산시,0,0,0,0,0,0,2018-10-09
3238,경기,오산시,4,1,1,6,5,0,2018-11-09
3239,경기,오산시,1,0,0,1,1,0,2018-12-09
3240,경기,용인시,13,1,6,20,10,0,2018-01-09
3241,경기,용인시,21,0,2,23,12,0,2018-02-09
3242,경기,용인시,3,3,0,6,6,1,2018-03-09
3243,경기,용인시,15,4,4,23,13,0,2018-04-09
3244,경기,용인시,2,5,3,10,7,0,2018-05-09
3245,경기,용인시,10,2,2,14,9,0,2018-06-09
3246,경기,용인시,5,0,0,5,5,0,2018-07-09
3247,경기,용인시,6,3,5,14,8,0,2018-08-09
3248,경기,용인시,4,3,2,9,7,1,2018-09-09
3249,경기,용인시,6,2,5,13,7,0,2018-10-09
3250,경기,용인시,7,1,3,11,11,0,2018-11-09
3251,경기,용인시,13,1,2,16,8,0,2018-12-09
3252,경기,의왕시,2,0,0,2,2,0,2018-01-09
3253,경기,의왕시,1,0,0,1,1,0,2018-02-09
3254,경기,의왕시,0,0,1,1,1,0,2018-03-09
3255,경기,의왕시,1,0,0,1,1,0,2018-04-09
3256,경기,의왕시,0,0,0,0,0,0,2018-05-09
3257,경기,의왕시,1,1,0,2,2,0,2018-06-09
3258,경기,의왕시,1,0,0,1,1,0,2018-07-09
3259,경기,의왕시,3,0,2,5,3,0,2018-08-09
3260,경기,의왕시,0,0,0,0,0,0,2018-09-09
3261,경기,의왕시,0,0,0,0,0,0,2018-10-09
3262,경기,의왕시,0,0,0,0,0,0,2018-11-09
3263,경기,의왕시,7,0,0,7,5,0,2018-12-09
3264,경기,의정부시,7,0,0,7,4,0,2018-01-09
3265,경기,의정부시,6,0,2,8,7,0,2018-02-09
3266,경기,의정부시,4,0,3,7,5,0,2018-03-09
3267,경기,의정부시,3,0,2,5,5,0,2018-04-09
3268,경기,의정부시,4,0,2,6,5,0,2018-05-09
3269,경기,의정부시,4,0,2,6,5,0,2018-06-09
3270,경기,의정부시,2,1,2,5,5,0,2018-07-09
3271,경기,의정부시,7,0,1,8,2,0,2018-08-09
3272,경기,의정부시,2,5,2,9,4,0,2018-09-09
3273,경기,의정부시,12,0,3,15,10,0,2018-10-09
3274,경기,의정부시,5,0,1,6,5,0,2018-11-09
3275,경기,의정부시,1,0,0,1,1,0,2018-12-09
3276,경기,이천시,2,0,5,7,3,0,2018-01-09
3277,경기,이천시,2,0,1,3,2,0,2018-02-09
3278,경기,이천시,2,0,3,5,4,0,2018-03-09
3279,경기,이천시,4,0,1,5,3,0,2018-04-09
3280,경기,이천시,0,0,0,0,0,0,2018-05-09
3281,경기,이천시,9,1,1,11,4,0,2018-06-09
3282,경기,이천시,0,0,0,0,0,0,2018-07-09
3283,경기,이천시,3,0,0,3,2,0,2018-08-09
3284,경기,이천시,1,0,0,1,1,0,2018-09-09
3285,경기,이천시,6,0,0,6,4,0,2018-10-09
3286,경기,이천시,4,0,2,6,5,0,2018-11-09
3287,경기,이천시,2,0,0,2,1,0,2018-12-09
3288,경기,파주시,3,0,0,3,3,0,2018-01-09
3289,경기,파주시,8,0,0,8,4,0,2018-02-09
3290,경기,파주시,3,0,0,3,3,0,2018-03-09
3291,경기,파주시,2,0,4,6,5,0,2018-04-09
3292,경기,파주시,3,1,4,8,5,0,2018-05-09
3293,경기,파주시,2,0,4,6,5,0,2018-06-09
3294,경기,파주시,3,0,1,4,3,0,2018-07-09
3295,경기,파주시,2,1,0,3,2,0,2018-08-09
3296,경기,파주시,1,0,3,4,2,0,2018-09-09
3297,경기,파주시,2,1,0,3,2,0,2018-10-09
3298,경기,파주시,3,1,2,6,6,0,2018-11-09
3299,경기,파주시,7,0,2,9,3,0,2018-12-09
3300,경기,평택시,15,2,4,21,11,0,2018-01-09
3301,경기,평택시,15,0,3,18,14,0,2018-02-09
3302,경기,평택시,42,2,4,48,16,0,2018-03-09
3303,경기,평택시,3,1,1,5,4,0,2018-04-09
3304,경기,평택시,14,2,5,21,13,0,2018-05-09
3305,경기,평택시,8,1,3,12,6,0,2018-06-09
3306,경기,평택시,13,0,1,14,9,0,2018-07-09
3307,경기,평택시,15,6,5,26,16,0,2018-08-09
3308,경기,평택시,21,4,2,27,11,1,2018-09-09
3309,경기,평택시,9,0,0,9,3,0,2018-10-09
3310,경기,평택시,8,2,2,12,10,1,2018-11-09
3311,경기,평택시,5,1,2,8,6,0,2018-12-09
3312,경기,포천시,5,5,3,13,7,1,2018-01-09
3313,경기,포천시,1,0,0,1,1,0,2018-02-09
3314,경기,포천시,2,5,0,7,3,0,2018-03-09
3315,경기,포천시,0,0,7,7,2,1,2018-04-09
3316,경기,포천시,2,1,0,3,1,0,2018-05-09
3317,경기,포천시,0,0,0,0,0,0,2018-06-09
3318,경기,포천시,1,0,0,1,1,0,2018-07-09
3319,경기,포천시,1,0,1,2,1,0,2018-08-09
3320,경기,포천시,11,0,0,11,3,0,2018-09-09
3321,경기,포천시,1,1,1,3,3,0,2018-10-09
3322,경기,포천시,0,0,0,0,1,1,2018-11-09
3323,경기,포천시,0,0,0,0,0,0,2018-12-09
3324,경기,하남시,1,0,1,2,2,0,2018-01-09
3325,경기,하남시,1,0,1,2,2,0,2018-02-09
3326,경기,하남시,3,0,0,3,2,0,2018-03-09
3327,경기,하남시,1,0,2,3,3,0,2018-04-09
3328,경기,하남시,5,1,1,7,4,1,2018-05-09
3329,경기,하남시,2,0,2,4,3,0,2018-06-09
3330,경기,하남시,3,0,3,6,4,0,2018-07-09
3331,경기,하남시,0,1,1,2,2,0,2018-08-09
3332,경기,하남시,2,0,0,2,1,0,2018-09-09
3333,경기,하남시,1,0,0,1,1,0,2018-10-09
3334,경기,하남시,0,0,0,0,0,0,2018-11-09
3335,경기,하남시,1,1,0,2,2,0,2018-12-09
3336,경기,화성시,10,1,5,16,13,1,2018-01-09
3337,경기,화성시,9,1,1,11,10,1,2018-02-09
3338,경기,화성시,7,2,0,9,5,0,2018-03-09
3339,경기,화성시,5,0,1,6,5,0,2018-04-09
3340,경기,화성시,15,3,4,22,12,0,2018-05-09
3341,경기,화성시,2,0,3,5,5,0,2018-06-09
3342,경기,화성시,8,0,3,11,9,1,2018-07-09
3343,경기,화성시,9,0,1,10,6,1,2018-08-09
3344,경기,화성시,11,0,0,11,6,0,2018-09-09
3345,경기,화성시,6,1,0,7,7,2,2018-10-09
3346,경기,화성시,23,27,8,58,12,0,2018-11-09
3347,경기,화성시,5,0,2,7,5,0,2018-12-09
3348,경기,가평군,0,0,2,2,2,0,2018-01-10
3349,경기,가평군,0,0,1,1,1,0,2018-02-10
3350,경기,가평군,1,0,0,1,1,0,2018-03-10
3351,경기,가평군,0,0,0,0,0,0,2018-04-10
3352,경기,가평군,1,0,0,1,1,0,2018-05-10
3353,경기,가평군,0,0,1,1,1,0,2018-06-10
3354,경기,가평군,0,0,0,0,0,0,2018-07-10
3355,경기,가평군,0,0,0,0,0,0,2018-08-10
3356,경기,가평군,1,0,0,1,1,0,2018-09-10
3357,경기,가평군,2,0,0,2,1,0,2018-10-10
3358,경기,가평군,6,0,1,7,2,0,2018-11-10
3359,경기,가평군,0,0,0,0,0,0,2018-12-10
3360,경기,고양시,29,3,7,39,23,0,2018-01-10
3361,경기,고양시,12,1,3,16,11,0,2018-02-10
3362,경기,고양시,15,3,4,22,14,0,2018-03-10
3363,경기,고양시,20,2,4,26,18,0,2018-04-10
3364,경기,고양시,6,2,1,9,7,0,2018-05-10
3365,경기,고양시,13,3,4,20,13,0,2018-06-10
3366,경기,고양시,6,1,5,12,10,0,2018-07-10
3367,경기,고양시,12,0,1,13,9,1,2018-08-10
3368,경기,고양시,7,3,8,18,15,0,2018-09-10
3369,경기,고양시,4,1,3,8,8,0,2018-10-10
3370,경기,고양시,27,2,13,42,26,0,2018-11-10
3371,경기,고양시,5,2,1,8,7,0,2018-12-10
3372,경기,과천시,3,0,0,3,1,0,2018-01-10
3373,경기,과천시,0,0,0,0,0,0,2018-02-10
3374,경기,과천시,0,0,0,0,0,0,2018-03-10
3375,경기,과천시,2,1,3,6,2,0,2018-04-10
3376,경기,과천시,2,0,0,2,1,0,2018-05-10
3377,경기,과천시,0,0,0,0,0,0,2018-06-10
3378,경기,과천시,0,1,1,2,2,0,2018-07-10
3379,경기,과천시,0,0,1,1,1,0,2018-08-10
3380,경기,과천시,0,0,0,0,0,0,2018-09-10
3381,경기,과천시,0,0,0,0,0,0,2018-10-10
3382,경기,과천시,0,0,0,0,0,0,2018-11-10
3383,경기,과천시,0,1,0,1,1,0,2018-12-10
3384,경기,광명시,6,1,1,8,5,0,2018-01-10
3385,경기,광명시,4,0,3,7,6,1,2018-02-10
3386,경기,광명시,4,0,2,6,5,0,2018-03-10
3387,경기,광명시,3,3,4,10,6,0,2018-04-10
3388,경기,광명시,4,1,1,6,4,0,2018-05-10
3389,경기,광명시,6,3,2,11,5,0,2018-06-10
3390,경기,광명시,0,0,1,1,1,0,2018-07-10
3391,경기,광명시,9,0,0,9,5,0,2018-08-10
3392,경기,광명시,4,2,0,6,4,0,2018-09-10
3393,경기,광명시,3,3,1,7,6,0,2018-10-10
3394,경기,광명시,7,1,0,8,6,0,2018-11-10
3395,경기,광명시,5,0,1,6,6,0,2018-12-10
3396,경기,광주시,4,0,0,4,4,0,2018-01-10
3397,경기,광주시,0,0,0,0,0,0,2018-02-10
3398,경기,광주시,1,0,0,1,1,0,2018-03-10
3399,경기,광주시,5,1,1,7,6,0,2018-04-10
3400,경기,광주시,1,0,0,1,1,0,2018-05-10
3401,경기,광주시,1,0,1,2,2,0,2018-06-10
3402,경기,광주시,2,0,1,3,3,0,2018-07-10
3403,경기,광주시,15,0,1,16,10,0,2018-08-10
3404,경기,광주시,15,0,1,16,7,0,2018-09-10
3405,경기,광주시,6,0,1,7,6,0,2018-10-10
3406,경기,광주시,7,0,3,10,6,0,2018-11-10
3407,경기,광주시,7,0,1,8,5,0,2018-12-10
3408,경기,구리시,3,0,0,3,3,0,2018-01-10
3409,경기,구리시,0,0,1,1,1,0,2018-02-10
3410,경기,구리시,0,0,0,0,0,0,2018-03-10
3411,경기,구리시,7,0,1,8,4,0,2018-04-10
3412,경기,구리시,3,0,0,3,2,0,2018-05-10
3413,경기,구리시,2,0,2,4,2,0,2018-06-10
3414,경기,구리시,4,0,4,8,5,0,2018-07-10
3415,경기,구리시,2,0,0,2,2,0,2018-08-10
3416,경기,구리시,0,0,0,0,0,0,2018-09-10
3417,경기,구리시,0,0,1,1,1,0,2018-10-10
3418,경기,구리시,3,1,0,4,3,0,2018-11-10
3419,경기,구리시,1,0,0,1,1,0,2018-12-10
3420,경기,군포시,0,0,0,0,0,0,2018-01-10
3421,경기,군포시,6,0,0,6,3,0,2018-02-10
3422,경기,군포시,2,0,1,3,1,0,2018-03-10
3423,경기,군포시,0,0,0,0,0,0,2018-04-10
3424,경기,군포시,3,0,0,3,3,0,2018-05-10
3425,경기,군포시,1,0,1,2,2,0,2018-06-10
3426,경기,군포시,0,1,0,1,1,0,2018-07-10
3427,경기,군포시,1,0,1,2,2,0,2018-08-10
3428,경기,군포시,2,3,3,8,4,0,2018-09-10
3429,경기,군포시,2,0,0,2,2,0,2018-10-10
3430,경기,군포시,2,1,0,3,3,0,2018-11-10
3431,경기,군포시,2,0,2,4,3,0,2018-12-10
3432,경기,김포시,6,0,3,9,8,0,2018-01-10
3433,경기,김포시,7,0,1,8,4,0,2018-02-10
3434,경기,김포시,3,0,4,7,6,0,2018-03-10
3435,경기,김포시,5,0,0,5,3,0,2018-04-10
3436,경기,김포시,8,1,1,10,8,0,2018-05-10
3437,경기,김포시,0,0,1,1,1,0,2018-06-10
3438,경기,김포시,14,0,0,14,5,0,2018-07-10
3439,경기,김포시,7,0,2,9,6,0,2018-08-10
3440,경기,김포시,2,0,1,3,2,0,2018-09-10
3441,경기,김포시,1,1,0,2,2,0,2018-10-10
3442,경기,김포시,7,1,4,12,8,0,2018-11-10
3443,경기,김포시,12,1,4,17,8,0,2018-12-10
3444,경기,남양주시,9,1,0,10,7,0,2018-01-10
3445,경기,남양주시,5,0,2,7,5,0,2018-02-10
3446,경기,남양주시,1,1,1,3,3,0,2018-03-10
3447,경기,남양주시,13,0,3,16,7,0,2018-04-10
3448,경기,남양주시,12,0,3,15,12,0,2018-05-10
3449,경기,남양주시,12,1,2,15,9,0,2018-06-10
3450,경기,남양주시,6,1,2,9,7,0,2018-07-10
3451,경기,남양주시,9,4,2,15,8,0,2018-08-10
3452,경기,남양주시,6,0,3,9,8,0,2018-09-10
3453,경기,남양주시,4,1,0,5,4,0,2018-10-10
3454,경기,남양주시,8,0,0,8,5,0,2018-11-10
3455,경기,남양주시,9,1,1,11,10,0,2018-12-10
3456,경기,동두천시,1,0,1,2,2,1,2018-01-10
3457,경기,동두천시,0,0,1,1,1,0,2018-02-10
3458,경기,동두천시,1,0,0,1,1,0,2018-03-10
3459,경기,동두천시,0,0,2,2,2,0,2018-04-10
3460,경기,동두천시,1,1,2,4,3,1,2018-05-10
3461,경기,동두천시,0,0,0,0,1,1,2018-06-10
3462,경기,동두천시,3,0,0,3,1,0,2018-07-10
3463,경기,동두천시,0,0,1,1,1,0,2018-08-10
3464,경기,동두천시,0,0,1,1,1,0,2018-09-10
3465,경기,동두천시,0,0,0,0,0,0,2018-10-10
3466,경기,동두천시,1,0,0,1,1,0,2018-11-10
3467,경기,동두천시,0,0,0,0,0,0,2018-12-10
3468,경기,부천시,5,1,3,9,7,0,2018-01-10
3469,경기,부천시,2,0,2,4,4,0,2018-02-10
3470,경기,부천시,14,0,2,16,11,0,2018-03-10
3471,경기,부천시,5,1,6,12,9,0,2018-04-10
3472,경기,부천시,11,0,1,12,8,0,2018-05-10
3473,경기,부천시,6,1,0,7,4,0,2018-06-10
3474,경기,부천시,14,1,4,19,17,0,2018-07-10
3475,경기,부천시,11,0,2,13,10,0,2018-08-10
3476,경기,부천시,8,4,2,14,8,0,2018-09-10
3477,경기,부천시,7,0,4,11,11,0,2018-10-10
3478,경기,부천시,18,7,1,26,14,0,2018-11-10
3479,경기,부천시,2,1,5,8,7,0,2018-12-10
3480,경기,성남시,23,0,6,29,22,3,2018-01-10
3481,경기,성남시,20,0,3,23,12,0,2018-02-10
3482,경기,성남시,16,0,5,21,12,0,2018-03-10
3483,경기,성남시,17,5,6,28,18,1,2018-04-10
3484,경기,성남시,16,1,1,18,11,0,2018-05-10
3485,경기,성남시,2,2,3,7,6,0,2018-06-10
3486,경기,성남시,15,0,2,17,13,0,2018-07-10
3487,경기,성남시,10,1,4,15,10,0,2018-08-10
3488,경기,성남시,6,3,2,11,7,0,2018-09-10
3489,경기,성남시,10,2,5,17,10,1,2018-10-10
3490,경기,성남시,9,3,0,12,8,0,2018-11-10
3491,경기,성남시,7,2,1,10,8,0,2018-12-10
3492,경기,수원시,16,2,4,22,16,0,2018-01-10
3493,경기,수원시,8,2,4,14,12,0,2018-02-10
3494,경기,수원시,15,0,6,21,13,0,2018-03-10
3495,경기,수원시,17,0,6,23,16,1,2018-04-10
3496,경기,수원시,11,1,4,16,15,0,2018-05-10
3497,경기,수원시,11,0,4,15,9,0,2018-06-10
3498,경기,수원시,14,3,3,20,13,0,2018-07-10
3499,경기,수원시,7,1,0,8,6,0,2018-08-10
3500,경기,수원시,12,4,5,21,14,0,2018-09-10
3501,경기,수원시,8,0,3,11,9,0,2018-10-10
3502,경기,수원시,18,3,6,27,20,0,2018-11-10
3503,경기,수원시,14,1,5,20,12,0,2018-12-10
3504,경기,시흥시,2,1,1,4,4,0,2018-01-10
3505,경기,시흥시,5,0,0,5,4,0,2018-02-10
3506,경기,시흥시,5,0,1,6,5,0,2018-03-10
3507,경기,시흥시,5,0,0,5,4,0,2018-04-10
3508,경기,시흥시,13,0,0,13,5,0,2018-05-10
3509,경기,시흥시,4,0,2,6,5,0,2018-06-10
3510,경기,시흥시,5,2,1,8,7,0,2018-07-10
3511,경기,시흥시,10,1,1,12,9,0,2018-08-10
3512,경기,시흥시,14,2,2,18,14,0,2018-09-10
3513,경기,시흥시,14,3,6,23,12,0,2018-10-10
3514,경기,시흥시,5,2,0,7,6,0,2018-11-10
3515,경기,시흥시,10,1,0,11,7,0,2018-12-10
3516,경기,안산시,22,1,4,27,20,2,2018-01-10
3517,경기,안산시,14,0,4,18,12,0,2018-02-10
3518,경기,안산시,25,0,1,26,8,0,2018-03-10
3519,경기,안산시,4,0,0,4,4,0,2018-04-10
3520,경기,안산시,9,1,3,13,11,0,2018-05-10
3521,경기,안산시,4,1,2,7,6,0,2018-06-10
3522,경기,안산시,17,1,3,21,13,0,2018-07-10
3523,경기,안산시,14,1,3,18,12,0,2018-08-10
3524,경기,안산시,21,3,4,28,17,0,2018-09-10
3525,경기,안산시,9,1,3,13,10,0,2018-10-10
3526,경기,안산시,16,2,4,22,15,0,2018-11-10
3527,경기,안산시,8,1,2,11,7,0,2018-12-10
3528,경기,안성시,2,0,2,4,4,0,2018-01-10
3529,경기,안성시,7,0,1,8,3,0,2018-02-10
3530,경기,안성시,2,0,0,2,1,0,2018-03-10
3531,경기,안성시,2,0,1,3,3,0,2018-04-10
3532,경기,안성시,0,0,0,0,0,0,2018-05-10
3533,경기,안성시,3,0,2,5,2,0,2018-06-10
3534,경기,안성시,7,0,0,7,2,0,2018-07-10
3535,경기,안성시,3,1,2,6,4,0,2018-08-10
3536,경기,안성시,3,1,2,6,4,0,2018-09-10
3537,경기,안성시,4,0,0,4,4,0,2018-10-10
3538,경기,안성시,2,0,0,2,1,0,2018-11-10
3539,경기,안성시,6,0,1,7,5,0,2018-12-10
3540,경기,안양시,9,0,2,11,8,0,2018-01-10
3541,경기,안양시,6,0,0,6,4,0,2018-02-10
3542,경기,안양시,4,2,1,7,5,0,2018-03-10
3543,경기,안양시,3,0,0,3,2,0,2018-04-10
3544,경기,안양시,2,0,2,4,3,0,2018-05-10
3545,경기,안양시,5,0,0,5,3,0,2018-06-10
3546,경기,안양시,7,0,2,9,8,0,2018-07-10
3547,경기,안양시,4,0,2,6,3,0,2018-08-10
3548,경기,안양시,7,1,1,9,5,0,2018-09-10
3549,경기,안양시,6,0,0,6,5,0,2018-10-10
3550,경기,안양시,1,0,1,2,3,1,2018-11-10
3551,경기,안양시,7,0,1,8,6,0,2018-12-10
3552,경기,양주시,6,0,1,7,5,0,2018-01-10
3553,경기,양주시,3,0,3,6,4,0,2018-02-10
3554,경기,양주시,2,0,0,2,2,0,2018-03-10
3555,경기,양주시,3,0,0,3,2,0,2018-04-10
3556,경기,양주시,8,0,1,9,5,0,2018-05-10
3557,경기,양주시,3,1,1,5,4,0,2018-06-10
3558,경기,양주시,10,0,1,11,6,0,2018-07-10
3559,경기,양주시,5,0,2,7,3,0,2018-08-10
3560,경기,양주시,7,0,3,10,7,0,2018-09-10
3561,경기,양주시,2,0,1,3,3,0,2018-10-10
3562,경기,양주시,6,0,2,8,5,0,2018-11-10
3563,경기,양주시,5,0,1,6,6,0,2018-12-10
3564,경기,양평군,0,0,2,2,1,0,2018-01-10
3565,경기,양평군,2,1,1,4,2,0,2018-02-10
3566,경기,양평군,0,0,1,1,1,0,2018-03-10
3567,경기,양평군,0,0,0,0,0,0,2018-04-10
3568,경기,양평군,2,0,0,2,2,0,2018-05-10
3569,경기,양평군,2,0,1,3,1,0,2018-06-10
3570,경기,양평군,3,0,1,4,2,0,2018-07-10
3571,경기,양평군,0,0,0,0,0,0,2018-08-10
3572,경기,양평군,0,1,0,1,1,0,2018-09-10
3573,경기,양평군,1,0,1,2,1,0,2018-10-10
3574,경기,양평군,1,0,0,1,1,0,2018-11-10
3575,경기,양평군,2,1,0,3,2,0,2018-12-10
3576,경기,여주시,5,0,0,5,2,0,2018-01-10
3577,경기,여주시,2,0,0,2,1,0,2018-02-10
3578,경기,여주시,0,0,0,0,0,0,2018-03-10
3579,경기,여주시,0,0,2,2,1,1,2018-04-10
3580,경기,여주시,1,0,1,2,2,0,2018-05-10
3581,경기,여주시,0,0,1,1,1,0,2018-06-10
3582,경기,여주시,0,0,0,0,0,0,2018-07-10
3583,경기,여주시,0,0,0,0,0,0,2018-08-10
3584,경기,여주시,1,0,0,1,1,0,2018-09-10
3585,경기,여주시,1,0,1,2,2,0,2018-10-10
3586,경기,여주시,2,0,0,2,1,0,2018-11-10
3587,경기,여주시,2,0,2,4,2,0,2018-12-10
3588,경기,연천군,3,0,0,3,2,0,2018-01-10
3589,경기,연천군,1,0,0,1,1,0,2018-02-10
3590,경기,연천군,1,0,0,1,1,0,2018-03-10
3591,경기,연천군,0,0,0,0,0,0,2018-04-10
3592,경기,연천군,0,0,1,1,2,1,2018-05-10
3593,경기,연천군,1,0,0,1,1,0,2018-06-10
3594,경기,연천군,0,0,0,0,0,0,2018-07-10
3595,경기,연천군,0,0,0,0,0,0,2018-08-10
3596,경기,연천군,2,0,1,3,1,0,2018-09-10
3597,경기,연천군,0,0,0,0,0,0,2018-10-10
3598,경기,연천군,0,0,0,0,0,0,2018-11-10
3599,경기,연천군,2,0,0,2,1,0,2018-12-10
3600,경기,오산시,6,0,2,8,4,0,2018-01-10
3601,경기,오산시,6,1,1,8,5,0,2018-02-10
3602,경기,오산시,4,0,2,6,6,0,2018-03-10
3603,경기,오산시,7,0,1,8,6,0,2018-04-10
3604,경기,오산시,1,0,3,4,3,0,2018-05-10
3605,경기,오산시,0,0,0,0,0,0,2018-06-10
3606,경기,오산시,2,1,0,3,3,0,2018-07-10
3607,경기,오산시,1,0,1,2,2,0,2018-08-10
3608,경기,오산시,2,0,2,4,3,0,2018-09-10
3609,경기,오산시,3,0,1,4,2,0,2018-10-10
3610,경기,오산시,1,0,1,2,2,0,2018-11-10
3611,경기,오산시,2,0,0,2,1,0,2018-12-10
3612,경기,용인시,4,1,1,6,6,0,2018-01-10
3613,경기,용인시,5,3,6,14,11,1,2018-02-10
3614,경기,용인시,7,0,0,7,5,0,2018-03-10
3615,경기,용인시,11,4,5,20,13,0,2018-04-10
3616,경기,용인시,11,1,4,16,13,0,2018-05-10
3617,경기,용인시,9,0,2,11,7,0,2018-06-10
3618,경기,용인시,8,2,2,12,10,1,2018-07-10
3619,경기,용인시,9,8,2,19,10,0,2018-08-10
3620,경기,용인시,9,3,3,15,14,0,2018-09-10
3621,경기,용인시,4,1,4,9,8,0,2018-10-10
3622,경기,용인시,8,0,3,11,10,0,2018-11-10
3623,경기,용인시,5,0,0,5,4,0,2018-12-10
3624,경기,의왕시,5,0,6,11,4,0,2018-01-10
3625,경기,의왕시,5,0,0,5,2,0,2018-02-10
3626,경기,의왕시,1,1,0,2,2,0,2018-03-10
3627,경기,의왕시,6,0,4,10,5,0,2018-04-10
3628,경기,의왕시,0,0,0,0,0,0,2018-05-10
3629,경기,의왕시,0,0,0,0,0,0,2018-06-10
3630,경기,의왕시,0,0,1,1,1,0,2018-07-10
3631,경기,의왕시,2,0,1,3,3,0,2018-08-10
3632,경기,의왕시,0,0,0,0,0,0,2018-09-10
3633,경기,의왕시,1,0,0,1,1,0,2018-10-10
3634,경기,의왕시,3,1,0,4,4,0,2018-11-10
3635,경기,의왕시,1,0,0,1,1,0,2018-12-10
3636,경기,의정부시,13,1,1,15,9,0,2018-01-10
3637,경기,의정부시,7,0,0,7,3,1,2018-02-10
3638,경기,의정부시,1,0,1,2,2,0,2018-03-10
3639,경기,의정부시,5,0,1,6,6,0,2018-04-10
3640,경기,의정부시,7,3,0,10,8,0,2018-05-10
3641,경기,의정부시,10,2,0,12,6,0,2018-06-10
3642,경기,의정부시,1,0,0,1,1,0,2018-07-10
3643,경기,의정부시,5,1,1,7,4,0,2018-08-10
3644,경기,의정부시,5,1,0,6,6,0,2018-09-10
3645,경기,의정부시,3,0,0,3,3,0,2018-10-10
3646,경기,의정부시,0,1,0,1,1,0,2018-11-10
3647,경기,의정부시,2,0,0,2,3,1,2018-12-10
3648,경기,이천시,5,0,1,6,4,0,2018-01-10
3649,경기,이천시,2,0,1,3,3,0,2018-02-10
3650,경기,이천시,8,0,1,9,3,0,2018-03-10
3651,경기,이천시,1,1,0,2,2,0,2018-04-10
3652,경기,이천시,2,0,0,2,2,0,2018-05-10
3653,경기,이천시,4,2,1,7,3,0,2018-06-10
3654,경기,이천시,1,0,2,3,2,0,2018-07-10
3655,경기,이천시,4,0,1,5,5,0,2018-08-10
3656,경기,이천시,3,0,1,4,3,0,2018-09-10
3657,경기,이천시,4,0,0,4,2,0,2018-10-10
3658,경기,이천시,10,0,0,10,3,0,2018-11-10
3659,경기,이천시,8,0,0,8,4,0,2018-12-10
3660,경기,파주시,2,0,1,3,3,0,2018-01-10
3661,경기,파주시,10,0,0,10,6,0,2018-02-10
3662,경기,파주시,5,0,0,5,4,0,2018-03-10
3663,경기,파주시,5,0,1,6,5,0,2018-04-10
3664,경기,파주시,6,0,1,7,3,0,2018-05-10
3665,경기,파주시,3,0,3,6,4,0,2018-06-10
3666,경기,파주시,5,0,0,5,3,0,2018-07-10
3667,경기,파주시,2,0,2,4,4,1,2018-08-10
3668,경기,파주시,4,1,1,6,4,0,2018-09-10
3669,경기,파주시,2,0,0,2,3,1,2018-10-10
3670,경기,파주시,2,0,0,2,2,0,2018-11-10
3671,경기,파주시,8,0,2,10,6,0,2018-12-10
3672,경기,평택시,8,2,1,11,6,0,2018-01-10
3673,경기,평택시,7,1,6,14,8,1,2018-02-10
3674,경기,평택시,8,0,1,9,9,1,2018-03-10
3675,경기,평택시,9,1,7,17,12,0,2018-04-10
3676,경기,평택시,17,1,6,24,16,0,2018-05-10
3677,경기,평택시,10,3,3,16,8,0,2018-06-10
3678,경기,평택시,8,0,6,14,9,1,2018-07-10
3679,경기,평택시,8,4,6,18,13,0,2018-08-10
3680,경기,평택시,17,2,1,20,13,0,2018-09-10
3681,경기,평택시,1,2,2,5,5,0,2018-10-10
3682,경기,평택시,13,1,3,17,13,0,2018-11-10
3683,경기,평택시,17,0,0,17,9,0,2018-12-10
3684,경기,포천시,2,11,1,14,2,0,2018-01-10
3685,경기,포천시,3,1,2,6,4,0,2018-02-10
3686,경기,포천시,4,3,1,8,4,0,2018-03-10
3687,경기,포천시,10,1,1,12,6,0,2018-04-10
3688,경기,포천시,1,0,0,1,1,0,2018-05-10
3689,경기,포천시,2,1,1,4,3,1,2018-06-10
3690,경기,포천시,1,0,0,1,1,0,2018-07-10
3691,경기,포천시,1,0,1,2,2,0,2018-08-10
3692,경기,포천시,0,0,1,1,1,0,2018-09-10
3693,경기,포천시,3,0,0,3,3,0,2018-10-10
3694,경기,포천시,4,1,0,5,3,0,2018-11-10
3695,경기,포천시,5,1,2,8,3,0,2018-12-10
3696,경기,하남시,0,0,1,1,1,0,2018-01-10
3697,경기,하남시,7,0,1,8,4,0,2018-02-10
3698,경기,하남시,3,1,3,7,3,0,2018-03-10
3699,경기,하남시,3,0,2,5,5,0,2018-04-10
3700,경기,하남시,1,1,0,2,1,0,2018-05-10
3701,경기,하남시,0,0,1,1,1,0,2018-06-10
3702,경기,하남시,2,0,0,2,2,0,2018-07-10
3703,경기,하남시,9,0,4,13,7,0,2018-08-10
3704,경기,하남시,1,0,0,1,1,0,2018-09-10
3705,경기,하남시,4,0,2,6,4,0,2018-10-10
3706,경기,하남시,3,0,0,3,3,0,2018-11-10
3707,경기,하남시,4,0,1,5,2,0,2018-12-10
3708,경기,화성시,18,4,5,27,8,1,2018-01-10
3709,경기,화성시,9,1,1,11,5,0,2018-02-10
3710,경기,화성시,3,2,0,5,3,0,2018-03-10
3711,경기,화성시,6,0,2,8,7,1,2018-04-10
3712,경기,화성시,2,0,3,5,4,0,2018-05-10
3713,경기,화성시,3,0,3,6,4,0,2018-06-10
3714,경기,화성시,6,3,3,12,7,0,2018-07-10
3715,경기,화성시,17,0,3,20,12,1,2018-08-10
3716,경기,화성시,6,1,4,11,8,1,2018-09-10
3717,경기,화성시,3,0,2,5,4,0,2018-10-10
3718,경기,화성시,10,1,2,13,8,0,2018-11-10
3719,경기,화성시,9,0,3,12,9,0,2018-12-10
3720,경기,가평군,0,0,0,0,1,1,2018-01-11
3721,경기,가평군,0,0,0,0,0,0,2018-02-11
3722,경기,가평군,0,0,0,0,0,0,2018-03-11
3723,경기,가평군,1,1,1,3,3,0,2018-04-11
3724,경기,가평군,0,0,0,0,0,0,2018-05-11
3725,경기,가평군,1,2,1,4,2,0,2018-06-11
3726,경기,가평군,1,0,0,1,1,0,2018-07-11
3727,경기,가평군,0,0,0,0,0,0,2018-08-11
3728,경기,가평군,0,2,1,3,1,0,2018-09-11
3729,경기,가평군,0,0,0,0,0,0,2018-10-11
3730,경기,가평군,1,0,2,3,2,0,2018-11-11
3731,경기,가평군,0,0,1,1,1,0,2018-12-11
3732,경기,고양시,35,1,7,43,25,0,2018-01-11
3733,경기,고양시,17,0,5,22,13,0,2018-02-11
3734,경기,고양시,14,2,2,18,11,0,2018-03-11
3735,경기,고양시,18,0,4,22,15,0,2018-04-11
3736,경기,고양시,18,1,1,20,12,0,2018-05-11
3737,경기,고양시,11,1,2,14,9,0,2018-06-11
3738,경기,고양시,15,0,5,20,16,0,2018-07-11
3739,경기,고양시,5,2,3,10,7,0,2018-08-11
3740,경기,고양시,11,1,2,14,10,0,2018-09-11
3741,경기,고양시,5,2,5,12,10,0,2018-10-11
3742,경기,고양시,9,2,2,13,9,0,2018-11-11
3743,경기,고양시,11,0,4,15,8,0,2018-12-11
3744,경기,과천시,0,0,0,0,0,0,2018-01-11
3745,경기,과천시,2,0,0,2,1,0,2018-02-11
3746,경기,과천시,2,0,1,3,3,0,2018-03-11
3747,경기,과천시,1,1,0,2,1,0,2018-04-11
3748,경기,과천시,0,0,0,0,0,0,2018-05-11
3749,경기,과천시,0,0,0,0,0,0,2018-06-11
3750,경기,과천시,0,0,0,0,0,0,2018-07-11
3751,경기,과천시,0,0,0,0,0,0,2018-08-11
3752,경기,과천시,0,0,0,0,0,0,2018-09-11
3753,경기,과천시,0,0,0,0,0,0,2018-10-11
3754,경기,과천시,3,0,0,3,1,0,2018-11-11
3755,경기,과천시,0,0,0,0,0,0,2018-12-11
3756,경기,광명시,3,0,2,5,3,0,2018-01-11
3757,경기,광명시,5,1,2,8,7,0,2018-02-11
3758,경기,광명시,4,0,0,4,2,0,2018-03-11
3759,경기,광명시,2,0,0,2,2,0,2018-04-11
3760,경기,광명시,1,0,0,1,1,0,2018-05-11
3761,경기,광명시,0,1,0,1,1,0,2018-06-11
3762,경기,광명시,3,0,3,6,1,0,2018-07-11
3763,경기,광명시,9,4,1,14,4,0,2018-08-11
3764,경기,광명시,1,0,3,4,1,0,2018-09-11
3765,경기,광명시,0,0,1,1,1,0,2018-10-11
3766,경기,광명시,0,1,1,2,2,1,2018-11-11
3767,경기,광명시,1,1,1,3,3,0,2018-12-11
3768,경기,광주시,2,0,3,5,5,0,2018-01-11
3769,경기,광주시,3,0,1,4,3,0,2018-02-11
3770,경기,광주시,5,0,0,5,2,0,2018-03-11
3771,경기,광주시,4,0,3,7,4,0,2018-04-11
3772,경기,광주시,2,0,0,2,2,0,2018-05-11
3773,경기,광주시,1,0,1,2,2,0,2018-06-11
3774,경기,광주시,4,0,0,4,4,0,2018-07-11
3775,경기,광주시,8,3,0,11,4,0,2018-08-11
3776,경기,광주시,13,2,2,17,8,0,2018-09-11
3777,경기,광주시,3,0,0,3,2,0,2018-10-11
3778,경기,광주시,3,0,1,4,3,0,2018-11-11
3779,경기,광주시,9,2,0,11,4,0,2018-12-11
3780,경기,구리시,1,0,1,2,2,0,2018-01-11
3781,경기,구리시,4,0,1,5,1,0,2018-02-11
3782,경기,구리시,6,0,0,6,2,0,2018-03-11
3783,경기,구리시,1,0,0,1,1,0,2018-04-11
3784,경기,구리시,1,0,0,1,1,0,2018-05-11
3785,경기,구리시,0,0,0,0,0,0,2018-06-11
3786,경기,구리시,6,0,0,6,3,0,2018-07-11
3787,경기,구리시,1,0,0,1,1,0,2018-08-11
3788,경기,구리시,2,0,1,3,4,1,2018-09-11
3789,경기,구리시,2,0,1,3,2,0,2018-10-11
3790,경기,구리시,2,0,0,2,1,0,2018-11-11
3791,경기,구리시,2,0,0,2,2,0,2018-12-11
3792,경기,군포시,6,0,1,7,4,0,2018-01-11
3793,경기,군포시,3,0,2,5,2,0,2018-02-11
3794,경기,군포시,1,0,0,1,1,0,2018-03-11
3795,경기,군포시,0,0,1,1,1,0,2018-04-11
3796,경기,군포시,0,0,1,1,1,0,2018-05-11
3797,경기,군포시,1,0,3,4,2,0,2018-06-11
3798,경기,군포시,5,2,3,10,5,0,2018-07-11
3799,경기,군포시,3,0,1,4,2,0,2018-08-11
3800,경기,군포시,0,0,1,1,1,0,2018-09-11
3801,경기,군포시,3,1,2,6,4,0,2018-10-11
3802,경기,군포시,0,0,0,0,0,0,2018-11-11
3803,경기,군포시,0,0,1,1,1,0,2018-12-11
3804,경기,김포시,12,1,5,18,6,1,2018-01-11
3805,경기,김포시,0,0,1,1,1,0,2018-02-11
3806,경기,김포시,1,0,1,2,2,0,2018-03-11
3807,경기,김포시,5,1,2,8,4,0,2018-04-11
3808,경기,김포시,7,0,2,9,4,0,2018-05-11
3809,경기,김포시,3,0,1,4,4,0,2018-06-11
3810,경기,김포시,2,0,0,2,2,0,2018-07-11
3811,경기,김포시,2,1,0,3,3,0,2018-08-11
3812,경기,김포시,3,0,0,3,2,0,2018-09-11
3813,경기,김포시,3,0,2,5,3,0,2018-10-11
3814,경기,김포시,8,0,0,8,5,0,2018-11-11
3815,경기,김포시,5,0,0,5,2,0,2018-12-11
3816,경기,남양주시,11,0,0,11,5,0,2018-01-11
3817,경기,남양주시,2,0,2,4,4,0,2018-02-11
3818,경기,남양주시,10,0,2,12,5,0,2018-03-11
3819,경기,남양주시,6,0,5,11,9,0,2018-04-11
3820,경기,남양주시,9,1,5,15,13,0,2018-05-11
3821,경기,남양주시,6,0,1,7,5,0,2018-06-11
3822,경기,남양주시,4,0,1,5,4,0,2018-07-11
3823,경기,남양주시,13,1,2,16,7,0,2018-08-11
3824,경기,남양주시,2,1,1,4,2,0,2018-09-11
3825,경기,남양주시,6,0,3,9,8,1,2018-10-11
3826,경기,남양주시,7,2,2,11,7,0,2018-11-11
3827,경기,남양주시,5,0,1,6,5,0,2018-12-11
3828,경기,동두천시,0,0,2,2,2,0,2018-01-11
3829,경기,동두천시,0,0,1,1,1,0,2018-02-11
3830,경기,동두천시,2,0,0,2,2,0,2018-03-11
3831,경기,동두천시,0,0,1,1,1,0,2018-04-11
3832,경기,동두천시,0,0,2,2,2,0,2018-05-11
3833,경기,동두천시,3,0,1,4,2,0,2018-06-11
3834,경기,동두천시,2,0,0,2,2,0,2018-07-11
3835,경기,동두천시,3,0,0,3,2,0,2018-08-11
3836,경기,동두천시,4,0,1,5,3,0,2018-09-11
3837,경기,동두천시,0,0,1,1,1,0,2018-10-11
3838,경기,동두천시,3,0,0,3,2,0,2018-11-11
3839,경기,동두천시,0,0,0,0,0,0,2018-12-11
3840,경기,부천시,16,0,1,17,5,0,2018-01-11
3841,경기,부천시,4,0,2,6,5,0,2018-02-11
3842,경기,부천시,5,0,0,5,3,0,2018-03-11
3843,경기,부천시,9,1,4,14,9,0,2018-04-11
3844,경기,부천시,6,1,1,8,7,0,2018-05-11
3845,경기,부천시,15,0,2,17,13,0,2018-06-11
3846,경기,부천시,6,0,1,7,7,0,2018-07-11
3847,경기,부천시,8,0,0,8,4,0,2018-08-11
3848,경기,부천시,6,1,2,9,8,0,2018-09-11
3849,경기,부천시,8,0,2,10,5,0,2018-10-11
3850,경기,부천시,6,3,1,10,6,0,2018-11-11
3851,경기,부천시,7,1,0,8,7,1,2018-12-11
3852,경기,성남시,20,5,10,35,24,0,2018-01-11
3853,경기,성남시,3,3,5,11,7,0,2018-02-11
3854,경기,성남시,4,0,4,8,6,0,2018-03-11
3855,경기,성남시,11,1,3,15,13,1,2018-04-11
3856,경기,성남시,12,2,8,22,16,0,2018-05-11
3857,경기,성남시,8,4,3,15,11,0,2018-06-11
3858,경기,성남시,8,1,3,12,8,0,2018-07-11
3859,경기,성남시,6,1,4,11,9,0,2018-08-11
3860,경기,성남시,14,1,2,17,11,0,2018-09-11
3861,경기,성남시,17,0,2,19,10,0,2018-10-11
3862,경기,성남시,6,3,2,11,9,0,2018-11-11
3863,경기,성남시,2,2,0,4,4,0,2018-12-11
3864,경기,수원시,21,1,9,31,23,0,2018-01-11
3865,경기,수원시,20,0,4,24,15,0,2018-02-11
3866,경기,수원시,13,2,3,18,10,0,2018-03-11
3867,경기,수원시,8,0,7,15,12,0,2018-04-11
3868,경기,수원시,13,1,3,17,12,0,2018-05-11
3869,경기,수원시,14,1,3,18,17,0,2018-06-11
3870,경기,수원시,12,4,1,17,12,0,2018-07-11
3871,경기,수원시,12,0,3,15,12,0,2018-08-11
3872,경기,수원시,17,1,4,22,16,1,2018-09-11
3873,경기,수원시,14,3,3,20,16,0,2018-10-11
3874,경기,수원시,9,3,5,17,12,1,2018-11-11
3875,경기,수원시,11,1,3,15,11,0,2018-12-11
3876,경기,시흥시,10,0,6,16,9,0,2018-01-11
3877,경기,시흥시,3,0,0,3,2,0,2018-02-11
3878,경기,시흥시,6,0,0,6,3,0,2018-03-11
3879,경기,시흥시,11,0,1,12,8,1,2018-04-11
3880,경기,시흥시,8,0,1,9,8,0,2018-05-11
3881,경기,시흥시,14,0,2,16,6,0,2018-06-11
3882,경기,시흥시,18,1,0,19,12,0,2018-07-11
3883,경기,시흥시,13,1,1,15,7,0,2018-08-11
3884,경기,시흥시,6,0,1,7,5,0,2018-09-11
3885,경기,시흥시,10,1,4,15,11,0,2018-10-11
3886,경기,시흥시,8,0,2,10,7,0,2018-11-11
3887,경기,시흥시,4,0,1,5,3,0,2018-12-11
3888,경기,안산시,18,0,6,24,21,1,2018-01-11
3889,경기,안산시,20,0,4,24,13,0,2018-02-11
3890,경기,안산시,9,0,6,15,8,0,2018-03-11
3891,경기,안산시,7,1,4,12,11,0,2018-04-11
3892,경기,안산시,9,3,2,14,8,1,2018-05-11
3893,경기,안산시,6,0,3,9,8,0,2018-06-11
3894,경기,안산시,9,0,4,13,12,0,2018-07-11
3895,경기,안산시,9,1,2,12,7,0,2018-08-11
3896,경기,안산시,8,0,4,12,9,0,2018-09-11
3897,경기,안산시,17,1,3,21,14,0,2018-10-11
3898,경기,안산시,13,0,1,14,8,0,2018-11-11
3899,경기,안산시,9,0,3,12,9,0,2018-12-11
3900,경기,안성시,6,1,3,10,6,1,2018-01-11
3901,경기,안성시,11,0,2,13,3,1,2018-02-11
3902,경기,안성시,0,0,0,0,0,0,2018-03-11
3903,경기,안성시,6,2,2,10,5,0,2018-04-11
3904,경기,안성시,2,0,0,2,2,0,2018-05-11
3905,경기,안성시,6,0,2,8,4,0,2018-06-11
3906,경기,안성시,1,0,1,2,2,0,2018-07-11
3907,경기,안성시,4,0,0,4,4,1,2018-08-11
3908,경기,안성시,3,0,0,3,2,0,2018-09-11
3909,경기,안성시,6,0,2,8,7,0,2018-10-11
3910,경기,안성시,7,0,0,7,3,0,2018-11-11
3911,경기,안성시,9,0,2,11,6,0,2018-12-11
3912,경기,안양시,13,0,2,15,9,0,2018-01-11
3913,경기,안양시,3,0,0,3,2,0,2018-02-11
3914,경기,안양시,4,0,0,4,4,0,2018-03-11
3915,경기,안양시,14,0,2,16,3,0,2018-04-11
3916,경기,안양시,11,0,4,15,9,0,2018-05-11
3917,경기,안양시,3,0,2,5,5,0,2018-06-11
3918,경기,안양시,4,1,3,8,5,0,2018-07-11
3919,경기,안양시,6,0,2,8,6,0,2018-08-11
3920,경기,안양시,5,0,2,7,7,0,2018-09-11
3921,경기,안양시,2,1,0,3,1,0,2018-10-11
3922,경기,안양시,3,0,1,4,3,0,2018-11-11
3923,경기,안양시,5,0,1,6,4,0,2018-12-11
3924,경기,양주시,3,2,0,5,4,0,2018-01-11
3925,경기,양주시,2,0,1,3,1,0,2018-02-11
3926,경기,양주시,6,1,1,8,4,0,2018-03-11
3927,경기,양주시,3,0,2,5,4,0,2018-04-11
3928,경기,양주시,1,0,2,3,3,0,2018-05-11
3929,경기,양주시,1,0,0,1,1,0,2018-06-11
3930,경기,양주시,6,1,2,9,8,0,2018-07-11
3931,경기,양주시,11,0,2,13,6,0,2018-08-11
3932,경기,양주시,4,2,1,7,4,0,2018-09-11
3933,경기,양주시,0,0,0,0,0,0,2018-10-11
3934,경기,양주시,2,0,0,2,2,0,2018-11-11
3935,경기,양주시,7,0,2,9,4,0,2018-12-11
3936,경기,양평군,0,0,1,1,1,0,2018-01-11
3937,경기,양평군,1,0,0,1,1,0,2018-02-11
3938,경기,양평군,0,0,0,0,0,0,2018-03-11
3939,경기,양평군,1,0,0,1,1,0,2018-04-11
3940,경기,양평군,0,0,2,2,2,0,2018-05-11
3941,경기,양평군,0,0,1,1,1,0,2018-06-11
3942,경기,양평군,1,0,3,4,4,0,2018-07-11
3943,경기,양평군,4,1,0,5,2,0,2018-08-11
3944,경기,양평군,0,0,0,0,1,1,2018-09-11
3945,경기,양평군,1,0,0,1,1,0,2018-10-11
3946,경기,양평군,5,1,5,11,5,0,2018-11-11
3947,경기,양평군,1,1,0,2,1,0,2018-12-11
3948,경기,여주시,1,0,0,1,1,0,2018-01-11
3949,경기,여주시,0,0,1,1,1,0,2018-02-11
3950,경기,여주시,1,0,0,1,1,0,2018-03-11
3951,경기,여주시,1,0,3,4,3,0,2018-04-11
3952,경기,여주시,1,0,0,1,2,1,2018-05-11
3953,경기,여주시,1,0,0,1,1,0,2018-06-11
3954,경기,여주시,0,0,4,4,1,0,2018-07-11
3955,경기,여주시,1,0,1,2,2,0,2018-08-11
3956,경기,여주시,0,0,0,0,0,0,2018-09-11
3957,경기,여주시,2,0,4,6,5,0,2018-10-11
3958,경기,여주시,0,0,1,1,1,0,2018-11-11
3959,경기,여주시,6,0,0,6,2,0,2018-12-11
3960,경기,연천군,0,0,1,1,1,0,2018-01-11
3961,경기,연천군,0,0,0,0,0,0,2018-02-11
3962,경기,연천군,1,0,2,3,2,0,2018-03-11
3963,경기,연천군,0,0,0,0,0,0,2018-04-11
3964,경기,연천군,0,0,1,1,1,0,2018-05-11
3965,경기,연천군,0,0,0,0,0,0,2018-06-11
3966,경기,연천군,1,0,0,1,1,0,2018-07-11
3967,경기,연천군,3,0,0,3,2,0,2018-08-11
3968,경기,연천군,1,0,0,1,1,0,2018-09-11
3969,경기,연천군,0,0,0,0,0,0,2018-10-11
3970,경기,연천군,0,0,0,0,0,0,2018-11-11
3971,경기,연천군,0,0,1,1,1,0,2018-12-11
3972,경기,오산시,4,0,0,4,3,0,2018-01-11
3973,경기,오산시,2,0,1,3,3,0,2018-02-11
3974,경기,오산시,7,0,0,7,2,0,2018-03-11
3975,경기,오산시,1,0,0,1,1,0,2018-04-11
3976,경기,오산시,0,0,0,0,0,0,2018-05-11
3977,경기,오산시,0,0,0,0,0,0,2018-06-11
3978,경기,오산시,1,0,0,1,1,0,2018-07-11
3979,경기,오산시,3,0,1,4,4,0,2018-08-11
3980,경기,오산시,0,0,0,0,0,0,2018-09-11
3981,경기,오산시,8,1,1,10,6,0,2018-10-11
3982,경기,오산시,1,0,1,2,2,0,2018-11-11
3983,경기,오산시,1,0,0,1,2,1,2018-12-11
3984,경기,용인시,20,2,1,23,12,0,2018-01-11
3985,경기,용인시,13,5,0,18,9,0,2018-02-11
3986,경기,용인시,4,0,6,10,6,0,2018-03-11
3987,경기,용인시,8,3,4,15,11,0,2018-04-11
3988,경기,용인시,10,0,10,20,9,0,2018-05-11
3989,경기,용인시,9,1,0,10,8,0,2018-06-11
3990,경기,용인시,11,1,3,15,12,0,2018-07-11
3991,경기,용인시,16,4,4,24,11,0,2018-08-11
3992,경기,용인시,10,0,5,15,12,0,2018-09-11
3993,경기,용인시,8,1,1,10,9,0,2018-10-11
3994,경기,용인시,1,0,4,5,3,0,2018-11-11
3995,경기,용인시,14,12,7,33,10,0,2018-12-11
3996,경기,의왕시,4,0,0,4,2,0,2018-01-11
3997,경기,의왕시,0,0,0,0,0,0,2018-02-11
3998,경기,의왕시,0,0,0,0,0,0,2018-03-11
3999,경기,의왕시,3,1,1,5,2,0,2018-04-11
4000,경기,의왕시,2,0,0,2,1,0,2018-05-11
4001,경기,의왕시,5,2,0,7,5,0,2018-06-11
4002,경기,의왕시,1,0,1,2,2,0,2018-07-11
4003,경기,의왕시,8,0,0,8,4,0,2018-08-11
4004,경기,의왕시,8,4,0,12,3,0,2018-09-11
4005,경기,의왕시,3,0,0,3,3,0,2018-10-11
4006,경기,의왕시,1,0,0,1,1,0,2018-11-11
4007,경기,의왕시,1,0,0,1,1,0,2018-12-11
4008,경기,의정부시,7,3,2,12,10,0,2018-01-11
4009,경기,의정부시,10,1,2,13,5,0,2018-02-11
4010,경기,의정부시,4,0,1,5,4,0,2018-03-11
4011,경기,의정부시,6,1,1,8,5,0,2018-04-11
4012,경기,의정부시,2,0,1,3,3,0,2018-05-11
4013,경기,의정부시,8,2,2,12,7,0,2018-06-11
4014,경기,의정부시,6,0,1,7,3,0,2018-07-11
4015,경기,의정부시,2,0,3,5,2,0,2018-08-11
4016,경기,의정부시,6,6,2,14,9,0,2018-09-11
4017,경기,의정부시,4,0,2,6,4,0,2018-10-11
4018,경기,의정부시,4,1,0,5,5,0,2018-11-11
4019,경기,의정부시,5,1,0,6,6,0,2018-12-11
4020,경기,이천시,7,1,5,13,5,0,2018-01-11
4021,경기,이천시,0,1,0,1,1,0,2018-02-11
4022,경기,이천시,1,0,1,2,2,0,2018-03-11
4023,경기,이천시,2,7,1,10,4,0,2018-04-11
4024,경기,이천시,2,0,0,2,2,0,2018-05-11
4025,경기,이천시,2,0,1,3,3,0,2018-06-11
4026,경기,이천시,4,0,3,7,6,0,2018-07-11
4027,경기,이천시,2,0,0,2,1,0,2018-08-11
4028,경기,이천시,1,1,0,2,2,0,2018-09-11
4029,경기,이천시,1,0,0,1,1,0,2018-10-11
4030,경기,이천시,1,0,0,1,1,0,2018-11-11
4031,경기,이천시,5,4,0,9,5,0,2018-12-11
4032,경기,파주시,4,0,1,5,4,0,2018-01-11
4033,경기,파주시,5,0,2,7,3,0,2018-02-11
4034,경기,파주시,3,0,1,4,3,0,2018-03-11
4035,경기,파주시,12,0,2,14,5,0,2018-04-11
4036,경기,파주시,4,1,0,5,5,0,2018-05-11
4037,경기,파주시,4,0,4,8,7,0,2018-06-11
4038,경기,파주시,3,0,3,6,5,0,2018-07-11
4039,경기,파주시,3,0,5,8,6,0,2018-08-11
4040,경기,파주시,3,0,2,5,4,0,2018-09-11
4041,경기,파주시,9,0,3,12,7,0,2018-10-11
4042,경기,파주시,5,1,1,7,5,0,2018-11-11
4043,경기,파주시,1,1,1,3,3,0,2018-12-11
4044,경기,평택시,14,0,3,17,11,0,2018-01-11
4045,경기,평택시,11,1,1,13,7,0,2018-02-11
4046,경기,평택시,5,0,5,10,5,0,2018-03-11
4047,경기,평택시,6,1,5,12,10,0,2018-04-11
4048,경기,평택시,4,0,0,4,4,0,2018-05-11
4049,경기,평택시,11,1,1,13,9,0,2018-06-11
4050,경기,평택시,20,4,4,28,16,0,2018-07-11
4051,경기,평택시,13,2,5,20,11,0,2018-08-11
4052,경기,평택시,9,0,2,11,8,0,2018-09-11
4053,경기,평택시,11,2,2,15,12,0,2018-10-11
4054,경기,평택시,5,0,1,6,5,0,2018-11-11
4055,경기,평택시,16,3,2,21,14,0,2018-12-11
4056,경기,포천시,1,1,0,2,1,0,2018-01-11
4057,경기,포천시,1,0,0,1,1,0,2018-02-11
4058,경기,포천시,3,0,0,3,2,0,2018-03-11
4059,경기,포천시,3,0,0,3,3,0,2018-04-11
4060,경기,포천시,4,3,3,10,5,0,2018-05-11
4061,경기,포천시,2,0,0,2,2,0,2018-06-11
4062,경기,포천시,1,0,1,2,2,0,2018-07-11
4063,경기,포천시,3,0,2,5,5,0,2018-08-11
4064,경기,포천시,4,0,2,6,4,0,2018-09-11
4065,경기,포천시,4,1,2,7,5,0,2018-10-11
4066,경기,포천시,3,0,2,5,1,0,2018-11-11
4067,경기,포천시,4,0,0,4,2,0,2018-12-11
4068,경기,하남시,3,0,0,3,3,0,2018-01-11
4069,경기,하남시,0,0,0,0,0,0,2018-02-11
4070,경기,하남시,4,0,0,4,4,0,2018-03-11
4071,경기,하남시,0,0,3,3,3,0,2018-04-11
4072,경기,하남시,3,0,0,3,1,0,2018-05-11
4073,경기,하남시,7,0,0,7,5,0,2018-06-11
4074,경기,하남시,5,0,4,9,4,0,2018-07-11
4075,경기,하남시,2,0,1,3,1,0,2018-08-11
4076,경기,하남시,1,0,1,2,2,0,2018-09-11
4077,경기,하남시,2,0,0,2,2,0,2018-10-11
4078,경기,하남시,3,1,4,8,5,0,2018-11-11
4079,경기,하남시,1,2,0,3,3,0,2018-12-11
4080,경기,화성시,5,0,1,6,4,0,2018-01-11
4081,경기,화성시,6,0,4,10,5,0,2018-02-11
4082,경기,화성시,2,0,3,5,4,0,2018-03-11
4083,경기,화성시,10,0,0,10,8,0,2018-04-11
4084,경기,화성시,5,0,1,6,5,0,2018-05-11
4085,경기,화성시,12,4,4,20,11,0,2018-06-11
4086,경기,화성시,9,0,3,12,4,0,2018-07-11
4087,경기,화성시,10,0,0,10,8,1,2018-08-11
4088,경기,화성시,9,0,3,12,9,0,2018-09-11
4089,경기,화성시,8,0,3,11,8,0,2018-10-11
4090,경기,화성시,3,0,1,4,4,0,2018-11-11
4091,경기,화성시,12,3,2,17,10,0,2018-12-11
4092,경기,가평군,0,0,0,0,0,0,2018-01-12
4093,경기,가평군,0,0,0,0,0,0,2018-02-12
4094,경기,가평군,0,1,0,1,1,0,2018-03-12
4095,경기,가평군,0,0,0,0,0,0,2018-04-12
4096,경기,가평군,2,1,0,3,2,0,2018-05-12
4097,경기,가평군,1,0,0,1,1,0,2018-06-12
4098,경기,가평군,0,0,0,0,0,0,2018-07-12
4099,경기,가평군,2,0,1,3,2,0,2018-08-12
4100,경기,가평군,6,0,3,9,5,0,2018-09-12
4101,경기,가평군,0,0,0,0,0,0,2018-10-12
4102,경기,가평군,3,0,0,3,1,0,2018-11-12
4103,경기,가평군,2,0,0,2,1,0,2018-12-12
4104,경기,고양시,29,4,3,36,28,0,2018-01-12
4105,경기,고양시,23,0,4,27,20,0,2018-02-12
4106,경기,고양시,10,0,1,11,8,0,2018-03-12
4107,경기,고양시,6,3,3,12,7,0,2018-04-12
4108,경기,고양시,14,3,3,20,13,0,2018-05-12
4109,경기,고양시,16,1,2,19,8,0,2018-06-12
4110,경기,고양시,3,1,2,6,6,0,2018-07-12
4111,경기,고양시,6,3,4,13,9,0,2018-08-12
4112,경기,고양시,12,7,5,24,18,0,2018-09-12
4113,경기,고양시,10,2,4,16,11,0,2018-10-12
4114,경기,고양시,7,4,1,12,8,0,2018-11-12
4115,경기,고양시,9,1,2,12,9,0,2018-12-12
4116,경기,과천시,0,0,0,0,0,0,2018-01-12
4117,경기,과천시,1,0,0,1,1,0,2018-02-12
4118,경기,과천시,1,0,1,2,2,0,2018-03-12
4119,경기,과천시,1,0,0,1,1,0,2018-04-12
4120,경기,과천시,2,0,2,4,2,0,2018-05-12
4121,경기,과천시,0,0,0,0,0,0,2018-06-12
4122,경기,과천시,0,0,0,0,0,0,2018-07-12
4123,경기,과천시,0,1,0,1,1,0,2018-08-12
4124,경기,과천시,0,0,0,0,0,0,2018-09-12
4125,경기,과천시,0,0,0,0,0,0,2018-10-12
4126,경기,과천시,0,0,0,0,0,0,2018-11-12
4127,경기,과천시,0,0,0,0,0,0,2018-12-12
4128,경기,광명시,2,0,0,2,2,0,2018-01-12
4129,경기,광명시,0,1,1,2,2,0,2018-02-12
4130,경기,광명시,2,0,2,4,3,0,2018-03-12
4131,경기,광명시,7,1,2,10,6,0,2018-04-12
4132,경기,광명시,0,1,0,1,1,0,2018-05-12
4133,경기,광명시,4,0,1,5,4,0,2018-06-12
4134,경기,광명시,0,0,0,0,0,0,2018-07-12
4135,경기,광명시,3,1,0,4,3,0,2018-08-12
4136,경기,광명시,12,1,0,13,8,0,2018-09-12
4137,경기,광명시,0,0,1,1,1,0,2018-10-12
4138,경기,광명시,2,1,0,3,3,0,2018-11-12
4139,경기,광명시,0,0,1,1,1,0,2018-12-12
4140,경기,광주시,4,0,1,5,5,0,2018-01-12
4141,경기,광주시,3,1,2,6,6,0,2018-02-12
4142,경기,광주시,9,0,2,11,7,0,2018-03-12
4143,경기,광주시,6,0,2,8,7,0,2018-04-12
4144,경기,광주시,6,0,0,6,2,0,2018-05-12
4145,경기,광주시,9,1,3,13,6,0,2018-06-12
4146,경기,광주시,7,0,2,9,6,0,2018-07-12
4147,경기,광주시,4,0,1,5,3,0,2018-08-12
4148,경기,광주시,8,0,1,9,5,0,2018-09-12
4149,경기,광주시,12,4,3,19,10,0,2018-10-12
4150,경기,광주시,3,0,3,6,5,0,2018-11-12
4151,경기,광주시,3,0,1,4,4,0,2018-12-12
4152,경기,구리시,6,0,1,7,4,0,2018-01-12
4153,경기,구리시,0,0,1,1,1,0,2018-02-12
4154,경기,구리시,2,0,0,2,2,0,2018-03-12
4155,경기,구리시,1,0,0,1,1,0,2018-04-12
4156,경기,구리시,1,0,0,1,1,0,2018-05-12
4157,경기,구리시,1,0,0,1,1,0,2018-06-12
4158,경기,구리시,1,0,1,2,2,0,2018-07-12
4159,경기,구리시,0,0,0,0,0,0,2018-08-12
4160,경기,구리시,1,0,0,1,1,0,2018-09-12
4161,경기,구리시,2,0,3,5,4,0,2018-10-12
4162,경기,구리시,2,0,0,2,2,0,2018-11-12
4163,경기,구리시,0,0,0,0,0,0,2018-12-12
4164,경기,군포시,5,1,1,7,5,0,2018-01-12
4165,경기,군포시,1,0,2,3,3,0,2018-02-12
4166,경기,군포시,0,0,0,0,0,0,2018-03-12
4167,경기,군포시,1,0,1,2,2,0,2018-04-12
4168,경기,군포시,1,0,1,2,2,0,2018-05-12
4169,경기,군포시,0,0,1,1,1,0,2018-06-12
4170,경기,군포시,1,0,0,1,1,0,2018-07-12
4171,경기,군포시,1,0,0,1,1,0,2018-08-12
4172,경기,군포시,0,0,1,1,1,0,2018-09-12
4173,경기,군포시,2,1,2,5,5,0,2018-10-12
4174,경기,군포시,1,0,1,2,1,0,2018-11-12
4175,경기,군포시,0,0,0,0,0,0,2018-12-12
4176,경기,김포시,6,0,1,7,7,0,2018-01-12
4177,경기,김포시,8,3,1,12,6,0,2018-02-12
4178,경기,김포시,8,0,2,10,6,0,2018-03-12
4179,경기,김포시,10,1,4,15,3,0,2018-04-12
4180,경기,김포시,8,1,3,12,6,0,2018-05-12
4181,경기,김포시,6,1,0,7,7,1,2018-06-12
4182,경기,김포시,10,1,1,12,8,0,2018-07-12
4183,경기,김포시,7,0,2,9,3,0,2018-08-12
4184,경기,김포시,18,2,3,23,13,0,2018-09-12
4185,경기,김포시,2,2,1,5,4,0,2018-10-12
4186,경기,김포시,7,0,3,10,4,0,2018-11-12
4187,경기,김포시,8,0,0,8,6,0,2018-12-12
4188,경기,남양주시,3,0,2,5,5,0,2018-01-12
4189,경기,남양주시,20,3,1,24,12,0,2018-02-12
4190,경기,남양주시,2,0,1,3,3,0,2018-03-12
4191,경기,남양주시,4,0,2,6,6,0,2018-04-12
4192,경기,남양주시,13,0,0,13,5,0,2018-05-12
4193,경기,남양주시,10,2,2,14,11,0,2018-06-12
4194,경기,남양주시,5,0,3,8,5,0,2018-07-12
4195,경기,남양주시,9,0,1,10,4,0,2018-08-12
4196,경기,남양주시,11,2,7,20,14,0,2018-09-12
4197,경기,남양주시,13,2,2,17,8,0,2018-10-12
4198,경기,남양주시,7,1,0,8,4,0,2018-11-12
4199,경기,남양주시,5,0,2,7,7,1,2018-12-12
4200,경기,동두천시,0,0,0,0,0,0,2018-01-12
4201,경기,동두천시,0,1,0,1,1,0,2018-02-12
4202,경기,동두천시,0,0,0,0,0,0,2018-03-12
4203,경기,동두천시,0,0,0,0,0,0,2018-04-12
4204,경기,동두천시,2,0,0,2,1,0,2018-05-12
4205,경기,동두천시,1,0,2,3,3,0,2018-06-12
4206,경기,동두천시,3,0,1,4,3,0,2018-07-12
4207,경기,동두천시,1,0,0,1,1,0,2018-08-12
4208,경기,동두천시,0,0,0,0,0,0,2018-09-12
4209,경기,동두천시,0,0,0,0,0,0,2018-10-12
4210,경기,동두천시,1,0,1,2,2,0,2018-11-12
4211,경기,동두천시,0,0,0,0,0,0,2018-12-12
4212,경기,부천시,6,0,6,12,11,0,2018-01-12
4213,경기,부천시,4,2,5,11,9,0,2018-02-12
4214,경기,부천시,20,0,3,23,14,0,2018-03-12
4215,경기,부천시,6,0,0,6,5,0,2018-04-12
4216,경기,부천시,9,2,2,13,11,0,2018-05-12
4217,경기,부천시,16,1,2,19,14,0,2018-06-12
4218,경기,부천시,9,1,4,14,10,0,2018-07-12
4219,경기,부천시,13,2,1,16,9,0,2018-08-12
4220,경기,부천시,6,2,0,8,7,0,2018-09-12
4221,경기,부천시,10,1,5,16,11,0,2018-10-12
4222,경기,부천시,6,0,3,9,8,0,2018-11-12
4223,경기,부천시,12,2,1,15,11,0,2018-12-12
4224,경기,성남시,23,3,6,32,25,1,2018-01-12
4225,경기,성남시,12,2,7,21,17,0,2018-02-12
4226,경기,성남시,1,0,2,3,3,0,2018-03-12
4227,경기,성남시,9,0,6,15,10,0,2018-04-12
4228,경기,성남시,13,1,8,22,15,0,2018-05-12
4229,경기,성남시,12,0,1,13,10,0,2018-06-12
4230,경기,성남시,15,4,6,25,19,0,2018-07-12
4231,경기,성남시,7,1,4,12,6,0,2018-08-12
4232,경기,성남시,16,0,3,19,13,0,2018-09-12
4233,경기,성남시,14,2,3,19,13,0,2018-10-12
4234,경기,성남시,21,2,5,28,14,0,2018-11-12
4235,경기,성남시,5,0,1,6,5,0,2018-12-12
4236,경기,수원시,17,0,5,22,18,0,2018-01-12
4237,경기,수원시,37,1,14,52,26,0,2018-02-12
4238,경기,수원시,18,1,3,22,14,0,2018-03-12
4239,경기,수원시,17,2,8,27,17,0,2018-04-12
4240,경기,수원시,15,1,5,21,16,0,2018-05-12
4241,경기,수원시,18,0,4,22,12,0,2018-06-12
4242,경기,수원시,13,0,2,15,12,0,2018-07-12
4243,경기,수원시,14,2,5,21,14,1,2018-08-12
4244,경기,수원시,28,2,0,30,17,0,2018-09-12
4245,경기,수원시,12,2,6,20,16,0,2018-10-12
4246,경기,수원시,18,3,2,23,16,0,2018-11-12
4247,경기,수원시,9,3,5,17,11,0,2018-12-12
4248,경기,시흥시,5,0,1,6,4,0,2018-01-12
4249,경기,시흥시,8,0,2,10,6,0,2018-02-12
4250,경기,시흥시,6,0,2,8,3,0,2018-03-12
4251,경기,시흥시,7,0,2,9,6,0,2018-04-12
4252,경기,시흥시,16,1,6,23,14,1,2018-05-12
4253,경기,시흥시,6,0,2,8,5,0,2018-06-12
4254,경기,시흥시,2,0,2,4,2,0,2018-07-12
4255,경기,시흥시,6,1,0,7,5,0,2018-08-12
4256,경기,시흥시,4,0,1,5,5,0,2018-09-12
4257,경기,시흥시,10,0,4,14,8,0,2018-10-12
4258,경기,시흥시,7,0,2,9,7,0,2018-11-12
4259,경기,시흥시,13,0,2,15,9,0,2018-12-12
4260,경기,안산시,15,2,3,20,9,0,2018-01-12
4261,경기,안산시,12,1,8,21,14,1,2018-02-12
4262,경기,안산시,11,0,1,12,12,0,2018-03-12
4263,경기,안산시,14,4,3,21,14,0,2018-04-12
4264,경기,안산시,24,2,6,32,12,0,2018-05-12
4265,경기,안산시,13,1,5,19,14,0,2018-06-12
4266,경기,안산시,9,1,3,13,9,0,2018-07-12
4267,경기,안산시,5,0,2,7,4,0,2018-08-12
4268,경기,안산시,7,0,10,17,13,1,2018-09-12
4269,경기,안산시,13,2,4,19,14,1,2018-10-12
4270,경기,안산시,9,0,3,12,9,0,2018-11-12
4271,경기,안산시,14,3,1,18,10,0,2018-12-12
4272,경기,안성시,1,0,2,3,2,0,2018-01-12
4273,경기,안성시,4,0,2,6,5,0,2018-02-12
4274,경기,안성시,3,1,3,7,5,0,2018-03-12
4275,경기,안성시,8,0,2,10,8,0,2018-04-12
4276,경기,안성시,1,0,1,2,2,1,2018-05-12
4277,경기,안성시,1,0,1,2,2,0,2018-06-12
4278,경기,안성시,0,0,0,0,0,0,2018-07-12
4279,경기,안성시,4,0,0,4,3,0,2018-08-12
4280,경기,안성시,0,2,2,4,2,0,2018-09-12
4281,경기,안성시,6,1,5,12,6,0,2018-10-12
4282,경기,안성시,0,0,2,2,2,0,2018-11-12
4283,경기,안성시,1,0,2,3,1,0,2018-12-12
4284,경기,안양시,3,0,0,3,2,0,2018-01-12
4285,경기,안양시,1,0,1,2,2,0,2018-02-12
4286,경기,안양시,3,0,0,3,3,1,2018-03-12
4287,경기,안양시,5,0,3,8,6,0,2018-04-12
4288,경기,안양시,9,1,0,10,3,0,2018-05-12
4289,경기,안양시,7,0,1,8,7,0,2018-06-12
4290,경기,안양시,4,0,1,5,4,0,2018-07-12
4291,경기,안양시,1,0,2,3,2,0,2018-08-12
4292,경기,안양시,5,0,3,8,6,0,2018-09-12
4293,경기,안양시,14,1,1,16,10,0,2018-10-12
4294,경기,안양시,9,0,1,10,7,0,2018-11-12
4295,경기,안양시,6,1,1,8,6,0,2018-12-12
4296,경기,양주시,4,0,0,4,2,0,2018-01-12
4297,경기,양주시,1,0,0,1,1,0,2018-02-12
4298,경기,양주시,0,0,1,1,2,1,2018-03-12
4299,경기,양주시,6,0,0,6,4,0,2018-04-12
4300,경기,양주시,6,0,2,8,6,0,2018-05-12
4301,경기,양주시,2,1,0,3,3,0,2018-06-12
4302,경기,양주시,1,0,1,2,2,0,2018-07-12
4303,경기,양주시,0,0,1,1,1,0,2018-08-12
4304,경기,양주시,5,0,1,6,3,1,2018-09-12
4305,경기,양주시,8,0,3,11,6,0,2018-10-12
4306,경기,양주시,2,0,1,3,3,0,2018-11-12
4307,경기,양주시,4,0,0,4,4,0,2018-12-12
4308,경기,양평군,1,0,0,1,1,0,2018-01-12
4309,경기,양평군,3,0,0,3,2,0,2018-02-12
4310,경기,양평군,0,3,1,4,2,0,2018-03-12
4311,경기,양평군,0,0,0,0,0,0,2018-04-12
4312,경기,양평군,9,0,2,11,4,1,2018-05-12
4313,경기,양평군,5,1,0,6,3,0,2018-06-12
4314,경기,양평군,3,0,0,3,3,0,2018-07-12
4315,경기,양평군,3,0,1,4,3,0,2018-08-12
4316,경기,양평군,1,1,1,3,3,0,2018-09-12
4317,경기,양평군,1,0,0,1,1,0,2018-10-12
4318,경기,양평군,2,0,1,3,2,0,2018-11-12
4319,경기,양평군,0,0,0,0,0,0,2018-12-12
4320,경기,여주시,2,1,1,4,3,0,2018-01-12
4321,경기,여주시,1,0,0,1,1,0,2018-02-12
4322,경기,여주시,2,0,1,3,2,0,2018-03-12
4323,경기,여주시,0,0,1,1,1,0,2018-04-12
4324,경기,여주시,8,1,1,10,4,0,2018-05-12
4325,경기,여주시,2,0,0,2,1,0,2018-06-12
4326,경기,여주시,3,0,0,3,1,0,2018-07-12
4327,경기,여주시,0,0,0,0,0,0,2018-08-12
4328,경기,여주시,2,0,0,2,2,0,2018-09-12
4329,경기,여주시,1,0,0,1,1,0,2018-10-12
4330,경기,여주시,1,0,0,1,1,0,2018-11-12
4331,경기,여주시,3,0,0,3,3,0,2018-12-12
4332,경기,연천군,1,0,0,1,1,0,2018-01-12
4333,경기,연천군,1,0,3,4,1,0,2018-02-12
4334,경기,연천군,0,0,1,1,1,0,2018-03-12
4335,경기,연천군,0,0,0,0,0,0,2018-04-12
4336,경기,연천군,0,0,0,0,0,0,2018-05-12
4337,경기,연천군,0,0,0,0,0,0,2018-06-12
4338,경기,연천군,2,0,0,2,1,0,2018-07-12
4339,경기,연천군,1,0,0,1,1,0,2018-08-12
4340,경기,연천군,0,0,0,0,0,0,2018-09-12
4341,경기,연천군,1,0,1,2,1,0,2018-10-12
4342,경기,연천군,0,0,0,0,0,0,2018-11-12
4343,경기,연천군,1,2,0,3,2,0,2018-12-12
4344,경기,오산시,6,3,3,12,6,0,2018-01-12
4345,경기,오산시,4,0,0,4,3,0,2018-02-12
4346,경기,오산시,1,1,0,2,2,0,2018-03-12
4347,경기,오산시,0,0,1,1,1,0,2018-04-12
4348,경기,오산시,0,2,1,3,3,0,2018-05-12
4349,경기,오산시,3,0,1,4,3,0,2018-06-12
4350,경기,오산시,0,0,1,1,1,0,2018-07-12
4351,경기,오산시,0,0,0,0,0,0,2018-08-12
4352,경기,오산시,0,0,0,0,0,0,2018-09-12
4353,경기,오산시,6,1,1,8,5,0,2018-10-12
4354,경기,오산시,0,0,1,1,1,0,2018-11-12
4355,경기,오산시,6,0,0,6,6,1,2018-12-12
4356,경기,용인시,10,2,4,16,10,0,2018-01-12
4357,경기,용인시,19,5,11,35,16,0,2018-02-12
4358,경기,용인시,8,2,2,12,11,0,2018-03-12
4359,경기,용인시,14,2,4,20,13,0,2018-04-12
4360,경기,용인시,18,15,2,35,15,0,2018-05-12
4361,경기,용인시,3,3,4,10,6,0,2018-06-12
4362,경기,용인시,11,4,1,16,11,0,2018-07-12
4363,경기,용인시,4,0,0,4,1,0,2018-08-12
4364,경기,용인시,27,4,7,38,16,0,2018-09-12
4365,경기,용인시,21,2,2,25,14,1,2018-10-12
4366,경기,용인시,6,1,2,9,8,0,2018-11-12
4367,경기,용인시,13,0,4,17,12,0,2018-12-12
4368,경기,의왕시,0,0,0,0,0,0,2018-01-12
4369,경기,의왕시,6,0,5,11,6,0,2018-02-12
4370,경기,의왕시,0,0,0,0,0,0,2018-03-12
4371,경기,의왕시,0,0,0,0,0,0,2018-04-12
4372,경기,의왕시,4,0,0,4,2,0,2018-05-12
4373,경기,의왕시,0,0,0,0,0,0,2018-06-12
4374,경기,의왕시,3,0,0,3,2,0,2018-07-12
4375,경기,의왕시,0,0,1,1,1,0,2018-08-12
4376,경기,의왕시,1,0,1,2,2,0,2018-09-12
4377,경기,의왕시,2,0,0,2,2,0,2018-10-12
4378,경기,의왕시,0,0,0,0,0,0,2018-11-12
4379,경기,의왕시,4,0,0,4,2,0,2018-12-12
4380,경기,의정부시,15,5,1,21,12,0,2018-01-12
4381,경기,의정부시,12,1,3,16,11,0,2018-02-12
4382,경기,의정부시,2,0,0,2,2,0,2018-03-12
4383,경기,의정부시,6,1,1,8,5,0,2018-04-12
4384,경기,의정부시,4,1,0,5,4,0,2018-05-12
4385,경기,의정부시,4,3,0,7,6,0,2018-06-12
4386,경기,의정부시,4,0,1,5,2,0,2018-07-12
4387,경기,의정부시,5,0,1,6,2,0,2018-08-12
4388,경기,의정부시,4,1,1,6,6,0,2018-09-12
4389,경기,의정부시,2,1,4,7,7,1,2018-10-12
4390,경기,의정부시,2,1,1,4,4,0,2018-11-12
4391,경기,의정부시,2,1,2,5,4,0,2018-12-12
4392,경기,이천시,5,0,0,5,4,0,2018-01-12
4393,경기,이천시,5,0,7,12,7,0,2018-02-12
4394,경기,이천시,7,0,0,7,3,0,2018-03-12
4395,경기,이천시,3,0,2,5,3,0,2018-04-12
4396,경기,이천시,10,4,4,18,2,0,2018-05-12
4397,경기,이천시,1,0,0,1,1,0,2018-06-12
4398,경기,이천시,4,0,0,4,3,0,2018-07-12
4399,경기,이천시,2,0,0,2,1,0,2018-08-12
4400,경기,이천시,3,1,0,4,4,0,2018-09-12
4401,경기,이천시,0,1,1,2,2,0,2018-10-12
4402,경기,이천시,8,1,6,15,6,0,2018-11-12
4403,경기,이천시,3,0,0,3,1,0,2018-12-12
4404,경기,파주시,9,0,2,11,7,0,2018-01-12
4405,경기,파주시,8,3,0,11,9,0,2018-02-12
4406,경기,파주시,3,0,3,6,6,0,2018-03-12
4407,경기,파주시,5,1,4,10,9,0,2018-04-12
4408,경기,파주시,16,1,4,21,8,0,2018-05-12
4409,경기,파주시,9,0,1,10,8,0,2018-06-12
4410,경기,파주시,3,0,0,3,3,0,2018-07-12
4411,경기,파주시,0,0,0,0,0,0,2018-08-12
4412,경기,파주시,7,0,1,8,5,0,2018-09-12
4413,경기,파주시,9,0,0,9,7,0,2018-10-12
4414,경기,파주시,7,1,1,9,7,0,2018-11-12
4415,경기,파주시,10,0,1,11,8,0,2018-12-12
4416,경기,평택시,17,2,3,22,17,0,2018-01-12
4417,경기,평택시,18,1,2,21,8,0,2018-02-12
4418,경기,평택시,14,0,3,17,8,0,2018-03-12
4419,경기,평택시,9,1,2,12,8,0,2018-04-12
4420,경기,평택시,10,1,2,13,10,0,2018-05-12
4421,경기,평택시,19,1,5,25,14,0,2018-06-12
4422,경기,평택시,10,2,2,14,11,0,2018-07-12
4423,경기,평택시,18,0,0,18,10,0,2018-08-12
4424,경기,평택시,15,0,2,17,15,1,2018-09-12
4425,경기,평택시,6,1,0,7,7,0,2018-10-12
4426,경기,평택시,6,2,0,8,6,0,2018-11-12
4427,경기,평택시,14,2,2,18,10,0,2018-12-12
4428,경기,포천시,0,1,0,1,1,0,2018-01-12
4429,경기,포천시,2,0,0,2,2,0,2018-02-12
4430,경기,포천시,0,0,0,0,0,0,2018-03-12
4431,경기,포천시,2,1,1,4,2,0,2018-04-12
4432,경기,포천시,3,0,0,3,3,0,2018-05-12
4433,경기,포천시,0,0,0,0,0,0,2018-06-12
4434,경기,포천시,2,0,0,2,1,0,2018-07-12
4435,경기,포천시,2,0,6,8,3,0,2018-08-12
4436,경기,포천시,13,3,4,20,9,0,2018-09-12
4437,경기,포천시,5,0,0,5,4,0,2018-10-12
4438,경기,포천시,0,0,0,0,0,0,2018-11-12
4439,경기,포천시,3,0,1,4,3,0,2018-12-12
4440,경기,하남시,2,1,1,4,3,0,2018-01-12
4441,경기,하남시,2,0,1,3,3,0,2018-02-12
4442,경기,하남시,3,0,0,3,3,1,2018-03-12
4443,경기,하남시,7,3,3,13,6,0,2018-04-12
4444,경기,하남시,2,2,0,4,3,0,2018-05-12
4445,경기,하남시,2,1,1,4,4,0,2018-06-12
4446,경기,하남시,1,0,1,2,2,0,2018-07-12
4447,경기,하남시,1,0,0,1,1,0,2018-08-12
4448,경기,하남시,1,0,0,1,1,0,2018-09-12
4449,경기,하남시,5,0,0,5,4,0,2018-10-12
4450,경기,하남시,4,0,1,5,4,0,2018-11-12
4451,경기,하남시,4,0,0,4,3,0,2018-12-12
4452,경기,화성시,10,1,6,17,12,1,2018-01-12
4453,경기,화성시,4,0,3,7,5,0,2018-02-12
4454,경기,화성시,5,0,3,8,4,0,2018-03-12
4455,경기,화성시,12,1,3,16,11,0,2018-04-12
4456,경기,화성시,6,1,3,10,8,0,2018-05-12
4457,경기,화성시,10,0,1,11,7,1,2018-06-12
4458,경기,화성시,13,0,2,15,13,0,2018-07-12
4459,경기,화성시,3,0,2,5,5,1,2018-08-12
4460,경기,화성시,12,1,4,17,12,0,2018-09-12
4461,경기,화성시,9,0,2,11,8,0,2018-10-12
4462,경기,화성시,10,1,0,11,9,0,2018-11-12
4463,경기,화성시,7,0,1,8,5,0,2018-12-12
4464,경기,가평군,2,0,0,2,1,0,2018-01-13
4465,경기,가평군,0,0,0,0,0,0,2018-02-13
4466,경기,가평군,1,0,0,1,1,0,2018-03-13
4467,경기,가평군,0,0,0,0,0,0,2018-04-13
4468,경기,가평군,6,0,2,8,4,2,2018-05-13
4469,경기,가평군,0,0,0,0,0,0,2018-06-13
4470,경기,가평군,1,0,0,1,1,0,2018-07-13
4471,경기,가평군,2,0,0,2,2,0,2018-08-13
4472,경기,가평군,0,0,0,0,0,0,2018-09-13
4473,경기,가평군,8,0,4,12,4,0,2018-10-13
4474,경기,가평군,0,0,0,0,0,0,2018-11-13
4475,경기,가평군,4,0,0,4,2,0,2018-12-13
4476,경기,고양시,3,0,1,4,3,0,2018-01-13
4477,경기,고양시,11,4,13,28,22,0,2018-02-13
4478,경기,고양시,19,2,9,30,15,0,2018-03-13
4479,경기,고양시,16,1,2,19,13,0,2018-04-13
4480,경기,고양시,6,0,3,9,7,0,2018-05-13
4481,경기,고양시,4,4,4,12,10,0,2018-06-13
4482,경기,고양시,17,1,10,28,22,0,2018-07-13
4483,경기,고양시,19,1,1,21,10,0,2018-08-13
4484,경기,고양시,12,1,4,17,12,0,2018-09-13
4485,경기,고양시,8,2,1,11,8,1,2018-10-13
4486,경기,고양시,14,2,2,18,11,0,2018-11-13
4487,경기,고양시,10,0,0,10,8,0,2018-12-13
4488,경기,과천시,0,0,0,0,0,0,2018-01-13
4489,경기,과천시,6,0,0,6,2,0,2018-02-13
4490,경기,과천시,1,0,0,1,1,0,2018-03-13
4491,경기,과천시,0,0,0,0,0,0,2018-04-13
4492,경기,과천시,1,1,2,4,2,0,2018-05-13
4493,경기,과천시,5,3,2,10,2,0,2018-06-13
4494,경기,과천시,0,0,0,0,0,0,2018-07-13
4495,경기,과천시,0,0,1,1,1,0,2018-08-13
4496,경기,과천시,0,1,0,1,1,0,2018-09-13
4497,경기,과천시,0,0,0,0,0,0,2018-10-13
4498,경기,과천시,1,1,0,2,1,0,2018-11-13
4499,경기,과천시,0,0,1,1,1,0,2018-12-13
4500,경기,광명시,2,0,0,2,2,0,2018-01-13
4501,경기,광명시,5,1,0,6,3,0,2018-02-13
4502,경기,광명시,2,1,0,3,3,0,2018-03-13
4503,경기,광명시,4,3,0,7,6,0,2018-04-13
4504,경기,광명시,1,1,1,3,3,0,2018-05-13
4505,경기,광명시,3,3,0,6,4,0,2018-06-13
4506,경기,광명시,4,1,2,7,3,0,2018-07-13
4507,경기,광명시,3,1,1,5,5,0,2018-08-13
4508,경기,광명시,2,0,0,2,2,0,2018-09-13
4509,경기,광명시,0,0,0,0,0,0,2018-10-13
4510,경기,광명시,2,0,0,2,2,0,2018-11-13
4511,경기,광명시,4,2,2,8,6,0,2018-12-13
4512,경기,광주시,1,0,0,1,1,0,2018-01-13
4513,경기,광주시,12,1,3,16,7,0,2018-02-13
4514,경기,광주시,3,0,3,6,5,0,2018-03-13
4515,경기,광주시,14,1,4,19,9,0,2018-04-13
4516,경기,광주시,0,1,1,2,2,0,2018-05-13
4517,경기,광주시,5,0,0,5,4,0,2018-06-13
4518,경기,광주시,2,0,1,3,3,0,2018-07-13
4519,경기,광주시,7,0,2,9,6,0,2018-08-13
4520,경기,광주시,1,0,3,4,4,0,2018-09-13
4521,경기,광주시,10,1,5,16,10,0,2018-10-13
4522,경기,광주시,1,0,0,1,1,0,2018-11-13
4523,경기,광주시,8,0,0,8,5,0,2018-12-13
4524,경기,구리시,2,0,1,3,2,0,2018-01-13
4525,경기,구리시,2,0,0,2,2,0,2018-02-13
4526,경기,구리시,2,0,0,2,2,0,2018-03-13
4527,경기,구리시,1,0,0,1,1,0,2018-04-13
4528,경기,구리시,0,0,0,0,0,0,2018-05-13
4529,경기,구리시,5,0,0,5,3,0,2018-06-13
4530,경기,구리시,1,0,2,3,2,0,2018-07-13
4531,경기,구리시,1,0,0,1,1,0,2018-08-13
4532,경기,구리시,1,0,2,3,3,0,2018-09-13
4533,경기,구리시,2,1,1,4,2,0,2018-10-13
4534,경기,구리시,3,0,0,3,3,0,2018-11-13
4535,경기,구리시,1,3,0,4,2,0,2018-12-13
4536,경기,군포시,3,1,0,4,3,0,2018-01-13
4537,경기,군포시,0,0,0,0,0,0,2018-02-13
4538,경기,군포시,1,0,0,1,1,0,2018-03-13
4539,경기,군포시,1,1,0,2,2,0,2018-04-13
4540,경기,군포시,0,1,0,1,1,0,2018-05-13
4541,경기,군포시,0,1,0,1,1,0,2018-06-13
4542,경기,군포시,5,0,0,5,2,0,2018-07-13
4543,경기,군포시,0,0,0,0,0,0,2018-08-13
4544,경기,군포시,2,0,0,2,2,0,2018-09-13
4545,경기,군포시,0,0,0,0,0,0,2018-10-13
4546,경기,군포시,1,0,1,2,2,0,2018-11-13
4547,경기,군포시,1,0,0,1,1,0,2018-12-13
4548,경기,김포시,9,0,0,9,2,0,2018-01-13
4549,경기,김포시,9,2,4,15,9,0,2018-02-13
4550,경기,김포시,14,1,3,18,6,0,2018-03-13
4551,경기,김포시,5,2,1,8,6,0,2018-04-13
4552,경기,김포시,10,1,2,13,6,0,2018-05-13
4553,경기,김포시,4,0,3,7,3,0,2018-06-13
4554,경기,김포시,3,0,1,4,4,0,2018-07-13
4555,경기,김포시,4,0,2,6,3,0,2018-08-13
4556,경기,김포시,2,0,1,3,2,0,2018-09-13
4557,경기,김포시,7,3,3,13,6,0,2018-10-13
4558,경기,김포시,2,0,2,4,5,1,2018-11-13
4559,경기,김포시,8,0,2,10,6,0,2018-12-13
4560,경기,남양주시,7,0,0,7,6,0,2018-01-13
4561,경기,남양주시,5,3,2,10,7,1,2018-02-13
4562,경기,남양주시,2,1,2,5,4,0,2018-03-13
4563,경기,남양주시,3,3,1,7,6,0,2018-04-13
4564,경기,남양주시,4,0,1,5,3,0,2018-05-13
4565,경기,남양주시,22,3,4,29,16,0,2018-06-13
4566,경기,남양주시,8,1,4,13,9,0,2018-07-13
4567,경기,남양주시,10,0,2,12,10,1,2018-08-13
4568,경기,남양주시,5,0,0,5,4,0,2018-09-13
4569,경기,남양주시,8,2,2,12,9,0,2018-10-13
4570,경기,남양주시,4,0,0,4,4,1,2018-11-13
4571,경기,남양주시,7,0,5,12,10,0,2018-12-13
4572,경기,동두천시,0,0,0,0,0,0,2018-01-13
4573,경기,동두천시,0,0,1,1,1,0,2018-02-13
4574,경기,동두천시,0,0,0,0,0,0,2018-03-13
4575,경기,동두천시,0,0,0,0,0,0,2018-04-13
4576,경기,동두천시,3,0,0,3,2,0,2018-05-13
4577,경기,동두천시,0,0,1,1,1,0,2018-06-13
4578,경기,동두천시,2,1,1,4,3,0,2018-07-13
4579,경기,동두천시,3,0,1,4,3,1,2018-08-13
4580,경기,동두천시,0,0,1,1,1,0,2018-09-13
4581,경기,동두천시,5,0,2,7,3,1,2018-10-13
4582,경기,동두천시,1,0,1,2,1,0,2018-11-13
4583,경기,동두천시,0,0,0,0,0,0,2018-12-13
4584,경기,부천시,7,0,2,9,6,0,2018-01-13
4585,경기,부천시,10,2,2,14,10,0,2018-02-13
4586,경기,부천시,8,0,1,9,7,0,2018-03-13
4587,경기,부천시,4,1,3,8,7,0,2018-04-13
4588,경기,부천시,2,1,3,6,4,0,2018-05-13
4589,경기,부천시,8,0,0,8,5,0,2018-06-13
4590,경기,부천시,5,0,4,9,9,0,2018-07-13
4591,경기,부천시,13,3,3,19,11,0,2018-08-13
4592,경기,부천시,19,2,2,23,15,0,2018-09-13
4593,경기,부천시,10,0,2,12,9,0,2018-10-13
4594,경기,부천시,12,3,2,17,13,0,2018-11-13
4595,경기,부천시,18,1,1,20,12,0,2018-12-13
4596,경기,성남시,12,0,1,13,8,0,2018-01-13
4597,경기,성남시,27,4,12,43,25,0,2018-02-13
4598,경기,성남시,12,2,1,15,13,0,2018-03-13
4599,경기,성남시,10,0,5,15,13,0,2018-04-13
4600,경기,성남시,12,3,3,18,12,0,2018-05-13
4601,경기,성남시,15,1,5,21,13,0,2018-06-13
4602,경기,성남시,1,0,1,2,2,0,2018-07-13
4603,경기,성남시,10,2,2,14,10,0,2018-08-13
4604,경기,성남시,10,4,3,17,11,0,2018-09-13
4605,경기,성남시,12,2,4,18,10,0,2018-10-13
4606,경기,성남시,6,0,4,10,11,1,2018-11-13
4607,경기,성남시,16,1,8,25,22,0,2018-12-13
4608,경기,수원시,16,5,0,21,14,0,2018-01-13
4609,경기,수원시,15,2,6,23,17,0,2018-02-13
4610,경기,수원시,12,3,3,18,13,0,2018-03-13
4611,경기,수원시,8,2,4,14,10,0,2018-04-13
4612,경기,수원시,14,1,6,21,17,0,2018-05-13
4613,경기,수원시,16,1,3,20,14,0,2018-06-13
4614,경기,수원시,14,0,2,16,13,0,2018-07-13
4615,경기,수원시,11,6,11,28,15,0,2018-08-13
4616,경기,수원시,5,1,3,9,9,0,2018-09-13
4617,경기,수원시,14,1,10,25,12,0,2018-10-13
4618,경기,수원시,10,3,2,15,10,0,2018-11-13
4619,경기,수원시,33,1,2,36,21,0,2018-12-13
4620,경기,시흥시,12,0,1,13,8,0,2018-01-13
4621,경기,시흥시,7,1,8,16,12,0,2018-02-13
4622,경기,시흥시,7,0,0,7,6,0,2018-03-13
4623,경기,시흥시,3,0,4,7,6,0,2018-04-13
4624,경기,시흥시,5,0,1,6,5,0,2018-05-13
4625,경기,시흥시,11,0,2,13,8,0,2018-06-13
4626,경기,시흥시,5,3,0,8,5,1,2018-07-13
4627,경기,시흥시,5,0,0,5,4,0,2018-08-13
4628,경기,시흥시,1,0,0,1,1,0,2018-09-13
4629,경기,시흥시,9,0,0,9,5,0,2018-10-13
4630,경기,시흥시,8,1,2,11,9,0,2018-11-13
4631,경기,시흥시,8,1,2,11,4,0,2018-12-13
4632,경기,안산시,13,0,4,17,10,0,2018-01-13
4633,경기,안산시,15,2,3,20,17,0,2018-02-13
4634,경기,안산시,8,0,4,12,9,0,2018-03-13
4635,경기,안산시,10,0,4,14,11,0,2018-04-13
4636,경기,안산시,6,0,1,7,6,1,2018-05-13
4637,경기,안산시,9,0,4,13,8,0,2018-06-13
4638,경기,안산시,8,1,1,10,7,0,2018-07-13
4639,경기,안산시,20,3,6,29,15,0,2018-08-13
4640,경기,안산시,15,0,7,22,12,0,2018-09-13
4641,경기,안산시,7,1,1,9,8,0,2018-10-13
4642,경기,안산시,14,0,0,14,9,0,2018-11-13
4643,경기,안산시,15,1,1,17,14,0,2018-12-13
4644,경기,안성시,4,0,0,4,2,0,2018-01-13
4645,경기,안성시,9,0,0,9,5,0,2018-02-13
4646,경기,안성시,1,0,0,1,1,0,2018-03-13
4647,경기,안성시,0,0,1,1,1,0,2018-04-13
4648,경기,안성시,0,0,3,3,3,0,2018-05-13
4649,경기,안성시,2,1,0,3,3,0,2018-06-13
4650,경기,안성시,1,0,1,2,1,0,2018-07-13
4651,경기,안성시,0,0,1,1,1,0,2018-08-13
4652,경기,안성시,5,0,1,6,4,0,2018-09-13
4653,경기,안성시,6,0,3,9,7,0,2018-10-13
4654,경기,안성시,5,0,2,7,3,0,2018-11-13
4655,경기,안성시,3,3,0,6,4,0,2018-12-13
4656,경기,안양시,5,0,3,8,4,0,2018-01-13
4657,경기,안양시,13,0,1,14,8,0,2018-02-13
4658,경기,안양시,5,0,2,7,6,0,2018-03-13
4659,경기,안양시,10,0,1,11,7,0,2018-04-13
4660,경기,안양시,3,3,2,8,4,0,2018-05-13
4661,경기,안양시,2,0,4,6,5,0,2018-06-13
4662,경기,안양시,1,0,2,3,2,0,2018-07-13
4663,경기,안양시,12,0,3,15,7,0,2018-08-13
4664,경기,안양시,3,1,1,5,5,0,2018-09-13
4665,경기,안양시,16,1,1,18,4,0,2018-10-13
4666,경기,안양시,3,0,2,5,2,0,2018-11-13
4667,경기,안양시,8,1,3,12,7,0,2018-12-13
4668,경기,양주시,6,0,0,6,3,0,2018-01-13
4669,경기,양주시,3,0,0,3,2,0,2018-02-13
4670,경기,양주시,0,0,0,0,0,0,2018-03-13
4671,경기,양주시,1,0,0,1,1,0,2018-04-13
4672,경기,양주시,0,1,0,1,1,0,2018-05-13
4673,경기,양주시,1,0,1,2,2,0,2018-06-13
4674,경기,양주시,0,0,0,0,0,0,2018-07-13
4675,경기,양주시,2,0,1,3,2,0,2018-08-13
4676,경기,양주시,1,1,2,4,3,0,2018-09-13
4677,경기,양주시,7,0,2,9,4,0,2018-10-13
4678,경기,양주시,10,0,0,10,9,0,2018-11-13
4679,경기,양주시,4,0,1,5,4,0,2018-12-13
4680,경기,양평군,1,0,1,2,2,0,2018-01-13
4681,경기,양평군,2,0,0,2,1,0,2018-02-13
4682,경기,양평군,0,1,0,1,1,0,2018-03-13
4683,경기,양평군,1,0,0,1,1,0,2018-04-13
4684,경기,양평군,1,0,1,2,2,0,2018-05-13
4685,경기,양평군,0,0,0,0,0,0,2018-06-13
4686,경기,양평군,0,0,0,0,0,0,2018-07-13
4687,경기,양평군,1,0,1,2,2,0,2018-08-13
4688,경기,양평군,2,0,2,4,3,0,2018-09-13
4689,경기,양평군,2,0,0,2,1,0,2018-10-13
4690,경기,양평군,3,0,3,6,3,0,2018-11-13
4691,경기,양평군,0,0,0,0,0,0,2018-12-13
4692,경기,여주시,0,0,0,0,0,0,2018-01-13
4693,경기,여주시,1,0,0,1,1,0,2018-02-13
4694,경기,여주시,1,0,0,1,1,0,2018-03-13
4695,경기,여주시,2,0,0,2,1,0,2018-04-13
4696,경기,여주시,3,0,0,3,1,0,2018-05-13
4697,경기,여주시,0,0,0,0,0,0,2018-06-13
4698,경기,여주시,0,0,0,0,0,0,2018-07-13
4699,경기,여주시,4,0,1,5,3,0,2018-08-13
4700,경기,여주시,3,0,1,4,3,0,2018-09-13
4701,경기,여주시,0,0,1,1,1,0,2018-10-13
4702,경기,여주시,1,1,1,3,3,0,2018-11-13
4703,경기,여주시,1,1,0,2,2,0,2018-12-13
4704,경기,연천군,0,0,0,0,0,0,2018-01-13
4705,경기,연천군,0,0,1,1,1,0,2018-02-13
4706,경기,연천군,0,0,0,0,0,0,2018-03-13
4707,경기,연천군,0,0,0,0,0,0,2018-04-13
4708,경기,연천군,0,0,0,0,0,0,2018-05-13
4709,경기,연천군,3,0,0,3,2,0,2018-06-13
4710,경기,연천군,3,0,0,3,2,0,2018-07-13
4711,경기,연천군,0,0,0,0,1,1,2018-08-13
4712,경기,연천군,1,0,0,1,1,0,2018-09-13
4713,경기,연천군,0,0,0,0,0,0,2018-10-13
4714,경기,연천군,0,0,0,0,0,0,2018-11-13
4715,경기,연천군,0,0,0,0,0,0,2018-12-13
4716,경기,오산시,7,0,0,7,3,0,2018-01-13
4717,경기,오산시,6,0,3,9,4,0,2018-02-13
4718,경기,오산시,3,3,1,7,5,0,2018-03-13
4719,경기,오산시,4,1,0,5,4,0,2018-04-13
4720,경기,오산시,1,0,0,1,1,0,2018-05-13
4721,경기,오산시,2,0,0,2,2,0,2018-06-13
4722,경기,오산시,1,0,0,1,1,0,2018-07-13
4723,경기,오산시,1,0,0,1,1,0,2018-08-13
4724,경기,오산시,1,0,1,2,2,0,2018-09-13
4725,경기,오산시,3,0,1,4,1,0,2018-10-13
4726,경기,오산시,1,0,2,3,3,0,2018-11-13
4727,경기,오산시,0,0,0,0,0,0,2018-12-13
4728,경기,용인시,3,1,2,6,6,0,2018-01-13
4729,경기,용인시,21,1,6,28,17,0,2018-02-13
4730,경기,용인시,8,0,3,11,7,0,2018-03-13
4731,경기,용인시,8,0,4,12,8,0,2018-04-13
4732,경기,용인시,3,1,2,6,3,0,2018-05-13
4733,경기,용인시,6,0,4,10,6,0,2018-06-13
4734,경기,용인시,6,2,3,11,9,0,2018-07-13
4735,경기,용인시,8,2,3,13,10,0,2018-08-13
4736,경기,용인시,4,4,1,9,6,0,2018-09-13
4737,경기,용인시,11,1,1,13,8,0,2018-10-13
4738,경기,용인시,11,2,5,18,11,0,2018-11-13
4739,경기,용인시,14,5,4,23,16,0,2018-12-13
4740,경기,의왕시,6,0,0,6,4,0,2018-01-13
4741,경기,의왕시,1,0,0,1,1,0,2018-02-13
4742,경기,의왕시,2,1,1,4,1,0,2018-03-13
4743,경기,의왕시,0,0,0,0,0,0,2018-04-13
4744,경기,의왕시,0,0,0,0,0,0,2018-05-13
4745,경기,의왕시,0,0,3,3,1,0,2018-06-13
4746,경기,의왕시,1,0,0,1,1,0,2018-07-13
4747,경기,의왕시,3,0,1,4,4,0,2018-08-13
4748,경기,의왕시,2,0,1,3,2,0,2018-09-13
4749,경기,의왕시,1,1,0,2,1,0,2018-10-13
4750,경기,의왕시,4,0,1,5,3,0,2018-11-13
4751,경기,의왕시,1,0,0,1,1,0,2018-12-13
4752,경기,의정부시,2,0,0,2,2,0,2018-01-13
4753,경기,의정부시,2,1,5,8,7,0,2018-02-13
4754,경기,의정부시,0,0,1,1,1,0,2018-03-13
4755,경기,의정부시,7,0,1,8,7,0,2018-04-13
4756,경기,의정부시,4,0,3,7,6,0,2018-05-13
4757,경기,의정부시,0,1,1,2,2,0,2018-06-13
4758,경기,의정부시,5,0,0,5,2,0,2018-07-13
4759,경기,의정부시,0,0,1,1,1,0,2018-08-13
4760,경기,의정부시,3,0,3,6,5,0,2018-09-13
4761,경기,의정부시,2,0,0,2,1,0,2018-10-13
4762,경기,의정부시,9,3,1,13,9,0,2018-11-13
4763,경기,의정부시,2,2,2,6,4,0,2018-12-13
4764,경기,이천시,2,0,1,3,3,0,2018-01-13
4765,경기,이천시,6,0,2,8,5,0,2018-02-13
4766,경기,이천시,1,0,0,1,1,0,2018-03-13
4767,경기,이천시,4,0,0,4,3,0,2018-04-13
4768,경기,이천시,1,0,1,2,2,0,2018-05-13
4769,경기,이천시,1,0,0,1,1,0,2018-06-13
4770,경기,이천시,4,0,2,6,4,0,2018-07-13
4771,경기,이천시,1,0,1,2,2,0,2018-08-13
4772,경기,이천시,2,0,0,2,1,0,2018-09-13
4773,경기,이천시,3,1,2,6,5,0,2018-10-13
4774,경기,이천시,5,2,2,9,5,0,2018-11-13
4775,경기,이천시,2,0,1,3,2,0,2018-12-13
4776,경기,파주시,8,0,4,12,8,0,2018-01-13
4777,경기,파주시,5,0,2,7,4,0,2018-02-13
4778,경기,파주시,1,2,2,5,2,0,2018-03-13
4779,경기,파주시,10,1,3,14,8,0,2018-04-13
4780,경기,파주시,0,0,0,0,0,0,2018-05-13
4781,경기,파주시,4,0,3,7,6,0,2018-06-13
4782,경기,파주시,6,1,1,8,6,0,2018-07-13
4783,경기,파주시,1,0,2,3,2,0,2018-08-13
4784,경기,파주시,3,0,2,5,4,0,2018-09-13
4785,경기,파주시,2,0,0,2,1,0,2018-10-13
4786,경기,파주시,4,0,1,5,5,0,2018-11-13
4787,경기,파주시,18,1,4,23,12,0,2018-12-13
4788,경기,평택시,8,2,1,11,5,0,2018-01-13
4789,경기,평택시,23,3,1,27,18,0,2018-02-13
4790,경기,평택시,4,1,1,6,6,0,2018-03-13
4791,경기,평택시,3,2,3,8,7,0,2018-04-13
4792,경기,평택시,1,1,3,5,3,0,2018-05-13
4793,경기,평택시,5,2,3,10,6,0,2018-06-13
4794,경기,평택시,14,5,2,21,13,0,2018-07-13
4795,경기,평택시,13,2,3,18,10,0,2018-08-13
4796,경기,평택시,13,2,3,18,11,0,2018-09-13
4797,경기,평택시,7,0,3,10,9,0,2018-10-13
4798,경기,평택시,11,1,1,13,10,0,2018-11-13
4799,경기,평택시,4,1,2,7,6,0,2018-12-13
4800,경기,포천시,1,0,0,1,1,0,2018-01-13
4801,경기,포천시,3,1,1,5,2,0,2018-02-13
4802,경기,포천시,2,0,2,4,3,0,2018-03-13
4803,경기,포천시,1,0,1,2,2,0,2018-04-13
4804,경기,포천시,4,0,1,5,3,0,2018-05-13
4805,경기,포천시,2,0,8,10,3,0,2018-06-13
4806,경기,포천시,5,0,1,6,4,1,2018-07-13
4807,경기,포천시,2,0,0,2,2,0,2018-08-13
4808,경기,포천시,5,0,0,5,3,0,2018-09-13
4809,경기,포천시,1,0,0,1,1,0,2018-10-13
4810,경기,포천시,0,0,0,0,0,0,2018-11-13
4811,경기,포천시,2,2,0,4,2,0,2018-12-13
4812,경기,하남시,3,3,0,6,4,0,2018-01-13
4813,경기,하남시,6,0,1,7,6,0,2018-02-13
4814,경기,하남시,1,0,2,3,3,0,2018-03-13
4815,경기,하남시,2,1,2,5,5,0,2018-04-13
4816,경기,하남시,0,0,0,0,0,0,2018-05-13
4817,경기,하남시,4,3,2,9,6,0,2018-06-13
4818,경기,하남시,3,0,0,3,3,0,2018-07-13
4819,경기,하남시,0,1,2,3,3,0,2018-08-13
4820,경기,하남시,4,0,1,5,4,0,2018-09-13
4821,경기,하남시,2,1,1,4,4,0,2018-10-13
4822,경기,하남시,3,0,1,4,3,0,2018-11-13
4823,경기,하남시,3,0,1,4,4,0,2018-12-13
4824,경기,화성시,10,0,3,13,8,0,2018-01-13
4825,경기,화성시,8,0,5,13,10,0,2018-02-13
4826,경기,화성시,5,1,3,9,7,0,2018-03-13
4827,경기,화성시,4,1,1,6,5,0,2018-04-13
4828,경기,화성시,9,0,2,11,6,0,2018-05-13
4829,경기,화성시,5,0,4,9,6,0,2018-06-13
4830,경기,화성시,19,0,10,29,14,0,2018-07-13
4831,경기,화성시,4,10,1,15,6,0,2018-08-13
4832,경기,화성시,6,0,4,10,8,0,2018-09-13
4833,경기,화성시,10,0,0,10,6,0,2018-10-13
4834,경기,화성시,13,1,5,19,12,0,2018-11-13
4835,경기,화성시,12,0,1,13,9,0,2018-12-13
4836,경기,가평군,1,0,2,3,2,0,2018-01-14
4837,경기,가평군,0,0,0,0,0,0,2018-02-14
4838,경기,가평군,0,0,0,0,0,0,2018-03-14
4839,경기,가평군,0,0,0,0,0,0,2018-04-14
4840,경기,가평군,0,0,0,0,0,0,2018-05-14
4841,경기,가평군,0,0,0,0,0,0,2018-06-14
4842,경기,가평군,1,0,2,3,2,0,2018-07-14
4843,경기,가평군,1,0,1,2,2,0,2018-08-14
4844,경기,가평군,0,1,0,1,1,0,2018-09-14
4845,경기,가평군,2,1,0,3,2,0,2018-10-14
4846,경기,가평군,1,0,0,1,1,0,2018-11-14
4847,경기,가평군,0,0,5,5,2,0,2018-12-14
4848,경기,고양시,8,0,4,12,6,1,2018-01-14
4849,경기,고양시,15,1,2,18,13,0,2018-02-14
4850,경기,고양시,9,1,4,14,10,0,2018-03-14
4851,경기,고양시,7,3,4,14,8,0,2018-04-14
4852,경기,고양시,4,0,1,5,2,0,2018-05-14
4853,경기,고양시,6,0,1,7,6,0,2018-06-14
4854,경기,고양시,6,4,1,11,9,0,2018-07-14
4855,경기,고양시,6,3,2,11,11,0,2018-08-14
4856,경기,고양시,5,0,2,7,7,0,2018-09-14
4857,경기,고양시,17,1,4,22,13,0,2018-10-14
4858,경기,고양시,8,1,4,13,11,0,2018-11-14
4859,경기,고양시,16,4,3,23,16,0,2018-12-14
4860,경기,과천시,0,0,1,1,1,0,2018-01-14
4861,경기,과천시,0,0,0,0,0,0,2018-02-14
4862,경기,과천시,0,0,0,0,0,0,2018-03-14
4863,경기,과천시,0,0,0,0,0,0,2018-04-14
4864,경기,과천시,0,0,0,0,0,0,2018-05-14
4865,경기,과천시,0,0,0,0,0,0,2018-06-14
4866,경기,과천시,0,0,0,0,0,0,2018-07-14
4867,경기,과천시,0,0,0,0,0,0,2018-08-14
4868,경기,과천시,2,0,2,4,3,0,2018-09-14
4869,경기,과천시,0,0,0,0,0,0,2018-10-14
4870,경기,과천시,0,1,0,1,1,0,2018-11-14
4871,경기,과천시,1,0,0,1,1,0,2018-12-14
4872,경기,광명시,7,3,0,10,5,0,2018-01-14
4873,경기,광명시,4,2,0,6,4,0,2018-02-14
4874,경기,광명시,2,0,3,5,4,0,2018-03-14
4875,경기,광명시,4,0,0,4,2,0,2018-04-14
4876,경기,광명시,1,0,1,2,2,0,2018-05-14
4877,경기,광명시,3,2,0,5,3,0,2018-06-14
4878,경기,광명시,1,1,0,2,2,0,2018-07-14
4879,경기,광명시,5,2,1,8,5,0,2018-08-14
4880,경기,광명시,1,2,0,3,3,0,2018-09-14
4881,경기,광명시,1,0,0,1,1,0,2018-10-14
4882,경기,광명시,2,0,0,2,2,0,2018-11-14
4883,경기,광명시,0,2,0,2,2,0,2018-12-14
4884,경기,광주시,3,0,0,3,2,0,2018-01-14
4885,경기,광주시,8,0,0,8,5,0,2018-02-14
4886,경기,광주시,6,3,1,10,7,0,2018-03-14
4887,경기,광주시,8,0,2,10,5,0,2018-04-14
4888,경기,광주시,7,0,0,7,4,0,2018-05-14
4889,경기,광주시,3,0,2,5,5,0,2018-06-14
4890,경기,광주시,1,0,0,1,1,0,2018-07-14
4891,경기,광주시,3,1,0,4,3,0,2018-08-14
4892,경기,광주시,3,0,3,6,4,0,2018-09-14
4893,경기,광주시,1,0,1,2,2,0,2018-10-14
4894,경기,광주시,6,0,1,7,6,0,2018-11-14
4895,경기,광주시,11,0,3,14,8,0,2018-12-14
4896,경기,구리시,1,0,0,1,1,0,2018-01-14
4897,경기,구리시,10,0,0,10,6,0,2018-02-14
4898,경기,구리시,9,0,0,9,3,0,2018-03-14
4899,경기,구리시,1,0,0,1,1,0,2018-04-14
4900,경기,구리시,1,1,1,3,2,0,2018-05-14
4901,경기,구리시,2,0,0,2,2,0,2018-06-14
4902,경기,구리시,0,0,0,0,0,0,2018-07-14
4903,경기,구리시,2,0,0,2,2,0,2018-08-14
4904,경기,구리시,1,1,0,2,1,0,2018-09-14
4905,경기,구리시,0,1,0,1,1,0,2018-10-14
4906,경기,구리시,2,0,1,3,1,0,2018-11-14
4907,경기,구리시,3,1,0,4,4,0,2018-12-14
4908,경기,군포시,0,0,2,2,2,0,2018-01-14
4909,경기,군포시,5,0,2,7,5,0,2018-02-14
4910,경기,군포시,3,1,1,5,3,0,2018-03-14
4911,경기,군포시,0,0,3,3,2,0,2018-04-14
4912,경기,군포시,2,0,0,2,1,0,2018-05-14
4913,경기,군포시,1,0,2,3,2,0,2018-06-14
4914,경기,군포시,2,0,2,4,3,0,2018-07-14
4915,경기,군포시,1,0,1,2,2,0,2018-08-14
4916,경기,군포시,2,0,0,2,2,0,2018-09-14
4917,경기,군포시,0,0,0,0,0,0,2018-10-14
4918,경기,군포시,1,2,0,3,3,0,2018-11-14
4919,경기,군포시,5,0,0,5,2,0,2018-12-14
4920,경기,김포시,5,1,1,7,3,0,2018-01-14
4921,경기,김포시,7,0,4,11,7,0,2018-02-14
4922,경기,김포시,3,0,4,7,6,0,2018-03-14
4923,경기,김포시,3,0,0,3,3,0,2018-04-14
4924,경기,김포시,4,0,4,8,5,0,2018-05-14
4925,경기,김포시,3,0,0,3,2,0,2018-06-14
4926,경기,김포시,1,0,1,2,2,0,2018-07-14
4927,경기,김포시,6,0,3,9,5,0,2018-08-14
4928,경기,김포시,3,1,1,5,5,1,2018-09-14
4929,경기,김포시,2,0,1,3,3,0,2018-10-14
4930,경기,김포시,8,1,1,10,8,0,2018-11-14
4931,경기,김포시,3,1,1,5,3,1,2018-12-14
4932,경기,남양주시,2,0,6,8,6,0,2018-01-14
4933,경기,남양주시,11,2,4,17,10,0,2018-02-14
4934,경기,남양주시,11,1,0,12,7,0,2018-03-14
4935,경기,남양주시,12,0,1,13,9,0,2018-04-14
4936,경기,남양주시,10,2,0,12,7,0,2018-05-14
4937,경기,남양주시,6,5,4,15,7,0,2018-06-14
4938,경기,남양주시,20,9,5,34,16,0,2018-07-14
4939,경기,남양주시,4,3,2,9,6,0,2018-08-14
4940,경기,남양주시,6,0,2,8,5,0,2018-09-14
4941,경기,남양주시,3,0,1,4,4,0,2018-10-14
4942,경기,남양주시,9,0,5,14,9,0,2018-11-14
4943,경기,남양주시,9,2,4,15,11,2,2018-12-14
4944,경기,동두천시,0,0,0,0,0,0,2018-01-14
4945,경기,동두천시,1,0,0,1,1,0,2018-02-14
4946,경기,동두천시,0,0,0,0,0,0,2018-03-14
4947,경기,동두천시,0,0,0,0,0,0,2018-04-14
4948,경기,동두천시,0,0,0,0,0,0,2018-05-14
4949,경기,동두천시,1,1,0,2,2,0,2018-06-14
4950,경기,동두천시,1,1,0,2,2,0,2018-07-14
4951,경기,동두천시,0,0,0,0,0,0,2018-08-14
4952,경기,동두천시,3,0,1,4,4,1,2018-09-14
4953,경기,동두천시,3,0,0,3,1,0,2018-10-14
4954,경기,동두천시,1,0,1,2,2,0,2018-11-14
4955,경기,동두천시,3,0,0,3,2,0,2018-12-14
4956,경기,부천시,5,0,3,8,7,0,2018-01-14
4957,경기,부천시,11,0,3,14,11,0,2018-02-14
4958,경기,부천시,11,3,2,16,8,0,2018-03-14
4959,경기,부천시,10,2,1,13,6,0,2018-04-14
4960,경기,부천시,7,2,5,14,10,0,2018-05-14
4961,경기,부천시,10,0,2,12,10,0,2018-06-14
4962,경기,부천시,14,0,2,16,11,0,2018-07-14
4963,경기,부천시,19,0,3,22,11,0,2018-08-14
4964,경기,부천시,10,2,5,17,12,1,2018-09-14
4965,경기,부천시,10,1,5,16,11,0,2018-10-14
4966,경기,부천시,4,0,1,5,4,0,2018-11-14
4967,경기,부천시,7,0,2,9,8,0,2018-12-14
4968,경기,성남시,17,0,5,22,12,0,2018-01-14
4969,경기,성남시,17,0,8,25,15,0,2018-02-14
4970,경기,성남시,14,4,4,22,15,0,2018-03-14
4971,경기,성남시,8,0,1,9,8,1,2018-04-14
4972,경기,성남시,8,1,5,14,10,0,2018-05-14
4973,경기,성남시,8,2,7,17,14,0,2018-06-14
4974,경기,성남시,13,2,8,23,16,0,2018-07-14
4975,경기,성남시,20,1,2,23,13,0,2018-08-14
4976,경기,성남시,16,0,3,19,15,0,2018-09-14
4977,경기,성남시,6,2,6,14,11,0,2018-10-14
4978,경기,성남시,14,2,7,23,14,0,2018-11-14
4979,경기,성남시,15,1,5,21,14,0,2018-12-14
4980,경기,수원시,12,0,6,18,12,0,2018-01-14
4981,경기,수원시,20,2,1,23,18,0,2018-02-14
4982,경기,수원시,11,0,6,17,13,0,2018-03-14
4983,경기,수원시,20,4,3,27,17,1,2018-04-14
4984,경기,수원시,15,0,5,20,13,0,2018-05-14
4985,경기,수원시,13,0,1,14,11,0,2018-06-14
4986,경기,수원시,5,1,3,9,7,0,2018-07-14
4987,경기,수원시,9,1,3,13,9,0,2018-08-14
4988,경기,수원시,18,1,8,27,22,0,2018-09-14
4989,경기,수원시,9,2,5,16,11,0,2018-10-14
4990,경기,수원시,12,5,5,22,11,0,2018-11-14
4991,경기,수원시,7,0,4,11,8,0,2018-12-14
4992,경기,시흥시,11,0,0,11,8,0,2018-01-14
4993,경기,시흥시,9,0,2,11,9,0,2018-02-14
4994,경기,시흥시,3,0,4,7,6,0,2018-03-14
4995,경기,시흥시,8,0,2,10,7,0,2018-04-14
4996,경기,시흥시,6,0,1,7,4,0,2018-05-14
4997,경기,시흥시,10,1,2,13,9,1,2018-06-14
4998,경기,시흥시,11,0,3,14,11,0,2018-07-14
4999,경기,시흥시,6,0,2,8,7,0,2018-08-14
5000,경기,시흥시,3,4,2,9,8,0,2018-09-14
5001,경기,시흥시,3,0,2,5,4,0,2018-10-14
5002,경기,시흥시,13,1,1,15,12,0,2018-11-14
5003,경기,시흥시,3,1,1,5,5,0,2018-12-14
5004,경기,안산시,11,1,5,17,13,0,2018-01-14
5005,경기,안산시,23,0,3,26,14,0,2018-02-14
5006,경기,안산시,17,1,4,22,13,0,2018-03-14
5007,경기,안산시,19,1,3,23,15,0,2018-04-14
5008,경기,안산시,13,0,8,21,17,0,2018-05-14
5009,경기,안산시,16,5,3,24,14,0,2018-06-14
5010,경기,안산시,14,0,4,18,11,0,2018-07-14
5011,경기,안산시,12,0,1,13,11,0,2018-08-14
5012,경기,안산시,15,0,4,19,14,0,2018-09-14
5013,경기,안산시,3,0,1,4,3,0,2018-10-14
5014,경기,안산시,7,0,4,11,11,0,2018-11-14
5015,경기,안산시,11,0,2,13,10,0,2018-12-14
5016,경기,안성시,0,0,0,0,0,0,2018-01-14
5017,경기,안성시,2,1,1,4,3,0,2018-02-14
5018,경기,안성시,7,0,0,7,3,0,2018-03-14
5019,경기,안성시,4,0,5,9,4,0,2018-04-14
5020,경기,안성시,4,0,0,4,1,0,2018-05-14
5021,경기,안성시,1,0,0,1,2,1,2018-06-14
5022,경기,안성시,2,0,0,2,1,0,2018-07-14
5023,경기,안성시,5,0,0,5,2,0,2018-08-14
5024,경기,안성시,0,0,1,1,1,0,2018-09-14
5025,경기,안성시,5,0,1,6,2,0,2018-10-14
5026,경기,안성시,0,0,0,0,0,0,2018-11-14
5027,경기,안성시,2,0,0,2,1,0,2018-12-14
5028,경기,안양시,5,1,4,10,7,0,2018-01-14
5029,경기,안양시,6,0,2,8,7,0,2018-02-14
5030,경기,안양시,4,0,2,6,5,0,2018-03-14
5031,경기,안양시,1,0,1,2,2,0,2018-04-14
5032,경기,안양시,4,0,2,6,5,0,2018-05-14
5033,경기,안양시,3,0,1,4,4,0,2018-06-14
5034,경기,안양시,1,0,2,3,3,0,2018-07-14
5035,경기,안양시,5,0,1,6,5,0,2018-08-14
5036,경기,안양시,7,1,2,10,7,0,2018-09-14
5037,경기,안양시,1,0,0,1,1,0,2018-10-14
5038,경기,안양시,7,1,1,9,5,0,2018-11-14
5039,경기,안양시,3,0,0,3,2,0,2018-12-14
5040,경기,양주시,6,0,1,7,3,0,2018-01-14
5041,경기,양주시,4,0,1,5,3,1,2018-02-14
5042,경기,양주시,2,0,0,2,2,0,2018-03-14
5043,경기,양주시,4,1,0,5,3,0,2018-04-14
5044,경기,양주시,6,1,1,8,4,0,2018-05-14
5045,경기,양주시,3,1,0,4,4,0,2018-06-14
5046,경기,양주시,4,0,0,4,3,0,2018-07-14
5047,경기,양주시,5,1,1,7,6,0,2018-08-14
5048,경기,양주시,6,0,1,7,3,0,2018-09-14
5049,경기,양주시,1,0,1,2,1,0,2018-10-14
5050,경기,양주시,0,0,3,3,3,0,2018-11-14
5051,경기,양주시,5,0,0,5,4,0,2018-12-14
5052,경기,양평군,0,0,0,0,0,0,2018-01-14
5053,경기,양평군,5,0,1,6,2,0,2018-02-14
5054,경기,양평군,3,0,2,5,4,1,2018-03-14
5055,경기,양평군,0,3,0,3,1,0,2018-04-14
5056,경기,양평군,0,0,0,0,0,0,2018-05-14
5057,경기,양평군,0,0,0,0,0,0,2018-06-14
5058,경기,양평군,2,0,0,2,1,0,2018-07-14
5059,경기,양평군,0,0,0,0,0,0,2018-08-14
5060,경기,양평군,2,1,0,3,2,0,2018-09-14
5061,경기,양평군,3,0,0,3,1,0,2018-10-14
5062,경기,양평군,1,0,0,1,1,0,2018-11-14
5063,경기,양평군,1,4,0,5,2,0,2018-12-14
5064,경기,여주시,0,0,0,0,0,0,2018-01-14
5065,경기,여주시,2,0,0,2,2,0,2018-02-14
5066,경기,여주시,0,0,0,0,0,0,2018-03-14
5067,경기,여주시,7,0,0,7,2,0,2018-04-14
5068,경기,여주시,0,1,0,1,1,0,2018-05-14
5069,경기,여주시,3,0,1,4,3,0,2018-06-14
5070,경기,여주시,1,0,2,3,2,0,2018-07-14
5071,경기,여주시,4,0,1,5,2,0,2018-08-14
5072,경기,여주시,0,0,0,0,0,0,2018-09-14
5073,경기,여주시,1,2,1,4,2,0,2018-10-14
5074,경기,여주시,1,0,0,1,1,0,2018-11-14
5075,경기,여주시,0,0,0,0,0,0,2018-12-14
5076,경기,연천군,0,0,0,0,0,0,2018-01-14
5077,경기,연천군,0,0,0,0,0,0,2018-02-14
5078,경기,연천군,0,0,0,0,0,0,2018-03-14
5079,경기,연천군,1,0,0,1,1,0,2018-04-14
5080,경기,연천군,0,0,0,0,0,0,2018-05-14
5081,경기,연천군,0,1,0,1,1,0,2018-06-14
5082,경기,연천군,1,0,0,1,1,0,2018-07-14
5083,경기,연천군,0,0,0,0,0,0,2018-08-14
5084,경기,연천군,0,0,0,0,0,0,2018-09-14
5085,경기,연천군,0,0,0,0,0,0,2018-10-14
5086,경기,연천군,0,0,0,0,0,0,2018-11-14
5087,경기,연천군,0,0,0,0,0,0,2018-12-14
5088,경기,오산시,5,1,0,6,5,0,2018-01-14
5089,경기,오산시,2,0,2,4,4,0,2018-02-14
5090,경기,오산시,3,1,2,6,3,0,2018-03-14
5091,경기,오산시,1,0,0,1,1,0,2018-04-14
5092,경기,오산시,2,0,0,2,2,0,2018-05-14
5093,경기,오산시,1,0,2,3,3,0,2018-06-14
5094,경기,오산시,2,0,2,4,2,0,2018-07-14
5095,경기,오산시,2,3,2,7,2,0,2018-08-14
5096,경기,오산시,6,0,1,7,5,0,2018-09-14
5097,경기,오산시,5,0,0,5,2,0,2018-10-14
5098,경기,오산시,0,0,1,1,1,0,2018-11-14
5099,경기,오산시,11,0,3,14,7,0,2018-12-14
5100,경기,용인시,2,1,0,3,3,0,2018-01-14
5101,경기,용인시,4,0,1,5,4,0,2018-02-14
5102,경기,용인시,1,0,4,5,5,0,2018-03-14
5103,경기,용인시,7,3,4,14,8,1,2018-04-14
5104,경기,용인시,5,0,2,7,6,0,2018-05-14
5105,경기,용인시,10,4,5,19,10,0,2018-06-14
5106,경기,용인시,5,2,2,9,7,1,2018-07-14
5107,경기,용인시,13,1,3,17,11,0,2018-08-14
5108,경기,용인시,10,0,4,14,11,0,2018-09-14
5109,경기,용인시,2,0,0,2,1,0,2018-10-14
5110,경기,용인시,8,0,1,9,8,1,2018-11-14
5111,경기,용인시,7,0,4,11,8,0,2018-12-14
5112,경기,의왕시,0,0,0,0,0,0,2018-01-14
5113,경기,의왕시,1,1,1,3,3,0,2018-02-14
5114,경기,의왕시,1,0,0,1,1,0,2018-03-14
5115,경기,의왕시,2,0,0,2,1,0,2018-04-14
5116,경기,의왕시,0,0,1,1,1,0,2018-05-14
5117,경기,의왕시,0,0,1,1,1,0,2018-06-14
5118,경기,의왕시,1,0,1,2,1,0,2018-07-14
5119,경기,의왕시,1,0,0,1,1,0,2018-08-14
5120,경기,의왕시,1,0,0,1,1,0,2018-09-14
5121,경기,의왕시,0,0,1,1,1,0,2018-10-14
5122,경기,의왕시,0,0,1,1,1,0,2018-11-14
5123,경기,의왕시,1,0,2,3,2,0,2018-12-14
5124,경기,의정부시,6,1,4,11,9,0,2018-01-14
5125,경기,의정부시,4,2,0,6,5,0,2018-02-14
5126,경기,의정부시,2,0,2,4,4,0,2018-03-14
5127,경기,의정부시,2,1,0,3,3,0,2018-04-14
5128,경기,의정부시,0,0,1,1,1,0,2018-05-14
5129,경기,의정부시,1,0,2,3,2,0,2018-06-14
5130,경기,의정부시,3,0,2,5,3,0,2018-07-14
5131,경기,의정부시,4,4,1,9,5,0,2018-08-14
5132,경기,의정부시,9,4,1,14,8,0,2018-09-14
5133,경기,의정부시,3,4,0,7,3,0,2018-10-14
5134,경기,의정부시,3,0,1,4,4,0,2018-11-14
5135,경기,의정부시,3,3,2,8,8,1,2018-12-14
5136,경기,이천시,3,0,0,3,2,0,2018-01-14
5137,경기,이천시,4,0,1,5,2,0,2018-02-14
5138,경기,이천시,3,0,2,5,4,0,2018-03-14
5139,경기,이천시,2,0,6,8,3,0,2018-04-14
5140,경기,이천시,1,0,0,1,1,0,2018-05-14
5141,경기,이천시,1,0,1,2,2,0,2018-06-14
5142,경기,이천시,2,0,5,7,4,0,2018-07-14
5143,경기,이천시,7,0,5,12,7,1,2018-08-14
5144,경기,이천시,3,0,2,5,5,0,2018-09-14
5145,경기,이천시,1,0,1,2,2,0,2018-10-14
5146,경기,이천시,7,0,1,8,3,0,2018-11-14
5147,경기,이천시,5,0,2,7,5,0,2018-12-14
5148,경기,파주시,7,0,2,9,4,0,2018-01-14
5149,경기,파주시,6,0,1,7,4,0,2018-02-14
5150,경기,파주시,8,0,0,8,4,0,2018-03-14
5151,경기,파주시,14,0,1,15,7,0,2018-04-14
5152,경기,파주시,4,1,3,8,5,0,2018-05-14
5153,경기,파주시,1,0,1,2,2,0,2018-06-14
5154,경기,파주시,10,1,2,13,7,0,2018-07-14
5155,경기,파주시,6,1,3,10,5,0,2018-08-14
5156,경기,파주시,7,2,1,10,6,0,2018-09-14
5157,경기,파주시,6,0,1,7,6,1,2018-10-14
5158,경기,파주시,8,0,4,12,10,0,2018-11-14
5159,경기,파주시,9,0,0,9,6,0,2018-12-14
5160,경기,평택시,1,2,0,3,2,0,2018-01-14
5161,경기,평택시,5,1,2,8,5,0,2018-02-14
5162,경기,평택시,20,0,3,23,10,0,2018-03-14
5163,경기,평택시,10,0,2,12,8,0,2018-04-14
5164,경기,평택시,15,0,4,19,14,0,2018-05-14
5165,경기,평택시,10,1,1,12,8,0,2018-06-14
5166,경기,평택시,14,2,5,21,10,0,2018-07-14
5167,경기,평택시,8,1,6,15,10,0,2018-08-14
5168,경기,평택시,5,2,1,8,5,0,2018-09-14
5169,경기,평택시,7,1,1,9,8,1,2018-10-14
5170,경기,평택시,10,2,1,13,10,0,2018-11-14
5171,경기,평택시,2,1,4,7,7,0,2018-12-14
5172,경기,포천시,5,13,0,18,2,0,2018-01-14
5173,경기,포천시,1,0,3,4,2,0,2018-02-14
5174,경기,포천시,2,0,0,2,2,0,2018-03-14
5175,경기,포천시,0,1,0,1,1,0,2018-04-14
5176,경기,포천시,6,0,1,7,2,0,2018-05-14
5177,경기,포천시,2,3,0,5,3,0,2018-06-14
5178,경기,포천시,4,1,1,6,3,0,2018-07-14
5179,경기,포천시,2,0,1,3,2,0,2018-08-14
5180,경기,포천시,3,1,0,4,3,0,2018-09-14
5181,경기,포천시,1,2,0,3,2,0,2018-10-14
5182,경기,포천시,2,0,3,5,2,0,2018-11-14
5183,경기,포천시,1,0,0,1,1,0,2018-12-14
5184,경기,하남시,5,0,0,5,2,0,2018-01-14
5185,경기,하남시,2,0,0,2,2,0,2018-02-14
5186,경기,하남시,3,0,0,3,2,0,2018-03-14
5187,경기,하남시,4,2,1,7,4,0,2018-04-14
5188,경기,하남시,2,0,0,2,2,0,2018-05-14
5189,경기,하남시,6,2,0,8,6,0,2018-06-14
5190,경기,하남시,6,1,2,9,6,0,2018-07-14
5191,경기,하남시,0,0,0,0,0,0,2018-08-14
5192,경기,하남시,3,1,1,5,4,0,2018-09-14
5193,경기,하남시,2,0,0,2,2,0,2018-10-14
5194,경기,하남시,2,1,0,3,3,0,2018-11-14
5195,경기,하남시,1,0,0,1,1,0,2018-12-14
5196,경기,화성시,5,0,0,5,2,0,2018-01-14
5197,경기,화성시,4,0,3,7,6,0,2018-02-14
5198,경기,화성시,8,0,4,12,10,0,2018-03-14
5199,경기,화성시,4,0,1,5,5,0,2018-04-14
5200,경기,화성시,8,1,2,11,7,0,2018-05-14
5201,경기,화성시,8,1,4,13,10,0,2018-06-14
5202,경기,화성시,8,0,1,9,4,0,2018-07-14
5203,경기,화성시,6,1,3,10,8,0,2018-08-14
5204,경기,화성시,6,1,0,7,6,1,2018-09-14
5205,경기,화성시,6,0,2,8,5,0,2018-10-14
5206,경기,화성시,13,0,4,17,13,0,2018-11-14
5207,경기,화성시,15,0,2,17,11,0,2018-12-14
5208,경기,가평군,6,0,0,6,2,0,2018-01-15
5209,경기,가평군,0,0,0,0,0,0,2018-02-15
5210,경기,가평군,0,0,0,0,0,0,2018-03-15
5211,경기,가평군,2,0,2,4,3,0,2018-04-15
5212,경기,가평군,0,0,0,0,0,0,2018-05-15
5213,경기,가평군,0,0,0,0,0,0,2018-06-15
5214,경기,가평군,2,0,0,2,1,0,2018-07-15
5215,경기,가평군,6,1,0,7,5,0,2018-08-15
5216,경기,가평군,0,0,0,0,0,0,2018-09-15
5217,경기,가평군,1,0,0,1,1,0,2018-10-15
5218,경기,가평군,0,0,0,0,0,0,2018-11-15
5219,경기,가평군,0,0,0,0,0,0,2018-12-15
5220,경기,고양시,13,0,3,16,11,0,2018-01-15
5221,경기,고양시,6,0,1,7,3,0,2018-02-15
5222,경기,고양시,7,1,5,13,9,0,2018-03-15
5223,경기,고양시,1,0,1,2,2,0,2018-04-15
5224,경기,고양시,10,0,2,12,8,0,2018-05-15
5225,경기,고양시,9,0,5,14,11,0,2018-06-15
5226,경기,고양시,10,1,4,15,8,0,2018-07-15
5227,경기,고양시,13,1,3,17,12,0,2018-08-15
5228,경기,고양시,16,0,2,18,10,0,2018-09-15
5229,경기,고양시,10,1,1,12,8,0,2018-10-15
5230,경기,고양시,8,0,2,10,10,0,2018-11-15
5231,경기,고양시,20,1,9,30,20,1,2018-12-15
5232,경기,과천시,2,0,1,3,1,0,2018-01-15
5233,경기,과천시,0,0,0,0,0,0,2018-02-15
5234,경기,과천시,0,0,0,0,0,0,2018-03-15
5235,경기,과천시,1,0,0,1,1,0,2018-04-15
5236,경기,과천시,1,1,1,3,3,0,2018-05-15
5237,경기,과천시,0,0,0,0,0,0,2018-06-15
5238,경기,과천시,1,0,0,1,1,0,2018-07-15
5239,경기,과천시,0,0,0,0,0,0,2018-08-15
5240,경기,과천시,0,2,0,2,2,0,2018-09-15
5241,경기,과천시,0,0,0,0,0,0,2018-10-15
5242,경기,과천시,0,0,0,0,0,0,2018-11-15
5243,경기,과천시,0,0,0,0,0,0,2018-12-15
5244,경기,광명시,0,0,3,3,3,0,2018-01-15
5245,경기,광명시,6,1,1,8,3,0,2018-02-15
5246,경기,광명시,3,1,2,6,5,1,2018-03-15
5247,경기,광명시,7,0,0,7,2,0,2018-04-15
5248,경기,광명시,0,1,1,2,2,0,2018-05-15
5249,경기,광명시,4,0,1,5,4,0,2018-06-15
5250,경기,광명시,7,1,1,9,3,0,2018-07-15
5251,경기,광명시,2,0,1,3,3,0,2018-08-15
5252,경기,광명시,6,0,0,6,5,0,2018-09-15
5253,경기,광명시,2,1,2,5,4,0,2018-10-15
5254,경기,광명시,3,0,0,3,3,0,2018-11-15
5255,경기,광명시,4,0,4,8,5,0,2018-12-15
5256,경기,광주시,5,0,1,6,2,0,2018-01-15
5257,경기,광주시,2,0,3,5,3,0,2018-02-15
5258,경기,광주시,12,0,1,13,6,0,2018-03-15
5259,경기,광주시,2,1,1,4,4,0,2018-04-15
5260,경기,광주시,0,1,0,1,1,0,2018-05-15
5261,경기,광주시,3,0,2,5,4,0,2018-06-15
5262,경기,광주시,6,0,2,8,5,0,2018-07-15
5263,경기,광주시,2,0,0,2,1,0,2018-08-15
5264,경기,광주시,3,1,3,7,4,0,2018-09-15
5265,경기,광주시,4,1,0,5,4,0,2018-10-15
5266,경기,광주시,4,0,2,6,5,0,2018-11-15
5267,경기,광주시,14,0,3,17,10,0,2018-12-15
5268,경기,구리시,2,0,0,2,2,0,2018-01-15
5269,경기,구리시,1,0,0,1,1,0,2018-02-15
5270,경기,구리시,0,0,0,0,0,0,2018-03-15
5271,경기,구리시,0,0,1,1,2,1,2018-04-15
5272,경기,구리시,1,0,0,1,1,0,2018-05-15
5273,경기,구리시,1,0,1,2,1,0,2018-06-15
5274,경기,구리시,0,0,0,0,1,1,2018-07-15
5275,경기,구리시,4,0,1,5,3,0,2018-08-15
5276,경기,구리시,2,0,4,6,3,0,2018-09-15
5277,경기,구리시,0,0,1,1,1,0,2018-10-15
5278,경기,구리시,0,0,0,0,0,0,2018-11-15
5279,경기,구리시,1,1,0,2,2,0,2018-12-15
5280,경기,군포시,1,0,0,1,1,0,2018-01-15
5281,경기,군포시,0,0,1,1,1,0,2018-02-15
5282,경기,군포시,1,2,1,4,2,0,2018-03-15
5283,경기,군포시,1,0,0,1,1,0,2018-04-15
5284,경기,군포시,1,0,1,2,2,0,2018-05-15
5285,경기,군포시,4,1,1,6,2,0,2018-06-15
5286,경기,군포시,6,0,1,7,3,0,2018-07-15
5287,경기,군포시,0,0,0,0,0,0,2018-08-15
5288,경기,군포시,0,0,0,0,0,0,2018-09-15
5289,경기,군포시,1,0,0,1,1,0,2018-10-15
5290,경기,군포시,2,0,0,2,2,0,2018-11-15
5291,경기,군포시,12,3,1,16,3,0,2018-12-15
5292,경기,김포시,2,0,0,2,2,0,2018-01-15
5293,경기,김포시,1,1,0,2,2,0,2018-02-15
5294,경기,김포시,2,0,3,5,4,0,2018-03-15
5295,경기,김포시,5,1,2,8,4,0,2018-04-15
5296,경기,김포시,10,4,2,16,5,0,2018-05-15
5297,경기,김포시,5,0,1,6,5,0,2018-06-15
5298,경기,김포시,9,0,1,10,3,0,2018-07-15
5299,경기,김포시,13,2,2,17,8,0,2018-08-15
5300,경기,김포시,10,1,1,12,8,0,2018-09-15
5301,경기,김포시,11,0,2,13,9,0,2018-10-15
5302,경기,김포시,13,1,3,17,8,0,2018-11-15
5303,경기,김포시,1,1,0,2,2,0,2018-12-15
5304,경기,남양주시,3,2,4,9,8,0,2018-01-15
5305,경기,남양주시,14,0,4,18,5,0,2018-02-15
5306,경기,남양주시,7,0,7,14,8,1,2018-03-15
5307,경기,남양주시,3,4,1,8,4,0,2018-04-15
5308,경기,남양주시,7,2,1,10,6,0,2018-05-15
5309,경기,남양주시,3,1,1,5,4,0,2018-06-15
5310,경기,남양주시,12,1,2,15,8,1,2018-07-15
5311,경기,남양주시,6,0,0,6,4,0,2018-08-15
5312,경기,남양주시,4,3,0,7,6,0,2018-09-15
5313,경기,남양주시,6,0,1,7,5,0,2018-10-15
5314,경기,남양주시,4,0,0,4,2,0,2018-11-15
5315,경기,남양주시,13,1,0,14,7,0,2018-12-15
5316,경기,동두천시,0,0,0,0,0,0,2018-01-15
5317,경기,동두천시,0,0,0,0,0,0,2018-02-15
5318,경기,동두천시,0,0,0,0,1,1,2018-03-15
5319,경기,동두천시,1,0,0,1,1,0,2018-04-15
5320,경기,동두천시,0,0,0,0,0,0,2018-05-15
5321,경기,동두천시,1,0,0,1,1,0,2018-06-15
5322,경기,동두천시,1,0,1,2,2,0,2018-07-15
5323,경기,동두천시,1,0,1,2,1,0,2018-08-15
5324,경기,동두천시,0,0,0,0,0,0,2018-09-15
5325,경기,동두천시,2,0,0,2,2,0,2018-10-15
5326,경기,동두천시,0,0,0,0,0,0,2018-11-15
5327,경기,동두천시,1,0,0,1,1,0,2018-12-15
5328,경기,부천시,11,0,8,19,10,0,2018-01-15
5329,경기,부천시,8,2,2,12,8,0,2018-02-15
5330,경기,부천시,5,0,4,9,9,0,2018-03-15
5331,경기,부천시,5,0,5,10,9,0,2018-04-15
5332,경기,부천시,5,0,0,5,4,0,2018-05-15
5333,경기,부천시,6,1,2,9,7,0,2018-06-15
5334,경기,부천시,6,0,4,10,7,1,2018-07-15
5335,경기,부천시,5,2,0,7,7,0,2018-08-15
5336,경기,부천시,9,0,2,11,10,0,2018-09-15
5337,경기,부천시,11,0,0,11,7,0,2018-10-15
5338,경기,부천시,12,1,4,17,11,0,2018-11-15
5339,경기,부천시,10,2,1,13,10,0,2018-12-15
5340,경기,성남시,17,2,7,26,19,0,2018-01-15
5341,경기,성남시,7,0,1,8,5,1,2018-02-15
5342,경기,성남시,12,0,3,15,11,0,2018-03-15
5343,경기,성남시,12,4,6,22,14,0,2018-04-15
5344,경기,성남시,11,0,1,12,8,0,2018-05-15
5345,경기,성남시,9,2,5,16,14,1,2018-06-15
5346,경기,성남시,4,2,2,8,6,0,2018-07-15
5347,경기,성남시,12,2,2,16,11,1,2018-08-15
5348,경기,성남시,10,3,6,19,14,0,2018-09-15
5349,경기,성남시,13,3,7,23,15,1,2018-10-15
5350,경기,성남시,7,1,3,11,5,0,2018-11-15
5351,경기,성남시,3,0,2,5,5,0,2018-12-15
5352,경기,수원시,12,1,3,16,14,0,2018-01-15
5353,경기,수원시,14,0,2,16,14,0,2018-02-15
5354,경기,수원시,9,1,4,14,11,0,2018-03-15
5355,경기,수원시,13,1,4,18,14,0,2018-04-15
5356,경기,수원시,6,0,4,10,8,0,2018-05-15
5357,경기,수원시,3,3,4,10,8,0,2018-06-15
5358,경기,수원시,7,0,3,10,7,1,2018-07-15
5359,경기,수원시,18,2,4,24,17,0,2018-08-15
5360,경기,수원시,17,2,3,22,16,0,2018-09-15
5361,경기,수원시,15,0,6,21,13,0,2018-10-15
5362,경기,수원시,10,1,2,13,10,0,2018-11-15
5363,경기,수원시,14,1,3,18,12,0,2018-12-15
5364,경기,시흥시,12,1,2,15,11,0,2018-01-15
5365,경기,시흥시,12,0,1,13,6,0,2018-02-15
5366,경기,시흥시,14,1,4,19,10,0,2018-03-15
5367,경기,시흥시,7,0,4,11,9,0,2018-04-15
5368,경기,시흥시,12,0,3,15,10,0,2018-05-15
5369,경기,시흥시,5,1,1,7,7,0,2018-06-15
5370,경기,시흥시,1,0,3,4,3,0,2018-07-15
5371,경기,시흥시,11,0,1,12,6,0,2018-08-15
5372,경기,시흥시,12,1,3,16,8,0,2018-09-15
5373,경기,시흥시,2,0,0,2,2,1,2018-10-15
5374,경기,시흥시,11,0,5,16,9,0,2018-11-15
5375,경기,시흥시,6,6,4,16,8,0,2018-12-15
5376,경기,안산시,13,1,1,15,10,0,2018-01-15
5377,경기,안산시,13,0,2,15,10,0,2018-02-15
5378,경기,안산시,19,1,3,23,6,0,2018-03-15
5379,경기,안산시,6,2,0,8,6,0,2018-04-15
5380,경기,안산시,7,0,4,11,8,0,2018-05-15
5381,경기,안산시,10,4,6,20,14,0,2018-06-15
5382,경기,안산시,6,0,1,7,3,0,2018-07-15
5383,경기,안산시,22,4,2,28,14,0,2018-08-15
5384,경기,안산시,16,4,4,24,20,0,2018-09-15
5385,경기,안산시,14,2,3,19,14,0,2018-10-15
5386,경기,안산시,23,4,4,31,19,0,2018-11-15
5387,경기,안산시,11,0,1,12,8,0,2018-12-15
5388,경기,안성시,3,1,2,6,4,0,2018-01-15
5389,경기,안성시,4,2,10,16,7,0,2018-02-15
5390,경기,안성시,5,0,2,7,3,0,2018-03-15
5391,경기,안성시,5,0,1,6,2,0,2018-04-15
5392,경기,안성시,7,2,1,10,7,0,2018-05-15
5393,경기,안성시,5,1,0,6,3,0,2018-06-15
5394,경기,안성시,7,0,2,9,1,0,2018-07-15
5395,경기,안성시,0,0,0,0,0,0,2018-08-15
5396,경기,안성시,5,0,1,6,5,0,2018-09-15
5397,경기,안성시,2,0,0,2,2,0,2018-10-15
5398,경기,안성시,3,0,1,4,2,0,2018-11-15
5399,경기,안성시,5,0,1,6,3,0,2018-12-15
5400,경기,안양시,6,1,1,8,6,0,2018-01-15
5401,경기,안양시,4,0,1,5,2,0,2018-02-15
5402,경기,안양시,2,0,0,2,1,0,2018-03-15
5403,경기,안양시,2,2,3,7,5,0,2018-04-15
5404,경기,안양시,2,0,3,5,4,0,2018-05-15
5405,경기,안양시,5,0,3,8,8,0,2018-06-15
5406,경기,안양시,1,1,1,3,3,0,2018-07-15
5407,경기,안양시,1,0,2,3,3,0,2018-08-15
5408,경기,안양시,5,0,1,6,3,0,2018-09-15
5409,경기,안양시,1,0,0,1,1,0,2018-10-15
5410,경기,안양시,4,1,1,6,6,0,2018-11-15
5411,경기,안양시,4,0,1,5,4,0,2018-12-15
5412,경기,양주시,3,0,2,5,5,0,2018-01-15
5413,경기,양주시,2,0,2,4,3,0,2018-02-15
5414,경기,양주시,3,0,1,4,4,0,2018-03-15
5415,경기,양주시,0,0,1,1,1,0,2018-04-15
5416,경기,양주시,2,0,0,2,1,0,2018-05-15
5417,경기,양주시,6,0,3,9,4,0,2018-06-15
5418,경기,양주시,3,0,0,3,4,1,2018-07-15
5419,경기,양주시,0,0,0,0,0,0,2018-08-15
5420,경기,양주시,2,1,0,3,2,0,2018-09-15
5421,경기,양주시,3,0,0,3,2,0,2018-10-15
5422,경기,양주시,0,0,2,2,2,0,2018-11-15
5423,경기,양주시,4,1,0,5,4,0,2018-12-15
5424,경기,양평군,1,1,0,2,1,0,2018-01-15
5425,경기,양평군,0,0,0,0,0,0,2018-02-15
5426,경기,양평군,0,0,0,0,0,0,2018-03-15
5427,경기,양평군,10,0,1,11,4,0,2018-04-15
5428,경기,양평군,0,0,0,0,0,0,2018-05-15
5429,경기,양평군,0,0,0,0,0,0,2018-06-15
5430,경기,양평군,0,0,0,0,0,0,2018-07-15
5431,경기,양평군,0,0,5,5,3,0,2018-08-15
5432,경기,양평군,2,0,0,2,2,0,2018-09-15
5433,경기,양평군,0,0,0,0,0,0,2018-10-15
5434,경기,양평군,1,0,1,2,2,0,2018-11-15
5435,경기,양평군,1,0,1,2,2,0,2018-12-15
5436,경기,여주시,3,0,0,3,2,0,2018-01-15
5437,경기,여주시,4,0,0,4,2,0,2018-02-15
5438,경기,여주시,0,0,0,0,0,0,2018-03-15
5439,경기,여주시,10,0,1,11,4,0,2018-04-15
5440,경기,여주시,0,0,0,0,0,0,2018-05-15
5441,경기,여주시,0,0,2,2,2,0,2018-06-15
5442,경기,여주시,0,0,0,0,0,0,2018-07-15
5443,경기,여주시,0,0,0,0,0,0,2018-08-15
5444,경기,여주시,6,0,1,7,3,0,2018-09-15
5445,경기,여주시,0,0,1,1,1,0,2018-10-15
5446,경기,여주시,1,0,0,1,1,0,2018-11-15
5447,경기,여주시,5,0,1,6,4,0,2018-12-15
5448,경기,연천군,4,0,0,4,2,0,2018-01-15
5449,경기,연천군,0,0,0,0,0,0,2018-02-15
5450,경기,연천군,0,0,0,0,0,0,2018-03-15
5451,경기,연천군,0,0,0,0,0,0,2018-04-15
5452,경기,연천군,0,0,0,0,0,0,2018-05-15
5453,경기,연천군,0,0,0,0,1,1,2018-06-15
5454,경기,연천군,0,0,0,0,0,0,2018-07-15
5455,경기,연천군,0,0,0,0,0,0,2018-08-15
5456,경기,연천군,0,0,0,0,0,0,2018-09-15
5457,경기,연천군,1,0,0,1,1,0,2018-10-15
5458,경기,연천군,0,0,0,0,0,0,2018-11-15
5459,경기,연천군,0,0,2,2,1,0,2018-12-15
5460,경기,오산시,1,0,1,2,2,0,2018-01-15
5461,경기,오산시,3,0,1,4,4,0,2018-02-15
5462,경기,오산시,4,0,0,4,2,0,2018-03-15
5463,경기,오산시,0,0,2,2,2,0,2018-04-15
5464,경기,오산시,4,0,1,5,4,0,2018-05-15
5465,경기,오산시,5,0,1,6,3,0,2018-06-15
5466,경기,오산시,2,1,2,5,4,0,2018-07-15
5467,경기,오산시,1,0,0,1,1,0,2018-08-15
5468,경기,오산시,1,0,0,1,1,0,2018-09-15
5469,경기,오산시,8,0,0,8,6,0,2018-10-15
5470,경기,오산시,0,0,3,3,2,0,2018-11-15
5471,경기,오산시,6,0,0,6,3,0,2018-12-15
5472,경기,용인시,4,0,2,6,4,0,2018-01-15
5473,경기,용인시,2,0,2,4,3,0,2018-02-15
5474,경기,용인시,16,6,4,26,14,0,2018-03-15
5475,경기,용인시,1,3,1,5,5,0,2018-04-15
5476,경기,용인시,10,8,1,19,8,0,2018-05-15
5477,경기,용인시,6,0,2,8,6,0,2018-06-15
5478,경기,용인시,16,0,7,23,5,0,2018-07-15
5479,경기,용인시,4,3,2,9,6,0,2018-08-15
5480,경기,용인시,13,2,1,16,9,0,2018-09-15
5481,경기,용인시,12,0,3,15,12,0,2018-10-15
5482,경기,용인시,22,3,6,31,13,0,2018-11-15
5483,경기,용인시,11,3,5,19,11,1,2018-12-15
5484,경기,의왕시,0,0,1,1,1,0,2018-01-15
5485,경기,의왕시,3,1,0,4,2,0,2018-02-15
5486,경기,의왕시,0,0,0,0,0,0,2018-03-15
5487,경기,의왕시,0,0,0,0,0,0,2018-04-15
5488,경기,의왕시,0,0,0,0,0,0,2018-05-15
5489,경기,의왕시,5,0,1,6,4,0,2018-06-15
5490,경기,의왕시,0,0,2,2,1,0,2018-07-15
5491,경기,의왕시,1,0,0,1,1,0,2018-08-15
5492,경기,의왕시,5,0,0,5,4,0,2018-09-15
5493,경기,의왕시,0,0,0,0,0,0,2018-10-15
5494,경기,의왕시,0,0,0,0,0,0,2018-11-15
5495,경기,의왕시,3,1,0,4,2,0,2018-12-15
5496,경기,의정부시,1,0,1,2,2,0,2018-01-15
5497,경기,의정부시,6,0,0,6,3,0,2018-02-15
5498,경기,의정부시,3,3,0,6,5,0,2018-03-15
5499,경기,의정부시,1,1,0,2,2,0,2018-04-15
5500,경기,의정부시,1,1,0,2,1,0,2018-05-15
5501,경기,의정부시,5,0,4,9,6,0,2018-06-15
5502,경기,의정부시,6,0,3,9,3,0,2018-07-15
5503,경기,의정부시,2,0,0,2,2,0,2018-08-15
5504,경기,의정부시,5,2,2,9,7,0,2018-09-15
5505,경기,의정부시,1,2,0,3,3,0,2018-10-15
5506,경기,의정부시,3,1,4,8,8,0,2018-11-15
5507,경기,의정부시,6,1,1,8,7,0,2018-12-15
5508,경기,이천시,5,0,0,5,3,0,2018-01-15
5509,경기,이천시,1,1,0,2,2,0,2018-02-15
5510,경기,이천시,4,0,0,4,4,0,2018-03-15
5511,경기,이천시,0,0,0,0,0,0,2018-04-15
5512,경기,이천시,0,0,1,1,1,0,2018-05-15
5513,경기,이천시,7,0,0,7,6,0,2018-06-15
5514,경기,이천시,2,1,0,3,2,0,2018-07-15
5515,경기,이천시,2,0,0,2,1,0,2018-08-15
5516,경기,이천시,1,0,2,3,3,0,2018-09-15
5517,경기,이천시,0,0,1,1,1,0,2018-10-15
5518,경기,이천시,3,0,2,5,3,0,2018-11-15
5519,경기,이천시,9,0,1,10,6,0,2018-12-15
5520,경기,파주시,5,0,3,8,6,0,2018-01-15
5521,경기,파주시,2,0,1,3,2,0,2018-02-15
5522,경기,파주시,6,0,4,10,8,0,2018-03-15
5523,경기,파주시,1,0,0,1,1,0,2018-04-15
5524,경기,파주시,1,1,1,3,3,0,2018-05-15
5525,경기,파주시,3,0,1,4,4,0,2018-06-15
5526,경기,파주시,2,0,0,2,1,0,2018-07-15
5527,경기,파주시,9,2,3,14,5,0,2018-08-15
5528,경기,파주시,1,0,1,2,2,0,2018-09-15
5529,경기,파주시,4,2,0,6,5,0,2018-10-15
5530,경기,파주시,5,0,2,7,4,0,2018-11-15
5531,경기,파주시,5,0,1,6,5,1,2018-12-15
5532,경기,평택시,10,1,4,15,7,0,2018-01-15
5533,경기,평택시,13,3,1,17,4,0,2018-02-15
5534,경기,평택시,8,1,1,10,5,1,2018-03-15
5535,경기,평택시,2,4,1,7,5,0,2018-04-15
5536,경기,평택시,7,4,2,13,8,0,2018-05-15
5537,경기,평택시,10,2,3,15,11,0,2018-06-15
5538,경기,평택시,7,0,4,11,9,0,2018-07-15
5539,경기,평택시,8,0,3,11,5,0,2018-08-15
5540,경기,평택시,15,3,4,22,13,0,2018-09-15
5541,경기,평택시,18,1,1,20,14,0,2018-10-15
5542,경기,평택시,14,1,4,19,11,0,2018-11-15
5543,경기,평택시,10,2,2,14,12,0,2018-12-15
5544,경기,포천시,3,0,0,3,2,0,2018-01-15
5545,경기,포천시,0,0,0,0,0,0,2018-02-15
5546,경기,포천시,1,0,2,3,2,0,2018-03-15
5547,경기,포천시,2,0,2,4,2,0,2018-04-15
5548,경기,포천시,0,0,3,3,1,0,2018-05-15
5549,경기,포천시,2,0,0,2,2,0,2018-06-15
5550,경기,포천시,8,0,1,9,3,0,2018-07-15
5551,경기,포천시,0,0,1,1,1,0,2018-08-15
5552,경기,포천시,1,2,0,3,3,0,2018-09-15
5553,경기,포천시,1,1,2,4,4,0,2018-10-15
5554,경기,포천시,1,0,0,1,1,0,2018-11-15
5555,경기,포천시,4,0,1,5,2,0,2018-12-15
5556,경기,하남시,3,1,2,6,5,0,2018-01-15
5557,경기,하남시,0,0,0,0,0,0,2018-02-15
5558,경기,하남시,8,1,1,10,6,0,2018-03-15
5559,경기,하남시,3,1,1,5,2,0,2018-04-15
5560,경기,하남시,10,2,1,13,5,0,2018-05-15
5561,경기,하남시,4,0,0,4,4,0,2018-06-15
5562,경기,하남시,3,0,0,3,1,0,2018-07-15
5563,경기,하남시,0,0,0,0,0,0,2018-08-15
5564,경기,하남시,2,0,1,3,3,0,2018-09-15
5565,경기,하남시,2,1,1,4,3,0,2018-10-15
5566,경기,하남시,1,0,0,1,2,1,2018-11-15
5567,경기,하남시,3,0,0,3,2,0,2018-12-15
5568,경기,화성시,3,0,6,9,7,0,2018-01-15
5569,경기,화성시,3,0,3,6,3,0,2018-02-15
5570,경기,화성시,10,3,5,18,11,0,2018-03-15
5571,경기,화성시,5,1,3,9,5,0,2018-04-15
5572,경기,화성시,13,0,2,15,9,0,2018-05-15
5573,경기,화성시,11,0,4,15,13,0,2018-06-15
5574,경기,화성시,0,0,2,2,2,0,2018-07-15
5575,경기,화성시,3,2,0,5,4,0,2018-08-15
5576,경기,화성시,15,1,1,17,7,0,2018-09-15
5577,경기,화성시,13,1,3,17,13,1,2018-10-15
5578,경기,화성시,12,0,1,13,9,1,2018-11-15
5579,경기,화성시,10,0,2,12,7,0,2018-12-15
5580,경기,가평군,0,0,0,0,0,0,2018-01-16
5581,경기,가평군,0,0,0,0,0,0,2018-02-16
5582,경기,가평군,3,0,0,3,1,0,2018-03-16
5583,경기,가평군,0,0,0,0,0,0,2018-04-16
5584,경기,가평군,0,0,0,0,0,0,2018-05-16
5585,경기,가평군,1,0,4,5,1,0,2018-06-16
5586,경기,가평군,0,0,0,0,0,0,2018-07-16
5587,경기,가평군,0,0,0,0,0,0,2018-08-16
5588,경기,가평군,0,0,0,0,0,0,2018-09-16
5589,경기,가평군,1,0,0,1,1,0,2018-10-16
5590,경기,가평군,0,0,0,0,0,0,2018-11-16
5591,경기,가평군,1,0,1,2,1,0,2018-12-16
5592,경기,고양시,13,3,1,17,11,0,2018-01-16
5593,경기,고양시,19,0,2,21,7,0,2018-02-16
5594,경기,고양시,10,0,2,12,10,0,2018-03-16
5595,경기,고양시,16,3,3,22,14,0,2018-04-16
5596,경기,고양시,4,0,3,7,6,0,2018-05-16
5597,경기,고양시,5,0,1,6,5,0,2018-06-16
5598,경기,고양시,6,5,4,15,11,0,2018-07-16
5599,경기,고양시,26,5,2,33,15,0,2018-08-16
5600,경기,고양시,23,2,3,28,13,0,2018-09-16
5601,경기,고양시,6,1,3,10,9,0,2018-10-16
5602,경기,고양시,12,5,1,18,12,0,2018-11-16
5603,경기,고양시,3,1,2,6,6,0,2018-12-16
5604,경기,과천시,0,0,0,0,0,0,2018-01-16
5605,경기,과천시,0,0,0,0,0,0,2018-02-16
5606,경기,과천시,0,0,0,0,0,0,2018-03-16
5607,경기,과천시,3,0,0,3,2,0,2018-04-16
5608,경기,과천시,0,0,0,0,0,0,2018-05-16
5609,경기,과천시,0,0,0,0,0,0,2018-06-16
5610,경기,과천시,2,0,0,2,1,0,2018-07-16
5611,경기,과천시,0,0,0,0,0,0,2018-08-16
5612,경기,과천시,0,0,0,0,0,0,2018-09-16
5613,경기,과천시,0,0,0,0,0,0,2018-10-16
5614,경기,과천시,0,0,1,1,1,0,2018-11-16
5615,경기,과천시,0,0,1,1,1,0,2018-12-16
5616,경기,광명시,1,0,0,1,1,0,2018-01-16
5617,경기,광명시,3,0,0,3,2,0,2018-02-16
5618,경기,광명시,6,2,1,9,5,0,2018-03-16
5619,경기,광명시,2,0,1,3,3,0,2018-04-16
5620,경기,광명시,2,1,0,3,3,0,2018-05-16
5621,경기,광명시,3,1,0,4,3,0,2018-06-16
5622,경기,광명시,3,1,0,4,4,0,2018-07-16
5623,경기,광명시,10,1,4,15,6,0,2018-08-16
5624,경기,광명시,3,2,2,7,6,0,2018-09-16
5625,경기,광명시,1,1,1,3,3,0,2018-10-16
5626,경기,광명시,3,1,1,5,4,0,2018-11-16
5627,경기,광명시,0,1,2,3,2,0,2018-12-16
5628,경기,광주시,14,0,1,15,9,0,2018-01-16
5629,경기,광주시,3,0,0,3,1,0,2018-02-16
5630,경기,광주시,15,0,0,15,6,0,2018-03-16
5631,경기,광주시,6,0,2,8,7,0,2018-04-16
5632,경기,광주시,5,0,1,6,6,0,2018-05-16
5633,경기,광주시,3,0,1,4,4,0,2018-06-16
5634,경기,광주시,6,0,2,8,4,0,2018-07-16
5635,경기,광주시,4,1,2,7,6,0,2018-08-16
5636,경기,광주시,4,2,1,7,5,1,2018-09-16
5637,경기,광주시,6,0,0,6,5,1,2018-10-16
5638,경기,광주시,4,0,1,5,4,0,2018-11-16
5639,경기,광주시,2,0,0,2,1,0,2018-12-16
5640,경기,구리시,1,0,0,1,1,0,2018-01-16
5641,경기,구리시,0,0,0,0,0,0,2018-02-16
5642,경기,구리시,0,1,1,2,2,0,2018-03-16
5643,경기,구리시,1,0,0,1,1,0,2018-04-16
5644,경기,구리시,1,0,0,1,1,0,2018-05-16
5645,경기,구리시,2,0,0,2,2,0,2018-06-16
5646,경기,구리시,3,0,2,5,3,0,2018-07-16
5647,경기,구리시,3,0,1,4,3,0,2018-08-16
5648,경기,구리시,1,0,2,3,2,0,2018-09-16
5649,경기,구리시,5,0,0,5,2,0,2018-10-16
5650,경기,구리시,3,0,0,3,2,0,2018-11-16
5651,경기,구리시,1,0,0,1,1,0,2018-12-16
5652,경기,군포시,8,0,4,12,4,0,2018-01-16
5653,경기,군포시,0,0,0,0,0,0,2018-02-16
5654,경기,군포시,6,0,1,7,1,0,2018-03-16
5655,경기,군포시,1,0,0,1,1,0,2018-04-16
5656,경기,군포시,2,1,0,3,2,0,2018-05-16
5657,경기,군포시,1,0,0,1,1,0,2018-06-16
5658,경기,군포시,1,1,0,2,2,0,2018-07-16
5659,경기,군포시,0,0,1,1,1,0,2018-08-16
5660,경기,군포시,2,1,0,3,3,0,2018-09-16
5661,경기,군포시,4,1,0,5,2,0,2018-10-16
5662,경기,군포시,3,2,1,6,4,0,2018-11-16
5663,경기,군포시,2,1,0,3,3,0,2018-12-16
5664,경기,김포시,3,0,0,3,2,0,2018-01-16
5665,경기,김포시,4,0,0,4,2,0,2018-02-16
5666,경기,김포시,1,1,0,2,2,0,2018-03-16
5667,경기,김포시,3,0,0,3,2,0,2018-04-16
5668,경기,김포시,3,0,0,3,3,0,2018-05-16
5669,경기,김포시,1,0,1,2,2,0,2018-06-16
5670,경기,김포시,9,0,6,15,7,0,2018-07-16
5671,경기,김포시,5,0,1,6,4,0,2018-08-16
5672,경기,김포시,4,0,2,6,4,0,2018-09-16
5673,경기,김포시,4,0,4,8,4,0,2018-10-16
5674,경기,김포시,5,4,2,11,6,0,2018-11-16
5675,경기,김포시,1,0,0,1,1,0,2018-12-16
5676,경기,남양주시,10,0,4,14,8,2,2018-01-16
5677,경기,남양주시,2,0,1,3,3,0,2018-02-16
5678,경기,남양주시,8,0,0,8,7,0,2018-03-16
5679,경기,남양주시,10,0,4,14,11,0,2018-04-16
5680,경기,남양주시,6,0,4,10,5,0,2018-05-16
5681,경기,남양주시,7,1,5,13,8,0,2018-06-16
5682,경기,남양주시,11,0,3,14,8,0,2018-07-16
5683,경기,남양주시,9,0,3,12,7,0,2018-08-16
5684,경기,남양주시,9,1,4,14,7,0,2018-09-16
5685,경기,남양주시,8,0,0,8,8,0,2018-10-16
5686,경기,남양주시,6,0,2,8,5,1,2018-11-16
5687,경기,남양주시,4,0,2,6,5,0,2018-12-16
5688,경기,동두천시,0,0,0,0,0,0,2018-01-16
5689,경기,동두천시,0,1,0,1,1,0,2018-02-16
5690,경기,동두천시,1,0,0,1,1,0,2018-03-16
5691,경기,동두천시,0,0,1,1,1,0,2018-04-16
5692,경기,동두천시,0,0,0,0,0,0,2018-05-16
5693,경기,동두천시,0,0,0,0,0,0,2018-06-16
5694,경기,동두천시,0,0,0,0,0,0,2018-07-16
5695,경기,동두천시,2,0,0,2,2,0,2018-08-16
5696,경기,동두천시,1,0,1,2,1,0,2018-09-16
5697,경기,동두천시,0,0,1,1,1,0,2018-10-16
5698,경기,동두천시,3,1,1,5,1,0,2018-11-16
5699,경기,동두천시,1,0,0,1,1,0,2018-12-16
5700,경기,부천시,5,1,1,7,6,0,2018-01-16
5701,경기,부천시,3,0,1,4,4,0,2018-02-16
5702,경기,부천시,14,1,2,17,9,0,2018-03-16
5703,경기,부천시,17,1,0,18,11,0,2018-04-16
5704,경기,부천시,9,0,0,9,6,0,2018-05-16
5705,경기,부천시,4,2,1,7,4,0,2018-06-16
5706,경기,부천시,10,3,2,15,13,0,2018-07-16
5707,경기,부천시,11,1,4,16,13,0,2018-08-16
5708,경기,부천시,7,0,2,9,5,0,2018-09-16
5709,경기,부천시,9,1,2,12,12,0,2018-10-16
5710,경기,부천시,12,0,2,14,12,0,2018-11-16
5711,경기,부천시,14,3,3,20,12,0,2018-12-16
5712,경기,성남시,8,2,2,12,12,0,2018-01-16
5713,경기,성남시,12,4,0,16,5,0,2018-02-16
5714,경기,성남시,12,0,7,19,10,0,2018-03-16
5715,경기,성남시,5,1,7,13,11,0,2018-04-16
5716,경기,성남시,6,1,3,10,9,0,2018-05-16
5717,경기,성남시,8,0,5,13,11,0,2018-06-16
5718,경기,성남시,17,5,5,27,15,0,2018-07-16
5719,경기,성남시,14,1,3,18,12,0,2018-08-16
5720,경기,성남시,6,1,2,9,5,1,2018-09-16
5721,경기,성남시,13,1,2,16,10,0,2018-10-16
5722,경기,성남시,16,0,2,18,9,0,2018-11-16
5723,경기,성남시,10,0,2,12,7,0,2018-12-16
5724,경기,수원시,21,3,3,27,18,0,2018-01-16
5725,경기,수원시,16,6,0,22,10,0,2018-02-16
5726,경기,수원시,9,3,2,14,11,0,2018-03-16
5727,경기,수원시,5,0,3,8,7,0,2018-04-16
5728,경기,수원시,16,2,11,29,20,0,2018-05-16
5729,경기,수원시,15,5,2,22,13,0,2018-06-16
5730,경기,수원시,12,1,6,19,14,0,2018-07-16
5731,경기,수원시,22,0,10,32,22,0,2018-08-16
5732,경기,수원시,16,2,4,22,11,0,2018-09-16
5733,경기,수원시,11,0,8,19,18,0,2018-10-16
5734,경기,수원시,14,1,5,20,9,0,2018-11-16
5735,경기,수원시,12,1,0,13,10,0,2018-12-16
5736,경기,시흥시,3,1,1,5,5,0,2018-01-16
5737,경기,시흥시,4,0,0,4,2,0,2018-02-16
5738,경기,시흥시,7,0,0,7,4,0,2018-03-16
5739,경기,시흥시,10,3,2,15,11,0,2018-04-16
5740,경기,시흥시,9,0,2,11,6,0,2018-05-16
5741,경기,시흥시,14,2,4,20,11,0,2018-06-16
5742,경기,시흥시,7,2,1,10,10,0,2018-07-16
5743,경기,시흥시,9,0,0,9,5,0,2018-08-16
5744,경기,시흥시,10,0,1,11,5,0,2018-09-16
5745,경기,시흥시,3,0,4,7,7,0,2018-10-16
5746,경기,시흥시,3,0,0,3,3,0,2018-11-16
5747,경기,시흥시,14,0,2,16,7,0,2018-12-16
5748,경기,안산시,10,1,1,12,10,0,2018-01-16
5749,경기,안산시,9,0,8,17,8,1,2018-02-16
5750,경기,안산시,12,1,3,16,10,0,2018-03-16
5751,경기,안산시,8,0,2,10,9,0,2018-04-16
5752,경기,안산시,12,2,3,17,11,0,2018-05-16
5753,경기,안산시,6,0,5,11,9,1,2018-06-16
5754,경기,안산시,12,2,0,14,11,0,2018-07-16
5755,경기,안산시,14,0,1,15,10,0,2018-08-16
5756,경기,안산시,13,0,2,15,11,0,2018-09-16
5757,경기,안산시,10,0,2,12,11,0,2018-10-16
5758,경기,안산시,29,2,4,35,20,0,2018-11-16
5759,경기,안산시,17,3,6,26,10,0,2018-12-16
5760,경기,안성시,3,2,0,5,4,0,2018-01-16
5761,경기,안성시,0,0,0,0,0,0,2018-02-16
5762,경기,안성시,9,0,2,11,5,0,2018-03-16
5763,경기,안성시,2,3,1,6,3,0,2018-04-16
5764,경기,안성시,2,0,0,2,1,0,2018-05-16
5765,경기,안성시,1,0,2,3,2,0,2018-06-16
5766,경기,안성시,3,1,0,4,2,0,2018-07-16
5767,경기,안성시,2,0,0,2,2,0,2018-08-16
5768,경기,안성시,1,0,0,1,1,0,2018-09-16
5769,경기,안성시,3,0,0,3,2,1,2018-10-16
5770,경기,안성시,8,1,4,13,6,0,2018-11-16
5771,경기,안성시,3,1,0,4,2,0,2018-12-16
5772,경기,안양시,9,1,2,12,6,0,2018-01-16
5773,경기,안양시,3,0,0,3,3,0,2018-02-16
5774,경기,안양시,7,0,3,10,8,0,2018-03-16
5775,경기,안양시,2,0,1,3,2,0,2018-04-16
5776,경기,안양시,4,0,1,5,5,0,2018-05-16
5777,경기,안양시,5,0,1,6,4,0,2018-06-16
5778,경기,안양시,8,0,1,9,6,0,2018-07-16
5779,경기,안양시,0,0,0,0,0,0,2018-08-16
5780,경기,안양시,4,0,1,5,4,0,2018-09-16
5781,경기,안양시,5,0,1,6,4,0,2018-10-16
5782,경기,안양시,4,0,2,6,6,0,2018-11-16
5783,경기,안양시,0,0,0,0,0,0,2018-12-16
5784,경기,양주시,2,0,1,3,2,0,2018-01-16
5785,경기,양주시,3,0,0,3,1,0,2018-02-16
5786,경기,양주시,9,1,0,10,6,0,2018-03-16
5787,경기,양주시,2,0,1,3,3,0,2018-04-16
5788,경기,양주시,4,0,0,4,3,0,2018-05-16
5789,경기,양주시,2,2,0,4,2,0,2018-06-16
5790,경기,양주시,3,0,3,6,5,0,2018-07-16
5791,경기,양주시,8,0,1,9,6,0,2018-08-16
5792,경기,양주시,1,0,0,1,1,0,2018-09-16
5793,경기,양주시,10,0,2,12,6,0,2018-10-16
5794,경기,양주시,7,0,0,7,7,1,2018-11-16
5795,경기,양주시,1,0,1,2,2,0,2018-12-16
5796,경기,양평군,0,0,3,3,1,0,2018-01-16
5797,경기,양평군,1,0,0,1,1,0,2018-02-16
5798,경기,양평군,0,0,0,0,0,0,2018-03-16
5799,경기,양평군,0,0,0,0,0,0,2018-04-16
5800,경기,양평군,0,0,1,1,1,0,2018-05-16
5801,경기,양평군,1,0,0,1,1,0,2018-06-16
5802,경기,양평군,0,0,0,0,0,0,2018-07-16
5803,경기,양평군,1,0,1,2,2,0,2018-08-16
5804,경기,양평군,9,2,2,13,5,0,2018-09-16
5805,경기,양평군,0,0,0,0,0,0,2018-10-16
5806,경기,양평군,0,1,0,1,1,0,2018-11-16
5807,경기,양평군,1,0,0,1,1,0,2018-12-16
5808,경기,여주시,0,1,1,2,2,0,2018-01-16
5809,경기,여주시,6,0,0,6,2,0,2018-02-16
5810,경기,여주시,14,0,0,14,6,0,2018-03-16
5811,경기,여주시,0,0,0,0,0,0,2018-04-16
5812,경기,여주시,0,0,1,1,1,0,2018-05-16
5813,경기,여주시,1,0,0,1,1,0,2018-06-16
5814,경기,여주시,0,0,0,0,0,0,2018-07-16
5815,경기,여주시,3,0,0,3,2,0,2018-08-16
5816,경기,여주시,0,0,0,0,0,0,2018-09-16
5817,경기,여주시,0,0,0,0,0,0,2018-10-16
5818,경기,여주시,4,0,0,4,3,0,2018-11-16
5819,경기,여주시,6,0,0,6,2,0,2018-12-16
5820,경기,연천군,0,0,0,0,0,0,2018-01-16
5821,경기,연천군,0,0,0,0,0,0,2018-02-16
5822,경기,연천군,0,0,0,0,0,0,2018-03-16
5823,경기,연천군,0,0,0,0,0,0,2018-04-16
5824,경기,연천군,0,0,0,0,0,0,2018-05-16
5825,경기,연천군,1,0,0,1,1,0,2018-06-16
5826,경기,연천군,1,0,1,2,2,0,2018-07-16
5827,경기,연천군,0,0,1,1,1,0,2018-08-16
5828,경기,연천군,0,0,0,0,0,0,2018-09-16
5829,경기,연천군,0,0,0,0,0,0,2018-10-16
5830,경기,연천군,1,0,0,1,1,0,2018-11-16
5831,경기,연천군,0,0,0,0,0,0,2018-12-16
5832,경기,오산시,6,0,1,7,3,0,2018-01-16
5833,경기,오산시,0,0,0,0,0,0,2018-02-16
5834,경기,오산시,3,1,1,5,4,0,2018-03-16
5835,경기,오산시,0,0,2,2,2,0,2018-04-16
5836,경기,오산시,3,0,0,3,1,0,2018-05-16
5837,경기,오산시,5,1,1,7,2,0,2018-06-16
5838,경기,오산시,1,1,0,2,2,0,2018-07-16
5839,경기,오산시,1,3,0,4,4,0,2018-08-16
5840,경기,오산시,5,1,0,6,3,0,2018-09-16
5841,경기,오산시,5,1,1,7,3,0,2018-10-16
5842,경기,오산시,3,0,0,3,3,0,2018-11-16
5843,경기,오산시,0,0,2,2,1,0,2018-12-16
5844,경기,용인시,6,0,1,7,7,0,2018-01-16
5845,경기,용인시,4,0,0,4,3,0,2018-02-16
5846,경기,용인시,5,0,0,5,5,0,2018-03-16
5847,경기,용인시,6,2,0,8,6,0,2018-04-16
5848,경기,용인시,6,0,9,15,7,0,2018-05-16
5849,경기,용인시,9,0,5,14,9,0,2018-06-16
5850,경기,용인시,15,1,3,19,12,0,2018-07-16
5851,경기,용인시,5,2,3,10,8,0,2018-08-16
5852,경기,용인시,9,0,2,11,5,0,2018-09-16
5853,경기,용인시,10,1,0,11,7,0,2018-10-16
5854,경기,용인시,6,1,4,11,8,0,2018-11-16
5855,경기,용인시,4,0,2,6,5,0,2018-12-16
5856,경기,의왕시,2,0,1,3,3,0,2018-01-16
5857,경기,의왕시,7,0,1,8,2,0,2018-02-16
5858,경기,의왕시,0,0,0,0,0,0,2018-03-16
5859,경기,의왕시,0,0,1,1,1,0,2018-04-16
5860,경기,의왕시,2,0,1,3,3,0,2018-05-16
5861,경기,의왕시,0,0,0,0,0,0,2018-06-16
5862,경기,의왕시,0,0,0,0,0,0,2018-07-16
5863,경기,의왕시,2,0,0,2,2,0,2018-08-16
5864,경기,의왕시,0,0,0,0,0,0,2018-09-16
5865,경기,의왕시,1,0,0,1,1,0,2018-10-16
5866,경기,의왕시,0,0,1,1,1,0,2018-11-16
5867,경기,의왕시,1,0,0,1,1,0,2018-12-16
5868,경기,의정부시,6,2,4,12,7,0,2018-01-16
5869,경기,의정부시,4,1,1,6,3,0,2018-02-16
5870,경기,의정부시,3,0,1,4,3,0,2018-03-16
5871,경기,의정부시,6,1,1,8,5,0,2018-04-16
5872,경기,의정부시,4,1,3,8,6,0,2018-05-16
5873,경기,의정부시,1,0,1,2,2,0,2018-06-16
5874,경기,의정부시,2,1,1,4,4,0,2018-07-16
5875,경기,의정부시,4,0,0,4,4,0,2018-08-16
5876,경기,의정부시,2,0,0,2,2,0,2018-09-16
5877,경기,의정부시,3,1,1,5,5,0,2018-10-16
5878,경기,의정부시,2,1,4,7,7,0,2018-11-16
5879,경기,의정부시,2,1,3,6,5,0,2018-12-16
5880,경기,이천시,2,4,2,8,4,0,2018-01-16
5881,경기,이천시,3,0,0,3,2,0,2018-02-16
5882,경기,이천시,5,0,1,6,3,0,2018-03-16
5883,경기,이천시,4,0,1,5,3,0,2018-04-16
5884,경기,이천시,1,0,1,2,2,0,2018-05-16
5885,경기,이천시,2,0,0,2,2,0,2018-06-16
5886,경기,이천시,0,0,1,1,1,0,2018-07-16
5887,경기,이천시,4,0,1,5,3,0,2018-08-16
5888,경기,이천시,4,0,1,5,4,0,2018-09-16
5889,경기,이천시,3,1,3,7,4,0,2018-10-16
5890,경기,이천시,3,0,0,3,2,0,2018-11-16
5891,경기,이천시,1,0,0,1,1,0,2018-12-16
5892,경기,파주시,4,0,0,4,4,0,2018-01-16
5893,경기,파주시,7,2,4,13,6,1,2018-02-16
5894,경기,파주시,3,1,1,5,4,0,2018-03-16
5895,경기,파주시,3,0,0,3,2,0,2018-04-16
5896,경기,파주시,0,0,0,0,0,0,2018-05-16
5897,경기,파주시,1,0,0,1,1,0,2018-06-16
5898,경기,파주시,14,1,2,17,8,0,2018-07-16
5899,경기,파주시,1,1,3,5,5,0,2018-08-16
5900,경기,파주시,14,0,0,14,5,0,2018-09-16
5901,경기,파주시,3,0,2,5,4,0,2018-10-16
5902,경기,파주시,2,0,2,4,3,0,2018-11-16
5903,경기,파주시,5,0,0,5,3,0,2018-12-16
5904,경기,평택시,4,2,5,11,6,0,2018-01-16
5905,경기,평택시,19,0,4,23,12,1,2018-02-16
5906,경기,평택시,6,0,5,11,6,0,2018-03-16
5907,경기,평택시,21,0,0,21,11,0,2018-04-16
5908,경기,평택시,5,3,2,10,6,0,2018-05-16
5909,경기,평택시,7,0,1,8,7,0,2018-06-16
5910,경기,평택시,7,1,1,9,8,0,2018-07-16
5911,경기,평택시,11,0,3,14,10,1,2018-08-16
5912,경기,평택시,8,0,0,8,5,0,2018-09-16
5913,경기,평택시,11,8,3,22,12,0,2018-10-16
5914,경기,평택시,14,2,2,18,13,0,2018-11-16
5915,경기,평택시,8,3,2,13,9,0,2018-12-16
5916,경기,포천시,1,0,0,1,1,0,2018-01-16
5917,경기,포천시,0,0,0,0,0,0,2018-02-16
5918,경기,포천시,2,1,0,3,2,0,2018-03-16
5919,경기,포천시,2,0,0,2,2,0,2018-04-16
5920,경기,포천시,2,0,0,2,2,0,2018-05-16
5921,경기,포천시,2,1,1,4,3,0,2018-06-16
5922,경기,포천시,4,1,1,6,4,0,2018-07-16
5923,경기,포천시,2,0,0,2,2,0,2018-08-16
5924,경기,포천시,4,2,0,6,3,0,2018-09-16
5925,경기,포천시,1,1,0,2,1,0,2018-10-16
5926,경기,포천시,2,0,0,2,2,0,2018-11-16
5927,경기,포천시,2,0,0,2,2,0,2018-12-16
5928,경기,하남시,1,0,1,2,2,0,2018-01-16
5929,경기,하남시,2,0,0,2,1,0,2018-02-16
5930,경기,하남시,3,0,1,4,4,0,2018-03-16
5931,경기,하남시,3,1,2,6,4,0,2018-04-16
5932,경기,하남시,5,1,1,7,3,0,2018-05-16
5933,경기,하남시,1,2,0,3,3,0,2018-06-16
5934,경기,하남시,7,0,0,7,5,0,2018-07-16
5935,경기,하남시,1,0,1,2,2,0,2018-08-16
5936,경기,하남시,2,0,0,2,2,0,2018-09-16
5937,경기,하남시,1,0,0,1,1,0,2018-10-16
5938,경기,하남시,0,0,0,0,0,0,2018-11-16
5939,경기,하남시,1,1,0,2,2,0,2018-12-16
5940,경기,화성시,14,3,4,21,14,1,2018-01-16
5941,경기,화성시,7,0,3,10,5,0,2018-02-16
5942,경기,화성시,2,0,3,5,5,0,2018-03-16
5943,경기,화성시,15,2,5,22,7,0,2018-04-16
5944,경기,화성시,8,0,1,9,5,0,2018-05-16
5945,경기,화성시,7,0,0,7,6,0,2018-06-16
5946,경기,화성시,5,0,2,7,7,0,2018-07-16
5947,경기,화성시,6,0,2,8,7,0,2018-08-16
5948,경기,화성시,10,0,1,11,5,0,2018-09-16
5949,경기,화성시,8,0,0,8,8,1,2018-10-16
5950,경기,화성시,18,2,1,21,14,0,2018-11-16
5951,경기,화성시,4,0,2,6,5,0,2018-12-16
5952,경기,가평군,0,0,0,0,0,0,2018-01-17
5953,경기,가평군,0,0,1,1,1,0,2018-02-17
5954,경기,가평군,6,0,0,6,2,0,2018-03-17
5955,경기,가평군,0,0,0,0,0,0,2018-04-17
5956,경기,가평군,1,0,0,1,1,0,2018-05-17
5957,경기,가평군,2,0,0,2,2,0,2018-06-17
5958,경기,가평군,4,0,0,4,1,0,2018-07-17
5959,경기,가평군,3,1,4,8,4,0,2018-08-17
5960,경기,가평군,0,1,0,1,1,0,2018-09-17
5961,경기,가평군,1,0,0,1,1,0,2018-10-17
5962,경기,가평군,3,0,0,3,2,0,2018-11-17
5963,경기,가평군,0,0,0,0,0,0,2018-12-17
5964,경기,고양시,9,1,0,10,9,1,2018-01-17
5965,경기,고양시,17,2,3,22,11,0,2018-02-17
5966,경기,고양시,14,0,4,18,12,0,2018-03-17
5967,경기,고양시,8,0,1,9,6,0,2018-04-17
5968,경기,고양시,14,0,3,17,17,1,2018-05-17
5969,경기,고양시,8,3,4,15,10,0,2018-06-17
5970,경기,고양시,11,2,7,20,15,0,2018-07-17
5971,경기,고양시,5,2,6,13,13,0,2018-08-17
5972,경기,고양시,10,1,1,12,11,1,2018-09-17
5973,경기,고양시,15,2,4,21,12,0,2018-10-17
5974,경기,고양시,6,1,2,9,6,0,2018-11-17
5975,경기,고양시,18,4,5,27,16,0,2018-12-17
5976,경기,과천시,0,0,0,0,0,0,2018-01-17
5977,경기,과천시,2,0,2,4,1,0,2018-02-17
5978,경기,과천시,0,0,0,0,0,0,2018-03-17
5979,경기,과천시,0,0,1,1,1,0,2018-04-17
5980,경기,과천시,1,0,0,1,1,0,2018-05-17
5981,경기,과천시,0,1,0,1,1,0,2018-06-17
5982,경기,과천시,0,0,0,0,0,0,2018-07-17
5983,경기,과천시,2,0,1,3,3,0,2018-08-17
5984,경기,과천시,0,0,0,0,0,0,2018-09-17
5985,경기,과천시,3,0,2,5,5,0,2018-10-17
5986,경기,과천시,1,1,0,2,1,0,2018-11-17
5987,경기,과천시,0,1,0,1,1,0,2018-12-17
5988,경기,광명시,2,0,0,2,2,0,2018-01-17
5989,경기,광명시,2,0,0,2,2,0,2018-02-17
5990,경기,광명시,3,2,2,7,3,0,2018-03-17
5991,경기,광명시,2,5,1,8,4,0,2018-04-17
5992,경기,광명시,3,0,0,3,2,0,2018-05-17
5993,경기,광명시,0,0,0,0,0,0,2018-06-17
5994,경기,광명시,4,2,3,9,5,0,2018-07-17
5995,경기,광명시,3,4,1,8,5,0,2018-08-17
5996,경기,광명시,1,2,0,3,3,0,2018-09-17
5997,경기,광명시,4,0,0,4,3,0,2018-10-17
5998,경기,광명시,7,0,0,7,4,0,2018-11-17
5999,경기,광명시,6,1,1,8,6,0,2018-12-17
6000,경기,광주시,1,0,3,4,4,0,2018-01-17
6001,경기,광주시,2,0,0,2,2,0,2018-02-17
6002,경기,광주시,3,0,2,5,3,0,2018-03-17
6003,경기,광주시,4,0,4,8,3,0,2018-04-17
6004,경기,광주시,2,0,3,5,4,0,2018-05-17
6005,경기,광주시,1,0,0,1,2,1,2018-06-17
6006,경기,광주시,6,0,0,6,5,0,2018-07-17
6007,경기,광주시,4,0,1,5,4,0,2018-08-17
6008,경기,광주시,6,0,1,7,5,0,2018-09-17
6009,경기,광주시,5,0,0,5,3,0,2018-10-17
6010,경기,광주시,11,2,0,13,9,1,2018-11-17
6011,경기,광주시,5,0,2,7,5,0,2018-12-17
6012,경기,구리시,1,0,0,1,1,0,2018-01-17
6013,경기,구리시,4,0,0,4,2,0,2018-02-17
6014,경기,구리시,0,0,0,0,0,0,2018-03-17
6015,경기,구리시,2,0,1,3,2,0,2018-04-17
6016,경기,구리시,0,0,1,1,1,0,2018-05-17
6017,경기,구리시,1,0,0,1,1,0,2018-06-17
6018,경기,구리시,1,0,2,3,3,0,2018-07-17
6019,경기,구리시,1,0,1,2,2,0,2018-08-17
6020,경기,구리시,2,0,0,2,2,0,2018-09-17
6021,경기,구리시,3,0,0,3,3,0,2018-10-17
6022,경기,구리시,3,0,2,5,2,0,2018-11-17
6023,경기,구리시,5,0,0,5,3,0,2018-12-17
6024,경기,군포시,1,0,1,2,2,0,2018-01-17
6025,경기,군포시,4,0,1,5,3,0,2018-02-17
6026,경기,군포시,0,0,1,1,1,0,2018-03-17
6027,경기,군포시,3,1,1,5,2,0,2018-04-17
6028,경기,군포시,2,0,2,4,3,0,2018-05-17
6029,경기,군포시,4,0,0,4,2,0,2018-06-17
6030,경기,군포시,1,0,0,1,1,0,2018-07-17
6031,경기,군포시,0,0,2,2,2,0,2018-08-17
6032,경기,군포시,1,0,0,1,2,1,2018-09-17
6033,경기,군포시,3,0,0,3,2,0,2018-10-17
6034,경기,군포시,1,0,0,1,1,0,2018-11-17
6035,경기,군포시,5,0,0,5,3,0,2018-12-17
6036,경기,김포시,6,0,2,8,5,0,2018-01-17
6037,경기,김포시,3,1,3,7,4,0,2018-02-17
6038,경기,김포시,3,0,1,4,2,0,2018-03-17
6039,경기,김포시,3,0,3,6,4,0,2018-04-17
6040,경기,김포시,4,3,1,8,5,0,2018-05-17
6041,경기,김포시,3,1,0,4,3,0,2018-06-17
6042,경기,김포시,5,0,0,5,4,0,2018-07-17
6043,경기,김포시,4,0,2,6,6,0,2018-08-17
6044,경기,김포시,3,0,0,3,3,1,2018-09-17
6045,경기,김포시,5,2,4,11,9,0,2018-10-17
6046,경기,김포시,9,2,2,13,8,0,2018-11-17
6047,경기,김포시,5,3,3,11,6,0,2018-12-17
6048,경기,남양주시,19,0,5,24,12,0,2018-01-17
6049,경기,남양주시,4,0,0,4,3,0,2018-02-17
6050,경기,남양주시,6,1,1,8,5,0,2018-03-17
6051,경기,남양주시,2,0,4,6,5,0,2018-04-17
6052,경기,남양주시,5,0,1,6,5,0,2018-05-17
6053,경기,남양주시,6,5,5,16,7,0,2018-06-17
6054,경기,남양주시,8,3,1,12,8,0,2018-07-17
6055,경기,남양주시,8,0,0,8,5,0,2018-08-17
6056,경기,남양주시,6,0,0,6,3,0,2018-09-17
6057,경기,남양주시,6,1,3,10,7,0,2018-10-17
6058,경기,남양주시,10,0,3,13,9,0,2018-11-17
6059,경기,남양주시,7,0,1,8,4,0,2018-12-17
6060,경기,동두천시,0,0,0,0,0,0,2018-01-17
6061,경기,동두천시,3,1,1,5,1,0,2018-02-17
6062,경기,동두천시,1,0,1,2,1,0,2018-03-17
6063,경기,동두천시,1,0,0,1,1,0,2018-04-17
6064,경기,동두천시,1,0,0,1,1,0,2018-05-17
6065,경기,동두천시,0,0,2,2,1,0,2018-06-17
6066,경기,동두천시,0,0,0,0,0,0,2018-07-17
6067,경기,동두천시,0,0,1,1,1,0,2018-08-17
6068,경기,동두천시,0,0,0,0,0,0,2018-09-17
6069,경기,동두천시,0,0,1,1,1,0,2018-10-17
6070,경기,동두천시,0,0,0,0,0,0,2018-11-17
6071,경기,동두천시,2,0,9,11,1,0,2018-12-17
6072,경기,부천시,7,0,1,8,7,0,2018-01-17
6073,경기,부천시,8,0,2,10,5,0,2018-02-17
6074,경기,부천시,4,1,2,7,5,0,2018-03-17
6075,경기,부천시,4,1,1,6,5,0,2018-04-17
6076,경기,부천시,10,2,0,12,6,0,2018-05-17
6077,경기,부천시,6,2,3,11,8,0,2018-06-17
6078,경기,부천시,30,4,11,45,15,1,2018-07-17
6079,경기,부천시,17,2,3,22,15,0,2018-08-17
6080,경기,부천시,9,0,4,13,11,0,2018-09-17
6081,경기,부천시,10,1,3,14,12,0,2018-10-17
6082,경기,부천시,11,0,2,13,11,0,2018-11-17
6083,경기,부천시,7,0,1,8,6,0,2018-12-17
6084,경기,성남시,15,2,2,19,14,0,2018-01-17
6085,경기,성남시,7,0,1,8,6,0,2018-02-17
6086,경기,성남시,11,1,3,15,11,0,2018-03-17
6087,경기,성남시,18,0,5,23,14,0,2018-04-17
6088,경기,성남시,15,0,1,16,11,0,2018-05-17
6089,경기,성남시,9,1,0,10,7,1,2018-06-17
6090,경기,성남시,4,0,3,7,7,0,2018-07-17
6091,경기,성남시,4,0,1,5,5,0,2018-08-17
6092,경기,성남시,12,0,6,18,15,0,2018-09-17
6093,경기,성남시,4,1,1,6,6,1,2018-10-17
6094,경기,성남시,13,2,2,17,8,0,2018-11-17
6095,경기,성남시,13,3,1,17,12,1,2018-12-17
6096,경기,수원시,13,0,2,15,13,0,2018-01-17
6097,경기,수원시,7,0,1,8,7,0,2018-02-17
6098,경기,수원시,13,3,3,19,14,0,2018-03-17
6099,경기,수원시,16,0,2,18,15,0,2018-04-17
6100,경기,수원시,5,2,5,12,9,0,2018-05-17
6101,경기,수원시,13,3,2,18,10,0,2018-06-17
6102,경기,수원시,18,2,6,26,19,0,2018-07-17
6103,경기,수원시,9,1,4,14,12,0,2018-08-17
6104,경기,수원시,17,2,3,22,17,0,2018-09-17
6105,경기,수원시,22,1,5,28,15,1,2018-10-17
6106,경기,수원시,13,1,1,15,13,2,2018-11-17
6107,경기,수원시,15,0,2,17,10,0,2018-12-17
6108,경기,시흥시,5,1,2,8,6,0,2018-01-17
6109,경기,시흥시,3,1,2,6,4,0,2018-02-17
6110,경기,시흥시,17,0,1,18,12,0,2018-03-17
6111,경기,시흥시,2,0,2,4,3,0,2018-04-17
6112,경기,시흥시,7,1,1,9,8,1,2018-05-17
6113,경기,시흥시,2,1,0,3,3,0,2018-06-17
6114,경기,시흥시,3,2,2,7,6,0,2018-07-17
6115,경기,시흥시,4,0,1,5,5,0,2018-08-17
6116,경기,시흥시,8,1,0,9,7,0,2018-09-17
6117,경기,시흥시,8,1,7,16,9,0,2018-10-17
6118,경기,시흥시,10,1,0,11,8,1,2018-11-17
6119,경기,시흥시,10,0,3,13,9,0,2018-12-17
6120,경기,안산시,17,2,9,28,15,0,2018-01-17
6121,경기,안산시,20,2,5,27,11,0,2018-02-17
6122,경기,안산시,6,3,5,14,9,0,2018-03-17
6123,경기,안산시,3,0,1,4,4,0,2018-04-17
6124,경기,안산시,18,2,1,21,16,0,2018-05-17
6125,경기,안산시,8,0,1,9,5,0,2018-06-17
6126,경기,안산시,19,0,2,21,16,1,2018-07-17
6127,경기,안산시,16,3,2,21,17,0,2018-08-17
6128,경기,안산시,17,1,2,20,11,0,2018-09-17
6129,경기,안산시,10,0,3,13,11,0,2018-10-17
6130,경기,안산시,16,0,1,17,10,0,2018-11-17
6131,경기,안산시,12,3,5,20,12,0,2018-12-17
6132,경기,안성시,3,1,3,7,6,0,2018-01-17
6133,경기,안성시,4,1,2,7,4,0,2018-02-17
6134,경기,안성시,9,1,8,18,5,0,2018-03-17
6135,경기,안성시,0,0,1,1,1,0,2018-04-17
6136,경기,안성시,6,0,0,6,6,0,2018-05-17
6137,경기,안성시,1,0,0,1,1,0,2018-06-17
6138,경기,안성시,1,0,0,1,1,0,2018-07-17
6139,경기,안성시,2,0,5,7,4,0,2018-08-17
6140,경기,안성시,2,1,0,3,3,0,2018-09-17
6141,경기,안성시,4,0,4,8,5,0,2018-10-17
6142,경기,안성시,4,0,4,8,4,0,2018-11-17
6143,경기,안성시,18,4,3,25,8,0,2018-12-17
6144,경기,안양시,3,0,4,7,7,0,2018-01-17
6145,경기,안양시,10,0,0,10,6,0,2018-02-17
6146,경기,안양시,4,2,1,7,4,0,2018-03-17
6147,경기,안양시,8,0,0,8,3,0,2018-04-17
6148,경기,안양시,6,0,1,7,6,0,2018-05-17
6149,경기,안양시,1,1,2,4,4,0,2018-06-17
6150,경기,안양시,4,0,2,6,6,0,2018-07-17
6151,경기,안양시,5,1,1,7,6,0,2018-08-17
6152,경기,안양시,8,1,0,9,6,0,2018-09-17
6153,경기,안양시,8,0,1,9,5,0,2018-10-17
6154,경기,안양시,13,0,1,14,8,0,2018-11-17
6155,경기,안양시,8,0,0,8,4,0,2018-12-17
6156,경기,양주시,0,0,2,2,2,0,2018-01-17
6157,경기,양주시,0,0,0,0,0,0,2018-02-17
6158,경기,양주시,0,0,2,2,2,0,2018-03-17
6159,경기,양주시,3,0,2,5,3,0,2018-04-17
6160,경기,양주시,2,0,0,2,2,0,2018-05-17
6161,경기,양주시,0,0,0,0,0,0,2018-06-17
6162,경기,양주시,3,0,2,5,4,0,2018-07-17
6163,경기,양주시,6,0,1,7,3,0,2018-08-17
6164,경기,양주시,3,0,2,5,3,0,2018-09-17
6165,경기,양주시,2,0,0,2,1,0,2018-10-17
6166,경기,양주시,2,0,2,4,2,0,2018-11-17
6167,경기,양주시,7,0,1,8,4,0,2018-12-17
6168,경기,양평군,0,1,0,1,1,0,2018-01-17
6169,경기,양평군,13,0,2,15,2,0,2018-02-17
6170,경기,양평군,0,0,1,1,1,0,2018-03-17
6171,경기,양평군,2,0,1,3,2,0,2018-04-17
6172,경기,양평군,0,0,0,0,0,0,2018-05-17
6173,경기,양평군,3,0,0,3,1,0,2018-06-17
6174,경기,양평군,0,1,0,1,1,0,2018-07-17
6175,경기,양평군,1,0,1,2,2,0,2018-08-17
6176,경기,양평군,5,2,0,7,3,0,2018-09-17
6177,경기,양평군,2,0,0,2,1,0,2018-10-17
6178,경기,양평군,0,0,0,0,0,0,2018-11-17
6179,경기,양평군,1,0,0,1,1,0,2018-12-17
6180,경기,여주시,0,0,1,1,1,0,2018-01-17
6181,경기,여주시,1,0,0,1,1,0,2018-02-17
6182,경기,여주시,6,0,0,6,4,0,2018-03-17
6183,경기,여주시,0,0,0,0,0,0,2018-04-17
6184,경기,여주시,2,0,1,3,3,0,2018-05-17
6185,경기,여주시,0,0,0,0,0,0,2018-06-17
6186,경기,여주시,0,0,0,0,0,0,2018-07-17
6187,경기,여주시,0,0,0,0,0,0,2018-08-17
6188,경기,여주시,6,0,1,7,5,0,2018-09-17
6189,경기,여주시,1,0,1,2,2,0,2018-10-17
6190,경기,여주시,0,0,1,1,1,0,2018-11-17
6191,경기,여주시,0,0,0,0,0,0,2018-12-17
6192,경기,연천군,0,0,0,0,0,0,2018-01-17
6193,경기,연천군,0,0,0,0,0,0,2018-02-17
6194,경기,연천군,0,0,2,2,1,0,2018-03-17
6195,경기,연천군,2,0,0,2,1,0,2018-04-17
6196,경기,연천군,0,0,1,1,1,0,2018-05-17
6197,경기,연천군,2,0,1,3,2,0,2018-06-17
6198,경기,연천군,0,0,0,0,0,0,2018-07-17
6199,경기,연천군,0,0,0,0,0,0,2018-08-17
6200,경기,연천군,1,0,1,2,2,0,2018-09-17
6201,경기,연천군,0,0,0,0,0,0,2018-10-17
6202,경기,연천군,0,0,0,0,0,0,2018-11-17
6203,경기,연천군,2,0,0,2,2,0,2018-12-17
6204,경기,오산시,10,0,3,13,6,0,2018-01-17
6205,경기,오산시,2,0,0,2,2,0,2018-02-17
6206,경기,오산시,0,0,0,0,0,0,2018-03-17
6207,경기,오산시,4,0,1,5,4,0,2018-04-17
6208,경기,오산시,4,3,0,7,3,0,2018-05-17
6209,경기,오산시,2,1,0,3,2,0,2018-06-17
6210,경기,오산시,2,0,1,3,3,0,2018-07-17
6211,경기,오산시,0,1,1,2,2,0,2018-08-17
6212,경기,오산시,3,0,2,5,4,0,2018-09-17
6213,경기,오산시,3,0,2,5,5,0,2018-10-17
6214,경기,오산시,2,2,0,4,3,0,2018-11-17
6215,경기,오산시,3,0,1,4,3,0,2018-12-17
6216,경기,용인시,11,4,0,15,10,0,2018-01-17
6217,경기,용인시,6,0,3,9,4,0,2018-02-17
6218,경기,용인시,15,1,5,21,9,0,2018-03-17
6219,경기,용인시,14,3,2,19,11,0,2018-04-17
6220,경기,용인시,9,0,2,11,9,0,2018-05-17
6221,경기,용인시,3,1,2,6,3,0,2018-06-17
6222,경기,용인시,6,2,4,12,11,0,2018-07-17
6223,경기,용인시,16,2,2,20,12,0,2018-08-17
6224,경기,용인시,9,7,1,17,14,0,2018-09-17
6225,경기,용인시,14,1,1,16,12,0,2018-10-17
6226,경기,용인시,12,0,1,13,8,0,2018-11-17
6227,경기,용인시,7,1,3,11,9,0,2018-12-17
6228,경기,의왕시,1,0,0,1,1,0,2018-01-17
6229,경기,의왕시,1,0,0,1,1,0,2018-02-17
6230,경기,의왕시,0,0,0,0,0,0,2018-03-17
6231,경기,의왕시,3,1,0,4,1,0,2018-04-17
6232,경기,의왕시,1,0,1,2,2,0,2018-05-17
6233,경기,의왕시,0,0,1,1,1,0,2018-06-17
6234,경기,의왕시,1,0,0,1,1,0,2018-07-17
6235,경기,의왕시,3,0,1,4,2,0,2018-08-17
6236,경기,의왕시,0,0,1,1,1,0,2018-09-17
6237,경기,의왕시,1,0,0,1,1,0,2018-10-17
6238,경기,의왕시,2,0,0,2,1,0,2018-11-17
6239,경기,의왕시,1,0,0,1,1,0,2018-12-17
6240,경기,의정부시,4,3,4,11,8,0,2018-01-17
6241,경기,의정부시,1,2,0,3,3,0,2018-02-17
6242,경기,의정부시,1,1,1,3,3,0,2018-03-17
6243,경기,의정부시,4,0,1,5,5,0,2018-04-17
6244,경기,의정부시,1,0,4,5,4,0,2018-05-17
6245,경기,의정부시,1,0,0,1,1,0,2018-06-17
6246,경기,의정부시,6,1,0,7,3,0,2018-07-17
6247,경기,의정부시,5,1,1,7,5,0,2018-08-17
6248,경기,의정부시,9,0,5,14,7,0,2018-09-17
6249,경기,의정부시,3,0,2,5,5,0,2018-10-17
6250,경기,의정부시,10,1,2,13,9,1,2018-11-17
6251,경기,의정부시,4,0,0,4,3,0,2018-12-17
6252,경기,이천시,2,0,0,2,2,0,2018-01-17
6253,경기,이천시,0,0,1,1,1,0,2018-02-17
6254,경기,이천시,7,0,2,9,6,1,2018-03-17
6255,경기,이천시,0,0,0,0,0,0,2018-04-17
6256,경기,이천시,4,0,2,6,4,0,2018-05-17
6257,경기,이천시,1,0,0,1,1,0,2018-06-17
6258,경기,이천시,1,0,0,1,1,0,2018-07-17
6259,경기,이천시,4,1,0,5,4,0,2018-08-17
6260,경기,이천시,7,1,2,10,5,0,2018-09-17
6261,경기,이천시,1,0,0,1,1,0,2018-10-17
6262,경기,이천시,4,3,2,9,5,0,2018-11-17
6263,경기,이천시,5,1,1,7,4,0,2018-12-17
6264,경기,파주시,2,0,2,4,3,0,2018-01-17
6265,경기,파주시,1,0,0,1,1,0,2018-02-17
6266,경기,파주시,3,1,2,6,5,0,2018-03-17
6267,경기,파주시,3,0,0,3,3,0,2018-04-17
6268,경기,파주시,6,0,1,7,5,0,2018-05-17
6269,경기,파주시,12,1,1,14,6,0,2018-06-17
6270,경기,파주시,3,1,2,6,5,0,2018-07-17
6271,경기,파주시,4,0,1,5,5,0,2018-08-17
6272,경기,파주시,8,0,5,13,5,0,2018-09-17
6273,경기,파주시,10,0,1,11,4,0,2018-10-17
6274,경기,파주시,2,1,2,5,4,0,2018-11-17
6275,경기,파주시,7,0,1,8,7,0,2018-12-17
6276,경기,평택시,8,0,2,10,8,0,2018-01-17
6277,경기,평택시,15,0,3,18,7,0,2018-02-17
6278,경기,평택시,14,1,1,16,10,0,2018-03-17
6279,경기,평택시,11,1,2,14,12,0,2018-04-17
6280,경기,평택시,10,0,5,15,9,0,2018-05-17
6281,경기,평택시,4,3,2,9,6,0,2018-06-17
6282,경기,평택시,16,7,5,28,13,0,2018-07-17
6283,경기,평택시,20,1,3,24,10,0,2018-08-17
6284,경기,평택시,10,3,6,19,13,0,2018-09-17
6285,경기,평택시,17,0,6,23,18,0,2018-10-17
6286,경기,평택시,17,7,1,25,11,0,2018-11-17
6287,경기,평택시,21,0,2,23,12,0,2018-12-17
6288,경기,포천시,2,1,2,5,4,0,2018-01-17
6289,경기,포천시,0,0,0,0,0,0,2018-02-17
6290,경기,포천시,1,0,0,1,1,0,2018-03-17
6291,경기,포천시,2,0,0,2,2,0,2018-04-17
6292,경기,포천시,6,2,4,12,4,0,2018-05-17
6293,경기,포천시,1,0,4,5,3,0,2018-06-17
6294,경기,포천시,6,0,0,6,4,0,2018-07-17
6295,경기,포천시,6,0,3,9,4,0,2018-08-17
6296,경기,포천시,0,0,0,0,0,0,2018-09-17
6297,경기,포천시,2,1,3,6,5,0,2018-10-17
6298,경기,포천시,6,1,2,9,5,0,2018-11-17
6299,경기,포천시,1,2,0,3,2,0,2018-12-17
6300,경기,하남시,4,0,1,5,3,0,2018-01-17
6301,경기,하남시,0,0,0,0,0,0,2018-02-17
6302,경기,하남시,2,0,0,2,1,0,2018-03-17
6303,경기,하남시,0,0,0,0,0,0,2018-04-17
6304,경기,하남시,1,0,5,6,2,0,2018-05-17
6305,경기,하남시,1,1,0,2,2,0,2018-06-17
6306,경기,하남시,3,0,1,4,3,0,2018-07-17
6307,경기,하남시,3,1,5,9,4,0,2018-08-17
6308,경기,하남시,3,0,1,4,4,0,2018-09-17
6309,경기,하남시,5,0,1,6,5,0,2018-10-17
6310,경기,하남시,8,2,0,10,5,0,2018-11-17
6311,경기,하남시,7,0,5,12,3,0,2018-12-17
6312,경기,화성시,9,0,3,12,8,0,2018-01-17
6313,경기,화성시,3,0,0,3,4,1,2018-02-17
6314,경기,화성시,5,0,5,10,5,0,2018-03-17
6315,경기,화성시,5,1,5,11,6,0,2018-04-17
6316,경기,화성시,5,0,1,6,5,0,2018-05-17
6317,경기,화성시,8,1,0,9,6,0,2018-06-17
6318,경기,화성시,16,0,4,20,11,0,2018-07-17
6319,경기,화성시,9,0,2,11,8,0,2018-08-17
6320,경기,화성시,9,1,3,13,6,0,2018-09-17
6321,경기,화성시,4,2,4,10,9,0,2018-10-17
6322,경기,화성시,10,0,2,12,9,0,2018-11-17
6323,경기,화성시,8,0,3,11,7,0,2018-12-17
6324,경기,가평군,0,0,0,0,0,0,2018-01-18
6325,경기,가평군,0,3,0,3,1,0,2018-02-18
6326,경기,가평군,3,2,1,6,2,0,2018-03-18
6327,경기,가평군,6,0,0,6,2,0,2018-04-18
6328,경기,가평군,0,0,1,1,1,0,2018-05-18
6329,경기,가평군,0,0,1,1,1,0,2018-06-18
6330,경기,가평군,3,0,3,6,3,0,2018-07-18
6331,경기,가평군,8,1,0,9,5,0,2018-08-18
6332,경기,가평군,3,1,0,4,2,0,2018-09-18
6333,경기,가평군,0,0,0,0,0,0,2018-10-18
6334,경기,가평군,2,0,0,2,1,0,2018-11-18
6335,경기,가평군,1,0,0,1,1,0,2018-12-18
6336,경기,고양시,10,0,4,14,11,1,2018-01-18
6337,경기,고양시,16,1,4,21,8,0,2018-02-18
6338,경기,고양시,10,2,2,14,10,0,2018-03-18
6339,경기,고양시,21,2,14,37,17,0,2018-04-18
6340,경기,고양시,13,0,6,19,13,0,2018-05-18
6341,경기,고양시,8,0,3,11,11,0,2018-06-18
6342,경기,고양시,8,1,1,10,9,0,2018-07-18
6343,경기,고양시,19,0,4,23,9,0,2018-08-18
6344,경기,고양시,3,1,2,6,6,0,2018-09-18
6345,경기,고양시,13,1,5,19,14,1,2018-10-18
6346,경기,고양시,6,0,1,7,7,0,2018-11-18
6347,경기,고양시,11,3,4,18,12,1,2018-12-18
6348,경기,과천시,0,0,0,0,0,0,2018-01-18
6349,경기,과천시,0,0,0,0,0,0,2018-02-18
6350,경기,과천시,4,0,2,6,2,0,2018-03-18
6351,경기,과천시,0,0,0,0,0,0,2018-04-18
6352,경기,과천시,2,0,0,2,1,0,2018-05-18
6353,경기,과천시,0,0,0,0,0,0,2018-06-18
6354,경기,과천시,0,0,0,0,0,0,2018-07-18
6355,경기,과천시,0,0,0,0,0,0,2018-08-18
6356,경기,과천시,1,0,0,1,1,0,2018-09-18
6357,경기,과천시,1,1,2,4,3,0,2018-10-18
6358,경기,과천시,0,0,1,1,1,0,2018-11-18
6359,경기,과천시,0,0,0,0,0,0,2018-12-18
6360,경기,광명시,1,0,2,3,1,0,2018-01-18
6361,경기,광명시,2,0,0,2,2,0,2018-02-18
6362,경기,광명시,3,0,0,3,3,0,2018-03-18
6363,경기,광명시,3,0,1,4,3,0,2018-04-18
6364,경기,광명시,3,0,2,5,4,0,2018-05-18
6365,경기,광명시,1,0,0,1,1,0,2018-06-18
6366,경기,광명시,1,0,1,2,2,0,2018-07-18
6367,경기,광명시,4,1,0,5,3,0,2018-08-18
6368,경기,광명시,0,0,0,0,0,0,2018-09-18
6369,경기,광명시,1,0,2,3,3,0,2018-10-18
6370,경기,광명시,1,0,0,1,1,0,2018-11-18
6371,경기,광명시,1,1,0,2,2,0,2018-12-18
6372,경기,광주시,8,0,0,8,5,0,2018-01-18
6373,경기,광주시,3,0,2,5,2,0,2018-02-18
6374,경기,광주시,2,0,1,3,3,0,2018-03-18
6375,경기,광주시,2,0,2,4,3,0,2018-04-18
6376,경기,광주시,2,0,1,3,2,0,2018-05-18
6377,경기,광주시,7,0,0,7,7,0,2018-06-18
6378,경기,광주시,4,0,5,9,8,1,2018-07-18
6379,경기,광주시,3,0,2,5,3,0,2018-08-18
6380,경기,광주시,8,0,3,11,9,0,2018-09-18
6381,경기,광주시,5,0,2,7,6,0,2018-10-18
6382,경기,광주시,2,0,0,2,1,0,2018-11-18
6383,경기,광주시,1,1,1,3,4,1,2018-12-18
6384,경기,구리시,0,0,0,0,0,0,2018-01-18
6385,경기,구리시,0,0,0,0,0,0,2018-02-18
6386,경기,구리시,4,0,2,6,4,0,2018-03-18
6387,경기,구리시,2,0,0,2,1,0,2018-04-18
6388,경기,구리시,2,0,0,2,2,0,2018-05-18
6389,경기,구리시,0,0,0,0,0,0,2018-06-18
6390,경기,구리시,0,0,1,1,1,0,2018-07-18
6391,경기,구리시,4,0,0,4,1,0,2018-08-18
6392,경기,구리시,1,0,1,2,2,0,2018-09-18
6393,경기,구리시,0,0,0,0,0,0,2018-10-18
6394,경기,구리시,1,0,0,1,1,0,2018-11-18
6395,경기,구리시,2,0,3,5,4,0,2018-12-18
6396,경기,군포시,5,0,1,6,2,0,2018-01-18
6397,경기,군포시,0,0,0,0,0,0,2018-02-18
6398,경기,군포시,1,0,0,1,1,0,2018-03-18
6399,경기,군포시,0,0,0,0,0,0,2018-04-18
6400,경기,군포시,2,3,0,5,1,0,2018-05-18
6401,경기,군포시,3,3,1,7,4,0,2018-06-18
6402,경기,군포시,0,0,0,0,0,0,2018-07-18
6403,경기,군포시,0,0,2,2,1,0,2018-08-18
6404,경기,군포시,0,0,0,0,0,0,2018-09-18
6405,경기,군포시,6,2,0,8,3,0,2018-10-18
6406,경기,군포시,0,0,0,0,0,0,2018-11-18
6407,경기,군포시,0,0,0,0,0,0,2018-12-18
6408,경기,김포시,4,0,3,7,4,0,2018-01-18
6409,경기,김포시,4,0,2,6,4,0,2018-02-18
6410,경기,김포시,15,0,1,16,6,0,2018-03-18
6411,경기,김포시,3,0,2,5,5,0,2018-04-18
6412,경기,김포시,2,0,2,4,4,0,2018-05-18
6413,경기,김포시,4,0,0,4,2,0,2018-06-18
6414,경기,김포시,5,0,1,6,5,0,2018-07-18
6415,경기,김포시,6,1,2,9,6,0,2018-08-18
6416,경기,김포시,6,0,0,6,5,0,2018-09-18
6417,경기,김포시,11,3,1,15,8,1,2018-10-18
6418,경기,김포시,0,1,0,1,1,0,2018-11-18
6419,경기,김포시,8,0,1,9,7,0,2018-12-18
6420,경기,남양주시,4,1,2,7,7,0,2018-01-18
6421,경기,남양주시,4,0,0,4,1,0,2018-02-18
6422,경기,남양주시,6,2,3,11,11,1,2018-03-18
6423,경기,남양주시,1,1,0,2,2,0,2018-04-18
6424,경기,남양주시,16,1,2,19,12,0,2018-05-18
6425,경기,남양주시,3,1,3,7,7,0,2018-06-18
6426,경기,남양주시,37,1,4,42,4,0,2018-07-18
6427,경기,남양주시,7,2,6,15,9,0,2018-08-18
6428,경기,남양주시,14,1,5,20,10,0,2018-09-18
6429,경기,남양주시,4,0,2,6,5,0,2018-10-18
6430,경기,남양주시,10,0,1,11,6,0,2018-11-18
6431,경기,남양주시,14,0,4,18,14,1,2018-12-18
6432,경기,동두천시,0,0,2,2,2,0,2018-01-18
6433,경기,동두천시,0,0,0,0,0,0,2018-02-18
6434,경기,동두천시,3,0,0,3,1,0,2018-03-18
6435,경기,동두천시,0,0,0,0,0,0,2018-04-18
6436,경기,동두천시,0,0,0,0,0,0,2018-05-18
6437,경기,동두천시,1,0,0,1,1,0,2018-06-18
6438,경기,동두천시,0,0,0,0,0,0,2018-07-18
6439,경기,동두천시,4,0,0,4,3,1,2018-08-18
6440,경기,동두천시,3,0,1,4,4,0,2018-09-18
6441,경기,동두천시,0,0,0,0,0,0,2018-10-18
6442,경기,동두천시,0,0,0,0,0,0,2018-11-18
6443,경기,동두천시,0,0,1,1,1,0,2018-12-18
6444,경기,부천시,4,0,2,6,5,0,2018-01-18
6445,경기,부천시,8,1,2,11,6,0,2018-02-18
6446,경기,부천시,5,0,2,7,6,0,2018-03-18
6447,경기,부천시,8,5,2,15,10,0,2018-04-18
6448,경기,부천시,8,1,3,12,10,0,2018-05-18
6449,경기,부천시,6,1,4,11,11,0,2018-06-18
6450,경기,부천시,9,0,4,13,11,0,2018-07-18
6451,경기,부천시,16,2,3,21,17,0,2018-08-18
6452,경기,부천시,4,1,2,7,6,0,2018-09-18
6453,경기,부천시,3,1,6,10,6,0,2018-10-18
6454,경기,부천시,4,0,2,6,5,0,2018-11-18
6455,경기,부천시,11,1,5,17,14,0,2018-12-18
6456,경기,성남시,10,2,3,15,8,0,2018-01-18
6457,경기,성남시,3,0,0,3,2,0,2018-02-18
6458,경기,성남시,5,1,0,6,6,0,2018-03-18
6459,경기,성남시,16,0,3,19,14,0,2018-04-18
6460,경기,성남시,10,1,3,14,8,0,2018-05-18
6461,경기,성남시,12,4,5,21,12,0,2018-06-18
6462,경기,성남시,12,2,0,14,11,0,2018-07-18
6463,경기,성남시,12,0,7,19,13,0,2018-08-18
6464,경기,성남시,10,1,7,18,15,0,2018-09-18
6465,경기,성남시,6,2,12,20,13,1,2018-10-18
6466,경기,성남시,11,1,7,19,11,0,2018-11-18
6467,경기,성남시,6,1,2,9,7,0,2018-12-18
6468,경기,수원시,12,2,3,17,12,0,2018-01-18
6469,경기,수원시,4,0,4,8,7,0,2018-02-18
6470,경기,수원시,9,0,2,11,9,0,2018-03-18
6471,경기,수원시,4,1,3,8,8,0,2018-04-18
6472,경기,수원시,25,6,2,33,19,0,2018-05-18
6473,경기,수원시,8,0,2,10,8,0,2018-06-18
6474,경기,수원시,13,2,3,18,12,0,2018-07-18
6475,경기,수원시,16,1,3,20,16,0,2018-08-18
6476,경기,수원시,15,0,8,23,18,2,2018-09-18
6477,경기,수원시,17,0,4,21,18,0,2018-10-18
6478,경기,수원시,16,1,2,19,14,1,2018-11-18
6479,경기,수원시,11,1,1,13,12,0,2018-12-18
6480,경기,시흥시,10,1,3,14,10,0,2018-01-18
6481,경기,시흥시,0,0,1,1,1,0,2018-02-18
6482,경기,시흥시,2,1,1,4,4,0,2018-03-18
6483,경기,시흥시,1,0,0,1,1,0,2018-04-18
6484,경기,시흥시,5,0,1,6,6,0,2018-05-18
6485,경기,시흥시,13,2,2,17,10,0,2018-06-18
6486,경기,시흥시,13,2,6,21,13,0,2018-07-18
6487,경기,시흥시,8,1,5,14,10,1,2018-08-18
6488,경기,시흥시,4,0,2,6,6,0,2018-09-18
6489,경기,시흥시,8,0,2,10,7,0,2018-10-18
6490,경기,시흥시,3,0,1,4,1,0,2018-11-18
6491,경기,시흥시,9,0,4,13,7,0,2018-12-18
6492,경기,안산시,7,2,3,12,9,0,2018-01-18
6493,경기,안산시,18,0,1,19,5,0,2018-02-18
6494,경기,안산시,4,0,2,6,6,0,2018-03-18
6495,경기,안산시,13,0,3,16,12,0,2018-04-18
6496,경기,안산시,16,0,4,20,10,0,2018-05-18
6497,경기,안산시,8,0,4,12,8,0,2018-06-18
6498,경기,안산시,10,0,1,11,9,0,2018-07-18
6499,경기,안산시,11,0,3,14,11,0,2018-08-18
6500,경기,안산시,13,0,12,25,15,0,2018-09-18
6501,경기,안산시,16,0,4,20,14,0,2018-10-18
6502,경기,안산시,15,3,2,20,9,0,2018-11-18
6503,경기,안산시,11,2,4,17,13,0,2018-12-18
6504,경기,안성시,5,2,0,7,5,0,2018-01-18
6505,경기,안성시,5,2,0,7,1,0,2018-02-18
6506,경기,안성시,13,0,2,15,4,0,2018-03-18
6507,경기,안성시,1,1,2,4,4,0,2018-04-18
6508,경기,안성시,5,1,0,6,4,1,2018-05-18
6509,경기,안성시,5,0,0,5,4,0,2018-06-18
6510,경기,안성시,7,0,0,7,5,0,2018-07-18
6511,경기,안성시,3,0,0,3,3,0,2018-08-18
6512,경기,안성시,1,0,2,3,3,0,2018-09-18
6513,경기,안성시,1,0,3,4,3,0,2018-10-18
6514,경기,안성시,0,1,1,2,2,0,2018-11-18
6515,경기,안성시,4,0,0,4,2,0,2018-12-18
6516,경기,안양시,4,0,3,7,4,0,2018-01-18
6517,경기,안양시,1,0,0,1,1,0,2018-02-18
6518,경기,안양시,4,0,1,5,5,1,2018-03-18
6519,경기,안양시,3,0,1,4,4,0,2018-04-18
6520,경기,안양시,6,1,1,8,7,1,2018-05-18
6521,경기,안양시,5,0,0,5,4,0,2018-06-18
6522,경기,안양시,2,2,0,4,4,0,2018-07-18
6523,경기,안양시,4,0,3,7,6,0,2018-08-18
6524,경기,안양시,6,0,0,6,5,0,2018-09-18
6525,경기,안양시,2,1,0,3,3,0,2018-10-18
6526,경기,안양시,4,0,0,4,2,0,2018-11-18
6527,경기,안양시,3,0,1,4,3,0,2018-12-18
6528,경기,양주시,5,0,1,6,4,0,2018-01-18
6529,경기,양주시,1,0,0,1,1,0,2018-02-18
6530,경기,양주시,2,1,1,4,2,0,2018-03-18
6531,경기,양주시,5,0,1,6,4,0,2018-04-18
6532,경기,양주시,3,1,1,5,5,0,2018-05-18
6533,경기,양주시,2,0,0,2,2,0,2018-06-18
6534,경기,양주시,3,0,1,4,3,0,2018-07-18
6535,경기,양주시,0,0,0,0,0,0,2018-08-18
6536,경기,양주시,8,4,0,12,5,0,2018-09-18
6537,경기,양주시,4,0,1,5,5,0,2018-10-18
6538,경기,양주시,0,0,0,0,0,0,2018-11-18
6539,경기,양주시,3,0,0,3,4,1,2018-12-18
6540,경기,양평군,1,0,0,1,1,0,2018-01-18
6541,경기,양평군,2,0,1,3,2,0,2018-02-18
6542,경기,양평군,4,0,1,5,3,0,2018-03-18
6543,경기,양평군,1,0,1,2,2,0,2018-04-18
6544,경기,양평군,0,0,0,0,0,0,2018-05-18
6545,경기,양평군,1,0,3,4,2,0,2018-06-18
6546,경기,양평군,4,0,0,4,3,0,2018-07-18
6547,경기,양평군,3,0,2,5,3,0,2018-08-18
6548,경기,양평군,1,0,0,1,2,1,2018-09-18
6549,경기,양평군,3,0,1,4,2,0,2018-10-18
6550,경기,양평군,4,0,3,7,4,0,2018-11-18
6551,경기,양평군,1,0,0,1,1,0,2018-12-18
6552,경기,여주시,1,0,2,3,2,0,2018-01-18
6553,경기,여주시,1,0,2,3,2,0,2018-02-18
6554,경기,여주시,2,0,1,3,1,0,2018-03-18
6555,경기,여주시,2,0,0,2,2,0,2018-04-18
6556,경기,여주시,0,0,0,0,0,0,2018-05-18
6557,경기,여주시,3,0,1,4,3,0,2018-06-18
6558,경기,여주시,0,0,0,0,0,0,2018-07-18
6559,경기,여주시,0,0,0,0,0,0,2018-08-18
6560,경기,여주시,0,0,0,0,0,0,2018-09-18
6561,경기,여주시,4,0,1,5,3,0,2018-10-18
6562,경기,여주시,0,0,0,0,0,0,2018-11-18
6563,경기,여주시,1,0,0,1,1,0,2018-12-18
6564,경기,연천군,0,0,0,0,0,0,2018-01-18
6565,경기,연천군,1,0,1,2,2,0,2018-02-18
6566,경기,연천군,0,0,0,0,0,0,2018-03-18
6567,경기,연천군,0,0,0,0,0,0,2018-04-18
6568,경기,연천군,0,0,0,0,0,0,2018-05-18
6569,경기,연천군,0,0,0,0,0,0,2018-06-18
6570,경기,연천군,0,0,0,0,0,0,2018-07-18
6571,경기,연천군,0,0,0,0,0,0,2018-08-18
6572,경기,연천군,6,0,0,6,3,0,2018-09-18
6573,경기,연천군,7,0,0,7,3,1,2018-10-18
6574,경기,연천군,2,0,0,2,1,0,2018-11-18
6575,경기,연천군,1,0,1,2,2,0,2018-12-18
6576,경기,오산시,4,0,2,6,3,0,2018-01-18
6577,경기,오산시,0,0,0,0,0,0,2018-02-18
6578,경기,오산시,7,0,0,7,3,0,2018-03-18
6579,경기,오산시,2,0,1,3,3,0,2018-04-18
6580,경기,오산시,2,0,1,3,2,0,2018-05-18
6581,경기,오산시,2,1,1,4,3,0,2018-06-18
6582,경기,오산시,3,0,0,3,2,0,2018-07-18
6583,경기,오산시,0,0,0,0,0,0,2018-08-18
6584,경기,오산시,2,1,0,3,2,0,2018-09-18
6585,경기,오산시,1,0,3,4,2,0,2018-10-18
6586,경기,오산시,0,0,0,0,0,0,2018-11-18
6587,경기,오산시,4,1,2,7,5,0,2018-12-18
6588,경기,용인시,4,0,2,6,5,0,2018-01-18
6589,경기,용인시,5,1,2,8,3,0,2018-02-18
6590,경기,용인시,5,1,12,18,7,0,2018-03-18
6591,경기,용인시,8,0,4,12,6,0,2018-04-18
6592,경기,용인시,9,0,1,10,5,1,2018-05-18
6593,경기,용인시,7,1,3,11,6,0,2018-06-18
6594,경기,용인시,12,5,2,19,10,0,2018-07-18
6595,경기,용인시,4,2,2,8,6,0,2018-08-18
6596,경기,용인시,10,2,2,14,11,0,2018-09-18
6597,경기,용인시,9,1,7,17,13,0,2018-10-18
6598,경기,용인시,12,0,5,17,13,0,2018-11-18
6599,경기,용인시,9,0,3,12,9,0,2018-12-18
6600,경기,의왕시,2,0,0,2,2,0,2018-01-18
6601,경기,의왕시,0,0,0,0,0,0,2018-02-18
6602,경기,의왕시,0,0,0,0,0,0,2018-03-18
6603,경기,의왕시,0,0,0,0,0,0,2018-04-18
6604,경기,의왕시,0,0,0,0,0,0,2018-05-18
6605,경기,의왕시,2,0,0,2,2,0,2018-06-18
6606,경기,의왕시,2,0,0,2,2,0,2018-07-18
6607,경기,의왕시,0,0,1,1,1,1,2018-08-18
6608,경기,의왕시,0,0,1,1,1,0,2018-09-18
6609,경기,의왕시,4,1,0,5,2,0,2018-10-18
6610,경기,의왕시,2,1,0,3,2,0,2018-11-18
6611,경기,의왕시,3,0,1,4,4,0,2018-12-18
6612,경기,의정부시,9,1,4,14,11,0,2018-01-18
6613,경기,의정부시,1,0,0,1,1,0,2018-02-18
6614,경기,의정부시,4,0,1,5,5,0,2018-03-18
6615,경기,의정부시,6,0,0,6,6,0,2018-04-18
6616,경기,의정부시,7,3,1,11,5,0,2018-05-18
6617,경기,의정부시,5,1,3,9,9,0,2018-06-18
6618,경기,의정부시,5,1,0,6,5,0,2018-07-18
6619,경기,의정부시,2,0,3,5,3,0,2018-08-18
6620,경기,의정부시,13,1,4,18,6,0,2018-09-18
6621,경기,의정부시,10,1,1,12,9,0,2018-10-18
6622,경기,의정부시,2,1,2,5,4,0,2018-11-18
6623,경기,의정부시,2,0,2,4,4,0,2018-12-18
6624,경기,이천시,2,0,1,3,3,0,2018-01-18
6625,경기,이천시,0,0,1,1,1,0,2018-02-18
6626,경기,이천시,1,0,0,1,1,0,2018-03-18
6627,경기,이천시,1,0,0,1,1,0,2018-04-18
6628,경기,이천시,2,0,1,3,3,0,2018-05-18
6629,경기,이천시,2,0,0,2,2,0,2018-06-18
6630,경기,이천시,1,0,3,4,3,0,2018-07-18
6631,경기,이천시,2,0,2,4,3,0,2018-08-18
6632,경기,이천시,4,1,1,6,5,0,2018-09-18
6633,경기,이천시,0,0,1,1,1,0,2018-10-18
6634,경기,이천시,1,0,0,1,1,0,2018-11-18
6635,경기,이천시,2,0,3,5,5,0,2018-12-18
6636,경기,파주시,6,0,1,7,5,0,2018-01-18
6637,경기,파주시,6,0,0,6,2,0,2018-02-18
6638,경기,파주시,1,1,3,5,3,0,2018-03-18
6639,경기,파주시,5,0,1,6,5,0,2018-04-18
6640,경기,파주시,3,0,2,5,3,0,2018-05-18
6641,경기,파주시,2,0,0,2,2,0,2018-06-18
6642,경기,파주시,2,13,1,16,3,0,2018-07-18
6643,경기,파주시,4,2,1,7,4,0,2018-08-18
6644,경기,파주시,5,0,3,8,5,0,2018-09-18
6645,경기,파주시,2,0,0,2,2,0,2018-10-18
6646,경기,파주시,0,1,0,1,1,0,2018-11-18
6647,경기,파주시,9,1,1,11,8,0,2018-12-18
6648,경기,평택시,11,5,5,21,14,0,2018-01-18
6649,경기,평택시,8,2,0,10,5,0,2018-02-18
6650,경기,평택시,6,2,4,12,6,0,2018-03-18
6651,경기,평택시,21,5,10,36,19,1,2018-04-18
6652,경기,평택시,3,1,2,6,6,0,2018-05-18
6653,경기,평택시,17,6,5,28,15,0,2018-06-18
6654,경기,평택시,7,0,5,12,6,0,2018-07-18
6655,경기,평택시,7,3,1,11,9,3,2018-08-18
6656,경기,평택시,9,4,0,13,9,0,2018-09-18
6657,경기,평택시,14,2,4,20,13,0,2018-10-18
6658,경기,평택시,13,2,4,19,10,0,2018-11-18
6659,경기,평택시,8,3,0,11,9,0,2018-12-18
6660,경기,포천시,2,0,0,2,2,0,2018-01-18
6661,경기,포천시,1,0,1,2,2,0,2018-02-18
6662,경기,포천시,6,0,0,6,3,0,2018-03-18
6663,경기,포천시,2,0,2,4,2,0,2018-04-18
6664,경기,포천시,2,0,1,3,2,0,2018-05-18
6665,경기,포천시,2,0,1,3,3,0,2018-06-18
6666,경기,포천시,3,0,1,4,3,0,2018-07-18
6667,경기,포천시,1,3,3,7,5,0,2018-08-18
6668,경기,포천시,2,1,3,6,4,0,2018-09-18
6669,경기,포천시,1,0,1,2,2,0,2018-10-18
6670,경기,포천시,0,0,0,0,0,0,2018-11-18
6671,경기,포천시,5,0,2,7,5,0,2018-12-18
6672,경기,하남시,1,0,0,1,1,0,2018-01-18
6673,경기,하남시,2,0,0,2,2,0,2018-02-18
6674,경기,하남시,3,0,0,3,1,0,2018-03-18
6675,경기,하남시,4,0,1,5,4,0,2018-04-18
6676,경기,하남시,8,1,2,11,5,0,2018-05-18
6677,경기,하남시,6,0,0,6,4,0,2018-06-18
6678,경기,하남시,3,1,0,4,2,0,2018-07-18
6679,경기,하남시,3,0,2,5,4,0,2018-08-18
6680,경기,하남시,4,0,1,5,3,0,2018-09-18
6681,경기,하남시,0,0,0,0,0,0,2018-10-18
6682,경기,하남시,9,1,3,13,4,0,2018-11-18
6683,경기,하남시,4,0,0,4,3,0,2018-12-18
6684,경기,화성시,8,0,2,10,7,0,2018-01-18
6685,경기,화성시,2,0,4,6,3,0,2018-02-18
6686,경기,화성시,9,0,2,11,6,0,2018-03-18
6687,경기,화성시,8,0,1,9,7,0,2018-04-18
6688,경기,화성시,2,1,5,8,7,0,2018-05-18
6689,경기,화성시,9,2,3,14,8,0,2018-06-18
6690,경기,화성시,15,1,5,21,13,0,2018-07-18
6691,경기,화성시,7,1,1,9,6,0,2018-08-18
6692,경기,화성시,5,0,4,9,7,0,2018-09-18
6693,경기,화성시,15,1,4,20,13,0,2018-10-18
6694,경기,화성시,8,0,4,12,6,0,2018-11-18
6695,경기,화성시,7,0,2,9,7,0,2018-12-18
6696,경기,가평군,0,0,0,0,0,0,2018-01-19
6697,경기,가평군,2,1,0,3,1,0,2018-02-19
6698,경기,가평군,1,0,0,1,1,0,2018-03-19
6699,경기,가평군,0,0,0,0,0,0,2018-04-19
6700,경기,가평군,4,1,4,9,3,0,2018-05-19
6701,경기,가평군,0,0,0,0,0,0,2018-06-19
6702,경기,가평군,2,0,0,2,1,0,2018-07-19
6703,경기,가평군,12,0,1,13,6,0,2018-08-19
6704,경기,가평군,2,0,0,2,1,0,2018-09-19
6705,경기,가평군,2,0,1,3,2,0,2018-10-19
6706,경기,가평군,1,0,0,1,1,0,2018-11-19
6707,경기,가평군,2,0,1,3,2,0,2018-12-19
6708,경기,고양시,9,3,2,14,10,0,2018-01-19
6709,경기,고양시,26,2,5,33,21,2,2018-02-19
6710,경기,고양시,8,0,2,10,9,0,2018-03-19
6711,경기,고양시,12,1,4,17,12,0,2018-04-19
6712,경기,고양시,8,0,4,12,9,1,2018-05-19
6713,경기,고양시,12,0,2,14,9,0,2018-06-19
6714,경기,고양시,26,3,6,35,15,0,2018-07-19
6715,경기,고양시,4,3,2,9,7,0,2018-08-19
6716,경기,고양시,8,3,10,21,14,1,2018-09-19
6717,경기,고양시,23,4,6,33,17,0,2018-10-19
6718,경기,고양시,13,0,4,17,12,0,2018-11-19
6719,경기,고양시,6,1,4,11,11,0,2018-12-19
6720,경기,과천시,0,0,1,1,1,0,2018-01-19
6721,경기,과천시,0,0,0,0,0,0,2018-02-19
6722,경기,과천시,0,0,0,0,0,0,2018-03-19
6723,경기,과천시,1,0,0,1,1,0,2018-04-19
6724,경기,과천시,0,0,0,0,0,0,2018-05-19
6725,경기,과천시,0,0,0,0,0,0,2018-06-19
6726,경기,과천시,1,0,0,1,1,0,2018-07-19
6727,경기,과천시,0,0,0,0,0,0,2018-08-19
6728,경기,과천시,0,0,0,0,0,0,2018-09-19
6729,경기,과천시,1,0,1,2,2,0,2018-10-19
6730,경기,과천시,1,0,0,1,1,0,2018-11-19
6731,경기,과천시,2,0,0,2,2,0,2018-12-19
6732,경기,광명시,6,0,1,7,5,0,2018-01-19
6733,경기,광명시,1,0,0,1,1,0,2018-02-19
6734,경기,광명시,0,0,1,1,1,0,2018-03-19
6735,경기,광명시,6,3,1,10,5,0,2018-04-19
6736,경기,광명시,0,0,0,0,0,0,2018-05-19
6737,경기,광명시,1,0,2,3,3,0,2018-06-19
6738,경기,광명시,3,0,1,4,2,0,2018-07-19
6739,경기,광명시,1,1,2,4,4,0,2018-08-19
6740,경기,광명시,7,2,0,9,8,0,2018-09-19
6741,경기,광명시,7,4,4,15,6,0,2018-10-19
6742,경기,광명시,4,1,2,7,5,0,2018-11-19
6743,경기,광명시,2,0,0,2,1,0,2018-12-19
6744,경기,광주시,2,0,5,7,7,0,2018-01-19
6745,경기,광주시,7,0,3,10,5,0,2018-02-19
6746,경기,광주시,5,0,1,6,4,0,2018-03-19
6747,경기,광주시,8,0,1,9,6,0,2018-04-19
6748,경기,광주시,1,0,4,5,3,0,2018-05-19
6749,경기,광주시,3,0,3,6,4,0,2018-06-19
6750,경기,광주시,5,0,4,9,8,0,2018-07-19
6751,경기,광주시,3,0,0,3,2,0,2018-08-19
6752,경기,광주시,16,1,1,18,11,0,2018-09-19
6753,경기,광주시,8,0,2,10,6,0,2018-10-19
6754,경기,광주시,3,0,0,3,3,0,2018-11-19
6755,경기,광주시,2,0,2,4,4,0,2018-12-19
6756,경기,구리시,0,0,0,0,0,0,2018-01-19
6757,경기,구리시,0,0,0,0,0,0,2018-02-19
6758,경기,구리시,0,0,1,1,2,1,2018-03-19
6759,경기,구리시,1,1,0,2,2,0,2018-04-19
6760,경기,구리시,1,0,0,1,1,0,2018-05-19
6761,경기,구리시,1,0,0,1,1,0,2018-06-19
6762,경기,구리시,3,0,0,3,2,0,2018-07-19
6763,경기,구리시,1,0,0,1,1,0,2018-08-19
6764,경기,구리시,1,0,0,1,1,0,2018-09-19
6765,경기,구리시,1,1,0,2,2,0,2018-10-19
6766,경기,구리시,1,0,0,1,1,0,2018-11-19
6767,경기,구리시,5,0,0,5,2,0,2018-12-19
6768,경기,군포시,3,0,2,5,2,0,2018-01-19
6769,경기,군포시,1,1,0,2,2,0,2018-02-19
6770,경기,군포시,0,0,1,1,1,0,2018-03-19
6771,경기,군포시,1,0,0,1,1,0,2018-04-19
6772,경기,군포시,4,0,1,5,4,0,2018-05-19
6773,경기,군포시,2,0,0,2,2,0,2018-06-19
6774,경기,군포시,5,0,3,8,4,0,2018-07-19
6775,경기,군포시,2,0,0,2,2,0,2018-08-19
6776,경기,군포시,0,0,2,2,2,0,2018-09-19
6777,경기,군포시,2,0,2,4,4,0,2018-10-19
6778,경기,군포시,0,2,0,2,1,0,2018-11-19
6779,경기,군포시,1,0,0,1,1,0,2018-12-19
6780,경기,김포시,2,0,0,2,2,0,2018-01-19
6781,경기,김포시,3,0,4,7,5,0,2018-02-19
6782,경기,김포시,3,0,0,3,2,0,2018-03-19
6783,경기,김포시,7,0,1,8,4,0,2018-04-19
6784,경기,김포시,3,0,1,4,3,0,2018-05-19
6785,경기,김포시,4,0,0,4,4,0,2018-06-19
6786,경기,김포시,11,0,2,13,6,0,2018-07-19
6787,경기,김포시,3,2,0,5,3,0,2018-08-19
6788,경기,김포시,11,1,6,18,10,0,2018-09-19
6789,경기,김포시,3,1,3,7,6,0,2018-10-19
6790,경기,김포시,4,0,2,6,5,0,2018-11-19
6791,경기,김포시,7,0,0,7,5,0,2018-12-19
6792,경기,남양주시,6,0,2,8,5,0,2018-01-19
6793,경기,남양주시,4,9,2,15,4,0,2018-02-19
6794,경기,남양주시,6,4,2,12,8,1,2018-03-19
6795,경기,남양주시,7,2,1,10,6,0,2018-04-19
6796,경기,남양주시,7,0,2,9,7,0,2018-05-19
6797,경기,남양주시,4,2,2,8,7,1,2018-06-19
6798,경기,남양주시,15,1,2,18,12,0,2018-07-19
6799,경기,남양주시,10,0,1,11,6,0,2018-08-19
6800,경기,남양주시,9,0,3,12,10,1,2018-09-19
6801,경기,남양주시,9,1,3,13,7,0,2018-10-19
6802,경기,남양주시,4,0,0,4,4,0,2018-11-19
6803,경기,남양주시,6,0,2,8,6,0,2018-12-19
6804,경기,동두천시,4,0,2,6,2,0,2018-01-19
6805,경기,동두천시,0,0,0,0,0,0,2018-02-19
6806,경기,동두천시,1,0,1,2,1,0,2018-03-19
6807,경기,동두천시,0,1,0,1,1,0,2018-04-19
6808,경기,동두천시,1,1,1,3,3,0,2018-05-19
6809,경기,동두천시,2,0,0,2,1,0,2018-06-19
6810,경기,동두천시,1,0,0,1,1,0,2018-07-19
6811,경기,동두천시,0,0,0,0,0,0,2018-08-19
6812,경기,동두천시,3,0,0,3,3,0,2018-09-19
6813,경기,동두천시,0,0,0,0,0,0,2018-10-19
6814,경기,동두천시,1,0,0,1,1,0,2018-11-19
6815,경기,동두천시,2,0,1,3,2,0,2018-12-19
6816,경기,부천시,5,1,1,7,6,0,2018-01-19
6817,경기,부천시,4,0,2,6,6,0,2018-02-19
6818,경기,부천시,14,0,2,16,9,0,2018-03-19
6819,경기,부천시,10,1,3,14,12,0,2018-04-19
6820,경기,부천시,11,2,2,15,9,0,2018-05-19
6821,경기,부천시,6,2,2,10,10,0,2018-06-19
6822,경기,부천시,11,0,4,15,10,0,2018-07-19
6823,경기,부천시,9,1,2,12,8,0,2018-08-19
6824,경기,부천시,8,2,2,12,10,1,2018-09-19
6825,경기,부천시,11,1,1,13,10,0,2018-10-19
6826,경기,부천시,5,0,2,7,5,0,2018-11-19
6827,경기,부천시,11,1,3,15,11,0,2018-12-19
6828,경기,성남시,14,0,7,21,16,0,2018-01-19
6829,경기,성남시,5,1,7,13,9,0,2018-02-19
6830,경기,성남시,5,0,2,7,6,0,2018-03-19
6831,경기,성남시,9,1,2,12,8,0,2018-04-19
6832,경기,성남시,8,0,3,11,7,0,2018-05-19
6833,경기,성남시,11,0,5,16,12,0,2018-06-19
6834,경기,성남시,19,0,5,24,17,0,2018-07-19
6835,경기,성남시,13,1,6,20,15,0,2018-08-19
6836,경기,성남시,4,1,0,5,4,0,2018-09-19
6837,경기,성남시,10,1,3,14,11,0,2018-10-19
6838,경기,성남시,14,0,4,18,10,0,2018-11-19
6839,경기,성남시,14,1,2,17,10,0,2018-12-19
6840,경기,수원시,23,2,4,29,22,0,2018-01-19
6841,경기,수원시,22,3,3,28,17,0,2018-02-19
6842,경기,수원시,11,6,2,19,12,0,2018-03-19
6843,경기,수원시,11,1,4,16,12,0,2018-04-19
6844,경기,수원시,19,2,10,31,22,1,2018-05-19
6845,경기,수원시,10,4,4,18,16,0,2018-06-19
6846,경기,수원시,10,1,3,14,10,0,2018-07-19
6847,경기,수원시,10,1,3,14,10,0,2018-08-19
6848,경기,수원시,24,2,3,29,19,0,2018-09-19
6849,경기,수원시,19,1,2,22,13,0,2018-10-19
6850,경기,수원시,11,1,4,16,12,1,2018-11-19
6851,경기,수원시,12,4,2,18,12,0,2018-12-19
6852,경기,시흥시,8,0,3,11,6,0,2018-01-19
6853,경기,시흥시,8,1,1,10,8,0,2018-02-19
6854,경기,시흥시,3,0,2,5,5,0,2018-03-19
6855,경기,시흥시,10,0,0,10,6,0,2018-04-19
6856,경기,시흥시,10,1,3,14,11,0,2018-05-19
6857,경기,시흥시,7,1,1,9,7,0,2018-06-19
6858,경기,시흥시,15,0,2,17,8,0,2018-07-19
6859,경기,시흥시,5,1,1,7,7,0,2018-08-19
6860,경기,시흥시,9,0,1,10,9,1,2018-09-19
6861,경기,시흥시,9,1,3,13,9,0,2018-10-19
6862,경기,시흥시,3,0,2,5,4,0,2018-11-19
6863,경기,시흥시,6,0,4,10,8,0,2018-12-19
6864,경기,안산시,14,0,5,19,9,0,2018-01-19
6865,경기,안산시,9,1,1,11,9,0,2018-02-19
6866,경기,안산시,8,0,7,15,10,0,2018-03-19
6867,경기,안산시,17,0,3,20,12,0,2018-04-19
6868,경기,안산시,17,1,4,22,13,0,2018-05-19
6869,경기,안산시,17,0,0,17,9,0,2018-06-19
6870,경기,안산시,8,0,5,13,11,0,2018-07-19
6871,경기,안산시,13,0,1,14,10,0,2018-08-19
6872,경기,안산시,4,0,3,7,7,0,2018-09-19
6873,경기,안산시,8,2,1,11,8,0,2018-10-19
6874,경기,안산시,12,0,1,13,8,0,2018-11-19
6875,경기,안산시,13,1,2,16,13,0,2018-12-19
6876,경기,안성시,7,1,2,10,5,0,2018-01-19
6877,경기,안성시,4,3,2,9,5,0,2018-02-19
6878,경기,안성시,1,0,0,1,1,0,2018-03-19
6879,경기,안성시,3,0,0,3,3,0,2018-04-19
6880,경기,안성시,4,0,1,5,4,0,2018-05-19
6881,경기,안성시,6,0,0,6,4,0,2018-06-19
6882,경기,안성시,6,0,3,9,5,0,2018-07-19
6883,경기,안성시,1,0,1,2,2,0,2018-08-19
6884,경기,안성시,1,1,0,2,1,0,2018-09-19
6885,경기,안성시,1,0,3,4,3,0,2018-10-19
6886,경기,안성시,2,0,0,2,1,0,2018-11-19
6887,경기,안성시,6,0,3,9,5,0,2018-12-19
6888,경기,안양시,1,0,2,3,3,0,2018-01-19
6889,경기,안양시,2,0,1,3,3,0,2018-02-19
6890,경기,안양시,2,0,0,2,1,0,2018-03-19
6891,경기,안양시,4,0,1,5,4,0,2018-04-19
6892,경기,안양시,4,0,1,5,3,0,2018-05-19
6893,경기,안양시,5,2,1,8,7,0,2018-06-19
6894,경기,안양시,6,0,1,7,5,0,2018-07-19
6895,경기,안양시,1,0,0,1,1,0,2018-08-19
6896,경기,안양시,4,0,3,7,5,0,2018-09-19
6897,경기,안양시,5,0,2,7,6,0,2018-10-19
6898,경기,안양시,4,0,1,5,3,0,2018-11-19
6899,경기,안양시,3,1,2,6,5,0,2018-12-19
6900,경기,양주시,5,1,0,6,3,0,2018-01-19
6901,경기,양주시,0,0,0,0,0,0,2018-02-19
6902,경기,양주시,2,0,1,3,3,0,2018-03-19
6903,경기,양주시,3,0,1,4,4,0,2018-04-19
6904,경기,양주시,3,0,0,3,3,0,2018-05-19
6905,경기,양주시,2,0,0,2,2,0,2018-06-19
6906,경기,양주시,0,0,0,0,0,0,2018-07-19
6907,경기,양주시,4,1,0,5,4,0,2018-08-19
6908,경기,양주시,0,1,0,1,1,0,2018-09-19
6909,경기,양주시,17,0,0,17,7,0,2018-10-19
6910,경기,양주시,1,0,2,3,3,0,2018-11-19
6911,경기,양주시,2,0,0,2,1,0,2018-12-19
6912,경기,양평군,1,0,1,2,2,0,2018-01-19
6913,경기,양평군,4,0,1,5,2,0,2018-02-19
6914,경기,양평군,1,1,2,4,3,0,2018-03-19
6915,경기,양평군,2,0,0,2,2,0,2018-04-19
6916,경기,양평군,4,0,0,4,2,0,2018-05-19
6917,경기,양평군,3,0,0,3,2,0,2018-06-19
6918,경기,양평군,2,0,1,3,3,0,2018-07-19
6919,경기,양평군,5,0,2,7,5,0,2018-08-19
6920,경기,양평군,1,1,0,2,2,0,2018-09-19
6921,경기,양평군,3,2,1,6,4,0,2018-10-19
6922,경기,양평군,1,0,1,2,2,0,2018-11-19
6923,경기,양평군,0,0,1,1,2,1,2018-12-19
6924,경기,여주시,2,0,1,3,2,0,2018-01-19
6925,경기,여주시,2,0,1,3,1,0,2018-02-19
6926,경기,여주시,5,0,0,5,3,0,2018-03-19
6927,경기,여주시,2,1,3,6,3,0,2018-04-19
6928,경기,여주시,2,0,1,3,2,0,2018-05-19
6929,경기,여주시,0,0,0,0,0,0,2018-06-19
6930,경기,여주시,0,0,2,2,2,0,2018-07-19
6931,경기,여주시,3,0,1,4,3,1,2018-08-19
6932,경기,여주시,0,0,0,0,0,0,2018-09-19
6933,경기,여주시,2,0,1,3,2,0,2018-10-19
6934,경기,여주시,0,0,2,2,2,0,2018-11-19
6935,경기,여주시,1,0,1,2,1,0,2018-12-19
6936,경기,연천군,1,0,1,2,1,0,2018-01-19
6937,경기,연천군,0,0,1,1,1,0,2018-02-19
6938,경기,연천군,2,0,0,2,1,0,2018-03-19
6939,경기,연천군,3,0,1,4,1,0,2018-04-19
6940,경기,연천군,0,0,1,1,1,0,2018-05-19
6941,경기,연천군,0,0,0,0,0,0,2018-06-19
6942,경기,연천군,0,0,0,0,0,0,2018-07-19
6943,경기,연천군,0,0,0,0,0,0,2018-08-19
6944,경기,연천군,0,0,0,0,0,0,2018-09-19
6945,경기,연천군,0,0,1,1,1,0,2018-10-19
6946,경기,연천군,0,0,0,0,0,0,2018-11-19
6947,경기,연천군,0,0,0,0,0,0,2018-12-19
6948,경기,오산시,2,0,1,3,3,0,2018-01-19
6949,경기,오산시,1,0,0,1,1,0,2018-02-19
6950,경기,오산시,1,0,1,2,2,0,2018-03-19
6951,경기,오산시,0,0,1,1,1,0,2018-04-19
6952,경기,오산시,3,1,2,6,5,0,2018-05-19
6953,경기,오산시,4,1,0,5,4,0,2018-06-19
6954,경기,오산시,1,0,1,2,2,0,2018-07-19
6955,경기,오산시,0,0,0,0,0,0,2018-08-19
6956,경기,오산시,6,0,0,6,5,0,2018-09-19
6957,경기,오산시,2,0,3,5,3,0,2018-10-19
6958,경기,오산시,0,0,0,0,0,0,2018-11-19
6959,경기,오산시,1,0,0,1,1,0,2018-12-19
6960,경기,용인시,10,2,1,13,5,0,2018-01-19
6961,경기,용인시,3,2,3,8,6,0,2018-02-19
6962,경기,용인시,8,1,1,10,6,0,2018-03-19
6963,경기,용인시,10,1,3,14,9,0,2018-04-19
6964,경기,용인시,12,1,2,15,11,0,2018-05-19
6965,경기,용인시,15,5,4,24,15,0,2018-06-19
6966,경기,용인시,15,2,2,19,19,1,2018-07-19
6967,경기,용인시,6,2,1,9,4,0,2018-08-19
6968,경기,용인시,5,1,3,9,8,0,2018-09-19
6969,경기,용인시,10,2,6,18,12,0,2018-10-19
6970,경기,용인시,12,0,3,15,9,0,2018-11-19
6971,경기,용인시,7,2,3,12,11,0,2018-12-19
6972,경기,의왕시,2,0,1,3,3,0,2018-01-19
6973,경기,의왕시,1,0,0,1,1,0,2018-02-19
6974,경기,의왕시,0,0,0,0,0,0,2018-03-19
6975,경기,의왕시,0,0,0,0,0,0,2018-04-19
6976,경기,의왕시,2,0,0,2,1,0,2018-05-19
6977,경기,의왕시,2,0,0,2,2,0,2018-06-19
6978,경기,의왕시,0,0,0,0,0,0,2018-07-19
6979,경기,의왕시,0,0,0,0,0,0,2018-08-19
6980,경기,의왕시,19,3,6,28,2,0,2018-09-19
6981,경기,의왕시,1,0,0,1,1,0,2018-10-19
6982,경기,의왕시,3,0,2,5,3,0,2018-11-19
6983,경기,의왕시,0,0,0,0,0,0,2018-12-19
6984,경기,의정부시,6,0,1,7,4,0,2018-01-19
6985,경기,의정부시,4,2,2,8,8,0,2018-02-19
6986,경기,의정부시,1,1,0,2,2,0,2018-03-19
6987,경기,의정부시,2,0,0,2,2,0,2018-04-19
6988,경기,의정부시,3,3,3,9,8,0,2018-05-19
6989,경기,의정부시,4,0,2,6,6,0,2018-06-19
6990,경기,의정부시,7,0,1,8,6,0,2018-07-19
6991,경기,의정부시,4,7,7,18,6,0,2018-08-19
6992,경기,의정부시,5,2,0,7,3,0,2018-09-19
6993,경기,의정부시,1,2,1,4,4,0,2018-10-19
6994,경기,의정부시,4,2,0,6,5,0,2018-11-19
6995,경기,의정부시,4,4,2,10,7,0,2018-12-19
6996,경기,이천시,1,0,0,1,1,0,2018-01-19
6997,경기,이천시,0,0,0,0,0,0,2018-02-19
6998,경기,이천시,5,1,4,10,5,0,2018-03-19
6999,경기,이천시,3,1,1,5,3,0,2018-04-19
7000,경기,이천시,1,0,1,2,2,0,2018-05-19
7001,경기,이천시,1,1,0,2,2,0,2018-06-19
7002,경기,이천시,4,0,0,4,2,0,2018-07-19
7003,경기,이천시,3,0,0,3,3,0,2018-08-19
7004,경기,이천시,3,0,1,4,4,0,2018-09-19
7005,경기,이천시,5,0,1,6,2,0,2018-10-19
7006,경기,이천시,2,0,0,2,2,0,2018-11-19
7007,경기,이천시,0,0,1,1,1,0,2018-12-19
7008,경기,파주시,10,0,0,10,5,0,2018-01-19
7009,경기,파주시,3,0,5,8,5,0,2018-02-19
7010,경기,파주시,1,0,1,2,2,0,2018-03-19
7011,경기,파주시,2,0,1,3,3,0,2018-04-19
7012,경기,파주시,2,0,6,8,7,0,2018-05-19
7013,경기,파주시,2,0,0,2,2,0,2018-06-19
7014,경기,파주시,13,0,1,14,8,0,2018-07-19
7015,경기,파주시,3,1,3,7,5,0,2018-08-19
7016,경기,파주시,8,0,4,12,7,0,2018-09-19
7017,경기,파주시,4,0,2,6,4,0,2018-10-19
7018,경기,파주시,0,0,1,1,1,0,2018-11-19
7019,경기,파주시,6,0,2,8,4,0,2018-12-19
7020,경기,평택시,16,0,2,18,7,0,2018-01-19
7021,경기,평택시,10,3,1,14,9,0,2018-02-19
7022,경기,평택시,7,0,0,7,3,0,2018-03-19
7023,경기,평택시,9,1,4,14,9,0,2018-04-19
7024,경기,평택시,13,0,1,14,10,1,2018-05-19
7025,경기,평택시,6,0,4,10,9,0,2018-06-19
7026,경기,평택시,11,3,1,15,9,0,2018-07-19
7027,경기,평택시,9,1,1,11,7,0,2018-08-19
7028,경기,평택시,12,5,3,20,9,0,2018-09-19
7029,경기,평택시,19,2,7,28,18,0,2018-10-19
7030,경기,평택시,10,0,1,11,7,0,2018-11-19
7031,경기,평택시,12,2,4,18,17,2,2018-12-19
7032,경기,포천시,8,0,1,9,5,0,2018-01-19
7033,경기,포천시,0,0,0,0,0,0,2018-02-19
7034,경기,포천시,0,0,0,0,0,0,2018-03-19
7035,경기,포천시,0,0,3,3,2,0,2018-04-19
7036,경기,포천시,5,0,1,6,4,0,2018-05-19
7037,경기,포천시,3,1,0,4,3,0,2018-06-19
7038,경기,포천시,5,1,1,7,3,0,2018-07-19
7039,경기,포천시,2,0,0,2,1,0,2018-08-19
7040,경기,포천시,3,1,2,6,3,0,2018-09-19
7041,경기,포천시,2,0,2,4,3,0,2018-10-19
7042,경기,포천시,2,0,1,3,2,0,2018-11-19
7043,경기,포천시,3,0,0,3,2,0,2018-12-19
7044,경기,하남시,9,1,1,11,5,0,2018-01-19
7045,경기,하남시,0,0,1,1,1,0,2018-02-19
7046,경기,하남시,2,0,0,2,2,0,2018-03-19
7047,경기,하남시,1,2,1,4,3,0,2018-04-19
7048,경기,하남시,1,0,1,2,1,0,2018-05-19
7049,경기,하남시,7,0,0,7,3,0,2018-06-19
7050,경기,하남시,4,2,0,6,3,0,2018-07-19
7051,경기,하남시,2,2,0,4,2,0,2018-08-19
7052,경기,하남시,3,1,0,4,3,0,2018-09-19
7053,경기,하남시,4,0,0,4,2,0,2018-10-19
7054,경기,하남시,2,1,1,4,4,0,2018-11-19
7055,경기,하남시,2,0,2,4,4,0,2018-12-19
7056,경기,화성시,10,0,1,11,5,0,2018-01-19
7057,경기,화성시,8,0,5,13,7,0,2018-02-19
7058,경기,화성시,10,1,1,12,10,0,2018-03-19
7059,경기,화성시,4,0,4,8,7,0,2018-04-19
7060,경기,화성시,25,0,1,26,11,0,2018-05-19
7061,경기,화성시,8,0,4,12,8,0,2018-06-19
7062,경기,화성시,12,1,3,16,14,1,2018-07-19
7063,경기,화성시,3,0,1,4,4,0,2018-08-19
7064,경기,화성시,12,0,3,15,11,0,2018-09-19
7065,경기,화성시,10,1,7,18,11,0,2018-10-19
7066,경기,화성시,5,0,1,6,4,0,2018-11-19
7067,경기,화성시,22,1,5,28,14,0,2018-12-19
7068,경기,가평군,1,0,0,1,2,1,2018-01-20
7069,경기,가평군,0,0,0,0,0,0,2018-02-20
7070,경기,가평군,0,0,0,0,0,0,2018-03-20
7071,경기,가평군,1,0,0,1,1,0,2018-04-20
7072,경기,가평군,1,0,0,1,1,0,2018-05-20
7073,경기,가평군,0,0,1,1,1,0,2018-06-20
7074,경기,가평군,1,0,1,2,2,0,2018-07-20
7075,경기,가평군,1,0,0,1,1,0,2018-08-20
7076,경기,가평군,2,0,0,2,2,0,2018-09-20
7077,경기,가평군,6,0,1,7,2,0,2018-10-20
7078,경기,가평군,0,0,0,0,0,0,2018-11-20
7079,경기,가평군,0,0,0,0,0,0,2018-12-20
7080,경기,고양시,8,1,4,13,12,0,2018-01-20
7081,경기,고양시,11,1,2,14,10,0,2018-02-20
7082,경기,고양시,12,0,5,17,14,0,2018-03-20
7083,경기,고양시,5,0,1,6,4,0,2018-04-20
7084,경기,고양시,4,1,2,7,5,1,2018-05-20
7085,경기,고양시,9,1,1,11,8,0,2018-06-20
7086,경기,고양시,6,0,2,8,8,0,2018-07-20
7087,경기,고양시,6,2,5,13,12,1,2018-08-20
7088,경기,고양시,7,1,0,8,7,0,2018-09-20
7089,경기,고양시,13,1,1,15,11,0,2018-10-20
7090,경기,고양시,10,1,6,17,9,0,2018-11-20
7091,경기,고양시,8,4,8,20,15,0,2018-12-20
7092,경기,과천시,0,0,0,0,0,0,2018-01-20
7093,경기,과천시,1,1,1,3,2,0,2018-02-20
7094,경기,과천시,2,0,0,2,1,0,2018-03-20
7095,경기,과천시,0,0,0,0,0,0,2018-04-20
7096,경기,과천시,1,2,2,5,1,0,2018-05-20
7097,경기,과천시,0,0,0,0,0,0,2018-06-20
7098,경기,과천시,1,0,0,1,1,0,2018-07-20
7099,경기,과천시,0,0,1,1,1,0,2018-08-20
7100,경기,과천시,2,0,0,2,1,0,2018-09-20
7101,경기,과천시,0,0,0,0,0,0,2018-10-20
7102,경기,과천시,0,0,0,0,0,0,2018-11-20
7103,경기,과천시,0,0,0,0,0,0,2018-12-20
7104,경기,광명시,1,0,3,4,1,0,2018-01-20
7105,경기,광명시,4,0,0,4,2,0,2018-02-20
7106,경기,광명시,1,1,0,2,2,0,2018-03-20
7107,경기,광명시,3,2,0,5,5,0,2018-04-20
7108,경기,광명시,1,2,1,4,3,0,2018-05-20
7109,경기,광명시,0,0,0,0,0,0,2018-06-20
7110,경기,광명시,2,1,0,3,2,0,2018-07-20
7111,경기,광명시,2,0,0,2,1,0,2018-08-20
7112,경기,광명시,0,0,2,2,2,0,2018-09-20
7113,경기,광명시,2,2,0,4,4,0,2018-10-20
7114,경기,광명시,6,1,1,8,4,0,2018-11-20
7115,경기,광명시,2,0,0,2,2,0,2018-12-20
7116,경기,광주시,1,0,0,1,1,0,2018-01-20
7117,경기,광주시,3,0,0,3,1,0,2018-02-20
7118,경기,광주시,8,0,2,10,6,0,2018-03-20
7119,경기,광주시,1,0,2,3,3,0,2018-04-20
7120,경기,광주시,1,0,0,1,1,0,2018-05-20
7121,경기,광주시,10,0,1,11,10,0,2018-06-20
7122,경기,광주시,6,2,0,8,5,0,2018-07-20
7123,경기,광주시,11,0,0,11,4,0,2018-08-20
7124,경기,광주시,5,0,1,6,5,0,2018-09-20
7125,경기,광주시,9,0,3,12,8,0,2018-10-20
7126,경기,광주시,2,1,3,6,6,0,2018-11-20
7127,경기,광주시,8,1,1,10,5,0,2018-12-20
7128,경기,구리시,12,0,0,12,5,0,2018-01-20
7129,경기,구리시,2,0,0,2,2,0,2018-02-20
7130,경기,구리시,3,0,1,4,4,0,2018-03-20
7131,경기,구리시,4,0,1,5,2,0,2018-04-20
7132,경기,구리시,1,0,1,2,2,0,2018-05-20
7133,경기,구리시,1,0,0,1,1,0,2018-06-20
7134,경기,구리시,1,0,0,1,1,0,2018-07-20
7135,경기,구리시,1,0,1,2,2,0,2018-08-20
7136,경기,구리시,1,0,1,2,2,0,2018-09-20
7137,경기,구리시,3,0,0,3,2,0,2018-10-20
7138,경기,구리시,1,0,2,3,3,0,2018-11-20
7139,경기,구리시,1,1,0,2,2,0,2018-12-20
7140,경기,군포시,3,1,0,4,3,0,2018-01-20
7141,경기,군포시,0,0,0,0,0,0,2018-02-20
7142,경기,군포시,1,0,0,1,1,0,2018-03-20
7143,경기,군포시,3,0,2,5,3,0,2018-04-20
7144,경기,군포시,1,0,0,1,1,0,2018-05-20
7145,경기,군포시,0,0,0,0,0,0,2018-06-20
7146,경기,군포시,2,0,0,2,2,0,2018-07-20
7147,경기,군포시,1,0,2,3,3,0,2018-08-20
7148,경기,군포시,2,1,1,4,4,1,2018-09-20
7149,경기,군포시,6,0,1,7,6,0,2018-10-20
7150,경기,군포시,1,0,0,1,1,0,2018-11-20
7151,경기,군포시,1,0,0,1,1,0,2018-12-20
7152,경기,김포시,0,1,0,1,1,0,2018-01-20
7153,경기,김포시,2,0,1,3,3,0,2018-02-20
7154,경기,김포시,1,0,2,3,3,0,2018-03-20
7155,경기,김포시,3,0,1,4,4,0,2018-04-20
7156,경기,김포시,5,1,5,11,5,0,2018-05-20
7157,경기,김포시,0,0,2,2,2,0,2018-06-20
7158,경기,김포시,9,3,2,14,8,0,2018-07-20
7159,경기,김포시,11,0,2,13,7,0,2018-08-20
7160,경기,김포시,9,1,1,11,8,0,2018-09-20
7161,경기,김포시,14,3,1,18,7,0,2018-10-20
7162,경기,김포시,7,2,1,10,7,0,2018-11-20
7163,경기,김포시,2,1,1,4,5,2,2018-12-20
7164,경기,남양주시,21,0,4,25,7,0,2018-01-20
7165,경기,남양주시,4,0,0,4,3,0,2018-02-20
7166,경기,남양주시,14,3,4,21,10,0,2018-03-20
7167,경기,남양주시,4,0,1,5,4,0,2018-04-20
7168,경기,남양주시,5,0,1,6,4,0,2018-05-20
7169,경기,남양주시,7,0,1,8,5,0,2018-06-20
7170,경기,남양주시,15,1,5,21,13,0,2018-07-20
7171,경기,남양주시,4,0,0,4,4,0,2018-08-20
7172,경기,남양주시,4,0,1,5,4,0,2018-09-20
7173,경기,남양주시,6,0,2,8,7,0,2018-10-20
7174,경기,남양주시,6,1,1,8,6,0,2018-11-20
7175,경기,남양주시,2,1,5,8,7,1,2018-12-20
7176,경기,동두천시,1,0,0,1,1,0,2018-01-20
7177,경기,동두천시,2,0,0,2,2,0,2018-02-20
7178,경기,동두천시,0,0,0,0,0,0,2018-03-20
7179,경기,동두천시,0,0,0,0,0,0,2018-04-20
7180,경기,동두천시,2,0,1,3,2,0,2018-05-20
7181,경기,동두천시,2,0,0,2,2,0,2018-06-20
7182,경기,동두천시,2,0,0,2,2,0,2018-07-20
7183,경기,동두천시,2,0,0,2,2,0,2018-08-20
7184,경기,동두천시,5,0,1,6,2,0,2018-09-20
7185,경기,동두천시,0,0,1,1,1,0,2018-10-20
7186,경기,동두천시,6,0,0,6,2,0,2018-11-20
7187,경기,동두천시,0,0,0,0,0,0,2018-12-20
7188,경기,부천시,4,1,3,8,8,0,2018-01-20
7189,경기,부천시,5,5,2,12,10,1,2018-02-20
7190,경기,부천시,11,0,5,16,12,0,2018-03-20
7191,경기,부천시,3,2,1,6,4,0,2018-04-20
7192,경기,부천시,9,0,1,10,6,0,2018-05-20
7193,경기,부천시,16,2,5,23,17,0,2018-06-20
7194,경기,부천시,19,0,2,21,14,0,2018-07-20
7195,경기,부천시,3,3,2,8,5,0,2018-08-20
7196,경기,부천시,8,3,5,16,9,0,2018-09-20
7197,경기,부천시,11,0,4,15,10,1,2018-10-20
7198,경기,부천시,21,1,7,29,16,0,2018-11-20
7199,경기,부천시,6,0,4,10,9,0,2018-12-20
7200,경기,성남시,15,0,4,19,12,0,2018-01-20
7201,경기,성남시,9,3,0,12,8,0,2018-02-20
7202,경기,성남시,8,5,4,17,8,0,2018-03-20
7203,경기,성남시,10,0,2,12,11,0,2018-04-20
7204,경기,성남시,16,1,1,18,11,0,2018-05-20
7205,경기,성남시,5,1,3,9,8,1,2018-06-20
7206,경기,성남시,12,2,4,18,12,0,2018-07-20
7207,경기,성남시,8,1,3,12,11,0,2018-08-20
7208,경기,성남시,11,2,10,23,17,0,2018-09-20
7209,경기,성남시,9,2,2,13,12,0,2018-10-20
7210,경기,성남시,10,0,1,11,9,0,2018-11-20
7211,경기,성남시,15,3,3,21,15,0,2018-12-20
7212,경기,수원시,19,3,2,24,19,0,2018-01-20
7213,경기,수원시,6,0,2,8,5,0,2018-02-20
7214,경기,수원시,9,0,5,14,12,0,2018-03-20
7215,경기,수원시,14,0,6,20,15,0,2018-04-20
7216,경기,수원시,11,0,2,13,8,0,2018-05-20
7217,경기,수원시,13,4,1,18,15,0,2018-06-20
7218,경기,수원시,14,0,3,17,12,0,2018-07-20
7219,경기,수원시,11,1,2,14,10,0,2018-08-20
7220,경기,수원시,26,4,5,35,24,0,2018-09-20
7221,경기,수원시,4,3,4,11,10,0,2018-10-20
7222,경기,수원시,19,2,7,28,17,0,2018-11-20
7223,경기,수원시,16,3,4,23,15,0,2018-12-20
7224,경기,시흥시,7,0,3,10,6,0,2018-01-20
7225,경기,시흥시,1,1,0,2,2,0,2018-02-20
7226,경기,시흥시,2,1,0,3,2,0,2018-03-20
7227,경기,시흥시,8,0,1,9,5,0,2018-04-20
7228,경기,시흥시,3,1,3,7,4,0,2018-05-20
7229,경기,시흥시,10,0,4,14,10,2,2018-06-20
7230,경기,시흥시,11,0,0,11,7,0,2018-07-20
7231,경기,시흥시,9,1,0,10,5,0,2018-08-20
7232,경기,시흥시,12,0,1,13,7,0,2018-09-20
7233,경기,시흥시,6,0,2,8,6,0,2018-10-20
7234,경기,시흥시,5,0,0,5,3,0,2018-11-20
7235,경기,시흥시,9,0,0,9,5,0,2018-12-20
7236,경기,안산시,8,0,5,13,9,1,2018-01-20
7237,경기,안산시,4,0,1,5,5,0,2018-02-20
7238,경기,안산시,8,0,0,8,7,0,2018-03-20
7239,경기,안산시,10,0,10,20,18,0,2018-04-20
7240,경기,안산시,4,3,0,7,4,0,2018-05-20
7241,경기,안산시,11,1,5,17,10,1,2018-06-20
7242,경기,안산시,10,1,4,15,11,0,2018-07-20
7243,경기,안산시,17,0,5,22,15,2,2018-08-20
7244,경기,안산시,14,1,2,17,12,0,2018-09-20
7245,경기,안산시,21,0,7,28,14,0,2018-10-20
7246,경기,안산시,16,3,2,21,13,0,2018-11-20
7247,경기,안산시,8,2,4,14,10,0,2018-12-20
7248,경기,안성시,3,0,0,3,2,0,2018-01-20
7249,경기,안성시,0,0,0,0,0,0,2018-02-20
7250,경기,안성시,1,1,0,2,2,0,2018-03-20
7251,경기,안성시,2,0,1,3,3,0,2018-04-20
7252,경기,안성시,0,0,0,0,0,0,2018-05-20
7253,경기,안성시,5,0,3,8,5,0,2018-06-20
7254,경기,안성시,5,0,3,8,6,0,2018-07-20
7255,경기,안성시,5,0,0,5,3,0,2018-08-20
7256,경기,안성시,2,0,0,2,1,0,2018-09-20
7257,경기,안성시,4,0,2,6,5,0,2018-10-20
7258,경기,안성시,1,0,1,2,1,0,2018-11-20
7259,경기,안성시,3,0,0,3,1,0,2018-12-20
7260,경기,안양시,6,0,0,6,5,0,2018-01-20
7261,경기,안양시,5,1,1,7,6,0,2018-02-20
7262,경기,안양시,5,0,1,6,6,0,2018-03-20
7263,경기,안양시,9,0,2,11,10,0,2018-04-20
7264,경기,안양시,8,0,1,9,5,0,2018-05-20
7265,경기,안양시,4,0,2,6,5,0,2018-06-20
7266,경기,안양시,10,1,1,12,9,0,2018-07-20
7267,경기,안양시,2,1,1,4,3,0,2018-08-20
7268,경기,안양시,11,0,3,14,8,0,2018-09-20
7269,경기,안양시,7,0,0,7,5,0,2018-10-20
7270,경기,안양시,4,0,5,9,7,0,2018-11-20
7271,경기,안양시,1,0,1,2,2,0,2018-12-20
7272,경기,양주시,3,0,1,4,3,0,2018-01-20
7273,경기,양주시,4,0,1,5,3,0,2018-02-20
7274,경기,양주시,4,0,2,6,4,0,2018-03-20
7275,경기,양주시,1,1,2,4,4,0,2018-04-20
7276,경기,양주시,1,0,0,1,1,0,2018-05-20
7277,경기,양주시,3,0,0,3,3,0,2018-06-20
7278,경기,양주시,7,0,4,11,8,0,2018-07-20
7279,경기,양주시,3,0,2,5,2,0,2018-08-20
7280,경기,양주시,4,0,0,4,2,0,2018-09-20
7281,경기,양주시,7,1,1,9,6,0,2018-10-20
7282,경기,양주시,8,0,1,9,2,0,2018-11-20
7283,경기,양주시,8,0,1,9,4,0,2018-12-20
7284,경기,양평군,0,0,1,1,1,0,2018-01-20
7285,경기,양평군,4,0,0,4,4,0,2018-02-20
7286,경기,양평군,1,0,1,2,2,0,2018-03-20
7287,경기,양평군,2,0,1,3,2,0,2018-04-20
7288,경기,양평군,1,0,0,1,2,1,2018-05-20
7289,경기,양평군,0,0,1,1,1,0,2018-06-20
7290,경기,양평군,1,0,1,2,1,0,2018-07-20
7291,경기,양평군,3,0,0,3,3,0,2018-08-20
7292,경기,양평군,2,1,0,3,3,0,2018-09-20
7293,경기,양평군,4,1,0,5,4,0,2018-10-20
7294,경기,양평군,2,0,0,2,1,0,2018-11-20
7295,경기,양평군,0,0,0,0,0,0,2018-12-20
7296,경기,여주시,2,0,1,3,2,0,2018-01-20
7297,경기,여주시,0,0,0,0,0,0,2018-02-20
7298,경기,여주시,0,0,0,0,0,0,2018-03-20
7299,경기,여주시,3,0,0,3,2,0,2018-04-20
7300,경기,여주시,3,0,0,3,2,0,2018-05-20
7301,경기,여주시,2,0,0,2,2,0,2018-06-20
7302,경기,여주시,5,0,1,6,5,0,2018-07-20
7303,경기,여주시,0,1,0,1,1,0,2018-08-20
7304,경기,여주시,1,0,0,1,1,0,2018-09-20
7305,경기,여주시,1,0,3,4,2,0,2018-10-20
7306,경기,여주시,5,0,2,7,4,0,2018-11-20
7307,경기,여주시,0,1,0,1,1,0,2018-12-20
7308,경기,연천군,0,0,0,0,0,0,2018-01-20
7309,경기,연천군,3,0,0,3,2,0,2018-02-20
7310,경기,연천군,0,0,0,0,0,0,2018-03-20
7311,경기,연천군,0,0,0,0,0,0,2018-04-20
7312,경기,연천군,0,0,0,0,0,0,2018-05-20
7313,경기,연천군,1,0,2,3,2,0,2018-06-20
7314,경기,연천군,1,0,1,2,1,0,2018-07-20
7315,경기,연천군,0,0,0,0,0,0,2018-08-20
7316,경기,연천군,0,0,0,0,0,0,2018-09-20
7317,경기,연천군,0,0,0,0,0,0,2018-10-20
7318,경기,연천군,0,1,0,1,1,0,2018-11-20
7319,경기,연천군,0,0,0,0,0,0,2018-12-20
7320,경기,오산시,2,0,0,2,1,0,2018-01-20
7321,경기,오산시,2,0,0,2,2,0,2018-02-20
7322,경기,오산시,7,0,0,7,5,0,2018-03-20
7323,경기,오산시,0,0,0,0,0,0,2018-04-20
7324,경기,오산시,2,0,1,3,3,0,2018-05-20
7325,경기,오산시,2,0,4,6,4,0,2018-06-20
7326,경기,오산시,2,0,0,2,2,0,2018-07-20
7327,경기,오산시,4,1,0,5,3,0,2018-08-20
7328,경기,오산시,1,0,3,4,4,0,2018-09-20
7329,경기,오산시,2,0,0,2,1,0,2018-10-20
7330,경기,오산시,2,0,1,3,2,0,2018-11-20
7331,경기,오산시,1,0,0,1,1,0,2018-12-20
7332,경기,용인시,7,1,2,10,6,0,2018-01-20
7333,경기,용인시,18,1,5,24,16,1,2018-02-20
7334,경기,용인시,4,1,2,7,6,0,2018-03-20
7335,경기,용인시,8,1,2,11,7,0,2018-04-20
7336,경기,용인시,7,5,0,12,5,0,2018-05-20
7337,경기,용인시,7,0,1,8,6,0,2018-06-20
7338,경기,용인시,10,3,4,17,9,0,2018-07-20
7339,경기,용인시,6,0,2,8,7,0,2018-08-20
7340,경기,용인시,4,4,5,13,11,0,2018-09-20
7341,경기,용인시,11,1,2,14,11,0,2018-10-20
7342,경기,용인시,6,2,4,12,10,0,2018-11-20
7343,경기,용인시,14,2,2,18,12,0,2018-12-20
7344,경기,의왕시,0,0,2,2,1,0,2018-01-20
7345,경기,의왕시,1,0,0,1,1,0,2018-02-20
7346,경기,의왕시,0,0,1,1,1,0,2018-03-20
7347,경기,의왕시,1,0,0,1,1,0,2018-04-20
7348,경기,의왕시,1,0,0,1,1,0,2018-05-20
7349,경기,의왕시,0,0,0,0,0,0,2018-06-20
7350,경기,의왕시,4,0,1,5,4,0,2018-07-20
7351,경기,의왕시,2,0,3,5,3,0,2018-08-20
7352,경기,의왕시,4,1,2,7,3,0,2018-09-20
7353,경기,의왕시,0,0,0,0,0,0,2018-10-20
7354,경기,의왕시,1,0,1,2,2,0,2018-11-20
7355,경기,의왕시,1,0,0,1,1,0,2018-12-20
7356,경기,의정부시,9,0,4,13,9,0,2018-01-20
7357,경기,의정부시,4,1,2,7,5,0,2018-02-20
7358,경기,의정부시,1,1,0,2,2,0,2018-03-20
7359,경기,의정부시,7,0,1,8,4,0,2018-04-20
7360,경기,의정부시,9,1,0,10,4,0,2018-05-20
7361,경기,의정부시,3,1,3,7,7,1,2018-06-20
7362,경기,의정부시,3,1,3,7,5,0,2018-07-20
7363,경기,의정부시,2,0,1,3,2,0,2018-08-20
7364,경기,의정부시,5,1,3,9,5,0,2018-09-20
7365,경기,의정부시,4,0,0,4,4,0,2018-10-20
7366,경기,의정부시,5,0,1,6,5,0,2018-11-20
7367,경기,의정부시,6,2,0,8,7,1,2018-12-20
7368,경기,이천시,1,0,0,1,1,0,2018-01-20
7369,경기,이천시,3,0,0,3,2,0,2018-02-20
7370,경기,이천시,3,0,1,4,3,0,2018-03-20
7371,경기,이천시,4,0,1,5,3,0,2018-04-20
7372,경기,이천시,0,0,1,1,1,0,2018-05-20
7373,경기,이천시,3,0,0,3,3,0,2018-06-20
7374,경기,이천시,0,0,0,0,0,0,2018-07-20
7375,경기,이천시,7,0,1,8,4,0,2018-08-20
7376,경기,이천시,3,0,0,3,1,0,2018-09-20
7377,경기,이천시,1,0,0,1,1,0,2018-10-20
7378,경기,이천시,5,1,5,11,4,1,2018-11-20
7379,경기,이천시,3,0,1,4,4,1,2018-12-20
7380,경기,파주시,7,0,4,11,10,0,2018-01-20
7381,경기,파주시,8,0,2,10,7,0,2018-02-20
7382,경기,파주시,2,0,1,3,3,0,2018-03-20
7383,경기,파주시,2,0,2,4,3,0,2018-04-20
7384,경기,파주시,7,4,7,18,6,0,2018-05-20
7385,경기,파주시,3,0,2,5,4,0,2018-06-20
7386,경기,파주시,4,1,3,8,6,0,2018-07-20
7387,경기,파주시,9,0,4,13,7,1,2018-08-20
7388,경기,파주시,3,1,3,7,6,0,2018-09-20
7389,경기,파주시,5,0,1,6,5,0,2018-10-20
7390,경기,파주시,5,1,2,8,7,0,2018-11-20
7391,경기,파주시,10,0,1,11,9,0,2018-12-20
7392,경기,평택시,22,4,2,28,14,0,2018-01-20
7393,경기,평택시,8,0,3,11,7,0,2018-02-20
7394,경기,평택시,6,0,0,6,4,0,2018-03-20
7395,경기,평택시,11,2,2,15,12,2,2018-04-20
7396,경기,평택시,7,1,3,11,6,0,2018-05-20
7397,경기,평택시,8,1,5,14,10,0,2018-06-20
7398,경기,평택시,19,5,9,33,14,0,2018-07-20
7399,경기,평택시,8,2,3,13,9,0,2018-08-20
7400,경기,평택시,14,6,7,27,16,0,2018-09-20
7401,경기,평택시,12,4,2,18,15,0,2018-10-20
7402,경기,평택시,11,2,6,19,16,0,2018-11-20
7403,경기,평택시,1,0,6,7,7,1,2018-12-20
7404,경기,포천시,0,0,0,0,0,0,2018-01-20
7405,경기,포천시,0,0,0,0,0,0,2018-02-20
7406,경기,포천시,3,0,0,3,3,0,2018-03-20
7407,경기,포천시,2,0,0,2,2,0,2018-04-20
7408,경기,포천시,0,0,0,0,0,0,2018-05-20
7409,경기,포천시,1,0,0,1,1,0,2018-06-20
7410,경기,포천시,1,0,0,1,1,0,2018-07-20
7411,경기,포천시,0,0,0,0,0,0,2018-08-20
7412,경기,포천시,6,0,1,7,3,0,2018-09-20
7413,경기,포천시,4,0,2,6,5,0,2018-10-20
7414,경기,포천시,1,0,1,2,2,0,2018-11-20
7415,경기,포천시,0,0,1,1,1,0,2018-12-20
7416,경기,하남시,3,0,0,3,1,0,2018-01-20
7417,경기,하남시,4,0,1,5,4,0,2018-02-20
7418,경기,하남시,3,0,0,3,3,0,2018-03-20
7419,경기,하남시,2,1,0,3,3,0,2018-04-20
7420,경기,하남시,4,1,1,6,3,0,2018-05-20
7421,경기,하남시,0,1,0,1,1,0,2018-06-20
7422,경기,하남시,8,0,1,9,7,0,2018-07-20
7423,경기,하남시,2,0,0,2,2,0,2018-08-20
7424,경기,하남시,8,0,1,9,6,0,2018-09-20
7425,경기,하남시,1,1,1,3,3,0,2018-10-20
7426,경기,하남시,1,0,1,2,2,0,2018-11-20
7427,경기,하남시,1,0,1,2,2,0,2018-12-20
7428,경기,화성시,10,1,3,14,6,0,2018-01-20
7429,경기,화성시,6,2,1,9,4,0,2018-02-20
7430,경기,화성시,10,0,0,10,7,0,2018-03-20
7431,경기,화성시,4,0,4,8,6,0,2018-04-20
7432,경기,화성시,6,0,2,8,5,0,2018-05-20
7433,경기,화성시,7,0,0,7,5,0,2018-06-20
7434,경기,화성시,6,2,3,11,6,0,2018-07-20
7435,경기,화성시,10,2,2,14,12,0,2018-08-20
7436,경기,화성시,8,0,3,11,8,0,2018-09-20
7437,경기,화성시,5,0,1,6,5,1,2018-10-20
7438,경기,화성시,8,1,5,14,11,0,2018-11-20
7439,경기,화성시,12,0,3,15,8,0,2018-12-20
7440,경기,가평군,0,0,0,0,0,0,2018-01-21
7441,경기,가평군,2,0,0,2,1,0,2018-02-21
7442,경기,가평군,0,0,0,0,0,0,2018-03-21
7443,경기,가평군,6,0,0,6,3,0,2018-04-21
7444,경기,가평군,3,0,0,3,1,0,2018-05-21
7445,경기,가평군,2,0,0,2,2,0,2018-06-21
7446,경기,가평군,9,0,0,9,5,0,2018-07-21
7447,경기,가평군,1,0,0,1,1,0,2018-08-21
7448,경기,가평군,0,0,0,0,0,0,2018-09-21
7449,경기,가평군,0,0,1,1,1,0,2018-10-21
7450,경기,가평군,0,0,0,0,0,0,2018-11-21
7451,경기,가평군,0,0,1,1,1,0,2018-12-21
7452,경기,고양시,17,0,6,23,10,0,2018-01-21
7453,경기,고양시,11,4,2,17,14,0,2018-02-21
7454,경기,고양시,5,0,2,7,7,0,2018-03-21
7455,경기,고양시,13,2,3,18,12,0,2018-04-21
7456,경기,고양시,6,0,3,9,7,0,2018-05-21
7457,경기,고양시,11,2,2,15,10,0,2018-06-21
7458,경기,고양시,9,2,1,12,7,0,2018-07-21
7459,경기,고양시,17,2,6,25,17,0,2018-08-21
7460,경기,고양시,21,1,4,26,17,0,2018-09-21
7461,경기,고양시,21,3,4,28,17,0,2018-10-21
7462,경기,고양시,45,1,7,53,17,0,2018-11-21
7463,경기,고양시,8,0,3,11,10,0,2018-12-21
7464,경기,과천시,0,0,0,0,0,0,2018-01-21
7465,경기,과천시,5,1,1,7,1,0,2018-02-21
7466,경기,과천시,0,0,0,0,0,0,2018-03-21
7467,경기,과천시,0,0,0,0,0,0,2018-04-21
7468,경기,과천시,1,0,0,1,1,0,2018-05-21
7469,경기,과천시,0,0,0,0,0,0,2018-06-21
7470,경기,과천시,0,4,0,4,1,0,2018-07-21
7471,경기,과천시,1,0,0,1,1,0,2018-08-21
7472,경기,과천시,1,0,0,1,1,0,2018-09-21
7473,경기,과천시,1,0,0,1,1,0,2018-10-21
7474,경기,과천시,1,0,0,1,1,0,2018-11-21
7475,경기,과천시,0,0,0,0,0,0,2018-12-21
7476,경기,광명시,3,0,3,6,5,0,2018-01-21
7477,경기,광명시,3,0,4,7,6,1,2018-02-21
7478,경기,광명시,1,1,1,3,3,0,2018-03-21
7479,경기,광명시,9,0,1,10,7,1,2018-04-21
7480,경기,광명시,6,2,0,8,5,0,2018-05-21
7481,경기,광명시,2,0,1,3,2,0,2018-06-21
7482,경기,광명시,1,2,0,3,3,0,2018-07-21
7483,경기,광명시,2,1,2,5,2,0,2018-08-21
7484,경기,광명시,0,0,1,1,1,0,2018-09-21
7485,경기,광명시,2,0,0,2,2,0,2018-10-21
7486,경기,광명시,1,2,0,3,2,0,2018-11-21
7487,경기,광명시,2,1,2,5,4,0,2018-12-21
7488,경기,광주시,8,1,2,11,3,0,2018-01-21
7489,경기,광주시,2,1,1,4,3,0,2018-02-21
7490,경기,광주시,3,0,0,3,3,0,2018-03-21
7491,경기,광주시,6,1,0,7,7,0,2018-04-21
7492,경기,광주시,8,2,0,10,8,0,2018-05-21
7493,경기,광주시,5,1,0,6,3,0,2018-06-21
7494,경기,광주시,6,0,0,6,5,0,2018-07-21
7495,경기,광주시,6,0,2,8,4,0,2018-08-21
7496,경기,광주시,9,1,0,10,6,0,2018-09-21
7497,경기,광주시,4,0,1,5,4,0,2018-10-21
7498,경기,광주시,8,3,0,11,11,0,2018-11-21
7499,경기,광주시,6,1,1,8,7,0,2018-12-21
7500,경기,구리시,0,0,0,0,0,0,2018-01-21
7501,경기,구리시,0,0,0,0,0,0,2018-02-21
7502,경기,구리시,0,0,1,1,1,0,2018-03-21
7503,경기,구리시,1,0,0,1,1,0,2018-04-21
7504,경기,구리시,2,0,0,2,2,1,2018-05-21
7505,경기,구리시,0,1,0,1,1,0,2018-06-21
7506,경기,구리시,0,0,1,1,1,0,2018-07-21
7507,경기,구리시,2,0,2,4,2,0,2018-08-21
7508,경기,구리시,4,0,3,7,3,0,2018-09-21
7509,경기,구리시,0,0,2,2,1,0,2018-10-21
7510,경기,구리시,0,0,0,0,0,0,2018-11-21
7511,경기,구리시,1,0,1,2,1,0,2018-12-21
7512,경기,군포시,0,0,0,0,0,0,2018-01-21
7513,경기,군포시,1,0,0,1,1,0,2018-02-21
7514,경기,군포시,0,0,0,0,0,0,2018-03-21
7515,경기,군포시,5,1,1,7,3,0,2018-04-21
7516,경기,군포시,1,0,0,1,1,0,2018-05-21
7517,경기,군포시,0,0,0,0,0,0,2018-06-21
7518,경기,군포시,3,1,0,4,2,0,2018-07-21
7519,경기,군포시,1,0,0,1,1,0,2018-08-21
7520,경기,군포시,1,0,0,1,1,0,2018-09-21
7521,경기,군포시,1,0,1,2,2,0,2018-10-21
7522,경기,군포시,0,2,0,2,1,0,2018-11-21
7523,경기,군포시,2,2,0,4,2,0,2018-12-21
7524,경기,김포시,3,0,1,4,2,0,2018-01-21
7525,경기,김포시,3,1,0,4,2,0,2018-02-21
7526,경기,김포시,4,0,0,4,3,0,2018-03-21
7527,경기,김포시,2,0,1,3,2,0,2018-04-21
7528,경기,김포시,3,1,2,6,6,0,2018-05-21
7529,경기,김포시,2,0,0,2,2,1,2018-06-21
7530,경기,김포시,6,0,0,6,2,0,2018-07-21
7531,경기,김포시,4,1,0,5,3,0,2018-08-21
7532,경기,김포시,5,1,2,8,5,0,2018-09-21
7533,경기,김포시,0,1,0,1,1,0,2018-10-21
7534,경기,김포시,2,0,1,3,2,0,2018-11-21
7535,경기,김포시,4,0,0,4,1,0,2018-12-21
7536,경기,남양주시,2,0,0,2,1,0,2018-01-21
7537,경기,남양주시,4,0,4,8,6,0,2018-02-21
7538,경기,남양주시,2,0,3,5,4,0,2018-03-21
7539,경기,남양주시,6,1,0,7,5,0,2018-04-21
7540,경기,남양주시,8,2,1,11,8,0,2018-05-21
7541,경기,남양주시,18,0,1,19,10,0,2018-06-21
7542,경기,남양주시,10,1,2,13,5,0,2018-07-21
7543,경기,남양주시,9,0,3,12,9,0,2018-08-21
7544,경기,남양주시,10,0,6,16,11,0,2018-09-21
7545,경기,남양주시,16,1,3,20,11,0,2018-10-21
7546,경기,남양주시,7,1,1,9,6,0,2018-11-21
7547,경기,남양주시,6,1,0,7,7,3,2018-12-21
7548,경기,동두천시,0,0,0,0,0,0,2018-01-21
7549,경기,동두천시,0,0,0,0,0,0,2018-02-21
7550,경기,동두천시,1,0,0,1,1,0,2018-03-21
7551,경기,동두천시,0,0,0,0,0,0,2018-04-21
7552,경기,동두천시,4,0,0,4,1,0,2018-05-21
7553,경기,동두천시,0,0,0,0,0,0,2018-06-21
7554,경기,동두천시,0,0,0,0,0,0,2018-07-21
7555,경기,동두천시,3,0,1,4,4,0,2018-08-21
7556,경기,동두천시,2,0,1,3,3,0,2018-09-21
7557,경기,동두천시,1,0,0,1,1,0,2018-10-21
7558,경기,동두천시,1,0,2,3,2,0,2018-11-21
7559,경기,동두천시,2,0,0,2,1,0,2018-12-21
7560,경기,부천시,7,0,5,12,10,0,2018-01-21
7561,경기,부천시,3,0,1,4,4,0,2018-02-21
7562,경기,부천시,20,1,2,23,16,0,2018-03-21
7563,경기,부천시,12,1,2,15,11,0,2018-04-21
7564,경기,부천시,9,0,0,9,3,0,2018-05-21
7565,경기,부천시,12,1,3,16,13,0,2018-06-21
7566,경기,부천시,11,0,1,12,8,0,2018-07-21
7567,경기,부천시,11,0,4,15,13,0,2018-08-21
7568,경기,부천시,19,1,2,22,15,0,2018-09-21
7569,경기,부천시,11,3,2,16,11,0,2018-10-21
7570,경기,부천시,9,0,3,12,10,0,2018-11-21
7571,경기,부천시,4,0,3,7,8,1,2018-12-21
7572,경기,성남시,6,0,3,9,7,1,2018-01-21
7573,경기,성남시,8,0,4,12,6,0,2018-02-21
7574,경기,성남시,11,1,2,14,11,0,2018-03-21
7575,경기,성남시,11,4,2,17,11,0,2018-04-21
7576,경기,성남시,4,2,2,8,8,0,2018-05-21
7577,경기,성남시,8,2,6,16,10,0,2018-06-21
7578,경기,성남시,9,5,2,16,12,0,2018-07-21
7579,경기,성남시,14,0,3,17,12,0,2018-08-21
7580,경기,성남시,10,0,4,14,11,1,2018-09-21
7581,경기,성남시,6,1,8,15,7,0,2018-10-21
7582,경기,성남시,14,1,2,17,8,0,2018-11-21
7583,경기,성남시,22,3,5,30,22,0,2018-12-21
7584,경기,수원시,7,0,5,12,8,0,2018-01-21
7585,경기,수원시,29,2,3,34,16,0,2018-02-21
7586,경기,수원시,14,0,10,24,20,0,2018-03-21
7587,경기,수원시,16,2,1,19,12,0,2018-04-21
7588,경기,수원시,8,0,6,14,13,0,2018-05-21
7589,경기,수원시,22,5,3,30,19,0,2018-06-21
7590,경기,수원시,18,4,5,27,15,0,2018-07-21
7591,경기,수원시,11,2,3,16,14,0,2018-08-21
7592,경기,수원시,22,1,8,31,21,1,2018-09-21
7593,경기,수원시,18,2,2,22,14,0,2018-10-21
7594,경기,수원시,4,0,4,8,8,0,2018-11-21
7595,경기,수원시,6,1,5,12,10,0,2018-12-21
7596,경기,시흥시,9,1,3,13,10,0,2018-01-21
7597,경기,시흥시,8,0,3,11,6,0,2018-02-21
7598,경기,시흥시,3,0,1,4,3,0,2018-03-21
7599,경기,시흥시,21,2,2,25,11,1,2018-04-21
7600,경기,시흥시,9,0,1,10,7,0,2018-05-21
7601,경기,시흥시,13,1,1,15,11,0,2018-06-21
7602,경기,시흥시,8,0,0,8,4,0,2018-07-21
7603,경기,시흥시,2,0,0,2,2,0,2018-08-21
7604,경기,시흥시,9,1,5,15,10,0,2018-09-21
7605,경기,시흥시,6,0,2,8,6,0,2018-10-21
7606,경기,시흥시,8,1,3,12,10,0,2018-11-21
7607,경기,시흥시,4,0,0,4,4,0,2018-12-21
7608,경기,안산시,12,0,4,16,10,0,2018-01-21
7609,경기,안산시,14,0,4,18,11,0,2018-02-21
7610,경기,안산시,14,1,7,22,17,0,2018-03-21
7611,경기,안산시,9,1,4,14,9,0,2018-04-21
7612,경기,안산시,10,1,7,18,11,0,2018-05-21
7613,경기,안산시,14,1,4,19,13,0,2018-06-21
7614,경기,안산시,7,0,6,13,7,0,2018-07-21
7615,경기,안산시,21,0,5,26,17,0,2018-08-21
7616,경기,안산시,26,1,7,34,18,0,2018-09-21
7617,경기,안산시,14,2,1,17,11,1,2018-10-21
7618,경기,안산시,5,1,5,11,9,0,2018-11-21
7619,경기,안산시,23,1,6,30,18,0,2018-12-21
7620,경기,안성시,13,1,0,14,2,0,2018-01-21
7621,경기,안성시,2,0,0,2,3,1,2018-02-21
7622,경기,안성시,7,0,1,8,4,0,2018-03-21
7623,경기,안성시,8,1,1,10,4,0,2018-04-21
7624,경기,안성시,3,1,2,6,2,0,2018-05-21
7625,경기,안성시,1,1,0,2,1,0,2018-06-21
7626,경기,안성시,1,3,2,6,4,0,2018-07-21
7627,경기,안성시,5,0,2,7,5,0,2018-08-21
7628,경기,안성시,4,0,0,4,3,0,2018-09-21
7629,경기,안성시,5,0,1,6,2,0,2018-10-21
7630,경기,안성시,3,0,3,6,3,0,2018-11-21
7631,경기,안성시,1,0,1,2,2,0,2018-12-21
7632,경기,안양시,1,1,0,2,1,0,2018-01-21
7633,경기,안양시,2,0,0,2,2,0,2018-02-21
7634,경기,안양시,2,0,2,4,4,0,2018-03-21
7635,경기,안양시,19,0,2,21,6,0,2018-04-21
7636,경기,안양시,1,0,0,1,1,0,2018-05-21
7637,경기,안양시,0,0,1,1,1,0,2018-06-21
7638,경기,안양시,5,1,0,6,5,0,2018-07-21
7639,경기,안양시,1,0,0,1,1,0,2018-08-21
7640,경기,안양시,10,1,1,12,7,0,2018-09-21
7641,경기,안양시,4,0,2,6,3,0,2018-10-21
7642,경기,안양시,7,0,0,7,4,0,2018-11-21
7643,경기,안양시,7,0,0,7,5,0,2018-12-21
7644,경기,양주시,0,0,0,0,0,0,2018-01-21
7645,경기,양주시,2,0,2,4,3,0,2018-02-21
7646,경기,양주시,1,0,2,3,3,0,2018-03-21
7647,경기,양주시,1,0,0,1,1,0,2018-04-21
7648,경기,양주시,8,0,0,8,4,0,2018-05-21
7649,경기,양주시,1,0,1,2,2,0,2018-06-21
7650,경기,양주시,2,0,1,3,2,0,2018-07-21
7651,경기,양주시,0,1,0,1,1,0,2018-08-21
7652,경기,양주시,0,1,1,2,2,0,2018-09-21
7653,경기,양주시,1,0,1,2,2,0,2018-10-21
7654,경기,양주시,5,0,1,6,5,0,2018-11-21
7655,경기,양주시,4,0,1,5,5,1,2018-12-21
7656,경기,양평군,1,0,2,3,2,0,2018-01-21
7657,경기,양평군,0,0,0,0,0,0,2018-02-21
7658,경기,양평군,1,0,0,1,1,0,2018-03-21
7659,경기,양평군,0,0,3,3,1,0,2018-04-21
7660,경기,양평군,1,0,0,1,1,0,2018-05-21
7661,경기,양평군,3,1,0,4,2,0,2018-06-21
7662,경기,양평군,2,0,3,5,3,0,2018-07-21
7663,경기,양평군,5,0,0,5,2,0,2018-08-21
7664,경기,양평군,1,0,3,4,2,0,2018-09-21
7665,경기,양평군,6,0,1,7,3,0,2018-10-21
7666,경기,양평군,0,0,1,1,1,0,2018-11-21
7667,경기,양평군,0,0,0,0,0,0,2018-12-21
7668,경기,여주시,0,0,0,0,0,0,2018-01-21
7669,경기,여주시,1,0,2,3,2,0,2018-02-21
7670,경기,여주시,1,0,0,1,1,0,2018-03-21
7671,경기,여주시,6,0,0,6,2,0,2018-04-21
7672,경기,여주시,0,0,0,0,0,0,2018-05-21
7673,경기,여주시,3,0,0,3,4,1,2018-06-21
7674,경기,여주시,1,0,0,1,1,0,2018-07-21
7675,경기,여주시,0,0,0,0,0,0,2018-08-21
7676,경기,여주시,0,0,0,0,0,0,2018-09-21
7677,경기,여주시,3,0,0,3,2,0,2018-10-21
7678,경기,여주시,0,0,2,2,1,0,2018-11-21
7679,경기,여주시,3,1,2,6,4,0,2018-12-21
7680,경기,연천군,0,0,0,0,0,0,2018-01-21
7681,경기,연천군,1,0,0,1,1,0,2018-02-21
7682,경기,연천군,0,0,0,0,0,0,2018-03-21
7683,경기,연천군,0,0,0,0,0,0,2018-04-21
7684,경기,연천군,0,0,0,0,0,0,2018-05-21
7685,경기,연천군,0,0,0,0,0,0,2018-06-21
7686,경기,연천군,0,0,0,0,0,0,2018-07-21
7687,경기,연천군,0,0,0,0,0,0,2018-08-21
7688,경기,연천군,0,0,0,0,0,0,2018-09-21
7689,경기,연천군,0,0,0,0,0,0,2018-10-21
7690,경기,연천군,0,0,0,0,0,0,2018-11-21
7691,경기,연천군,1,0,0,1,1,0,2018-12-21
7692,경기,오산시,1,0,0,1,1,0,2018-01-21
7693,경기,오산시,5,0,1,6,5,0,2018-02-21
7694,경기,오산시,1,0,2,3,2,0,2018-03-21
7695,경기,오산시,4,10,1,15,4,0,2018-04-21
7696,경기,오산시,4,0,0,4,4,0,2018-05-21
7697,경기,오산시,0,0,0,0,0,0,2018-06-21
7698,경기,오산시,2,0,0,2,1,0,2018-07-21
7699,경기,오산시,5,0,2,7,3,0,2018-08-21
7700,경기,오산시,3,0,2,5,4,0,2018-09-21
7701,경기,오산시,0,0,0,0,0,0,2018-10-21
7702,경기,오산시,1,0,0,1,1,0,2018-11-21
7703,경기,오산시,2,0,0,2,2,0,2018-12-21
7704,경기,용인시,5,0,3,8,4,0,2018-01-21
7705,경기,용인시,7,1,2,10,7,0,2018-02-21
7706,경기,용인시,4,1,5,10,9,0,2018-03-21
7707,경기,용인시,6,0,2,8,8,0,2018-04-21
7708,경기,용인시,15,8,12,35,14,0,2018-05-21
7709,경기,용인시,6,7,2,15,11,0,2018-06-21
7710,경기,용인시,8,1,4,13,11,0,2018-07-21
7711,경기,용인시,3,1,4,8,6,0,2018-08-21
7712,경기,용인시,17,1,9,27,15,0,2018-09-21
7713,경기,용인시,19,3,3,25,11,0,2018-10-21
7714,경기,용인시,6,2,3,11,10,0,2018-11-21
7715,경기,용인시,9,2,6,17,12,0,2018-12-21
7716,경기,의왕시,0,0,0,0,0,0,2018-01-21
7717,경기,의왕시,0,0,0,0,0,0,2018-02-21
7718,경기,의왕시,0,1,0,1,1,0,2018-03-21
7719,경기,의왕시,1,0,1,2,1,0,2018-04-21
7720,경기,의왕시,2,0,0,2,1,0,2018-05-21
7721,경기,의왕시,1,0,0,1,1,0,2018-06-21
7722,경기,의왕시,0,0,0,0,0,0,2018-07-21
7723,경기,의왕시,1,1,0,2,1,0,2018-08-21
7724,경기,의왕시,10,2,0,12,4,0,2018-09-21
7725,경기,의왕시,0,0,0,0,0,0,2018-10-21
7726,경기,의왕시,4,1,1,6,1,0,2018-11-21
7727,경기,의왕시,0,0,1,1,1,0,2018-12-21
7728,경기,의정부시,1,0,0,1,1,0,2018-01-21
7729,경기,의정부시,5,0,1,6,5,1,2018-02-21
7730,경기,의정부시,2,0,2,4,4,0,2018-03-21
7731,경기,의정부시,0,1,5,6,6,0,2018-04-21
7732,경기,의정부시,8,3,0,11,7,0,2018-05-21
7733,경기,의정부시,4,1,3,8,7,0,2018-06-21
7734,경기,의정부시,5,1,0,6,5,0,2018-07-21
7735,경기,의정부시,1,0,1,2,2,0,2018-08-21
7736,경기,의정부시,5,0,0,5,3,0,2018-09-21
7737,경기,의정부시,0,0,0,0,0,0,2018-10-21
7738,경기,의정부시,5,3,0,8,7,0,2018-11-21
7739,경기,의정부시,4,0,2,6,6,1,2018-12-21
7740,경기,이천시,3,1,0,4,3,0,2018-01-21
7741,경기,이천시,1,0,0,1,1,0,2018-02-21
7742,경기,이천시,6,1,0,7,6,0,2018-03-21
7743,경기,이천시,3,0,1,4,2,0,2018-04-21
7744,경기,이천시,4,0,1,5,3,0,2018-05-21
7745,경기,이천시,8,0,2,10,6,0,2018-06-21
7746,경기,이천시,2,1,0,3,3,0,2018-07-21
7747,경기,이천시,3,1,1,5,4,0,2018-08-21
7748,경기,이천시,5,0,1,6,3,0,2018-09-21
7749,경기,이천시,4,2,0,6,4,0,2018-10-21
7750,경기,이천시,4,0,0,4,2,0,2018-11-21
7751,경기,이천시,1,0,0,1,1,0,2018-12-21
7752,경기,파주시,0,0,0,0,0,0,2018-01-21
7753,경기,파주시,5,1,2,8,6,0,2018-02-21
7754,경기,파주시,0,0,0,0,1,1,2018-03-21
7755,경기,파주시,9,0,4,13,8,0,2018-04-21
7756,경기,파주시,5,1,2,8,6,1,2018-05-21
7757,경기,파주시,2,0,2,4,4,0,2018-06-21
7758,경기,파주시,2,0,2,4,2,0,2018-07-21
7759,경기,파주시,6,1,4,11,7,0,2018-08-21
7760,경기,파주시,7,1,3,11,9,0,2018-09-21
7761,경기,파주시,3,0,2,5,4,0,2018-10-21
7762,경기,파주시,7,1,1,9,5,0,2018-11-21
7763,경기,파주시,1,2,0,3,2,0,2018-12-21
7764,경기,평택시,2,0,1,3,2,0,2018-01-21
7765,경기,평택시,11,6,2,19,7,0,2018-02-21
7766,경기,평택시,12,5,6,23,15,0,2018-03-21
7767,경기,평택시,14,1,5,20,13,0,2018-04-21
7768,경기,평택시,10,1,2,13,10,1,2018-05-21
7769,경기,평택시,15,4,6,25,18,1,2018-06-21
7770,경기,평택시,16,4,5,25,11,0,2018-07-21
7771,경기,평택시,15,2,2,19,13,0,2018-08-21
7772,경기,평택시,16,1,5,22,17,0,2018-09-21
7773,경기,평택시,15,1,1,17,7,0,2018-10-21
7774,경기,평택시,8,0,2,10,6,0,2018-11-21
7775,경기,평택시,12,1,4,17,15,0,2018-12-21
7776,경기,포천시,1,0,3,4,3,1,2018-01-21
7777,경기,포천시,2,0,2,4,2,0,2018-02-21
7778,경기,포천시,0,0,0,0,0,0,2018-03-21
7779,경기,포천시,1,1,3,5,4,0,2018-04-21
7780,경기,포천시,5,1,0,6,3,1,2018-05-21
7781,경기,포천시,3,0,0,3,1,0,2018-06-21
7782,경기,포천시,6,0,1,7,6,0,2018-07-21
7783,경기,포천시,0,0,1,1,1,0,2018-08-21
7784,경기,포천시,1,0,1,2,1,0,2018-09-21
7785,경기,포천시,5,0,0,5,1,0,2018-10-21
7786,경기,포천시,0,0,0,0,0,0,2018-11-21
7787,경기,포천시,2,0,0,2,1,0,2018-12-21
7788,경기,하남시,1,0,0,1,1,0,2018-01-21
7789,경기,하남시,3,0,3,6,4,0,2018-02-21
7790,경기,하남시,1,0,0,1,1,0,2018-03-21
7791,경기,하남시,4,0,2,6,5,0,2018-04-21
7792,경기,하남시,1,1,1,3,3,0,2018-05-21
7793,경기,하남시,5,0,1,6,5,0,2018-06-21
7794,경기,하남시,4,0,0,4,2,0,2018-07-21
7795,경기,하남시,1,0,0,1,1,0,2018-08-21
7796,경기,하남시,0,0,0,0,0,0,2018-09-21
7797,경기,하남시,6,1,0,7,4,0,2018-10-21
7798,경기,하남시,1,4,0,5,4,0,2018-11-21
7799,경기,하남시,5,0,1,6,5,0,2018-12-21
7800,경기,화성시,3,0,0,3,3,1,2018-01-21
7801,경기,화성시,14,1,1,16,9,0,2018-02-21
7802,경기,화성시,12,0,2,14,12,0,2018-03-21
7803,경기,화성시,4,0,3,7,6,0,2018-04-21
7804,경기,화성시,2,0,2,4,3,0,2018-05-21
7805,경기,화성시,6,0,5,11,6,0,2018-06-21
7806,경기,화성시,17,4,2,23,10,0,2018-07-21
7807,경기,화성시,4,0,2,6,5,0,2018-08-21
7808,경기,화성시,11,0,2,13,10,0,2018-09-21
7809,경기,화성시,8,0,3,11,8,1,2018-10-21
7810,경기,화성시,6,0,1,7,5,0,2018-11-21
7811,경기,화성시,10,2,2,14,9,0,2018-12-21
7812,경기,가평군,2,0,0,2,1,0,2018-01-22
7813,경기,가평군,2,1,0,3,1,0,2018-02-22
7814,경기,가평군,0,0,0,0,0,0,2018-03-22
7815,경기,가평군,0,0,0,0,0,0,2018-04-22
7816,경기,가평군,2,0,2,4,1,0,2018-05-22
7817,경기,가평군,0,0,0,0,0,0,2018-06-22
7818,경기,가평군,5,0,0,5,2,0,2018-07-22
7819,경기,가평군,5,0,0,5,2,0,2018-08-22
7820,경기,가평군,0,0,0,0,0,0,2018-09-22
7821,경기,가평군,0,0,0,0,0,0,2018-10-22
7822,경기,가평군,1,0,0,1,1,0,2018-11-22
7823,경기,가평군,0,0,0,0,0,0,2018-12-22
7824,경기,고양시,9,1,1,11,8,0,2018-01-22
7825,경기,고양시,19,1,3,23,16,0,2018-02-22
7826,경기,고양시,7,2,3,12,8,0,2018-03-22
7827,경기,고양시,16,0,7,23,13,0,2018-04-22
7828,경기,고양시,13,2,6,21,13,0,2018-05-22
7829,경기,고양시,12,1,1,14,11,1,2018-06-22
7830,경기,고양시,8,1,0,9,6,0,2018-07-22
7831,경기,고양시,11,1,3,15,10,0,2018-08-22
7832,경기,고양시,6,2,1,9,8,0,2018-09-22
7833,경기,고양시,9,2,4,15,10,0,2018-10-22
7834,경기,고양시,12,2,2,16,11,0,2018-11-22
7835,경기,고양시,15,1,0,16,10,0,2018-12-22
7836,경기,과천시,2,0,0,2,1,0,2018-01-22
7837,경기,과천시,0,0,1,1,1,0,2018-02-22
7838,경기,과천시,1,1,0,2,1,0,2018-03-22
7839,경기,과천시,0,0,0,0,0,0,2018-04-22
7840,경기,과천시,1,0,2,3,2,0,2018-05-22
7841,경기,과천시,4,1,1,6,1,0,2018-06-22
7842,경기,과천시,7,0,0,7,1,0,2018-07-22
7843,경기,과천시,0,0,0,0,0,0,2018-08-22
7844,경기,과천시,0,0,0,0,0,0,2018-09-22
7845,경기,과천시,0,0,0,0,0,0,2018-10-22
7846,경기,과천시,0,0,0,0,0,0,2018-11-22
7847,경기,과천시,1,0,0,1,1,0,2018-12-22
7848,경기,광명시,3,1,0,4,4,0,2018-01-22
7849,경기,광명시,3,0,0,3,2,0,2018-02-22
7850,경기,광명시,0,0,2,2,1,0,2018-03-22
7851,경기,광명시,0,0,0,0,0,0,2018-04-22
7852,경기,광명시,2,2,0,4,3,0,2018-05-22
7853,경기,광명시,5,0,1,6,5,0,2018-06-22
7854,경기,광명시,3,0,2,5,3,0,2018-07-22
7855,경기,광명시,1,0,1,2,2,0,2018-08-22
7856,경기,광명시,2,0,2,4,4,0,2018-09-22
7857,경기,광명시,0,1,0,1,1,0,2018-10-22
7858,경기,광명시,0,0,0,0,0,0,2018-11-22
7859,경기,광명시,1,0,1,2,2,0,2018-12-22
7860,경기,광주시,3,0,0,3,3,0,2018-01-22
7861,경기,광주시,9,0,2,11,7,0,2018-02-22
7862,경기,광주시,3,0,0,3,2,1,2018-03-22
7863,경기,광주시,2,0,0,2,2,0,2018-04-22
7864,경기,광주시,2,0,1,3,2,0,2018-05-22
7865,경기,광주시,9,0,2,11,6,0,2018-06-22
7866,경기,광주시,2,1,2,5,5,0,2018-07-22
7867,경기,광주시,14,2,1,17,10,0,2018-08-22
7868,경기,광주시,3,1,2,6,6,1,2018-09-22
7869,경기,광주시,4,0,1,5,4,0,2018-10-22
7870,경기,광주시,6,1,1,8,7,0,2018-11-22
7871,경기,광주시,5,0,0,5,3,0,2018-12-22
7872,경기,구리시,0,0,0,0,0,0,2018-01-22
7873,경기,구리시,6,0,1,7,4,0,2018-02-22
7874,경기,구리시,1,0,0,1,1,0,2018-03-22
7875,경기,구리시,1,1,0,2,1,0,2018-04-22
7876,경기,구리시,0,0,2,2,2,0,2018-05-22
7877,경기,구리시,5,0,1,6,5,0,2018-06-22
7878,경기,구리시,1,0,0,1,1,0,2018-07-22
7879,경기,구리시,1,0,0,1,1,0,2018-08-22
7880,경기,구리시,0,0,2,2,2,0,2018-09-22
7881,경기,구리시,0,0,1,1,1,0,2018-10-22
7882,경기,구리시,0,0,0,0,0,0,2018-11-22
7883,경기,구리시,0,0,0,0,0,0,2018-12-22
7884,경기,군포시,0,0,0,0,0,0,2018-01-22
7885,경기,군포시,2,0,1,3,3,0,2018-02-22
7886,경기,군포시,3,0,0,3,3,0,2018-03-22
7887,경기,군포시,5,0,1,6,3,0,2018-04-22
7888,경기,군포시,2,0,1,3,2,0,2018-05-22
7889,경기,군포시,1,0,2,3,3,0,2018-06-22
7890,경기,군포시,2,0,0,2,1,0,2018-07-22
7891,경기,군포시,2,0,1,3,3,0,2018-08-22
7892,경기,군포시,0,1,0,1,1,0,2018-09-22
7893,경기,군포시,7,1,1,9,4,0,2018-10-22
7894,경기,군포시,5,0,0,5,4,0,2018-11-22
7895,경기,군포시,0,0,0,0,0,0,2018-12-22
7896,경기,김포시,4,1,2,7,5,0,2018-01-22
7897,경기,김포시,4,2,1,7,5,0,2018-02-22
7898,경기,김포시,3,0,4,7,6,0,2018-03-22
7899,경기,김포시,2,2,2,6,1,0,2018-04-22
7900,경기,김포시,3,0,3,6,5,0,2018-05-22
7901,경기,김포시,2,1,1,4,4,0,2018-06-22
7902,경기,김포시,8,0,1,9,6,0,2018-07-22
7903,경기,김포시,7,0,1,8,6,0,2018-08-22
7904,경기,김포시,10,3,7,20,6,0,2018-09-22
7905,경기,김포시,3,0,7,10,4,0,2018-10-22
7906,경기,김포시,12,0,1,13,9,0,2018-11-22
7907,경기,김포시,3,0,2,5,4,0,2018-12-22
7908,경기,남양주시,5,0,1,6,3,0,2018-01-22
7909,경기,남양주시,4,0,1,5,3,0,2018-02-22
7910,경기,남양주시,6,1,4,11,5,0,2018-03-22
7911,경기,남양주시,11,2,1,14,6,0,2018-04-22
7912,경기,남양주시,7,2,1,10,6,0,2018-05-22
7913,경기,남양주시,3,3,2,8,4,0,2018-06-22
7914,경기,남양주시,4,0,0,4,3,0,2018-07-22
7915,경기,남양주시,9,1,3,13,7,0,2018-08-22
7916,경기,남양주시,3,1,2,6,5,0,2018-09-22
7917,경기,남양주시,2,1,1,4,3,0,2018-10-22
7918,경기,남양주시,5,0,3,8,6,0,2018-11-22
7919,경기,남양주시,11,0,1,12,9,1,2018-12-22
7920,경기,동두천시,0,0,0,0,0,0,2018-01-22
7921,경기,동두천시,1,0,0,1,1,0,2018-02-22
7922,경기,동두천시,1,0,0,1,1,0,2018-03-22
7923,경기,동두천시,2,0,1,3,2,0,2018-04-22
7924,경기,동두천시,0,0,0,0,0,0,2018-05-22
7925,경기,동두천시,3,0,0,3,2,0,2018-06-22
7926,경기,동두천시,1,0,0,1,1,0,2018-07-22
7927,경기,동두천시,3,0,2,5,3,0,2018-08-22
7928,경기,동두천시,0,0,1,1,1,0,2018-09-22
7929,경기,동두천시,2,0,0,2,2,0,2018-10-22
7930,경기,동두천시,1,0,2,3,2,0,2018-11-22
7931,경기,동두천시,3,0,0,3,1,0,2018-12-22
7932,경기,부천시,3,2,1,6,6,0,2018-01-22
7933,경기,부천시,8,1,3,12,11,0,2018-02-22
7934,경기,부천시,9,0,1,10,6,0,2018-03-22
7935,경기,부천시,3,0,2,5,3,0,2018-04-22
7936,경기,부천시,15,0,7,22,12,1,2018-05-22
7937,경기,부천시,13,0,2,15,12,0,2018-06-22
7938,경기,부천시,7,4,0,11,8,0,2018-07-22
7939,경기,부천시,6,1,7,14,13,2,2018-08-22
7940,경기,부천시,4,0,3,7,6,1,2018-09-22
7941,경기,부천시,10,1,3,14,11,0,2018-10-22
7942,경기,부천시,11,0,3,14,8,0,2018-11-22
7943,경기,부천시,14,0,3,17,12,0,2018-12-22
7944,경기,성남시,7,0,2,9,5,0,2018-01-22
7945,경기,성남시,13,0,7,20,13,0,2018-02-22
7946,경기,성남시,6,1,7,14,11,1,2018-03-22
7947,경기,성남시,9,0,3,12,6,0,2018-04-22
7948,경기,성남시,10,3,2,15,11,0,2018-05-22
7949,경기,성남시,5,1,6,12,12,0,2018-06-22
7950,경기,성남시,11,2,2,15,9,0,2018-07-22
7951,경기,성남시,7,1,3,11,8,0,2018-08-22
7952,경기,성남시,11,1,1,13,10,0,2018-09-22
7953,경기,성남시,8,9,3,20,8,0,2018-10-22
7954,경기,성남시,7,2,6,15,11,0,2018-11-22
7955,경기,성남시,15,2,3,20,14,0,2018-12-22
7956,경기,수원시,7,1,4,12,8,0,2018-01-22
7957,경기,수원시,20,1,7,28,20,0,2018-02-22
7958,경기,수원시,18,1,5,24,18,1,2018-03-22
7959,경기,수원시,15,3,2,20,11,1,2018-04-22
7960,경기,수원시,17,2,8,27,18,0,2018-05-22
7961,경기,수원시,3,0,6,9,10,1,2018-06-22
7962,경기,수원시,12,0,4,16,10,0,2018-07-22
7963,경기,수원시,7,1,4,12,8,0,2018-08-22
7964,경기,수원시,10,2,3,15,14,0,2018-09-22
7965,경기,수원시,7,0,8,15,14,0,2018-10-22
7966,경기,수원시,20,1,2,23,17,1,2018-11-22
7967,경기,수원시,12,4,1,17,12,0,2018-12-22
7968,경기,시흥시,9,1,1,11,10,0,2018-01-22
7969,경기,시흥시,9,1,2,12,8,0,2018-02-22
7970,경기,시흥시,10,0,0,10,7,0,2018-03-22
7971,경기,시흥시,2,0,3,5,4,1,2018-04-22
7972,경기,시흥시,10,2,2,14,10,0,2018-05-22
7973,경기,시흥시,5,1,5,11,6,0,2018-06-22
7974,경기,시흥시,8,1,2,11,6,0,2018-07-22
7975,경기,시흥시,9,0,1,10,5,0,2018-08-22
7976,경기,시흥시,8,0,2,10,8,0,2018-09-22
7977,경기,시흥시,10,1,2,13,9,0,2018-10-22
7978,경기,시흥시,14,0,2,16,11,0,2018-11-22
7979,경기,시흥시,10,0,2,12,7,0,2018-12-22
7980,경기,안산시,19,1,6,26,14,0,2018-01-22
7981,경기,안산시,6,0,2,8,8,0,2018-02-22
7982,경기,안산시,11,1,2,14,10,0,2018-03-22
7983,경기,안산시,6,1,2,9,8,0,2018-04-22
7984,경기,안산시,15,0,4,19,12,0,2018-05-22
7985,경기,안산시,13,0,5,18,14,0,2018-06-22
7986,경기,안산시,6,1,6,13,9,0,2018-07-22
7987,경기,안산시,18,3,3,24,14,0,2018-08-22
7988,경기,안산시,3,2,3,8,8,0,2018-09-22
7989,경기,안산시,9,0,0,9,5,0,2018-10-22
7990,경기,안산시,13,2,2,17,11,0,2018-11-22
7991,경기,안산시,23,1,3,27,15,0,2018-12-22
7992,경기,안성시,2,0,1,3,3,0,2018-01-22
7993,경기,안성시,2,0,1,3,3,0,2018-02-22
7994,경기,안성시,2,1,0,3,1,0,2018-03-22
7995,경기,안성시,6,4,0,10,2,0,2018-04-22
7996,경기,안성시,2,0,1,3,2,0,2018-05-22
7997,경기,안성시,2,0,1,3,2,0,2018-06-22
7998,경기,안성시,5,0,0,5,2,0,2018-07-22
7999,경기,안성시,5,0,0,5,3,0,2018-08-22
8000,경기,안성시,10,1,2,13,6,0,2018-09-22
8001,경기,안성시,1,0,1,2,2,0,2018-10-22
8002,경기,안성시,6,0,2,8,4,0,2018-11-22
8003,경기,안성시,12,1,0,13,7,0,2018-12-22
8004,경기,안양시,6,0,3,9,5,0,2018-01-22
8005,경기,안양시,3,0,1,4,4,0,2018-02-22
8006,경기,안양시,5,0,1,6,5,0,2018-03-22
8007,경기,안양시,1,1,2,4,4,0,2018-04-22
8008,경기,안양시,5,0,4,9,7,0,2018-05-22
8009,경기,안양시,3,0,0,3,3,0,2018-06-22
8010,경기,안양시,3,0,0,3,3,0,2018-07-22
8011,경기,안양시,8,1,10,19,3,0,2018-08-22
8012,경기,안양시,2,0,2,4,3,0,2018-09-22
8013,경기,안양시,3,0,0,3,4,1,2018-10-22
8014,경기,안양시,2,0,1,3,3,0,2018-11-22
8015,경기,안양시,1,0,2,3,3,0,2018-12-22
8016,경기,양주시,4,0,1,5,4,0,2018-01-22
8017,경기,양주시,0,0,0,0,0,0,2018-02-22
8018,경기,양주시,1,0,4,5,3,0,2018-03-22
8019,경기,양주시,1,0,0,1,1,0,2018-04-22
8020,경기,양주시,7,0,1,8,4,0,2018-05-22
8021,경기,양주시,3,0,0,3,3,0,2018-06-22
8022,경기,양주시,7,1,0,8,5,0,2018-07-22
8023,경기,양주시,2,0,0,2,2,0,2018-08-22
8024,경기,양주시,12,0,4,16,7,0,2018-09-22
8025,경기,양주시,2,0,2,4,3,0,2018-10-22
8026,경기,양주시,7,1,0,8,6,0,2018-11-22
8027,경기,양주시,4,0,0,4,2,0,2018-12-22
8028,경기,양평군,2,0,0,2,1,0,2018-01-22
8029,경기,양평군,5,0,0,5,4,0,2018-02-22
8030,경기,양평군,1,0,1,2,1,0,2018-03-22
8031,경기,양평군,3,0,0,3,1,0,2018-04-22
8032,경기,양평군,5,0,2,7,2,0,2018-05-22
8033,경기,양평군,1,0,0,1,1,0,2018-06-22
8034,경기,양평군,8,0,4,12,5,0,2018-07-22
8035,경기,양평군,1,0,0,1,1,0,2018-08-22
8036,경기,양평군,2,0,0,2,2,0,2018-09-22
8037,경기,양평군,0,0,1,1,1,0,2018-10-22
8038,경기,양평군,3,1,0,4,1,0,2018-11-22
8039,경기,양평군,0,0,0,0,0,0,2018-12-22
8040,경기,여주시,2,0,0,2,2,0,2018-01-22
8041,경기,여주시,0,0,1,1,1,0,2018-02-22
8042,경기,여주시,1,0,1,2,2,0,2018-03-22
8043,경기,여주시,0,0,0,0,0,0,2018-04-22
8044,경기,여주시,0,0,0,0,0,0,2018-05-22
8045,경기,여주시,0,0,1,1,1,0,2018-06-22
8046,경기,여주시,0,0,0,0,0,0,2018-07-22
8047,경기,여주시,2,1,1,4,3,0,2018-08-22
8048,경기,여주시,2,0,0,2,1,0,2018-09-22
8049,경기,여주시,2,0,0,2,1,0,2018-10-22
8050,경기,여주시,0,0,0,0,0,0,2018-11-22
8051,경기,여주시,0,0,0,0,1,1,2018-12-22
8052,경기,연천군,0,0,0,0,0,0,2018-01-22
8053,경기,연천군,1,0,0,1,1,0,2018-02-22
8054,경기,연천군,0,0,0,0,0,0,2018-03-22
8055,경기,연천군,1,0,0,1,1,0,2018-04-22
8056,경기,연천군,0,0,0,0,0,0,2018-05-22
8057,경기,연천군,1,0,1,2,2,0,2018-06-22
8058,경기,연천군,4,0,0,4,2,0,2018-07-22
8059,경기,연천군,0,0,0,0,0,0,2018-08-22
8060,경기,연천군,0,0,1,1,1,0,2018-09-22
8061,경기,연천군,0,1,1,2,1,0,2018-10-22
8062,경기,연천군,0,0,0,0,0,0,2018-11-22
8063,경기,연천군,0,0,0,0,0,0,2018-12-22
8064,경기,오산시,4,0,0,4,3,0,2018-01-22
8065,경기,오산시,6,0,2,8,4,0,2018-02-22
8066,경기,오산시,0,0,2,2,2,0,2018-03-22
8067,경기,오산시,1,0,0,1,1,0,2018-04-22
8068,경기,오산시,4,0,0,4,1,0,2018-05-22
8069,경기,오산시,4,2,2,8,7,0,2018-06-22
8070,경기,오산시,1,2,2,5,2,0,2018-07-22
8071,경기,오산시,2,7,1,10,4,0,2018-08-22
8072,경기,오산시,1,0,2,3,2,0,2018-09-22
8073,경기,오산시,4,0,0,4,2,0,2018-10-22
8074,경기,오산시,1,0,2,3,2,0,2018-11-22
8075,경기,오산시,9,0,5,14,7,0,2018-12-22
8076,경기,용인시,10,3,1,14,10,0,2018-01-22
8077,경기,용인시,15,0,6,21,14,0,2018-02-22
8078,경기,용인시,4,3,2,9,7,0,2018-03-22
8079,경기,용인시,12,4,12,28,9,1,2018-04-22
8080,경기,용인시,3,2,2,7,6,0,2018-05-22
8081,경기,용인시,12,1,2,15,10,0,2018-06-22
8082,경기,용인시,8,0,1,9,6,0,2018-07-22
8083,경기,용인시,14,3,4,21,10,0,2018-08-22
8084,경기,용인시,7,3,6,16,10,0,2018-09-22
8085,경기,용인시,8,3,1,12,9,0,2018-10-22
8086,경기,용인시,15,2,2,19,11,0,2018-11-22
8087,경기,용인시,10,4,4,18,12,0,2018-12-22
8088,경기,의왕시,2,0,0,2,2,0,2018-01-22
8089,경기,의왕시,1,0,1,2,2,0,2018-02-22
8090,경기,의왕시,1,0,1,2,2,0,2018-03-22
8091,경기,의왕시,1,0,0,1,1,0,2018-04-22
8092,경기,의왕시,0,0,0,0,0,0,2018-05-22
8093,경기,의왕시,0,1,1,2,2,0,2018-06-22
8094,경기,의왕시,2,0,0,2,1,0,2018-07-22
8095,경기,의왕시,0,0,1,1,1,0,2018-08-22
8096,경기,의왕시,2,0,0,2,2,0,2018-09-22
8097,경기,의왕시,0,0,0,0,0,0,2018-10-22
8098,경기,의왕시,0,0,2,2,2,0,2018-11-22
8099,경기,의왕시,2,0,2,4,2,0,2018-12-22
8100,경기,의정부시,6,0,2,8,4,0,2018-01-22
8101,경기,의정부시,0,1,1,2,2,0,2018-02-22
8102,경기,의정부시,6,0,1,7,5,0,2018-03-22
8103,경기,의정부시,2,0,2,4,3,0,2018-04-22
8104,경기,의정부시,3,0,1,4,3,0,2018-05-22
8105,경기,의정부시,3,0,1,4,4,0,2018-06-22
8106,경기,의정부시,2,0,2,4,3,0,2018-07-22
8107,경기,의정부시,1,0,0,1,1,0,2018-08-22
8108,경기,의정부시,3,3,0,6,3,0,2018-09-22
8109,경기,의정부시,7,0,1,8,5,0,2018-10-22
8110,경기,의정부시,1,0,1,2,2,0,2018-11-22
8111,경기,의정부시,2,2,0,4,3,0,2018-12-22
8112,경기,이천시,4,0,1,5,3,0,2018-01-22
8113,경기,이천시,4,1,1,6,6,0,2018-02-22
8114,경기,이천시,6,0,0,6,4,0,2018-03-22
8115,경기,이천시,1,0,0,1,1,0,2018-04-22
8116,경기,이천시,11,0,0,11,3,0,2018-05-22
8117,경기,이천시,11,1,0,12,4,0,2018-06-22
8118,경기,이천시,4,0,0,4,4,0,2018-07-22
8119,경기,이천시,5,0,0,5,1,0,2018-08-22
8120,경기,이천시,2,1,2,5,3,0,2018-09-22
8121,경기,이천시,1,0,1,2,2,0,2018-10-22
8122,경기,이천시,9,0,1,10,7,0,2018-11-22
8123,경기,이천시,2,0,0,2,2,0,2018-12-22
8124,경기,파주시,12,0,1,13,7,0,2018-01-22
8125,경기,파주시,10,3,4,17,10,0,2018-02-22
8126,경기,파주시,1,0,1,2,2,0,2018-03-22
8127,경기,파주시,2,0,1,3,2,0,2018-04-22
8128,경기,파주시,11,0,1,12,5,0,2018-05-22
8129,경기,파주시,9,0,0,9,5,0,2018-06-22
8130,경기,파주시,6,0,0,6,4,0,2018-07-22
8131,경기,파주시,2,1,3,6,6,0,2018-08-22
8132,경기,파주시,5,0,0,5,2,0,2018-09-22
8133,경기,파주시,5,1,1,7,5,0,2018-10-22
8134,경기,파주시,4,2,2,8,7,0,2018-11-22
8135,경기,파주시,6,0,1,7,5,0,2018-12-22
8136,경기,평택시,5,0,2,7,5,0,2018-01-22
8137,경기,평택시,13,2,1,16,10,0,2018-02-22
8138,경기,평택시,31,0,7,38,20,0,2018-03-22
8139,경기,평택시,3,1,3,7,6,0,2018-04-22
8140,경기,평택시,13,4,3,20,13,0,2018-05-22
8141,경기,평택시,19,2,5,26,16,0,2018-06-22
8142,경기,평택시,6,0,2,8,5,0,2018-07-22
8143,경기,평택시,5,0,2,7,6,0,2018-08-22
8144,경기,평택시,9,1,1,11,6,0,2018-09-22
8145,경기,평택시,16,0,6,22,15,0,2018-10-22
8146,경기,평택시,14,4,1,19,13,0,2018-11-22
8147,경기,평택시,11,1,1,13,10,0,2018-12-22
8148,경기,포천시,2,0,1,3,3,0,2018-01-22
8149,경기,포천시,1,0,0,1,1,0,2018-02-22
8150,경기,포천시,3,2,1,6,3,0,2018-03-22
8151,경기,포천시,0,1,1,2,2,0,2018-04-22
8152,경기,포천시,1,0,1,2,1,0,2018-05-22
8153,경기,포천시,6,1,0,7,5,1,2018-06-22
8154,경기,포천시,16,3,1,20,6,0,2018-07-22
8155,경기,포천시,1,0,1,2,2,0,2018-08-22
8156,경기,포천시,1,0,0,1,2,1,2018-09-22
8157,경기,포천시,2,0,1,3,3,1,2018-10-22
8158,경기,포천시,3,0,2,5,3,0,2018-11-22
8159,경기,포천시,3,0,0,3,2,0,2018-12-22
8160,경기,하남시,1,0,0,1,1,0,2018-01-22
8161,경기,하남시,0,0,0,0,0,0,2018-02-22
8162,경기,하남시,0,0,0,0,0,0,2018-03-22
8163,경기,하남시,2,0,0,2,2,0,2018-04-22
8164,경기,하남시,11,2,2,15,4,0,2018-05-22
8165,경기,하남시,0,2,0,2,2,0,2018-06-22
8166,경기,하남시,3,0,0,3,2,0,2018-07-22
8167,경기,하남시,2,1,3,6,4,0,2018-08-22
8168,경기,하남시,4,0,0,4,2,0,2018-09-22
8169,경기,하남시,3,0,0,3,3,0,2018-10-22
8170,경기,하남시,3,0,1,4,2,0,2018-11-22
8171,경기,하남시,1,0,0,1,1,0,2018-12-22
8172,경기,화성시,8,0,2,10,6,0,2018-01-22
8173,경기,화성시,5,0,1,6,2,0,2018-02-22
8174,경기,화성시,7,0,5,12,9,1,2018-03-22
8175,경기,화성시,8,2,5,15,5,0,2018-04-22
8176,경기,화성시,9,0,1,10,5,0,2018-05-22
8177,경기,화성시,6,1,1,8,5,0,2018-06-22
8178,경기,화성시,8,1,1,10,9,0,2018-07-22
8179,경기,화성시,11,0,3,14,8,0,2018-08-22
8180,경기,화성시,6,0,4,10,8,0,2018-09-22
8181,경기,화성시,6,2,3,11,9,0,2018-10-22
8182,경기,화성시,6,0,3,9,8,0,2018-11-22
8183,경기,화성시,10,0,0,10,8,0,2018-12-22
8184,경기,가평군,3,0,0,3,1,0,2018-01-23
8185,경기,가평군,2,2,2,6,3,0,2018-02-23
8186,경기,가평군,0,0,0,0,0,0,2018-03-23
8187,경기,가평군,1,0,0,1,1,0,2018-04-23
8188,경기,가평군,0,1,1,2,2,0,2018-05-23
8189,경기,가평군,2,0,0,2,2,0,2018-06-23
8190,경기,가평군,0,0,0,0,0,0,2018-07-23
8191,경기,가평군,0,0,0,0,0,0,2018-08-23
8192,경기,가평군,1,0,1,2,1,0,2018-09-23
8193,경기,가평군,1,0,0,1,1,0,2018-10-23
8194,경기,가평군,0,1,0,1,1,0,2018-11-23
8195,경기,가평군,0,0,0,0,0,0,2018-12-23
8196,경기,고양시,15,2,3,20,14,1,2018-01-23
8197,경기,고양시,8,1,4,13,12,0,2018-02-23
8198,경기,고양시,15,4,4,23,15,0,2018-03-23
8199,경기,고양시,19,0,3,22,12,0,2018-04-23
8200,경기,고양시,6,0,1,7,6,0,2018-05-23
8201,경기,고양시,4,2,5,11,10,0,2018-06-23
8202,경기,고양시,6,1,4,11,9,0,2018-07-23
8203,경기,고양시,14,0,4,18,10,0,2018-08-23
8204,경기,고양시,14,1,7,22,9,0,2018-09-23
8205,경기,고양시,8,2,1,11,7,0,2018-10-23
8206,경기,고양시,12,4,3,19,13,0,2018-11-23
8207,경기,고양시,9,0,0,9,6,0,2018-12-23
8208,경기,과천시,0,0,0,0,0,0,2018-01-23
8209,경기,과천시,2,0,0,2,1,0,2018-02-23
8210,경기,과천시,1,0,0,1,1,0,2018-03-23
8211,경기,과천시,0,0,0,0,0,0,2018-04-23
8212,경기,과천시,0,0,1,1,1,0,2018-05-23
8213,경기,과천시,1,0,3,4,2,0,2018-06-23
8214,경기,과천시,1,0,0,1,1,0,2018-07-23
8215,경기,과천시,0,0,0,0,0,0,2018-08-23
8216,경기,과천시,0,0,0,0,0,0,2018-09-23
8217,경기,과천시,0,0,0,0,0,0,2018-10-23
8218,경기,과천시,0,0,1,1,1,0,2018-11-23
8219,경기,과천시,0,0,0,0,0,0,2018-12-23
8220,경기,광명시,1,0,3,4,4,0,2018-01-23
8221,경기,광명시,2,2,2,6,5,0,2018-02-23
8222,경기,광명시,3,2,2,7,6,0,2018-03-23
8223,경기,광명시,3,0,1,4,3,0,2018-04-23
8224,경기,광명시,8,3,0,11,6,0,2018-05-23
8225,경기,광명시,2,1,2,5,4,0,2018-06-23
8226,경기,광명시,0,0,0,0,0,0,2018-07-23
8227,경기,광명시,2,1,0,3,3,0,2018-08-23
8228,경기,광명시,2,0,0,2,1,0,2018-09-23
8229,경기,광명시,1,0,2,3,3,0,2018-10-23
8230,경기,광명시,3,0,1,4,4,1,2018-11-23
8231,경기,광명시,1,0,0,1,1,0,2018-12-23
8232,경기,광주시,5,0,3,8,6,0,2018-01-23
8233,경기,광주시,10,0,1,11,5,0,2018-02-23
8234,경기,광주시,3,0,0,3,4,1,2018-03-23
8235,경기,광주시,9,0,1,10,5,0,2018-04-23
8236,경기,광주시,3,1,2,6,6,0,2018-05-23
8237,경기,광주시,0,0,0,0,0,0,2018-06-23
8238,경기,광주시,10,1,0,11,6,0,2018-07-23
8239,경기,광주시,1,0,0,1,1,0,2018-08-23
8240,경기,광주시,2,0,0,2,2,0,2018-09-23
8241,경기,광주시,5,1,2,8,5,0,2018-10-23
8242,경기,광주시,12,0,1,13,9,0,2018-11-23
8243,경기,광주시,2,0,2,4,2,0,2018-12-23
8244,경기,구리시,2,1,2,5,3,0,2018-01-23
8245,경기,구리시,1,0,0,1,1,0,2018-02-23
8246,경기,구리시,2,0,0,2,2,0,2018-03-23
8247,경기,구리시,2,0,1,3,2,0,2018-04-23
8248,경기,구리시,2,0,0,2,2,0,2018-05-23
8249,경기,구리시,0,0,0,0,0,0,2018-06-23
8250,경기,구리시,1,0,2,3,3,0,2018-07-23
8251,경기,구리시,1,0,0,1,1,0,2018-08-23
8252,경기,구리시,2,0,0,2,2,0,2018-09-23
8253,경기,구리시,1,0,1,2,2,0,2018-10-23
8254,경기,구리시,1,0,0,1,1,0,2018-11-23
8255,경기,구리시,2,3,0,5,3,0,2018-12-23
8256,경기,군포시,1,0,1,2,1,0,2018-01-23
8257,경기,군포시,0,0,2,2,2,0,2018-02-23
8258,경기,군포시,0,1,0,1,1,0,2018-03-23
8259,경기,군포시,0,0,0,0,0,0,2018-04-23
8260,경기,군포시,1,0,1,2,2,0,2018-05-23
8261,경기,군포시,2,0,0,2,1,0,2018-06-23
8262,경기,군포시,0,1,0,1,1,0,2018-07-23
8263,경기,군포시,0,0,0,0,0,0,2018-08-23
8264,경기,군포시,0,0,0,0,0,0,2018-09-23
8265,경기,군포시,0,0,0,0,0,0,2018-10-23
8266,경기,군포시,2,1,1,4,3,0,2018-11-23
8267,경기,군포시,5,0,0,5,3,0,2018-12-23
8268,경기,김포시,11,7,1,19,5,0,2018-01-23
8269,경기,김포시,10,0,1,11,4,0,2018-02-23
8270,경기,김포시,4,0,0,4,3,0,2018-03-23
8271,경기,김포시,2,0,1,3,3,0,2018-04-23
8272,경기,김포시,3,0,0,3,2,0,2018-05-23
8273,경기,김포시,0,1,1,2,2,0,2018-06-23
8274,경기,김포시,12,0,1,13,6,0,2018-07-23
8275,경기,김포시,2,1,0,3,2,0,2018-08-23
8276,경기,김포시,1,0,0,1,1,0,2018-09-23
8277,경기,김포시,6,0,0,6,3,0,2018-10-23
8278,경기,김포시,3,1,2,6,6,0,2018-11-23
8279,경기,김포시,3,0,0,3,2,0,2018-12-23
8280,경기,남양주시,9,0,1,10,4,0,2018-01-23
8281,경기,남양주시,8,3,1,12,9,0,2018-02-23
8282,경기,남양주시,4,0,1,5,4,0,2018-03-23
8283,경기,남양주시,6,1,3,10,9,0,2018-04-23
8284,경기,남양주시,3,0,0,3,3,0,2018-05-23
8285,경기,남양주시,11,1,2,14,8,0,2018-06-23
8286,경기,남양주시,5,0,1,6,6,0,2018-07-23
8287,경기,남양주시,3,3,3,9,8,0,2018-08-23
8288,경기,남양주시,7,1,2,10,3,0,2018-09-23
8289,경기,남양주시,6,0,3,9,7,0,2018-10-23
8290,경기,남양주시,2,1,2,5,4,0,2018-11-23
8291,경기,남양주시,10,0,1,11,6,0,2018-12-23
8292,경기,동두천시,0,0,0,0,0,0,2018-01-23
8293,경기,동두천시,5,0,2,7,3,0,2018-02-23
8294,경기,동두천시,0,0,2,2,2,0,2018-03-23
8295,경기,동두천시,1,0,0,1,1,0,2018-04-23
8296,경기,동두천시,2,0,1,3,2,0,2018-05-23
8297,경기,동두천시,0,0,0,0,0,0,2018-06-23
8298,경기,동두천시,2,0,0,2,2,0,2018-07-23
8299,경기,동두천시,1,0,0,1,1,0,2018-08-23
8300,경기,동두천시,2,0,0,2,1,0,2018-09-23
8301,경기,동두천시,2,0,0,2,2,0,2018-10-23
8302,경기,동두천시,0,0,0,0,0,0,2018-11-23
8303,경기,동두천시,1,0,0,1,1,0,2018-12-23
8304,경기,부천시,11,0,4,15,12,1,2018-01-23
8305,경기,부천시,10,3,5,18,11,0,2018-02-23
8306,경기,부천시,7,1,5,13,10,0,2018-03-23
8307,경기,부천시,6,0,4,10,8,0,2018-04-23
8308,경기,부천시,10,1,3,14,11,0,2018-05-23
8309,경기,부천시,5,0,3,8,5,0,2018-06-23
8310,경기,부천시,8,2,2,12,11,0,2018-07-23
8311,경기,부천시,16,1,4,21,16,0,2018-08-23
8312,경기,부천시,4,2,1,7,6,0,2018-09-23
8313,경기,부천시,10,0,3,13,13,1,2018-10-23
8314,경기,부천시,9,3,3,15,12,0,2018-11-23
8315,경기,부천시,16,3,1,20,12,0,2018-12-23
8316,경기,성남시,13,3,3,19,13,0,2018-01-23
8317,경기,성남시,13,0,2,15,9,0,2018-02-23
8318,경기,성남시,8,0,5,13,7,0,2018-03-23
8319,경기,성남시,11,0,7,18,14,0,2018-04-23
8320,경기,성남시,12,2,3,17,10,0,2018-05-23
8321,경기,성남시,7,0,2,9,9,0,2018-06-23
8322,경기,성남시,9,0,3,12,9,0,2018-07-23
8323,경기,성남시,3,1,1,5,4,0,2018-08-23
8324,경기,성남시,4,0,2,6,6,0,2018-09-23
8325,경기,성남시,12,2,2,16,13,0,2018-10-23
8326,경기,성남시,8,0,1,9,6,0,2018-11-23
8327,경기,성남시,5,0,4,9,7,0,2018-12-23
8328,경기,수원시,13,1,5,19,11,0,2018-01-23
8329,경기,수원시,25,5,2,32,16,0,2018-02-23
8330,경기,수원시,12,2,1,15,14,1,2018-03-23
8331,경기,수원시,11,2,7,20,16,0,2018-04-23
8332,경기,수원시,9,0,5,14,11,0,2018-05-23
8333,경기,수원시,16,0,4,20,14,0,2018-06-23
8334,경기,수원시,12,2,6,20,16,0,2018-07-23
8335,경기,수원시,10,1,2,13,10,0,2018-08-23
8336,경기,수원시,22,4,4,30,11,0,2018-09-23
8337,경기,수원시,9,0,6,15,13,0,2018-10-23
8338,경기,수원시,13,4,7,24,16,0,2018-11-23
8339,경기,수원시,5,1,3,9,7,0,2018-12-23
8340,경기,시흥시,4,0,1,5,5,0,2018-01-23
8341,경기,시흥시,9,1,4,14,10,0,2018-02-23
8342,경기,시흥시,6,0,1,7,6,0,2018-03-23
8343,경기,시흥시,6,0,3,9,7,0,2018-04-23
8344,경기,시흥시,5,0,0,5,4,0,2018-05-23
8345,경기,시흥시,3,0,2,5,4,0,2018-06-23
8346,경기,시흥시,4,0,0,4,4,0,2018-07-23
8347,경기,시흥시,4,0,1,5,4,0,2018-08-23
8348,경기,시흥시,7,0,0,7,3,0,2018-09-23
8349,경기,시흥시,4,0,1,5,4,0,2018-10-23
8350,경기,시흥시,4,0,0,4,3,0,2018-11-23
8351,경기,시흥시,8,1,4,13,7,0,2018-12-23
8352,경기,안산시,13,0,4,17,13,0,2018-01-23
8353,경기,안산시,7,1,6,14,11,0,2018-02-23
8354,경기,안산시,23,0,2,25,13,0,2018-03-23
8355,경기,안산시,7,0,1,8,7,0,2018-04-23
8356,경기,안산시,13,1,1,15,9,0,2018-05-23
8357,경기,안산시,10,1,0,11,8,0,2018-06-23
8358,경기,안산시,16,2,6,24,13,0,2018-07-23
8359,경기,안산시,9,0,4,13,10,0,2018-08-23
8360,경기,안산시,8,0,3,11,3,0,2018-09-23
8361,경기,안산시,26,0,4,30,16,0,2018-10-23
8362,경기,안산시,14,1,2,17,11,0,2018-11-23
8363,경기,안산시,10,0,1,11,7,0,2018-12-23
8364,경기,안성시,2,0,1,3,2,0,2018-01-23
8365,경기,안성시,5,0,3,8,4,0,2018-02-23
8366,경기,안성시,1,0,1,2,3,1,2018-03-23
8367,경기,안성시,3,0,1,4,3,0,2018-04-23
8368,경기,안성시,4,0,0,4,2,0,2018-05-23
8369,경기,안성시,1,0,1,2,1,0,2018-06-23
8370,경기,안성시,1,0,1,2,2,0,2018-07-23
8371,경기,안성시,2,1,2,5,4,0,2018-08-23
8372,경기,안성시,3,0,4,7,5,0,2018-09-23
8373,경기,안성시,2,0,1,3,3,0,2018-10-23
8374,경기,안성시,4,0,1,5,4,0,2018-11-23
8375,경기,안성시,0,0,1,1,1,0,2018-12-23
8376,경기,안양시,4,0,2,6,4,0,2018-01-23
8377,경기,안양시,6,0,2,8,6,0,2018-02-23
8378,경기,안양시,1,0,2,3,2,0,2018-03-23
8379,경기,안양시,13,1,2,16,9,0,2018-04-23
8380,경기,안양시,5,0,0,5,3,0,2018-05-23
8381,경기,안양시,4,0,4,8,5,0,2018-06-23
8382,경기,안양시,1,1,1,3,2,0,2018-07-23
8383,경기,안양시,5,0,1,6,5,0,2018-08-23
8384,경기,안양시,6,0,0,6,3,0,2018-09-23
8385,경기,안양시,4,0,1,5,4,0,2018-10-23
8386,경기,안양시,6,0,6,12,10,0,2018-11-23
8387,경기,안양시,5,0,0,5,2,0,2018-12-23
8388,경기,양주시,7,0,2,9,6,0,2018-01-23
8389,경기,양주시,4,0,2,6,6,0,2018-02-23
8390,경기,양주시,5,0,1,6,7,1,2018-03-23
8391,경기,양주시,5,0,1,6,4,0,2018-04-23
8392,경기,양주시,7,0,3,10,3,0,2018-05-23
8393,경기,양주시,0,0,1,1,1,0,2018-06-23
8394,경기,양주시,6,2,2,10,6,0,2018-07-23
8395,경기,양주시,2,0,0,2,2,0,2018-08-23
8396,경기,양주시,5,0,0,5,2,0,2018-09-23
8397,경기,양주시,4,0,2,6,4,0,2018-10-23
8398,경기,양주시,2,0,2,4,4,0,2018-11-23
8399,경기,양주시,2,1,1,4,4,0,2018-12-23
8400,경기,양평군,0,0,0,0,0,0,2018-01-23
8401,경기,양평군,1,0,2,3,2,0,2018-02-23
8402,경기,양평군,7,1,0,8,5,0,2018-03-23
8403,경기,양평군,0,0,2,2,1,0,2018-04-23
8404,경기,양평군,0,0,0,0,0,0,2018-05-23
8405,경기,양평군,0,0,1,1,1,0,2018-06-23
8406,경기,양평군,2,0,0,2,2,0,2018-07-23
8407,경기,양평군,3,0,2,5,4,0,2018-08-23
8408,경기,양평군,0,0,0,0,0,0,2018-09-23
8409,경기,양평군,0,1,1,2,2,0,2018-10-23
8410,경기,양평군,1,0,0,1,1,0,2018-11-23
8411,경기,양평군,0,0,0,0,0,0,2018-12-23
8412,경기,여주시,2,0,1,3,2,0,2018-01-23
8413,경기,여주시,0,0,0,0,0,0,2018-02-23
8414,경기,여주시,0,0,2,2,1,0,2018-03-23
8415,경기,여주시,5,0,0,5,2,0,2018-04-23
8416,경기,여주시,4,0,0,4,1,0,2018-05-23
8417,경기,여주시,4,0,0,4,2,0,2018-06-23
8418,경기,여주시,0,0,0,0,0,0,2018-07-23
8419,경기,여주시,3,0,1,4,3,0,2018-08-23
8420,경기,여주시,0,0,0,0,0,0,2018-09-23
8421,경기,여주시,0,0,1,1,1,0,2018-10-23
8422,경기,여주시,1,0,0,1,1,0,2018-11-23
8423,경기,여주시,1,0,0,1,1,0,2018-12-23
8424,경기,연천군,0,0,0,0,0,0,2018-01-23
8425,경기,연천군,0,0,0,0,0,0,2018-02-23
8426,경기,연천군,0,0,0,0,0,0,2018-03-23
8427,경기,연천군,0,0,0,0,0,0,2018-04-23
8428,경기,연천군,0,0,0,0,0,0,2018-05-23
8429,경기,연천군,1,0,0,1,1,0,2018-06-23
8430,경기,연천군,0,0,0,0,0,0,2018-07-23
8431,경기,연천군,0,0,0,0,0,0,2018-08-23
8432,경기,연천군,0,0,0,0,0,0,2018-09-23
8433,경기,연천군,0,0,0,0,0,0,2018-10-23
8434,경기,연천군,0,0,0,0,0,0,2018-11-23
8435,경기,연천군,0,0,0,0,0,0,2018-12-23
8436,경기,오산시,2,0,1,3,3,0,2018-01-23
8437,경기,오산시,0,0,1,1,1,0,2018-02-23
8438,경기,오산시,0,0,2,2,1,0,2018-03-23
8439,경기,오산시,1,0,0,1,1,0,2018-04-23
8440,경기,오산시,2,1,1,4,3,0,2018-05-23
8441,경기,오산시,0,1,0,1,1,0,2018-06-23
8442,경기,오산시,5,0,2,7,4,0,2018-07-23
8443,경기,오산시,1,0,0,1,1,0,2018-08-23
8444,경기,오산시,0,0,1,1,1,0,2018-09-23
8445,경기,오산시,2,0,0,2,1,0,2018-10-23
8446,경기,오산시,8,4,0,12,3,0,2018-11-23
8447,경기,오산시,2,2,0,4,4,0,2018-12-23
8448,경기,용인시,6,1,2,9,5,0,2018-01-23
8449,경기,용인시,12,2,4,18,14,0,2018-02-23
8450,경기,용인시,13,2,6,21,13,0,2018-03-23
8451,경기,용인시,10,6,2,18,9,0,2018-04-23
8452,경기,용인시,14,1,6,21,14,0,2018-05-23
8453,경기,용인시,3,1,3,7,6,2,2018-06-23
8454,경기,용인시,12,5,3,20,6,0,2018-07-23
8455,경기,용인시,3,2,3,8,5,0,2018-08-23
8456,경기,용인시,7,0,5,12,10,0,2018-09-23
8457,경기,용인시,13,3,2,18,11,0,2018-10-23
8458,경기,용인시,10,8,7,25,9,0,2018-11-23
8459,경기,용인시,7,2,1,10,6,0,2018-12-23
8460,경기,의왕시,2,0,0,2,1,0,2018-01-23
8461,경기,의왕시,2,0,1,3,3,0,2018-02-23
8462,경기,의왕시,0,0,0,0,0,0,2018-03-23
8463,경기,의왕시,1,0,0,1,1,0,2018-04-23
8464,경기,의왕시,0,0,0,0,0,0,2018-05-23
8465,경기,의왕시,0,0,0,0,0,0,2018-06-23
8466,경기,의왕시,0,1,4,5,1,0,2018-07-23
8467,경기,의왕시,1,0,0,1,1,0,2018-08-23
8468,경기,의왕시,4,0,4,8,1,0,2018-09-23
8469,경기,의왕시,0,0,2,2,2,0,2018-10-23
8470,경기,의왕시,1,0,0,1,1,0,2018-11-23
8471,경기,의왕시,0,0,0,0,0,0,2018-12-23
8472,경기,의정부시,1,0,2,3,3,0,2018-01-23
8473,경기,의정부시,6,1,4,11,6,0,2018-02-23
8474,경기,의정부시,2,0,0,2,3,1,2018-03-23
8475,경기,의정부시,1,1,1,3,3,0,2018-04-23
8476,경기,의정부시,3,0,1,4,3,0,2018-05-23
8477,경기,의정부시,3,0,5,8,5,1,2018-06-23
8478,경기,의정부시,11,2,2,15,6,0,2018-07-23
8479,경기,의정부시,13,1,1,15,7,0,2018-08-23
8480,경기,의정부시,0,2,0,2,2,0,2018-09-23
8481,경기,의정부시,6,2,1,9,6,0,2018-10-23
8482,경기,의정부시,6,1,0,7,4,0,2018-11-23
8483,경기,의정부시,4,1,1,6,3,0,2018-12-23
8484,경기,이천시,1,0,2,3,3,0,2018-01-23
8485,경기,이천시,10,0,2,12,4,0,2018-02-23
8486,경기,이천시,7,0,2,9,3,0,2018-03-23
8487,경기,이천시,2,2,5,9,5,0,2018-04-23
8488,경기,이천시,2,0,2,4,2,0,2018-05-23
8489,경기,이천시,0,0,0,0,0,0,2018-06-23
8490,경기,이천시,2,0,0,2,2,0,2018-07-23
8491,경기,이천시,5,1,2,8,2,0,2018-08-23
8492,경기,이천시,2,1,0,3,3,0,2018-09-23
8493,경기,이천시,0,1,1,2,1,0,2018-10-23
8494,경기,이천시,4,1,0,5,5,0,2018-11-23
8495,경기,이천시,3,0,0,3,1,0,2018-12-23
8496,경기,파주시,17,1,2,20,8,0,2018-01-23
8497,경기,파주시,6,0,2,8,7,0,2018-02-23
8498,경기,파주시,2,0,2,4,1,0,2018-03-23
8499,경기,파주시,6,0,3,9,7,0,2018-04-23
8500,경기,파주시,11,1,2,14,9,0,2018-05-23
8501,경기,파주시,2,1,1,4,4,0,2018-06-23
8502,경기,파주시,3,0,1,4,4,0,2018-07-23
8503,경기,파주시,6,1,0,7,7,0,2018-08-23
8504,경기,파주시,5,0,0,5,3,0,2018-09-23
8505,경기,파주시,1,0,1,2,2,0,2018-10-23
8506,경기,파주시,2,0,1,3,3,0,2018-11-23
8507,경기,파주시,1,0,0,1,1,0,2018-12-23
8508,경기,평택시,16,2,2,20,15,0,2018-01-23
8509,경기,평택시,9,0,2,11,8,0,2018-02-23
8510,경기,평택시,14,1,3,18,14,0,2018-03-23
8511,경기,평택시,9,1,1,11,8,0,2018-04-23
8512,경기,평택시,11,1,3,15,9,0,2018-05-23
8513,경기,평택시,2,10,4,16,7,0,2018-06-23
8514,경기,평택시,10,0,3,13,8,1,2018-07-23
8515,경기,평택시,7,0,7,14,10,0,2018-08-23
8516,경기,평택시,6,0,2,8,5,0,2018-09-23
8517,경기,평택시,5,2,3,10,9,0,2018-10-23
8518,경기,평택시,15,6,4,25,16,0,2018-11-23
8519,경기,평택시,9,2,2,13,6,0,2018-12-23
8520,경기,포천시,6,1,1,8,4,0,2018-01-23
8521,경기,포천시,5,0,1,6,5,0,2018-02-23
8522,경기,포천시,3,0,3,6,3,0,2018-03-23
8523,경기,포천시,2,1,1,4,3,0,2018-04-23
8524,경기,포천시,3,0,1,4,3,0,2018-05-23
8525,경기,포천시,2,0,2,4,3,0,2018-06-23
8526,경기,포천시,0,0,0,0,0,0,2018-07-23
8527,경기,포천시,2,0,0,2,2,0,2018-08-23
8528,경기,포천시,0,0,0,0,0,0,2018-09-23
8529,경기,포천시,2,0,0,2,1,0,2018-10-23
8530,경기,포천시,3,1,0,4,3,0,2018-11-23
8531,경기,포천시,3,0,0,3,1,0,2018-12-23
8532,경기,하남시,1,0,1,2,2,0,2018-01-23
8533,경기,하남시,4,1,1,6,3,0,2018-02-23
8534,경기,하남시,1,1,0,2,1,0,2018-03-23
8535,경기,하남시,2,0,1,3,2,0,2018-04-23
8536,경기,하남시,1,0,1,2,2,0,2018-05-23
8537,경기,하남시,7,0,0,7,4,0,2018-06-23
8538,경기,하남시,0,3,1,4,1,0,2018-07-23
8539,경기,하남시,4,0,0,4,2,0,2018-08-23
8540,경기,하남시,0,0,1,1,1,0,2018-09-23
8541,경기,하남시,3,0,0,3,3,0,2018-10-23
8542,경기,하남시,0,0,1,1,1,0,2018-11-23
8543,경기,하남시,1,1,0,2,2,0,2018-12-23
8544,경기,화성시,3,0,1,4,4,0,2018-01-23
8545,경기,화성시,5,0,3,8,7,0,2018-02-23
8546,경기,화성시,3,0,1,4,4,0,2018-03-23
8547,경기,화성시,13,1,4,18,11,0,2018-04-23
8548,경기,화성시,4,0,1,5,5,0,2018-05-23
8549,경기,화성시,5,0,3,8,6,0,2018-06-23
8550,경기,화성시,11,1,2,14,9,0,2018-07-23
8551,경기,화성시,9,0,3,12,9,0,2018-08-23
8552,경기,화성시,1,0,1,2,2,0,2018-09-23
8553,경기,화성시,6,0,2,8,8,1,2018-10-23
8554,경기,화성시,15,2,4,21,15,2,2018-11-23
8555,경기,화성시,6,1,3,10,5,0,2018-12-23
8556,경기,가평군,0,0,0,0,0,0,2018-01-24
8557,경기,가평군,2,0,0,2,2,0,2018-02-24
8558,경기,가평군,0,2,0,2,2,1,2018-03-24
8559,경기,가평군,1,0,0,1,1,0,2018-04-24
8560,경기,가평군,2,1,0,3,2,0,2018-05-24
8561,경기,가평군,6,0,3,9,3,0,2018-06-24
8562,경기,가평군,0,0,0,0,0,0,2018-07-24
8563,경기,가평군,1,0,0,1,1,0,2018-08-24
8564,경기,가평군,3,0,1,4,3,0,2018-09-24
8565,경기,가평군,3,0,2,5,3,0,2018-10-24
8566,경기,가평군,3,0,0,3,1,0,2018-11-24
8567,경기,가평군,0,0,0,0,0,0,2018-12-24
8568,경기,고양시,9,0,3,12,11,0,2018-01-24
8569,경기,고양시,11,1,4,16,9,0,2018-02-24
8570,경기,고양시,13,3,1,17,13,0,2018-03-24
8571,경기,고양시,6,4,4,14,12,0,2018-04-24
8572,경기,고양시,4,1,2,7,6,0,2018-05-24
8573,경기,고양시,4,0,3,7,6,0,2018-06-24
8574,경기,고양시,13,1,3,17,12,0,2018-07-24
8575,경기,고양시,12,1,3,16,13,0,2018-08-24
8576,경기,고양시,13,1,3,17,12,0,2018-09-24
8577,경기,고양시,21,2,4,27,10,1,2018-10-24
8578,경기,고양시,15,0,4,19,16,0,2018-11-24
8579,경기,고양시,21,2,5,28,18,0,2018-12-24
8580,경기,과천시,0,0,0,0,0,0,2018-01-24
8581,경기,과천시,0,0,0,0,0,0,2018-02-24
8582,경기,과천시,1,0,0,1,1,0,2018-03-24
8583,경기,과천시,0,0,0,0,1,1,2018-04-24
8584,경기,과천시,0,0,0,0,0,0,2018-05-24
8585,경기,과천시,0,0,0,0,0,0,2018-06-24
8586,경기,과천시,0,0,0,0,0,0,2018-07-24
8587,경기,과천시,0,0,0,0,0,0,2018-08-24
8588,경기,과천시,0,0,0,0,0,0,2018-09-24
8589,경기,과천시,1,1,0,2,2,0,2018-10-24
8590,경기,과천시,2,0,1,3,2,0,2018-11-24
8591,경기,과천시,0,0,1,1,1,0,2018-12-24
8592,경기,광명시,1,0,0,1,1,0,2018-01-24
8593,경기,광명시,4,7,0,11,3,0,2018-02-24
8594,경기,광명시,4,1,0,5,5,0,2018-03-24
8595,경기,광명시,3,2,0,5,3,0,2018-04-24
8596,경기,광명시,0,0,0,0,0,0,2018-05-24
8597,경기,광명시,0,0,0,0,0,0,2018-06-24
8598,경기,광명시,5,2,0,7,6,0,2018-07-24
8599,경기,광명시,3,3,2,8,7,0,2018-08-24
8600,경기,광명시,1,1,1,3,3,0,2018-09-24
8601,경기,광명시,2,0,1,3,3,0,2018-10-24
8602,경기,광명시,1,0,0,1,1,0,2018-11-24
8603,경기,광명시,3,0,3,6,4,0,2018-12-24
8604,경기,광주시,3,0,1,4,4,0,2018-01-24
8605,경기,광주시,2,0,2,4,4,0,2018-02-24
8606,경기,광주시,0,0,2,2,2,0,2018-03-24
8607,경기,광주시,3,0,4,7,5,0,2018-04-24
8608,경기,광주시,10,0,4,14,6,0,2018-05-24
8609,경기,광주시,7,0,1,8,6,0,2018-06-24
8610,경기,광주시,5,0,2,7,7,0,2018-07-24
8611,경기,광주시,1,0,1,2,2,0,2018-08-24
8612,경기,광주시,6,0,0,6,3,0,2018-09-24
8613,경기,광주시,2,2,2,6,4,0,2018-10-24
8614,경기,광주시,9,1,4,14,7,0,2018-11-24
8615,경기,광주시,5,1,0,6,6,0,2018-12-24
8616,경기,구리시,3,0,0,3,2,0,2018-01-24
8617,경기,구리시,5,0,0,5,2,0,2018-02-24
8618,경기,구리시,1,0,0,1,1,0,2018-03-24
8619,경기,구리시,1,0,0,1,1,0,2018-04-24
8620,경기,구리시,3,0,2,5,5,0,2018-05-24
8621,경기,구리시,1,1,0,2,1,0,2018-06-24
8622,경기,구리시,2,0,1,3,2,0,2018-07-24
8623,경기,구리시,2,0,0,2,1,0,2018-08-24
8624,경기,구리시,2,0,0,2,2,0,2018-09-24
8625,경기,구리시,2,1,0,3,1,0,2018-10-24
8626,경기,구리시,3,1,0,4,3,0,2018-11-24
8627,경기,구리시,4,1,0,5,3,0,2018-12-24
8628,경기,군포시,1,0,1,2,2,0,2018-01-24
8629,경기,군포시,0,0,0,0,0,0,2018-02-24
8630,경기,군포시,0,0,0,0,0,0,2018-03-24
8631,경기,군포시,2,0,0,2,2,0,2018-04-24
8632,경기,군포시,4,1,1,6,4,0,2018-05-24
8633,경기,군포시,0,0,0,0,0,0,2018-06-24
8634,경기,군포시,1,0,1,2,2,0,2018-07-24
8635,경기,군포시,2,0,1,3,2,0,2018-08-24
8636,경기,군포시,0,0,0,0,0,0,2018-09-24
8637,경기,군포시,0,1,0,1,1,0,2018-10-24
8638,경기,군포시,2,4,2,8,4,0,2018-11-24
8639,경기,군포시,1,1,1,3,2,0,2018-12-24
8640,경기,김포시,9,0,0,9,5,0,2018-01-24
8641,경기,김포시,6,0,1,7,4,0,2018-02-24
8642,경기,김포시,3,0,0,3,1,0,2018-03-24
8643,경기,김포시,0,0,1,1,1,0,2018-04-24
8644,경기,김포시,5,0,2,7,5,0,2018-05-24
8645,경기,김포시,6,2,2,10,3,0,2018-06-24
8646,경기,김포시,3,0,1,4,4,0,2018-07-24
8647,경기,김포시,5,0,0,5,3,0,2018-08-24
8648,경기,김포시,3,0,0,3,3,0,2018-09-24
8649,경기,김포시,2,0,3,5,4,0,2018-10-24
8650,경기,김포시,4,0,0,4,3,0,2018-11-24
8651,경기,김포시,8,1,1,10,6,0,2018-12-24
8652,경기,남양주시,8,1,1,10,5,0,2018-01-24
8653,경기,남양주시,9,0,0,9,4,0,2018-02-24
8654,경기,남양주시,2,0,1,3,2,0,2018-03-24
8655,경기,남양주시,11,0,2,13,7,1,2018-04-24
8656,경기,남양주시,14,2,0,16,8,0,2018-05-24
8657,경기,남양주시,12,3,3,18,8,0,2018-06-24
8658,경기,남양주시,9,0,1,10,9,0,2018-07-24
8659,경기,남양주시,6,0,2,8,6,0,2018-08-24
8660,경기,남양주시,4,0,1,5,3,0,2018-09-24
8661,경기,남양주시,6,1,0,7,5,0,2018-10-24
8662,경기,남양주시,8,1,1,10,5,0,2018-11-24
8663,경기,남양주시,14,1,2,17,13,0,2018-12-24
8664,경기,동두천시,2,0,0,2,3,1,2018-01-24
8665,경기,동두천시,2,0,2,4,2,0,2018-02-24
8666,경기,동두천시,0,0,0,0,0,0,2018-03-24
8667,경기,동두천시,0,0,0,0,0,0,2018-04-24
8668,경기,동두천시,1,1,1,3,2,0,2018-05-24
8669,경기,동두천시,1,0,0,1,1,0,2018-06-24
8670,경기,동두천시,2,0,0,2,2,0,2018-07-24
8671,경기,동두천시,0,0,0,0,0,0,2018-08-24
8672,경기,동두천시,0,0,0,0,0,0,2018-09-24
8673,경기,동두천시,3,0,3,6,3,0,2018-10-24
8674,경기,동두천시,1,0,0,1,1,0,2018-11-24
8675,경기,동두천시,3,0,0,3,1,0,2018-12-24
8676,경기,부천시,14,1,4,19,14,0,2018-01-24
8677,경기,부천시,7,1,1,9,6,0,2018-02-24
8678,경기,부천시,5,0,1,6,5,1,2018-03-24
8679,경기,부천시,10,3,8,21,15,0,2018-04-24
8680,경기,부천시,12,2,2,16,13,1,2018-05-24
8681,경기,부천시,6,1,0,7,7,0,2018-06-24
8682,경기,부천시,15,2,1,18,9,0,2018-07-24
8683,경기,부천시,5,1,2,8,7,0,2018-08-24
8684,경기,부천시,11,0,0,11,4,0,2018-09-24
8685,경기,부천시,15,1,6,22,15,0,2018-10-24
8686,경기,부천시,15,1,1,17,11,0,2018-11-24
8687,경기,부천시,14,0,1,15,12,0,2018-12-24
8688,경기,성남시,4,1,7,12,12,0,2018-01-24
8689,경기,성남시,5,2,3,10,6,0,2018-02-24
8690,경기,성남시,11,2,4,17,9,1,2018-03-24
8691,경기,성남시,14,3,8,25,17,0,2018-04-24
8692,경기,성남시,14,1,2,17,11,0,2018-05-24
8693,경기,성남시,6,4,2,12,9,0,2018-06-24
8694,경기,성남시,20,3,4,27,23,0,2018-07-24
8695,경기,성남시,4,1,4,9,8,0,2018-08-24
8696,경기,성남시,2,0,1,3,3,0,2018-09-24
8697,경기,성남시,13,2,5,20,14,0,2018-10-24
8698,경기,성남시,10,1,6,17,9,0,2018-11-24
8699,경기,성남시,6,3,2,11,10,1,2018-12-24
8700,경기,수원시,21,1,4,26,18,1,2018-01-24
8701,경기,수원시,15,2,2,19,14,0,2018-02-24
8702,경기,수원시,12,0,2,14,12,0,2018-03-24
8703,경기,수원시,13,1,3,17,12,0,2018-04-24
8704,경기,수원시,10,1,5,16,12,0,2018-05-24
8705,경기,수원시,6,2,6,14,6,0,2018-06-24
8706,경기,수원시,19,1,4,24,16,0,2018-07-24
8707,경기,수원시,19,0,3,22,16,0,2018-08-24
8708,경기,수원시,12,2,5,19,9,0,2018-09-24
8709,경기,수원시,23,3,11,37,22,0,2018-10-24
8710,경기,수원시,16,4,1,21,17,0,2018-11-24
8711,경기,수원시,13,1,2,16,10,0,2018-12-24
8712,경기,시흥시,9,5,1,15,10,0,2018-01-24
8713,경기,시흥시,8,0,0,8,6,0,2018-02-24
8714,경기,시흥시,3,0,3,6,4,0,2018-03-24
8715,경기,시흥시,15,1,4,20,11,0,2018-04-24
8716,경기,시흥시,10,0,1,11,10,1,2018-05-24
8717,경기,시흥시,1,0,0,1,1,0,2018-06-24
8718,경기,시흥시,13,0,4,17,11,0,2018-07-24
8719,경기,시흥시,6,1,1,8,4,0,2018-08-24
8720,경기,시흥시,0,0,0,0,0,0,2018-09-24
8721,경기,시흥시,11,1,5,17,10,0,2018-10-24
8722,경기,시흥시,3,2,1,6,4,0,2018-11-24
8723,경기,시흥시,5,0,2,7,7,1,2018-12-24
8724,경기,안산시,12,2,3,17,10,0,2018-01-24
8725,경기,안산시,11,1,3,15,9,0,2018-02-24
8726,경기,안산시,12,1,0,13,9,0,2018-03-24
8727,경기,안산시,12,1,5,18,14,1,2018-04-24
8728,경기,안산시,15,0,1,16,11,0,2018-05-24
8729,경기,안산시,9,0,4,13,10,0,2018-06-24
8730,경기,안산시,14,2,4,20,16,0,2018-07-24
8731,경기,안산시,12,0,2,14,10,0,2018-08-24
8732,경기,안산시,7,0,1,8,5,0,2018-09-24
8733,경기,안산시,8,4,5,17,13,0,2018-10-24
8734,경기,안산시,15,0,4,19,11,0,2018-11-24
8735,경기,안산시,13,0,3,16,11,1,2018-12-24
8736,경기,안성시,5,0,0,5,4,0,2018-01-24
8737,경기,안성시,9,0,1,10,5,0,2018-02-24
8738,경기,안성시,3,0,1,4,4,0,2018-03-24
8739,경기,안성시,1,2,0,3,2,0,2018-04-24
8740,경기,안성시,3,1,0,4,2,0,2018-05-24
8741,경기,안성시,0,0,0,0,0,0,2018-06-24
8742,경기,안성시,3,1,1,5,3,0,2018-07-24
8743,경기,안성시,11,0,0,11,4,0,2018-08-24
8744,경기,안성시,10,0,4,14,2,0,2018-09-24
8745,경기,안성시,5,1,3,9,5,1,2018-10-24
8746,경기,안성시,6,1,0,7,3,0,2018-11-24
8747,경기,안성시,9,1,1,11,7,0,2018-12-24
8748,경기,안양시,4,1,0,5,5,0,2018-01-24
8749,경기,안양시,10,0,1,11,6,0,2018-02-24
8750,경기,안양시,7,0,3,10,5,0,2018-03-24
8751,경기,안양시,9,0,2,11,5,0,2018-04-24
8752,경기,안양시,8,0,2,10,8,0,2018-05-24
8753,경기,안양시,6,0,0,6,6,0,2018-06-24
8754,경기,안양시,0,0,1,1,1,0,2018-07-24
8755,경기,안양시,7,0,1,8,7,0,2018-08-24
8756,경기,안양시,5,0,0,5,1,0,2018-09-24
8757,경기,안양시,9,0,2,11,7,0,2018-10-24
8758,경기,안양시,2,0,1,3,3,0,2018-11-24
8759,경기,안양시,2,0,1,3,2,0,2018-12-24
8760,경기,양주시,1,0,1,2,2,0,2018-01-24
8761,경기,양주시,1,1,0,2,2,0,2018-02-24
8762,경기,양주시,4,0,2,6,2,0,2018-03-24
8763,경기,양주시,3,0,0,3,3,0,2018-04-24
8764,경기,양주시,2,0,1,3,3,0,2018-05-24
8765,경기,양주시,5,1,0,6,2,0,2018-06-24
8766,경기,양주시,8,0,0,8,5,0,2018-07-24
8767,경기,양주시,1,1,0,2,2,0,2018-08-24
8768,경기,양주시,0,0,0,0,0,0,2018-09-24
8769,경기,양주시,8,0,0,8,5,0,2018-10-24
8770,경기,양주시,3,0,0,3,3,0,2018-11-24
8771,경기,양주시,1,0,0,1,1,0,2018-12-24
8772,경기,양평군,0,0,0,0,0,0,2018-01-24
8773,경기,양평군,0,0,1,1,1,0,2018-02-24
8774,경기,양평군,1,0,0,1,1,0,2018-03-24
8775,경기,양평군,4,0,4,8,4,0,2018-04-24
8776,경기,양평군,0,0,0,0,0,0,2018-05-24
8777,경기,양평군,0,0,0,0,0,0,2018-06-24
8778,경기,양평군,0,0,0,0,0,0,2018-07-24
8779,경기,양평군,1,2,0,3,2,0,2018-08-24
8780,경기,양평군,0,1,2,3,3,0,2018-09-24
8781,경기,양평군,3,0,0,3,1,0,2018-10-24
8782,경기,양평군,2,0,1,3,2,0,2018-11-24
8783,경기,양평군,0,0,0,0,0,0,2018-12-24
8784,경기,여주시,0,0,0,0,0,0,2018-01-24
8785,경기,여주시,0,0,0,0,0,0,2018-02-24
8786,경기,여주시,0,0,0,0,0,0,2018-03-24
8787,경기,여주시,6,0,4,10,3,0,2018-04-24
8788,경기,여주시,0,0,0,0,0,0,2018-05-24
8789,경기,여주시,9,0,2,11,3,0,2018-06-24
8790,경기,여주시,1,0,0,1,1,0,2018-07-24
8791,경기,여주시,1,0,0,1,1,0,2018-08-24
8792,경기,여주시,0,0,0,0,0,0,2018-09-24
8793,경기,여주시,2,0,2,4,4,0,2018-10-24
8794,경기,여주시,3,0,1,4,3,0,2018-11-24
8795,경기,여주시,0,0,1,1,1,0,2018-12-24
8796,경기,연천군,1,0,1,2,1,0,2018-01-24
8797,경기,연천군,0,0,0,0,0,0,2018-02-24
8798,경기,연천군,0,0,1,1,1,0,2018-03-24
8799,경기,연천군,0,0,1,1,1,0,2018-04-24
8800,경기,연천군,0,0,0,0,0,0,2018-05-24
8801,경기,연천군,0,0,0,0,0,0,2018-06-24
8802,경기,연천군,2,0,0,2,1,0,2018-07-24
8803,경기,연천군,0,0,0,0,0,0,2018-08-24
8804,경기,연천군,4,0,0,4,1,0,2018-09-24
8805,경기,연천군,2,0,1,3,3,0,2018-10-24
8806,경기,연천군,0,0,0,0,0,0,2018-11-24
8807,경기,연천군,0,0,1,1,1,0,2018-12-24
8808,경기,오산시,2,1,4,7,5,0,2018-01-24
8809,경기,오산시,2,1,2,5,2,1,2018-02-24
8810,경기,오산시,2,0,0,2,1,0,2018-03-24
8811,경기,오산시,2,2,1,5,3,0,2018-04-24
8812,경기,오산시,1,1,1,3,3,0,2018-05-24
8813,경기,오산시,7,2,3,12,6,0,2018-06-24
8814,경기,오산시,5,1,1,7,5,0,2018-07-24
8815,경기,오산시,1,0,2,3,3,1,2018-08-24
8816,경기,오산시,0,0,0,0,0,0,2018-09-24
8817,경기,오산시,2,0,1,3,3,0,2018-10-24
8818,경기,오산시,0,0,1,1,1,0,2018-11-24
8819,경기,오산시,4,0,1,5,4,0,2018-12-24
8820,경기,용인시,4,2,2,8,5,0,2018-01-24
8821,경기,용인시,5,0,4,9,7,0,2018-02-24
8822,경기,용인시,12,2,6,20,12,0,2018-03-24
8823,경기,용인시,11,5,2,18,10,0,2018-04-24
8824,경기,용인시,2,2,3,7,6,0,2018-05-24
8825,경기,용인시,3,0,2,5,3,0,2018-06-24
8826,경기,용인시,19,8,4,31,15,0,2018-07-24
8827,경기,용인시,13,1,5,19,11,0,2018-08-24
8828,경기,용인시,19,3,5,27,10,0,2018-09-24
8829,경기,용인시,4,1,0,5,5,0,2018-10-24
8830,경기,용인시,12,0,3,15,10,0,2018-11-24
8831,경기,용인시,12,3,4,19,13,1,2018-12-24
8832,경기,의왕시,0,0,0,0,0,0,2018-01-24
8833,경기,의왕시,1,0,0,1,1,0,2018-02-24
8834,경기,의왕시,8,0,2,10,3,0,2018-03-24
8835,경기,의왕시,0,0,2,2,2,0,2018-04-24
8836,경기,의왕시,0,0,1,1,1,0,2018-05-24
8837,경기,의왕시,2,2,0,4,2,0,2018-06-24
8838,경기,의왕시,1,0,0,1,1,0,2018-07-24
8839,경기,의왕시,0,0,0,0,0,0,2018-08-24
8840,경기,의왕시,0,0,0,0,0,0,2018-09-24
8841,경기,의왕시,1,0,0,1,1,0,2018-10-24
8842,경기,의왕시,4,0,0,4,1,0,2018-11-24
8843,경기,의왕시,0,0,0,0,0,0,2018-12-24
8844,경기,의정부시,8,1,1,10,6,0,2018-01-24
8845,경기,의정부시,2,2,3,7,5,0,2018-02-24
8846,경기,의정부시,7,0,2,9,5,0,2018-03-24
8847,경기,의정부시,5,2,1,8,7,0,2018-04-24
8848,경기,의정부시,5,0,0,5,5,0,2018-05-24
8849,경기,의정부시,1,1,1,3,2,0,2018-06-24
8850,경기,의정부시,2,2,0,4,3,0,2018-07-24
8851,경기,의정부시,4,0,1,5,4,0,2018-08-24
8852,경기,의정부시,6,0,0,6,2,0,2018-09-24
8853,경기,의정부시,5,2,2,9,6,0,2018-10-24
8854,경기,의정부시,6,0,1,7,4,0,2018-11-24
8855,경기,의정부시,7,0,0,7,5,0,2018-12-24
8856,경기,이천시,4,0,1,5,3,1,2018-01-24
8857,경기,이천시,1,0,0,1,1,0,2018-02-24
8858,경기,이천시,6,0,0,6,4,0,2018-03-24
8859,경기,이천시,3,1,0,4,4,0,2018-04-24
8860,경기,이천시,2,0,1,3,3,0,2018-05-24
8861,경기,이천시,1,1,1,3,2,0,2018-06-24
8862,경기,이천시,2,1,1,4,4,0,2018-07-24
8863,경기,이천시,3,0,3,6,2,0,2018-08-24
8864,경기,이천시,1,0,0,1,1,0,2018-09-24
8865,경기,이천시,6,2,1,9,5,0,2018-10-24
8866,경기,이천시,8,1,2,11,6,0,2018-11-24
8867,경기,이천시,0,1,1,2,2,0,2018-12-24
8868,경기,파주시,12,0,2,14,8,0,2018-01-24
8869,경기,파주시,4,0,0,4,3,0,2018-02-24
8870,경기,파주시,3,0,2,5,4,0,2018-03-24
8871,경기,파주시,1,0,2,3,3,0,2018-04-24
8872,경기,파주시,1,0,0,1,1,0,2018-05-24
8873,경기,파주시,3,0,2,5,4,0,2018-06-24
8874,경기,파주시,3,0,1,4,4,0,2018-07-24
8875,경기,파주시,2,0,0,2,1,0,2018-08-24
8876,경기,파주시,0,0,0,0,0,0,2018-09-24
8877,경기,파주시,5,0,3,8,6,0,2018-10-24
8878,경기,파주시,10,0,1,11,8,0,2018-11-24
8879,경기,파주시,3,2,2,7,3,0,2018-12-24
8880,경기,평택시,11,1,1,13,9,0,2018-01-24
8881,경기,평택시,12,1,3,16,11,0,2018-02-24
8882,경기,평택시,6,0,1,7,5,0,2018-03-24
8883,경기,평택시,12,0,3,15,8,0,2018-04-24
8884,경기,평택시,8,10,0,18,10,0,2018-05-24
8885,경기,평택시,5,0,1,6,3,0,2018-06-24
8886,경기,평택시,15,2,6,23,8,0,2018-07-24
8887,경기,평택시,9,2,5,16,13,0,2018-08-24
8888,경기,평택시,18,1,0,19,6,0,2018-09-24
8889,경기,평택시,16,3,3,22,11,1,2018-10-24
8890,경기,평택시,8,0,2,10,9,0,2018-11-24
8891,경기,평택시,16,7,3,26,11,0,2018-12-24
8892,경기,포천시,2,2,0,4,4,0,2018-01-24
8893,경기,포천시,1,0,1,2,1,0,2018-02-24
8894,경기,포천시,4,1,0,5,2,0,2018-03-24
8895,경기,포천시,6,0,0,6,2,0,2018-04-24
8896,경기,포천시,2,0,1,3,2,0,2018-05-24
8897,경기,포천시,1,1,0,2,2,0,2018-06-24
8898,경기,포천시,2,1,1,4,3,0,2018-07-24
8899,경기,포천시,6,0,0,6,5,0,2018-08-24
8900,경기,포천시,2,1,1,4,2,0,2018-09-24
8901,경기,포천시,2,2,1,5,3,0,2018-10-24
8902,경기,포천시,12,0,1,13,5,0,2018-11-24
8903,경기,포천시,3,0,0,3,3,0,2018-12-24
8904,경기,하남시,3,0,0,3,2,0,2018-01-24
8905,경기,하남시,4,0,2,6,3,0,2018-02-24
8906,경기,하남시,0,2,0,2,1,0,2018-03-24
8907,경기,하남시,2,0,0,2,2,0,2018-04-24
8908,경기,하남시,3,0,1,4,5,1,2018-05-24
8909,경기,하남시,2,0,0,2,1,0,2018-06-24
8910,경기,하남시,3,0,2,5,3,0,2018-07-24
8911,경기,하남시,7,0,0,7,3,0,2018-08-24
8912,경기,하남시,3,0,0,3,1,0,2018-09-24
8913,경기,하남시,3,1,2,6,4,0,2018-10-24
8914,경기,하남시,4,0,1,5,2,0,2018-11-24
8915,경기,하남시,3,0,0,3,2,0,2018-12-24
8916,경기,화성시,9,0,3,12,7,0,2018-01-24
8917,경기,화성시,10,1,3,14,7,0,2018-02-24
8918,경기,화성시,13,0,2,15,9,1,2018-03-24
8919,경기,화성시,3,0,3,6,5,0,2018-04-24
8920,경기,화성시,4,0,2,6,5,0,2018-05-24
8921,경기,화성시,8,1,2,11,7,0,2018-06-24
8922,경기,화성시,5,0,2,7,5,0,2018-07-24
8923,경기,화성시,16,0,3,19,13,0,2018-08-24
8924,경기,화성시,7,0,1,8,5,0,2018-09-24
8925,경기,화성시,7,2,1,10,7,0,2018-10-24
8926,경기,화성시,10,0,5,15,6,0,2018-11-24
8927,경기,화성시,7,1,1,9,6,0,2018-12-24
8928,경기,가평군,0,0,0,0,0,0,2018-01-25
8929,경기,가평군,4,0,0,4,1,0,2018-02-25
8930,경기,가평군,1,0,1,2,2,0,2018-03-25
8931,경기,가평군,1,0,0,1,1,0,2018-04-25
8932,경기,가평군,1,0,0,1,1,0,2018-05-25
8933,경기,가평군,0,0,0,0,1,1,2018-06-25
8934,경기,가평군,5,0,0,5,1,0,2018-07-25
8935,경기,가평군,2,0,1,3,2,0,2018-08-25
8936,경기,가평군,0,0,0,0,0,0,2018-09-25
8937,경기,가평군,5,0,1,6,2,0,2018-10-25
8938,경기,가평군,1,0,0,1,1,0,2018-11-25
8939,경기,가평군,0,0,0,0,0,0,2018-12-25
8940,경기,고양시,16,5,1,22,12,0,2018-01-25
8941,경기,고양시,10,1,2,13,12,0,2018-02-25
8942,경기,고양시,11,1,1,13,7,0,2018-03-25
8943,경기,고양시,12,0,0,12,11,0,2018-04-25
8944,경기,고양시,13,1,2,16,12,0,2018-05-25
8945,경기,고양시,12,4,1,17,14,0,2018-06-25
8946,경기,고양시,16,2,2,20,10,0,2018-07-25
8947,경기,고양시,5,0,1,6,6,1,2018-08-25
8948,경기,고양시,15,1,2,18,12,0,2018-09-25
8949,경기,고양시,14,0,2,16,10,0,2018-10-25
8950,경기,고양시,10,1,2,13,7,0,2018-11-25
8951,경기,고양시,17,2,2,21,12,0,2018-12-25
8952,경기,과천시,0,0,1,1,1,0,2018-01-25
8953,경기,과천시,0,0,0,0,0,0,2018-02-25
8954,경기,과천시,0,0,0,0,0,0,2018-03-25
8955,경기,과천시,2,0,0,2,2,0,2018-04-25
8956,경기,과천시,0,0,0,0,0,0,2018-05-25
8957,경기,과천시,0,2,0,2,2,0,2018-06-25
8958,경기,과천시,0,0,1,1,1,0,2018-07-25
8959,경기,과천시,5,0,0,5,2,0,2018-08-25
8960,경기,과천시,6,0,0,6,1,0,2018-09-25
8961,경기,과천시,1,1,0,2,2,0,2018-10-25
8962,경기,과천시,0,0,0,0,0,0,2018-11-25
8963,경기,과천시,1,0,0,1,1,0,2018-12-25
8964,경기,광명시,3,1,1,5,4,0,2018-01-25
8965,경기,광명시,2,1,1,4,2,0,2018-02-25
8966,경기,광명시,1,0,0,1,1,0,2018-03-25
8967,경기,광명시,4,0,0,4,4,0,2018-04-25
8968,경기,광명시,5,1,2,8,7,0,2018-05-25
8969,경기,광명시,6,0,5,11,5,1,2018-06-25
8970,경기,광명시,4,0,2,6,5,0,2018-07-25
8971,경기,광명시,0,0,0,0,0,0,2018-08-25
8972,경기,광명시,6,1,2,9,3,0,2018-09-25
8973,경기,광명시,1,0,0,1,1,0,2018-10-25
8974,경기,광명시,2,8,2,12,2,0,2018-11-25
8975,경기,광명시,2,0,0,2,1,0,2018-12-25
8976,경기,광주시,10,0,2,12,7,0,2018-01-25
8977,경기,광주시,6,0,2,8,3,0,2018-02-25
8978,경기,광주시,0,0,0,0,0,0,2018-03-25
8979,경기,광주시,3,0,0,3,2,0,2018-04-25
8980,경기,광주시,10,3,3,16,9,0,2018-05-25
8981,경기,광주시,2,0,0,2,2,0,2018-06-25
8982,경기,광주시,13,0,0,13,7,0,2018-07-25
8983,경기,광주시,12,0,3,15,7,1,2018-08-25
8984,경기,광주시,6,0,0,6,3,0,2018-09-25
8985,경기,광주시,6,1,2,9,8,0,2018-10-25
8986,경기,광주시,2,0,0,2,2,0,2018-11-25
8987,경기,광주시,7,0,2,9,4,0,2018-12-25
8988,경기,구리시,1,0,1,2,2,0,2018-01-25
8989,경기,구리시,2,0,0,2,2,0,2018-02-25
8990,경기,구리시,2,0,0,2,2,0,2018-03-25
8991,경기,구리시,2,0,0,2,2,0,2018-04-25
8992,경기,구리시,1,0,1,2,2,0,2018-05-25
8993,경기,구리시,0,0,0,0,0,0,2018-06-25
8994,경기,구리시,1,0,1,2,2,0,2018-07-25
8995,경기,구리시,5,0,1,6,4,0,2018-08-25
8996,경기,구리시,1,0,1,2,2,0,2018-09-25
8997,경기,구리시,5,0,1,6,4,0,2018-10-25
8998,경기,구리시,0,0,0,0,0,0,2018-11-25
8999,경기,구리시,5,0,1,6,3,0,2018-12-25
9000,경기,군포시,1,0,0,1,1,0,2018-01-25
9001,경기,군포시,1,0,1,2,2,0,2018-02-25
9002,경기,군포시,2,1,0,3,1,0,2018-03-25
9003,경기,군포시,8,2,1,11,5,0,2018-04-25
9004,경기,군포시,0,0,0,0,0,0,2018-05-25
9005,경기,군포시,6,1,2,9,5,0,2018-06-25
9006,경기,군포시,3,0,0,3,3,0,2018-07-25
9007,경기,군포시,2,0,0,2,2,0,2018-08-25
9008,경기,군포시,0,0,0,0,0,0,2018-09-25
9009,경기,군포시,2,0,0,2,1,0,2018-10-25
9010,경기,군포시,0,0,2,2,2,0,2018-11-25
9011,경기,군포시,0,0,0,0,0,0,2018-12-25
9012,경기,김포시,2,2,2,6,4,0,2018-01-25
9013,경기,김포시,3,0,1,4,3,0,2018-02-25
9014,경기,김포시,1,0,0,1,1,0,2018-03-25
9015,경기,김포시,7,1,2,10,7,0,2018-04-25
9016,경기,김포시,4,0,1,5,4,0,2018-05-25
9017,경기,김포시,9,2,0,11,7,0,2018-06-25
9018,경기,김포시,9,1,2,12,8,0,2018-07-25
9019,경기,김포시,1,0,2,3,3,1,2018-08-25
9020,경기,김포시,4,0,0,4,2,0,2018-09-25
9021,경기,김포시,5,0,2,7,7,0,2018-10-25
9022,경기,김포시,7,0,1,8,4,0,2018-11-25
9023,경기,김포시,2,3,0,5,2,0,2018-12-25
9024,경기,남양주시,7,3,0,10,6,0,2018-01-25
9025,경기,남양주시,2,0,1,3,2,0,2018-02-25
9026,경기,남양주시,3,0,1,4,4,0,2018-03-25
9027,경기,남양주시,5,1,2,8,6,0,2018-04-25
9028,경기,남양주시,5,1,1,7,6,0,2018-05-25
9029,경기,남양주시,7,1,4,12,10,0,2018-06-25
9030,경기,남양주시,8,1,5,14,7,0,2018-07-25
9031,경기,남양주시,7,2,4,13,10,0,2018-08-25
9032,경기,남양주시,18,1,3,22,9,0,2018-09-25
9033,경기,남양주시,10,3,2,15,4,0,2018-10-25
9034,경기,남양주시,8,3,0,11,4,1,2018-11-25
9035,경기,남양주시,7,0,1,8,4,0,2018-12-25
9036,경기,동두천시,0,0,0,0,0,0,2018-01-25
9037,경기,동두천시,1,0,1,2,2,0,2018-02-25
9038,경기,동두천시,1,0,0,1,1,0,2018-03-25
9039,경기,동두천시,0,0,0,0,0,0,2018-04-25
9040,경기,동두천시,2,0,0,2,2,0,2018-05-25
9041,경기,동두천시,1,0,0,1,1,0,2018-06-25
9042,경기,동두천시,1,1,0,2,2,0,2018-07-25
9043,경기,동두천시,0,0,1,1,1,0,2018-08-25
9044,경기,동두천시,1,0,0,1,1,0,2018-09-25
9045,경기,동두천시,2,0,0,2,2,0,2018-10-25
9046,경기,동두천시,0,0,2,2,2,0,2018-11-25
9047,경기,동두천시,3,0,1,4,3,0,2018-12-25
9048,경기,부천시,3,0,4,7,4,0,2018-01-25
9049,경기,부천시,4,1,3,8,7,0,2018-02-25
9050,경기,부천시,8,1,3,12,7,0,2018-03-25
9051,경기,부천시,7,1,2,10,9,0,2018-04-25
9052,경기,부천시,7,0,4,11,10,0,2018-05-25
9053,경기,부천시,7,0,3,10,6,0,2018-06-25
9054,경기,부천시,8,0,2,10,9,0,2018-07-25
9055,경기,부천시,14,0,6,20,7,1,2018-08-25
9056,경기,부천시,21,0,2,23,8,0,2018-09-25
9057,경기,부천시,6,1,0,7,7,0,2018-10-25
9058,경기,부천시,7,0,1,8,6,0,2018-11-25
9059,경기,부천시,14,2,0,16,11,0,2018-12-25
9060,경기,성남시,12,2,3,17,15,0,2018-01-25
9061,경기,성남시,16,3,1,20,8,0,2018-02-25
9062,경기,성남시,10,2,5,17,10,0,2018-03-25
9063,경기,성남시,11,1,2,14,8,0,2018-04-25
9064,경기,성남시,7,0,3,10,9,1,2018-05-25
9065,경기,성남시,12,1,3,16,11,0,2018-06-25
9066,경기,성남시,5,0,3,8,8,0,2018-07-25
9067,경기,성남시,10,2,2,14,10,0,2018-08-25
9068,경기,성남시,5,0,4,9,4,0,2018-09-25
9069,경기,성남시,11,2,2,15,11,0,2018-10-25
9070,경기,성남시,8,2,6,16,9,0,2018-11-25
9071,경기,성남시,1,1,0,2,2,0,2018-12-25
9072,경기,수원시,13,2,6,21,14,0,2018-01-25
9073,경기,수원시,21,1,1,23,15,0,2018-02-25
9074,경기,수원시,7,2,2,11,6,0,2018-03-25
9075,경기,수원시,13,1,3,17,10,0,2018-04-25
9076,경기,수원시,13,4,8,25,19,0,2018-05-25
9077,경기,수원시,17,3,2,22,15,0,2018-06-25
9078,경기,수원시,14,0,8,22,15,0,2018-07-25
9079,경기,수원시,7,0,2,9,8,0,2018-08-25
9080,경기,수원시,12,0,4,16,12,0,2018-09-25
9081,경기,수원시,23,1,6,30,19,0,2018-10-25
9082,경기,수원시,8,0,8,16,12,0,2018-11-25
9083,경기,수원시,11,2,1,14,11,0,2018-12-25
9084,경기,시흥시,5,0,1,6,5,0,2018-01-25
9085,경기,시흥시,1,0,1,2,2,0,2018-02-25
9086,경기,시흥시,7,0,1,8,4,0,2018-03-25
9087,경기,시흥시,6,0,0,6,4,0,2018-04-25
9088,경기,시흥시,10,0,2,12,8,0,2018-05-25
9089,경기,시흥시,12,2,2,16,12,1,2018-06-25
9090,경기,시흥시,9,1,2,12,11,0,2018-07-25
9091,경기,시흥시,4,0,0,4,3,0,2018-08-25
9092,경기,시흥시,12,0,2,14,8,0,2018-09-25
9093,경기,시흥시,9,0,1,10,9,0,2018-10-25
9094,경기,시흥시,3,0,0,3,3,0,2018-11-25
9095,경기,시흥시,2,1,1,4,3,0,2018-12-25
9096,경기,안산시,13,0,4,17,15,0,2018-01-25
9097,경기,안산시,3,0,4,7,5,0,2018-02-25
9098,경기,안산시,8,0,2,10,6,1,2018-03-25
9099,경기,안산시,9,5,5,19,14,0,2018-04-25
9100,경기,안산시,17,0,7,24,17,0,2018-05-25
9101,경기,안산시,7,1,5,13,13,0,2018-06-25
9102,경기,안산시,13,0,2,15,12,0,2018-07-25
9103,경기,안산시,5,0,2,7,6,0,2018-08-25
9104,경기,안산시,12,0,4,16,7,1,2018-09-25
9105,경기,안산시,16,1,2,19,12,0,2018-10-25
9106,경기,안산시,9,1,2,12,7,0,2018-11-25
9107,경기,안산시,13,2,2,17,9,0,2018-12-25
9108,경기,안성시,2,0,0,2,2,0,2018-01-25
9109,경기,안성시,3,0,1,4,2,0,2018-02-25
9110,경기,안성시,5,0,0,5,3,0,2018-03-25
9111,경기,안성시,6,0,0,6,4,0,2018-04-25
9112,경기,안성시,0,1,0,1,1,0,2018-05-25
9113,경기,안성시,7,0,5,12,6,0,2018-06-25
9114,경기,안성시,0,0,1,1,1,0,2018-07-25
9115,경기,안성시,5,1,3,9,3,0,2018-08-25
9116,경기,안성시,0,1,0,1,1,0,2018-09-25
9117,경기,안성시,0,0,1,1,1,0,2018-10-25
9118,경기,안성시,0,0,2,2,2,0,2018-11-25
9119,경기,안성시,2,0,0,2,1,0,2018-12-25
9120,경기,안양시,13,0,0,13,7,0,2018-01-25
9121,경기,안양시,3,1,0,4,4,0,2018-02-25
9122,경기,안양시,7,1,1,9,4,0,2018-03-25
9123,경기,안양시,1,0,1,2,2,0,2018-04-25
9124,경기,안양시,6,0,1,7,4,0,2018-05-25
9125,경기,안양시,10,1,0,11,8,0,2018-06-25
9126,경기,안양시,4,0,0,4,3,0,2018-07-25
9127,경기,안양시,6,2,4,12,9,0,2018-08-25
9128,경기,안양시,0,1,1,2,1,0,2018-09-25
9129,경기,안양시,1,0,2,3,3,0,2018-10-25
9130,경기,안양시,2,0,2,4,2,0,2018-11-25
9131,경기,안양시,5,0,2,7,2,0,2018-12-25
9132,경기,양주시,2,0,2,4,2,0,2018-01-25
9133,경기,양주시,0,1,0,1,1,0,2018-02-25
9134,경기,양주시,4,0,1,5,3,0,2018-03-25
9135,경기,양주시,1,1,0,2,2,0,2018-04-25
9136,경기,양주시,2,0,2,4,4,0,2018-05-25
9137,경기,양주시,6,1,2,9,5,0,2018-06-25
9138,경기,양주시,2,1,2,5,4,0,2018-07-25
9139,경기,양주시,10,0,1,11,6,0,2018-08-25
9140,경기,양주시,5,1,0,6,4,0,2018-09-25
9141,경기,양주시,1,1,0,2,2,0,2018-10-25
9142,경기,양주시,2,1,1,4,4,0,2018-11-25
9143,경기,양주시,0,0,1,1,1,0,2018-12-25
9144,경기,양평군,1,0,0,1,1,0,2018-01-25
9145,경기,양평군,1,0,0,1,1,0,2018-02-25
9146,경기,양평군,0,0,0,0,0,0,2018-03-25
9147,경기,양평군,1,0,0,1,1,0,2018-04-25
9148,경기,양평군,1,0,0,1,1,0,2018-05-25
9149,경기,양평군,0,0,1,1,1,0,2018-06-25
9150,경기,양평군,2,0,0,2,1,0,2018-07-25
9151,경기,양평군,0,0,0,0,0,0,2018-08-25
9152,경기,양평군,4,0,4,8,5,0,2018-09-25
9153,경기,양평군,2,0,0,2,1,0,2018-10-25
9154,경기,양평군,1,0,0,1,1,0,2018-11-25
9155,경기,양평군,2,1,1,4,1,0,2018-12-25
9156,경기,여주시,2,1,1,4,3,0,2018-01-25
9157,경기,여주시,0,0,0,0,0,0,2018-02-25
9158,경기,여주시,1,0,0,1,1,0,2018-03-25
9159,경기,여주시,0,0,0,0,0,0,2018-04-25
9160,경기,여주시,1,0,0,1,1,0,2018-05-25
9161,경기,여주시,3,0,0,3,2,0,2018-06-25
9162,경기,여주시,0,0,0,0,0,0,2018-07-25
9163,경기,여주시,2,3,0,5,1,0,2018-08-25
9164,경기,여주시,2,0,0,2,1,0,2018-09-25
9165,경기,여주시,4,0,2,6,3,0,2018-10-25
9166,경기,여주시,0,0,0,0,0,0,2018-11-25
9167,경기,여주시,5,0,1,6,2,0,2018-12-25
9168,경기,연천군,0,0,0,0,0,0,2018-01-25
9169,경기,연천군,0,0,0,0,0,0,2018-02-25
9170,경기,연천군,0,0,0,0,0,0,2018-03-25
9171,경기,연천군,0,0,0,0,0,0,2018-04-25
9172,경기,연천군,0,0,0,0,0,0,2018-05-25
9173,경기,연천군,0,0,0,0,0,0,2018-06-25
9174,경기,연천군,0,0,0,0,0,0,2018-07-25
9175,경기,연천군,0,0,1,1,1,0,2018-08-25
9176,경기,연천군,3,0,0,3,2,0,2018-09-25
9177,경기,연천군,0,0,0,0,0,0,2018-10-25
9178,경기,연천군,1,0,1,2,1,0,2018-11-25
9179,경기,연천군,1,0,0,1,1,0,2018-12-25
9180,경기,오산시,0,0,1,1,1,0,2018-01-25
9181,경기,오산시,0,0,2,2,1,0,2018-02-25
9182,경기,오산시,1,1,0,2,2,0,2018-03-25
9183,경기,오산시,2,1,0,3,2,0,2018-04-25
9184,경기,오산시,4,0,0,4,4,0,2018-05-25
9185,경기,오산시,4,0,3,7,6,0,2018-06-25
9186,경기,오산시,3,0,1,4,2,0,2018-07-25
9187,경기,오산시,7,1,0,8,4,0,2018-08-25
9188,경기,오산시,6,1,1,8,3,0,2018-09-25
9189,경기,오산시,0,2,0,2,2,0,2018-10-25
9190,경기,오산시,1,1,0,2,2,0,2018-11-25
9191,경기,오산시,2,0,0,2,2,0,2018-12-25
9192,경기,용인시,14,1,3,18,9,0,2018-01-25
9193,경기,용인시,3,1,3,7,5,0,2018-02-25
9194,경기,용인시,2,0,3,5,4,0,2018-03-25
9195,경기,용인시,15,0,3,18,10,0,2018-04-25
9196,경기,용인시,11,1,2,14,8,0,2018-05-25
9197,경기,용인시,11,3,0,14,8,0,2018-06-25
9198,경기,용인시,3,4,4,11,5,0,2018-07-25
9199,경기,용인시,7,3,4,14,7,0,2018-08-25
9200,경기,용인시,5,0,0,5,2,0,2018-09-25
9201,경기,용인시,16,2,3,21,13,0,2018-10-25
9202,경기,용인시,6,1,0,7,5,0,2018-11-25
9203,경기,용인시,5,1,5,11,9,0,2018-12-25
9204,경기,의왕시,3,0,1,4,3,0,2018-01-25
9205,경기,의왕시,4,0,1,5,2,0,2018-02-25
9206,경기,의왕시,0,0,1,1,1,0,2018-03-25
9207,경기,의왕시,1,0,1,2,2,0,2018-04-25
9208,경기,의왕시,1,0,0,1,1,0,2018-05-25
9209,경기,의왕시,2,0,1,3,1,0,2018-06-25
9210,경기,의왕시,2,0,0,2,1,0,2018-07-25
9211,경기,의왕시,0,1,0,1,1,0,2018-08-25
9212,경기,의왕시,7,2,0,9,2,0,2018-09-25
9213,경기,의왕시,4,0,0,4,1,0,2018-10-25
9214,경기,의왕시,0,0,1,1,1,0,2018-11-25
9215,경기,의왕시,0,0,0,0,0,0,2018-12-25
9216,경기,의정부시,14,2,1,17,11,0,2018-01-25
9217,경기,의정부시,0,1,1,2,3,1,2018-02-25
9218,경기,의정부시,3,0,0,3,3,0,2018-03-25
9219,경기,의정부시,2,1,3,6,6,0,2018-04-25
9220,경기,의정부시,3,0,3,6,6,0,2018-05-25
9221,경기,의정부시,5,1,0,6,6,0,2018-06-25
9222,경기,의정부시,1,2,0,3,3,0,2018-07-25
9223,경기,의정부시,3,0,0,3,2,0,2018-08-25
9224,경기,의정부시,5,0,0,5,4,0,2018-09-25
9225,경기,의정부시,7,0,1,8,4,0,2018-10-25
9226,경기,의정부시,3,0,0,3,2,0,2018-11-25
9227,경기,의정부시,3,1,3,7,5,0,2018-12-25
9228,경기,이천시,1,1,3,5,3,1,2018-01-25
9229,경기,이천시,0,0,0,0,0,0,2018-02-25
9230,경기,이천시,0,0,0,0,0,0,2018-03-25
9231,경기,이천시,2,0,0,2,2,0,2018-04-25
9232,경기,이천시,3,1,3,7,4,0,2018-05-25
9233,경기,이천시,3,0,0,3,3,0,2018-06-25
9234,경기,이천시,1,3,0,4,2,0,2018-07-25
9235,경기,이천시,2,0,1,3,1,0,2018-08-25
9236,경기,이천시,2,0,0,2,1,0,2018-09-25
9237,경기,이천시,2,0,2,4,3,0,2018-10-25
9238,경기,이천시,1,2,1,4,4,0,2018-11-25
9239,경기,이천시,3,0,0,3,1,0,2018-12-25
9240,경기,파주시,15,3,0,18,8,0,2018-01-25
9241,경기,파주시,5,0,2,7,7,0,2018-02-25
9242,경기,파주시,3,1,0,4,3,0,2018-03-25
9243,경기,파주시,3,1,0,4,5,1,2018-04-25
9244,경기,파주시,1,1,4,6,5,1,2018-05-25
9245,경기,파주시,6,0,6,12,6,0,2018-06-25
9246,경기,파주시,4,0,1,5,5,0,2018-07-25
9247,경기,파주시,3,0,2,5,4,0,2018-08-25
9248,경기,파주시,1,0,1,2,2,0,2018-09-25
9249,경기,파주시,5,0,2,7,6,0,2018-10-25
9250,경기,파주시,4,0,0,4,4,0,2018-11-25
9251,경기,파주시,7,1,1,9,6,0,2018-12-25
9252,경기,평택시,7,0,2,9,3,0,2018-01-25
9253,경기,평택시,7,0,2,9,4,0,2018-02-25
9254,경기,평택시,9,2,3,14,10,0,2018-03-25
9255,경기,평택시,14,0,5,19,11,0,2018-04-25
9256,경기,평택시,11,1,2,14,10,0,2018-05-25
9257,경기,평택시,13,4,1,18,14,0,2018-06-25
9258,경기,평택시,10,2,1,13,11,0,2018-07-25
9259,경기,평택시,14,0,4,18,9,0,2018-08-25
9260,경기,평택시,4,1,1,6,4,0,2018-09-25
9261,경기,평택시,13,0,1,14,11,0,2018-10-25
9262,경기,평택시,9,3,3,15,7,0,2018-11-25
9263,경기,평택시,10,0,0,10,7,0,2018-12-25
9264,경기,포천시,3,1,1,5,3,0,2018-01-25
9265,경기,포천시,2,0,0,2,2,0,2018-02-25
9266,경기,포천시,0,0,0,0,0,0,2018-03-25
9267,경기,포천시,0,0,0,0,0,0,2018-04-25
9268,경기,포천시,1,0,0,1,1,0,2018-05-25
9269,경기,포천시,6,6,0,12,4,0,2018-06-25
9270,경기,포천시,0,0,0,0,0,0,2018-07-25
9271,경기,포천시,5,0,1,6,4,0,2018-08-25
9272,경기,포천시,4,0,3,7,2,0,2018-09-25
9273,경기,포천시,0,0,1,1,1,0,2018-10-25
9274,경기,포천시,1,0,0,1,1,0,2018-11-25
9275,경기,포천시,0,0,0,0,0,0,2018-12-25
9276,경기,하남시,1,0,0,1,1,0,2018-01-25
9277,경기,하남시,0,0,0,0,0,0,2018-02-25
9278,경기,하남시,4,1,0,5,3,0,2018-03-25
9279,경기,하남시,5,0,0,5,4,1,2018-04-25
9280,경기,하남시,10,3,5,18,12,0,2018-05-25
9281,경기,하남시,1,0,0,1,1,0,2018-06-25
9282,경기,하남시,5,1,0,6,4,0,2018-07-25
9283,경기,하남시,3,0,0,3,2,0,2018-08-25
9284,경기,하남시,5,0,1,6,2,0,2018-09-25
9285,경기,하남시,2,1,0,3,3,0,2018-10-25
9286,경기,하남시,0,0,0,0,0,0,2018-11-25
9287,경기,하남시,1,0,0,1,1,0,2018-12-25
9288,경기,화성시,1,0,2,3,3,0,2018-01-25
9289,경기,화성시,1,0,0,1,1,0,2018-02-25
9290,경기,화성시,8,0,2,10,5,1,2018-03-25
9291,경기,화성시,8,1,3,12,7,0,2018-04-25
9292,경기,화성시,15,0,0,15,12,2,2018-05-25
9293,경기,화성시,7,1,1,9,9,0,2018-06-25
9294,경기,화성시,10,0,6,16,11,0,2018-07-25
9295,경기,화성시,11,5,4,20,9,0,2018-08-25
9296,경기,화성시,6,0,3,9,4,0,2018-09-25
9297,경기,화성시,16,0,1,17,7,0,2018-10-25
9298,경기,화성시,4,2,1,7,6,0,2018-11-25
9299,경기,화성시,5,2,0,7,4,0,2018-12-25
9300,경기,가평군,0,0,0,0,0,0,2018-01-26
9301,경기,가평군,0,0,0,0,0,0,2018-02-26
9302,경기,가평군,8,0,0,8,4,0,2018-03-26
9303,경기,가평군,0,0,0,0,0,0,2018-04-26
9304,경기,가평군,0,1,4,5,3,0,2018-05-26
9305,경기,가평군,1,0,0,1,1,0,2018-06-26
9306,경기,가평군,1,0,0,1,1,0,2018-07-26
9307,경기,가평군,2,0,5,7,2,1,2018-08-26
9308,경기,가평군,2,0,1,3,2,0,2018-09-26
9309,경기,가평군,0,0,0,0,0,0,2018-10-26
9310,경기,가평군,0,1,0,1,1,0,2018-11-26
9311,경기,가평군,1,0,1,2,1,0,2018-12-26
9312,경기,고양시,13,1,3,17,11,0,2018-01-26
9313,경기,고양시,11,0,4,15,13,0,2018-02-26
9314,경기,고양시,11,0,2,13,12,0,2018-03-26
9315,경기,고양시,16,2,3,21,15,0,2018-04-26
9316,경기,고양시,3,0,2,5,3,0,2018-05-26
9317,경기,고양시,15,0,3,18,15,1,2018-06-26
9318,경기,고양시,6,3,5,14,9,0,2018-07-26
9319,경기,고양시,3,1,2,6,5,0,2018-08-26
9320,경기,고양시,15,0,3,18,11,0,2018-09-26
9321,경기,고양시,7,0,7,14,9,1,2018-10-26
9322,경기,고양시,3,1,1,5,5,0,2018-11-26
9323,경기,고양시,10,1,2,13,8,0,2018-12-26
9324,경기,과천시,0,0,0,0,0,0,2018-01-26
9325,경기,과천시,0,0,0,0,0,0,2018-02-26
9326,경기,과천시,0,0,0,0,0,0,2018-03-26
9327,경기,과천시,0,0,0,0,0,0,2018-04-26
9328,경기,과천시,0,0,0,0,0,0,2018-05-26
9329,경기,과천시,1,0,0,1,1,0,2018-06-26
9330,경기,과천시,2,0,1,3,3,0,2018-07-26
9331,경기,과천시,0,0,0,0,0,0,2018-08-26
9332,경기,과천시,0,0,0,0,0,0,2018-09-26
9333,경기,과천시,1,0,0,1,1,0,2018-10-26
9334,경기,과천시,0,1,0,1,1,0,2018-11-26
9335,경기,과천시,0,0,0,0,0,0,2018-12-26
9336,경기,광명시,2,0,0,2,2,0,2018-01-26
9337,경기,광명시,3,3,0,6,5,0,2018-02-26
9338,경기,광명시,3,0,0,3,1,0,2018-03-26
9339,경기,광명시,1,2,2,5,4,0,2018-04-26
9340,경기,광명시,0,0,0,0,0,0,2018-05-26
9341,경기,광명시,1,0,0,1,1,0,2018-06-26
9342,경기,광명시,1,0,1,2,2,0,2018-07-26
9343,경기,광명시,1,1,0,2,2,0,2018-08-26
9344,경기,광명시,0,1,2,3,3,0,2018-09-26
9345,경기,광명시,6,0,0,6,2,0,2018-10-26
9346,경기,광명시,4,1,1,6,5,0,2018-11-26
9347,경기,광명시,4,0,4,8,4,0,2018-12-26
9348,경기,광주시,7,2,2,11,5,0,2018-01-26
9349,경기,광주시,1,0,1,2,2,0,2018-02-26
9350,경기,광주시,6,0,2,8,6,0,2018-03-26
9351,경기,광주시,4,0,1,5,4,0,2018-04-26
9352,경기,광주시,3,0,1,4,3,0,2018-05-26
9353,경기,광주시,7,1,1,9,7,0,2018-06-26
9354,경기,광주시,7,0,2,9,6,0,2018-07-26
9355,경기,광주시,5,0,0,5,3,0,2018-08-26
9356,경기,광주시,3,0,5,8,5,0,2018-09-26
9357,경기,광주시,6,0,1,7,5,0,2018-10-26
9358,경기,광주시,4,0,1,5,4,0,2018-11-26
9359,경기,광주시,10,3,1,14,11,0,2018-12-26
9360,경기,구리시,3,0,0,3,2,0,2018-01-26
9361,경기,구리시,1,0,0,1,1,0,2018-02-26
9362,경기,구리시,3,0,1,4,3,0,2018-03-26
9363,경기,구리시,1,0,0,1,1,0,2018-04-26
9364,경기,구리시,2,0,1,3,2,0,2018-05-26
9365,경기,구리시,3,0,0,3,2,0,2018-06-26
9366,경기,구리시,2,0,0,2,2,0,2018-07-26
9367,경기,구리시,9,0,4,13,5,0,2018-08-26
9368,경기,구리시,6,0,0,6,3,0,2018-09-26
9369,경기,구리시,0,0,0,0,0,0,2018-10-26
9370,경기,구리시,4,0,0,4,3,0,2018-11-26
9371,경기,구리시,2,0,1,3,2,0,2018-12-26
9372,경기,군포시,0,0,0,0,0,0,2018-01-26
9373,경기,군포시,2,0,1,3,3,0,2018-02-26
9374,경기,군포시,1,0,0,1,1,0,2018-03-26
9375,경기,군포시,0,1,1,2,2,0,2018-04-26
9376,경기,군포시,2,0,3,5,5,0,2018-05-26
9377,경기,군포시,0,0,0,0,0,0,2018-06-26
9378,경기,군포시,0,0,2,2,2,0,2018-07-26
9379,경기,군포시,2,2,0,4,2,0,2018-08-26
9380,경기,군포시,1,0,0,1,1,0,2018-09-26
9381,경기,군포시,1,1,0,2,2,0,2018-10-26
9382,경기,군포시,2,0,1,3,3,0,2018-11-26
9383,경기,군포시,1,0,1,2,2,0,2018-12-26
9384,경기,김포시,5,0,3,8,6,0,2018-01-26
9385,경기,김포시,1,0,1,2,2,0,2018-02-26
9386,경기,김포시,0,0,0,0,0,0,2018-03-26
9387,경기,김포시,4,0,5,9,5,0,2018-04-26
9388,경기,김포시,1,1,3,5,4,0,2018-05-26
9389,경기,김포시,7,1,5,13,10,0,2018-06-26
9390,경기,김포시,7,0,3,10,6,1,2018-07-26
9391,경기,김포시,2,0,1,3,3,0,2018-08-26
9392,경기,김포시,2,0,1,3,3,0,2018-09-26
9393,경기,김포시,8,0,2,10,6,0,2018-10-26
9394,경기,김포시,4,2,3,9,6,0,2018-11-26
9395,경기,김포시,10,0,1,11,6,0,2018-12-26
9396,경기,남양주시,12,2,5,19,13,0,2018-01-26
9397,경기,남양주시,13,0,1,14,8,0,2018-02-26
9398,경기,남양주시,2,0,3,5,5,0,2018-03-26
9399,경기,남양주시,5,1,3,9,6,0,2018-04-26
9400,경기,남양주시,18,1,4,23,12,1,2018-05-26
9401,경기,남양주시,10,1,1,12,6,0,2018-06-26
9402,경기,남양주시,7,0,3,10,9,3,2018-07-26
9403,경기,남양주시,12,2,0,14,9,0,2018-08-26
9404,경기,남양주시,5,0,2,7,5,0,2018-09-26
9405,경기,남양주시,6,0,1,7,5,0,2018-10-26
9406,경기,남양주시,6,1,4,11,8,0,2018-11-26
9407,경기,남양주시,8,1,1,10,5,0,2018-12-26
9408,경기,동두천시,0,2,0,2,1,0,2018-01-26
9409,경기,동두천시,0,0,0,0,0,0,2018-02-26
9410,경기,동두천시,3,1,1,5,3,0,2018-03-26
9411,경기,동두천시,2,0,1,3,2,0,2018-04-26
9412,경기,동두천시,0,0,1,1,1,0,2018-05-26
9413,경기,동두천시,0,0,0,0,0,0,2018-06-26
9414,경기,동두천시,1,0,0,1,1,0,2018-07-26
9415,경기,동두천시,0,0,1,1,1,0,2018-08-26
9416,경기,동두천시,5,0,0,5,3,0,2018-09-26
9417,경기,동두천시,0,1,0,1,1,0,2018-10-26
9418,경기,동두천시,4,0,1,5,4,0,2018-11-26
9419,경기,동두천시,0,0,0,0,0,0,2018-12-26
9420,경기,부천시,10,3,0,13,10,0,2018-01-26
9421,경기,부천시,3,0,2,5,4,0,2018-02-26
9422,경기,부천시,15,0,1,16,7,0,2018-03-26
9423,경기,부천시,10,0,2,12,7,0,2018-04-26
9424,경기,부천시,7,3,3,13,11,0,2018-05-26
9425,경기,부천시,12,1,2,15,12,0,2018-06-26
9426,경기,부천시,12,0,3,15,10,0,2018-07-26
9427,경기,부천시,12,3,3,18,12,0,2018-08-26
9428,경기,부천시,20,1,6,27,13,0,2018-09-26
9429,경기,부천시,6,0,1,7,5,0,2018-10-26
9430,경기,부천시,5,0,1,6,4,0,2018-11-26
9431,경기,부천시,3,1,7,11,10,0,2018-12-26
9432,경기,성남시,16,1,4,21,14,0,2018-01-26
9433,경기,성남시,14,1,1,16,10,0,2018-02-26
9434,경기,성남시,4,0,2,6,5,0,2018-03-26
9435,경기,성남시,15,1,2,18,15,0,2018-04-26
9436,경기,성남시,4,0,6,10,8,0,2018-05-26
9437,경기,성남시,22,1,8,31,22,0,2018-06-26
9438,경기,성남시,9,1,3,13,9,0,2018-07-26
9439,경기,성남시,16,1,1,18,11,0,2018-08-26
9440,경기,성남시,2,1,1,4,3,0,2018-09-26
9441,경기,성남시,17,2,6,25,16,0,2018-10-26
9442,경기,성남시,7,1,3,11,8,0,2018-11-26
9443,경기,성남시,8,0,6,14,12,0,2018-12-26
9444,경기,수원시,12,2,3,17,15,0,2018-01-26
9445,경기,수원시,20,0,1,21,18,0,2018-02-26
9446,경기,수원시,14,0,5,19,14,0,2018-03-26
9447,경기,수원시,13,4,2,19,13,0,2018-04-26
9448,경기,수원시,24,3,7,34,22,0,2018-05-26
9449,경기,수원시,20,0,3,23,16,0,2018-06-26
9450,경기,수원시,7,0,4,11,10,1,2018-07-26
9451,경기,수원시,13,0,7,20,14,0,2018-08-26
9452,경기,수원시,14,5,2,21,12,0,2018-09-26
9453,경기,수원시,17,2,2,21,14,0,2018-10-26
9454,경기,수원시,8,1,1,10,8,0,2018-11-26
9455,경기,수원시,13,2,3,18,12,0,2018-12-26
9456,경기,시흥시,8,1,4,13,8,0,2018-01-26
9457,경기,시흥시,5,0,5,10,5,0,2018-02-26
9458,경기,시흥시,6,0,3,9,6,0,2018-03-26
9459,경기,시흥시,2,0,2,4,3,0,2018-04-26
9460,경기,시흥시,9,1,2,12,8,0,2018-05-26
9461,경기,시흥시,8,0,2,10,9,0,2018-06-26
9462,경기,시흥시,8,0,4,12,10,0,2018-07-26
9463,경기,시흥시,11,0,6,17,8,0,2018-08-26
9464,경기,시흥시,3,0,1,4,3,0,2018-09-26
9465,경기,시흥시,16,3,5,24,14,0,2018-10-26
9466,경기,시흥시,7,0,3,10,7,0,2018-11-26
9467,경기,시흥시,8,0,1,9,8,0,2018-12-26
9468,경기,안산시,4,2,2,8,6,0,2018-01-26
9469,경기,안산시,6,0,1,7,4,0,2018-02-26
9470,경기,안산시,11,3,3,17,14,0,2018-03-26
9471,경기,안산시,8,1,2,11,8,0,2018-04-26
9472,경기,안산시,3,2,4,9,7,0,2018-05-26
9473,경기,안산시,15,0,1,16,8,0,2018-06-26
9474,경기,안산시,9,3,4,16,13,0,2018-07-26
9475,경기,안산시,7,0,4,11,9,0,2018-08-26
9476,경기,안산시,9,0,1,10,8,0,2018-09-26
9477,경기,안산시,12,0,3,15,9,0,2018-10-26
9478,경기,안산시,25,3,6,34,18,0,2018-11-26
9479,경기,안산시,11,0,3,14,8,0,2018-12-26
9480,경기,안성시,2,0,0,2,2,0,2018-01-26
9481,경기,안성시,1,1,2,4,4,0,2018-02-26
9482,경기,안성시,3,0,1,4,3,0,2018-03-26
9483,경기,안성시,2,0,1,3,3,0,2018-04-26
9484,경기,안성시,5,2,0,7,2,0,2018-05-26
9485,경기,안성시,1,0,3,4,3,5,2018-06-26
9486,경기,안성시,0,0,0,0,0,0,2018-07-26
9487,경기,안성시,2,0,0,2,1,0,2018-08-26
9488,경기,안성시,0,0,0,0,0,0,2018-09-26
9489,경기,안성시,9,0,0,9,5,0,2018-10-26
9490,경기,안성시,2,0,1,3,3,0,2018-11-26
9491,경기,안성시,4,1,1,6,4,0,2018-12-26
9492,경기,안양시,8,3,0,11,6,0,2018-01-26
9493,경기,안양시,8,0,1,9,6,0,2018-02-26
9494,경기,안양시,2,0,1,3,2,0,2018-03-26
9495,경기,안양시,6,0,2,8,6,0,2018-04-26
9496,경기,안양시,2,0,1,3,3,0,2018-05-26
9497,경기,안양시,6,0,0,6,3,0,2018-06-26
9498,경기,안양시,5,0,1,6,3,0,2018-07-26
9499,경기,안양시,6,0,2,8,3,0,2018-08-26
9500,경기,안양시,2,1,0,3,2,0,2018-09-26
9501,경기,안양시,14,1,1,16,7,0,2018-10-26
9502,경기,안양시,5,0,2,7,6,0,2018-11-26
9503,경기,안양시,3,0,0,3,3,1,2018-12-26
9504,경기,양주시,2,0,0,2,2,0,2018-01-26
9505,경기,양주시,8,0,0,8,7,0,2018-02-26
9506,경기,양주시,2,0,2,4,3,0,2018-03-26
9507,경기,양주시,1,0,2,3,3,0,2018-04-26
9508,경기,양주시,7,1,5,13,4,0,2018-05-26
9509,경기,양주시,8,0,1,9,6,0,2018-06-26
9510,경기,양주시,0,0,1,1,1,0,2018-07-26
9511,경기,양주시,0,0,0,0,0,0,2018-08-26
9512,경기,양주시,2,1,0,3,1,0,2018-09-26
9513,경기,양주시,6,1,0,7,5,0,2018-10-26
9514,경기,양주시,3,0,2,5,4,0,2018-11-26
9515,경기,양주시,3,0,0,3,3,0,2018-12-26
9516,경기,양평군,0,0,0,0,2,2,2018-01-26
9517,경기,양평군,1,0,0,1,1,0,2018-02-26
9518,경기,양평군,2,0,0,2,2,0,2018-03-26
9519,경기,양평군,1,0,0,1,1,0,2018-04-26
9520,경기,양평군,0,0,3,3,3,0,2018-05-26
9521,경기,양평군,1,0,3,4,2,0,2018-06-26
9522,경기,양평군,3,1,0,4,2,0,2018-07-26
9523,경기,양평군,3,1,2,6,3,0,2018-08-26
9524,경기,양평군,2,0,0,2,2,0,2018-09-26
9525,경기,양평군,0,0,0,0,0,0,2018-10-26
9526,경기,양평군,0,0,2,2,2,0,2018-11-26
9527,경기,양평군,0,0,0,0,0,0,2018-12-26
9528,경기,여주시,0,0,0,0,0,0,2018-01-26
9529,경기,여주시,0,0,0,0,0,0,2018-02-26
9530,경기,여주시,0,0,1,1,1,0,2018-03-26
9531,경기,여주시,2,0,1,3,2,0,2018-04-26
9532,경기,여주시,1,0,0,1,1,0,2018-05-26
9533,경기,여주시,4,0,0,4,1,0,2018-06-26
9534,경기,여주시,0,0,1,1,1,0,2018-07-26
9535,경기,여주시,1,0,0,1,1,0,2018-08-26
9536,경기,여주시,1,0,5,6,3,0,2018-09-26
9537,경기,여주시,1,1,2,4,3,0,2018-10-26
9538,경기,여주시,0,0,0,0,0,0,2018-11-26
9539,경기,여주시,4,0,1,5,4,0,2018-12-26
9540,경기,연천군,0,0,0,0,0,0,2018-01-26
9541,경기,연천군,0,0,0,0,0,0,2018-02-26
9542,경기,연천군,0,0,1,1,1,0,2018-03-26
9543,경기,연천군,0,0,0,0,0,0,2018-04-26
9544,경기,연천군,0,0,0,0,0,0,2018-05-26
9545,경기,연천군,0,0,0,0,0,0,2018-06-26
9546,경기,연천군,0,0,0,0,0,0,2018-07-26
9547,경기,연천군,0,0,0,0,0,0,2018-08-26
9548,경기,연천군,4,0,0,4,2,0,2018-09-26
9549,경기,연천군,2,0,1,3,3,0,2018-10-26
9550,경기,연천군,0,0,0,0,0,0,2018-11-26
9551,경기,연천군,0,1,0,1,1,0,2018-12-26
9552,경기,오산시,0,0,1,1,1,0,2018-01-26
9553,경기,오산시,0,0,0,0,0,0,2018-02-26
9554,경기,오산시,0,0,2,2,2,0,2018-03-26
9555,경기,오산시,0,0,2,2,2,0,2018-04-26
9556,경기,오산시,2,0,0,2,2,0,2018-05-26
9557,경기,오산시,2,0,1,3,3,0,2018-06-26
9558,경기,오산시,1,0,0,1,1,0,2018-07-26
9559,경기,오산시,0,0,1,1,1,0,2018-08-26
9560,경기,오산시,0,0,2,2,2,0,2018-09-26
9561,경기,오산시,4,0,0,4,3,0,2018-10-26
9562,경기,오산시,4,0,1,5,4,0,2018-11-26
9563,경기,오산시,1,0,1,2,1,0,2018-12-26
9564,경기,용인시,14,1,2,17,10,0,2018-01-26
9565,경기,용인시,5,0,0,5,3,0,2018-02-26
9566,경기,용인시,4,0,1,5,6,1,2018-03-26
9567,경기,용인시,7,4,2,13,10,0,2018-04-26
9568,경기,용인시,8,7,1,16,8,0,2018-05-26
9569,경기,용인시,11,4,4,19,15,0,2018-06-26
9570,경기,용인시,15,2,2,19,10,0,2018-07-26
9571,경기,용인시,15,1,2,18,11,0,2018-08-26
9572,경기,용인시,6,1,1,8,3,0,2018-09-26
9573,경기,용인시,12,3,5,20,15,0,2018-10-26
9574,경기,용인시,5,2,2,9,9,0,2018-11-26
9575,경기,용인시,16,3,1,20,12,0,2018-12-26
9576,경기,의왕시,1,0,0,1,2,1,2018-01-26
9577,경기,의왕시,1,0,0,1,1,0,2018-02-26
9578,경기,의왕시,0,0,0,0,0,0,2018-03-26
9579,경기,의왕시,1,0,1,2,2,0,2018-04-26
9580,경기,의왕시,2,0,0,2,2,0,2018-05-26
9581,경기,의왕시,1,0,0,1,1,0,2018-06-26
9582,경기,의왕시,0,0,0,0,0,0,2018-07-26
9583,경기,의왕시,0,0,0,0,0,0,2018-08-26
9584,경기,의왕시,0,0,0,0,0,0,2018-09-26
9585,경기,의왕시,0,0,0,0,0,0,2018-10-26
9586,경기,의왕시,0,0,0,0,0,0,2018-11-26
9587,경기,의왕시,1,0,0,1,1,0,2018-12-26
9588,경기,의정부시,10,2,0,12,9,0,2018-01-26
9589,경기,의정부시,3,0,2,5,4,0,2018-02-26
9590,경기,의정부시,1,0,1,2,2,0,2018-03-26
9591,경기,의정부시,3,1,1,5,4,0,2018-04-26
9592,경기,의정부시,6,0,1,7,4,0,2018-05-26
9593,경기,의정부시,2,0,0,2,2,0,2018-06-26
9594,경기,의정부시,12,0,2,14,5,0,2018-07-26
9595,경기,의정부시,7,3,1,11,7,0,2018-08-26
9596,경기,의정부시,16,4,2,22,6,0,2018-09-26
9597,경기,의정부시,2,0,1,3,1,0,2018-10-26
9598,경기,의정부시,12,0,4,16,12,0,2018-11-26
9599,경기,의정부시,7,0,3,10,10,0,2018-12-26
9600,경기,이천시,6,0,2,8,7,0,2018-01-26
9601,경기,이천시,1,0,1,2,2,0,2018-02-26
9602,경기,이천시,3,0,1,4,4,0,2018-03-26
9603,경기,이천시,5,0,0,5,3,0,2018-04-26
9604,경기,이천시,0,0,1,1,1,0,2018-05-26
9605,경기,이천시,4,1,2,7,6,0,2018-06-26
9606,경기,이천시,4,0,2,6,4,0,2018-07-26
9607,경기,이천시,4,0,0,4,3,0,2018-08-26
9608,경기,이천시,6,2,2,10,4,0,2018-09-26
9609,경기,이천시,0,0,0,0,0,0,2018-10-26
9610,경기,이천시,0,0,1,1,2,1,2018-11-26
9611,경기,이천시,0,0,2,2,1,0,2018-12-26
9612,경기,파주시,4,0,3,7,6,0,2018-01-26
9613,경기,파주시,1,1,1,3,3,0,2018-02-26
9614,경기,파주시,4,0,2,6,5,0,2018-03-26
9615,경기,파주시,2,0,0,2,2,0,2018-04-26
9616,경기,파주시,2,0,0,2,2,0,2018-05-26
9617,경기,파주시,8,2,4,14,5,0,2018-06-26
9618,경기,파주시,3,0,0,3,1,0,2018-07-26
9619,경기,파주시,8,1,1,10,5,0,2018-08-26
9620,경기,파주시,9,2,1,12,5,0,2018-09-26
9621,경기,파주시,0,0,3,3,3,0,2018-10-26
9622,경기,파주시,2,0,2,4,3,0,2018-11-26
9623,경기,파주시,1,0,2,3,3,0,2018-12-26
9624,경기,평택시,6,8,5,19,9,1,2018-01-26
9625,경기,평택시,10,2,4,16,9,0,2018-02-26
9626,경기,평택시,5,3,2,10,8,1,2018-03-26
9627,경기,평택시,7,3,3,13,8,0,2018-04-26
9628,경기,평택시,13,1,2,16,7,0,2018-05-26
9629,경기,평택시,11,1,7,19,12,0,2018-06-26
9630,경기,평택시,5,1,5,11,7,0,2018-07-26
9631,경기,평택시,9,0,2,11,9,1,2018-08-26
9632,경기,평택시,10,1,0,11,5,0,2018-09-26
9633,경기,평택시,15,4,2,21,12,0,2018-10-26
9634,경기,평택시,9,4,3,16,14,1,2018-11-26
9635,경기,평택시,12,2,2,16,9,0,2018-12-26
9636,경기,포천시,3,0,0,3,1,0,2018-01-26
9637,경기,포천시,2,5,0,7,3,1,2018-02-26
9638,경기,포천시,3,0,0,3,3,0,2018-03-26
9639,경기,포천시,1,2,0,3,3,1,2018-04-26
9640,경기,포천시,4,0,0,4,2,0,2018-05-26
9641,경기,포천시,1,1,0,2,2,0,2018-06-26
9642,경기,포천시,0,0,1,1,1,0,2018-07-26
9643,경기,포천시,6,1,1,8,5,0,2018-08-26
9644,경기,포천시,0,0,0,0,0,0,2018-09-26
9645,경기,포천시,3,0,1,4,3,0,2018-10-26
9646,경기,포천시,3,0,2,5,3,0,2018-11-26
9647,경기,포천시,4,0,1,5,4,0,2018-12-26
9648,경기,하남시,1,0,1,2,2,0,2018-01-26
9649,경기,하남시,3,0,2,5,2,0,2018-02-26
9650,경기,하남시,0,1,1,2,1,0,2018-03-26
9651,경기,하남시,8,1,0,9,3,0,2018-04-26
9652,경기,하남시,0,0,2,2,3,1,2018-05-26
9653,경기,하남시,5,1,0,6,6,0,2018-06-26
9654,경기,하남시,2,0,0,2,2,0,2018-07-26
9655,경기,하남시,0,0,0,0,0,0,2018-08-26
9656,경기,하남시,0,0,0,0,0,0,2018-09-26
9657,경기,하남시,1,0,0,1,1,0,2018-10-26
9658,경기,하남시,3,0,0,3,3,0,2018-11-26
9659,경기,하남시,0,0,0,0,0,0,2018-12-26
9660,경기,화성시,9,0,2,11,9,0,2018-01-26
9661,경기,화성시,7,4,1,12,10,0,2018-02-26
9662,경기,화성시,18,0,7,25,13,1,2018-03-26
9663,경기,화성시,3,2,0,5,4,0,2018-04-26
9664,경기,화성시,8,0,4,12,9,0,2018-05-26
9665,경기,화성시,3,0,1,4,3,0,2018-06-26
9666,경기,화성시,3,0,2,5,4,0,2018-07-26
9667,경기,화성시,4,0,0,4,3,0,2018-08-26
9668,경기,화성시,7,1,8,16,10,1,2018-09-26
9669,경기,화성시,21,1,1,23,10,0,2018-10-26
9670,경기,화성시,17,0,4,21,15,0,2018-11-26
9671,경기,화성시,11,0,2,13,10,0,2018-12-26
9672,경기,가평군,4,0,0,4,1,0,2018-01-27
9673,경기,가평군,1,0,0,1,1,0,2018-02-27
9674,경기,가평군,0,0,0,0,0,0,2018-03-27
9675,경기,가평군,0,0,0,0,0,0,2018-04-27
9676,경기,가평군,0,0,1,1,1,0,2018-05-27
9677,경기,가평군,0,0,0,0,0,0,2018-06-27
9678,경기,가평군,0,0,0,0,0,0,2018-07-27
9679,경기,가평군,3,2,0,5,2,0,2018-08-27
9680,경기,가평군,2,0,0,2,1,0,2018-09-27
9681,경기,가평군,0,0,0,0,0,0,2018-10-27
9682,경기,가평군,0,0,0,0,0,0,2018-11-27
9683,경기,가평군,0,0,1,1,1,0,2018-12-27
9684,경기,고양시,16,1,5,22,16,0,2018-01-27
9685,경기,고양시,10,0,3,13,10,0,2018-02-27
9686,경기,고양시,5,0,2,7,4,0,2018-03-27
9687,경기,고양시,13,0,2,15,9,0,2018-04-27
9688,경기,고양시,1,0,2,3,3,0,2018-05-27
9689,경기,고양시,8,0,1,9,8,0,2018-06-27
9690,경기,고양시,14,0,2,16,12,0,2018-07-27
9691,경기,고양시,9,1,3,13,9,0,2018-08-27
9692,경기,고양시,7,1,1,9,8,0,2018-09-27
9693,경기,고양시,12,0,5,17,12,0,2018-10-27
9694,경기,고양시,6,1,2,9,8,0,2018-11-27
9695,경기,고양시,11,1,3,15,12,0,2018-12-27
9696,경기,과천시,0,0,0,0,0,0,2018-01-27
9697,경기,과천시,0,0,0,0,0,0,2018-02-27
9698,경기,과천시,1,0,0,1,1,0,2018-03-27
9699,경기,과천시,0,0,0,0,0,0,2018-04-27
9700,경기,과천시,0,0,0,0,0,0,2018-05-27
9701,경기,과천시,0,1,0,1,1,0,2018-06-27
9702,경기,과천시,0,0,0,0,0,0,2018-07-27
9703,경기,과천시,2,0,0,2,2,0,2018-08-27
9704,경기,과천시,0,1,0,1,1,0,2018-09-27
9705,경기,과천시,1,0,0,1,1,0,2018-10-27
9706,경기,과천시,0,0,0,0,0,0,2018-11-27
9707,경기,과천시,11,0,1,12,2,0,2018-12-27
9708,경기,광명시,0,0,0,0,0,0,2018-01-27
9709,경기,광명시,1,0,0,1,1,0,2018-02-27
9710,경기,광명시,0,0,0,0,0,0,2018-03-27
9711,경기,광명시,5,1,0,6,5,0,2018-04-27
9712,경기,광명시,4,0,0,4,2,0,2018-05-27
9713,경기,광명시,0,0,0,0,0,0,2018-06-27
9714,경기,광명시,2,0,1,3,3,0,2018-07-27
9715,경기,광명시,1,1,0,2,1,0,2018-08-27
9716,경기,광명시,5,0,1,6,5,0,2018-09-27
9717,경기,광명시,5,1,2,8,4,0,2018-10-27
9718,경기,광명시,5,1,2,8,4,0,2018-11-27
9719,경기,광명시,1,0,1,2,2,0,2018-12-27
9720,경기,광주시,10,0,1,11,6,0,2018-01-27
9721,경기,광주시,7,1,3,11,6,0,2018-02-27
9722,경기,광주시,6,0,0,6,4,0,2018-03-27
9723,경기,광주시,6,37,0,43,5,0,2018-04-27
9724,경기,광주시,1,0,0,1,1,0,2018-05-27
9725,경기,광주시,7,0,1,8,8,0,2018-06-27
9726,경기,광주시,9,3,3,15,7,0,2018-07-27
9727,경기,광주시,4,0,0,4,4,0,2018-08-27
9728,경기,광주시,6,0,0,6,4,0,2018-09-27
9729,경기,광주시,5,1,1,7,5,0,2018-10-27
9730,경기,광주시,2,0,2,4,3,0,2018-11-27
9731,경기,광주시,7,0,2,9,5,0,2018-12-27
9732,경기,구리시,0,0,0,0,0,0,2018-01-27
9733,경기,구리시,3,0,1,4,2,0,2018-02-27
9734,경기,구리시,3,0,1,4,3,0,2018-03-27
9735,경기,구리시,1,0,0,1,1,0,2018-04-27
9736,경기,구리시,6,0,1,7,3,0,2018-05-27
9737,경기,구리시,0,0,0,0,0,0,2018-06-27
9738,경기,구리시,4,0,1,5,4,0,2018-07-27
9739,경기,구리시,3,0,2,5,4,2,2018-08-27
9740,경기,구리시,0,0,0,0,0,0,2018-09-27
9741,경기,구리시,1,0,0,1,1,0,2018-10-27
9742,경기,구리시,0,0,0,0,0,0,2018-11-27
9743,경기,구리시,1,0,0,1,1,0,2018-12-27
9744,경기,군포시,1,0,2,3,3,0,2018-01-27
9745,경기,군포시,5,0,1,6,3,0,2018-02-27
9746,경기,군포시,1,0,0,1,1,0,2018-03-27
9747,경기,군포시,5,0,1,6,5,0,2018-04-27
9748,경기,군포시,2,1,1,4,3,0,2018-05-27
9749,경기,군포시,2,0,2,4,3,0,2018-06-27
9750,경기,군포시,2,0,0,2,2,0,2018-07-27
9751,경기,군포시,1,0,0,1,1,0,2018-08-27
9752,경기,군포시,1,0,5,6,4,0,2018-09-27
9753,경기,군포시,1,0,2,3,2,0,2018-10-27
9754,경기,군포시,0,0,2,2,2,0,2018-11-27
9755,경기,군포시,0,0,1,1,1,0,2018-12-27
9756,경기,김포시,10,0,1,11,5,0,2018-01-27
9757,경기,김포시,5,0,3,8,6,0,2018-02-27
9758,경기,김포시,1,0,0,1,1,0,2018-03-27
9759,경기,김포시,0,0,1,1,1,0,2018-04-27
9760,경기,김포시,2,0,4,6,6,0,2018-05-27
9761,경기,김포시,9,1,3,13,5,0,2018-06-27
9762,경기,김포시,6,0,2,8,5,0,2018-07-27
9763,경기,김포시,2,0,1,3,2,0,2018-08-27
9764,경기,김포시,3,0,1,4,3,0,2018-09-27
9765,경기,김포시,5,2,4,11,5,0,2018-10-27
9766,경기,김포시,3,0,1,4,2,0,2018-11-27
9767,경기,김포시,5,0,1,6,4,1,2018-12-27
9768,경기,남양주시,18,3,1,22,11,0,2018-01-27
9769,경기,남양주시,8,0,2,10,7,0,2018-02-27
9770,경기,남양주시,9,0,3,12,9,1,2018-03-27
9771,경기,남양주시,2,0,1,3,3,0,2018-04-27
9772,경기,남양주시,4,0,2,6,5,0,2018-05-27
9773,경기,남양주시,2,0,2,4,3,0,2018-06-27
9774,경기,남양주시,3,1,1,5,3,0,2018-07-27
9775,경기,남양주시,9,0,3,12,7,0,2018-08-27
9776,경기,남양주시,3,1,3,7,5,0,2018-09-27
9777,경기,남양주시,6,0,3,9,3,0,2018-10-27
9778,경기,남양주시,11,1,3,15,11,0,2018-11-27
9779,경기,남양주시,5,0,0,5,3,0,2018-12-27
9780,경기,동두천시,0,0,0,0,0,0,2018-01-27
9781,경기,동두천시,0,0,0,0,0,0,2018-02-27
9782,경기,동두천시,0,0,0,0,0,0,2018-03-27
9783,경기,동두천시,0,0,2,2,1,0,2018-04-27
9784,경기,동두천시,0,0,0,0,0,0,2018-05-27
9785,경기,동두천시,1,1,0,2,2,0,2018-06-27
9786,경기,동두천시,1,0,0,1,1,0,2018-07-27
9787,경기,동두천시,0,0,0,0,0,0,2018-08-27
9788,경기,동두천시,0,0,3,3,2,0,2018-09-27
9789,경기,동두천시,0,0,0,0,0,0,2018-10-27
9790,경기,동두천시,0,0,0,0,0,0,2018-11-27
9791,경기,동두천시,0,0,0,0,0,0,2018-12-27
9792,경기,부천시,2,0,0,2,2,0,2018-01-27
9793,경기,부천시,6,0,2,8,6,0,2018-02-27
9794,경기,부천시,4,1,1,6,4,0,2018-03-27
9795,경기,부천시,7,0,2,9,9,0,2018-04-27
9796,경기,부천시,14,0,2,16,9,0,2018-05-27
9797,경기,부천시,8,0,0,8,6,0,2018-06-27
9798,경기,부천시,10,1,3,14,8,0,2018-07-27
9799,경기,부천시,11,2,5,18,13,0,2018-08-27
9800,경기,부천시,5,0,5,10,8,0,2018-09-27
9801,경기,부천시,7,0,2,9,8,0,2018-10-27
9802,경기,부천시,9,1,2,12,10,0,2018-11-27
9803,경기,부천시,9,1,1,11,10,0,2018-12-27
9804,경기,성남시,17,0,3,20,12,0,2018-01-27
9805,경기,성남시,16,1,5,22,11,1,2018-02-27
9806,경기,성남시,8,0,1,9,7,0,2018-03-27
9807,경기,성남시,11,4,1,16,12,1,2018-04-27
9808,경기,성남시,6,0,1,7,5,0,2018-05-27
9809,경기,성남시,10,0,3,13,6,0,2018-06-27
9810,경기,성남시,10,2,5,17,13,0,2018-07-27
9811,경기,성남시,16,0,1,17,13,1,2018-08-27
9812,경기,성남시,7,1,3,11,10,0,2018-09-27
9813,경기,성남시,9,2,4,15,9,0,2018-10-27
9814,경기,성남시,13,0,5,18,9,1,2018-11-27
9815,경기,성남시,13,0,4,17,13,1,2018-12-27
9816,경기,수원시,16,2,3,21,14,0,2018-01-27
9817,경기,수원시,12,2,8,22,13,0,2018-02-27
9818,경기,수원시,9,0,5,14,9,0,2018-03-27
9819,경기,수원시,23,1,1,25,17,0,2018-04-27
9820,경기,수원시,15,0,1,16,11,0,2018-05-27
9821,경기,수원시,20,4,2,26,18,0,2018-06-27
9822,경기,수원시,10,2,0,12,8,0,2018-07-27
9823,경기,수원시,13,0,4,17,13,0,2018-08-27
9824,경기,수원시,13,2,1,16,13,0,2018-09-27
9825,경기,수원시,16,1,5,22,16,0,2018-10-27
9826,경기,수원시,20,0,5,25,20,0,2018-11-27
9827,경기,수원시,10,0,2,12,10,0,2018-12-27
9828,경기,시흥시,7,2,1,10,3,0,2018-01-27
9829,경기,시흥시,9,1,3,13,9,0,2018-02-27
9830,경기,시흥시,1,2,3,6,4,0,2018-03-27
9831,경기,시흥시,7,0,3,10,6,0,2018-04-27
9832,경기,시흥시,9,5,2,16,4,1,2018-05-27
9833,경기,시흥시,5,0,4,9,6,0,2018-06-27
9834,경기,시흥시,6,0,2,8,6,0,2018-07-27
9835,경기,시흥시,7,0,5,12,10,0,2018-08-27
9836,경기,시흥시,3,0,2,5,5,0,2018-09-27
9837,경기,시흥시,8,0,1,9,6,0,2018-10-27
9838,경기,시흥시,11,0,2,13,9,0,2018-11-27
9839,경기,시흥시,8,0,3,11,6,0,2018-12-27
9840,경기,안산시,19,5,3,27,7,0,2018-01-27
9841,경기,안산시,6,1,1,8,6,1,2018-02-27
9842,경기,안산시,7,1,0,8,6,0,2018-03-27
9843,경기,안산시,13,0,1,14,7,0,2018-04-27
9844,경기,안산시,19,0,7,26,11,0,2018-05-27
9845,경기,안산시,8,1,1,10,9,0,2018-06-27
9846,경기,안산시,17,1,5,23,11,0,2018-07-27
9847,경기,안산시,11,0,3,14,13,0,2018-08-27
9848,경기,안산시,15,4,7,26,18,0,2018-09-27
9849,경기,안산시,8,4,3,15,11,0,2018-10-27
9850,경기,안산시,10,2,1,13,8,0,2018-11-27
9851,경기,안산시,11,1,3,15,7,1,2018-12-27
9852,경기,안성시,2,0,1,3,3,0,2018-01-27
9853,경기,안성시,2,0,0,2,2,0,2018-02-27
9854,경기,안성시,1,0,0,1,1,0,2018-03-27
9855,경기,안성시,1,0,1,2,2,0,2018-04-27
9856,경기,안성시,2,0,0,2,1,0,2018-05-27
9857,경기,안성시,7,0,2,9,4,0,2018-06-27
9858,경기,안성시,14,0,0,14,4,0,2018-07-27
9859,경기,안성시,1,0,3,4,3,0,2018-08-27
9860,경기,안성시,3,0,1,4,4,0,2018-09-27
9861,경기,안성시,0,0,1,1,1,0,2018-10-27
9862,경기,안성시,6,1,2,9,5,0,2018-11-27
9863,경기,안성시,4,0,3,7,5,0,2018-12-27
9864,경기,안양시,4,0,0,4,4,0,2018-01-27
9865,경기,안양시,3,1,1,5,4,0,2018-02-27
9866,경기,안양시,9,0,1,10,5,0,2018-03-27
9867,경기,안양시,1,0,0,1,1,0,2018-04-27
9868,경기,안양시,2,0,1,3,3,0,2018-05-27
9869,경기,안양시,6,0,1,7,4,0,2018-06-27
9870,경기,안양시,8,0,4,12,9,0,2018-07-27
9871,경기,안양시,2,0,0,2,2,0,2018-08-27
9872,경기,안양시,9,0,1,10,8,0,2018-09-27
9873,경기,안양시,4,0,1,5,5,0,2018-10-27
9874,경기,안양시,2,0,0,2,2,0,2018-11-27
9875,경기,안양시,1,0,0,1,1,0,2018-12-27
9876,경기,양주시,7,0,1,8,4,0,2018-01-27
9877,경기,양주시,2,0,0,2,1,0,2018-02-27
9878,경기,양주시,3,0,2,5,3,0,2018-03-27
9879,경기,양주시,2,0,1,3,2,0,2018-04-27
9880,경기,양주시,0,0,1,1,1,0,2018-05-27
9881,경기,양주시,7,2,0,9,5,0,2018-06-27
9882,경기,양주시,9,0,1,10,9,0,2018-07-27
9883,경기,양주시,2,0,1,3,2,0,2018-08-27
9884,경기,양주시,1,0,0,1,2,1,2018-09-27
9885,경기,양주시,8,1,2,11,7,0,2018-10-27
9886,경기,양주시,0,0,1,1,1,0,2018-11-27
9887,경기,양주시,1,0,0,1,1,0,2018-12-27
9888,경기,양평군,0,0,0,0,0,0,2018-01-27
9889,경기,양평군,1,0,0,1,1,0,2018-02-27
9890,경기,양평군,1,1,0,2,2,0,2018-03-27
9891,경기,양평군,0,0,2,2,2,0,2018-04-27
9892,경기,양평군,0,0,1,1,1,0,2018-05-27
9893,경기,양평군,2,0,0,2,3,1,2018-06-27
9894,경기,양평군,5,0,0,5,3,0,2018-07-27
9895,경기,양평군,4,0,0,4,2,0,2018-08-27
9896,경기,양평군,2,0,2,4,2,0,2018-09-27
9897,경기,양평군,4,1,2,7,2,0,2018-10-27
9898,경기,양평군,2,0,0,2,2,0,2018-11-27
9899,경기,양평군,1,0,1,2,2,0,2018-12-27
9900,경기,여주시,1,0,2,3,2,0,2018-01-27
9901,경기,여주시,0,0,0,0,0,0,2018-02-27
9902,경기,여주시,4,0,0,4,4,1,2018-03-27
9903,경기,여주시,1,0,0,1,1,0,2018-04-27
9904,경기,여주시,1,0,1,2,2,0,2018-05-27
9905,경기,여주시,0,1,0,1,1,0,2018-06-27
9906,경기,여주시,2,0,0,2,2,0,2018-07-27
9907,경기,여주시,0,0,0,0,0,0,2018-08-27
9908,경기,여주시,3,0,1,4,3,0,2018-09-27
9909,경기,여주시,0,0,0,0,0,0,2018-10-27
9910,경기,여주시,0,0,0,0,0,0,2018-11-27
9911,경기,여주시,0,0,1,1,2,1,2018-12-27
9912,경기,연천군,0,0,0,0,0,0,2018-01-27
9913,경기,연천군,0,0,0,0,0,0,2018-02-27
9914,경기,연천군,0,0,0,0,0,0,2018-03-27
9915,경기,연천군,2,1,0,3,1,0,2018-04-27
9916,경기,연천군,0,0,0,0,0,0,2018-05-27
9917,경기,연천군,0,3,0,3,1,0,2018-06-27
9918,경기,연천군,0,0,0,0,0,0,2018-07-27
9919,경기,연천군,0,0,1,1,1,0,2018-08-27
9920,경기,연천군,0,0,0,0,0,0,2018-09-27
9921,경기,연천군,3,0,0,3,1,0,2018-10-27
9922,경기,연천군,0,0,0,0,0,0,2018-11-27
9923,경기,연천군,4,0,0,4,1,0,2018-12-27
9924,경기,오산시,1,0,0,1,1,0,2018-01-27
9925,경기,오산시,4,0,0,4,2,0,2018-02-27
9926,경기,오산시,1,0,3,4,3,0,2018-03-27
9927,경기,오산시,1,0,0,1,1,0,2018-04-27
9928,경기,오산시,0,1,3,4,3,0,2018-05-27
9929,경기,오산시,1,0,2,3,1,0,2018-06-27
9930,경기,오산시,5,0,5,10,8,0,2018-07-27
9931,경기,오산시,0,0,1,1,1,0,2018-08-27
9932,경기,오산시,2,0,0,2,2,0,2018-09-27
9933,경기,오산시,9,1,2,12,7,0,2018-10-27
9934,경기,오산시,5,0,0,5,2,0,2018-11-27
9935,경기,오산시,3,0,1,4,3,1,2018-12-27
9936,경기,용인시,10,2,1,13,7,0,2018-01-27
9937,경기,용인시,14,1,2,17,9,0,2018-02-27
9938,경기,용인시,3,0,0,3,2,0,2018-03-27
9939,경기,용인시,4,2,8,14,10,0,2018-04-27
9940,경기,용인시,5,2,2,9,6,0,2018-05-27
9941,경기,용인시,6,2,2,10,7,0,2018-06-27
9942,경기,용인시,11,6,1,18,10,0,2018-07-27
9943,경기,용인시,7,3,4,14,10,0,2018-08-27
9944,경기,용인시,11,1,3,15,12,0,2018-09-27
9945,경기,용인시,28,1,4,33,17,0,2018-10-27
9946,경기,용인시,8,0,4,12,9,0,2018-11-27
9947,경기,용인시,7,2,4,13,9,0,2018-12-27
9948,경기,의왕시,2,0,2,4,2,0,2018-01-27
9949,경기,의왕시,0,0,0,0,0,0,2018-02-27
9950,경기,의왕시,0,0,0,0,0,0,2018-03-27
9951,경기,의왕시,0,0,1,1,1,0,2018-04-27
9952,경기,의왕시,0,0,0,0,0,0,2018-05-27
9953,경기,의왕시,1,0,0,1,1,0,2018-06-27
9954,경기,의왕시,0,0,1,1,1,0,2018-07-27
9955,경기,의왕시,0,0,0,0,0,0,2018-08-27
9956,경기,의왕시,0,0,1,1,1,0,2018-09-27
9957,경기,의왕시,1,1,0,2,2,0,2018-10-27
9958,경기,의왕시,0,0,0,0,0,0,2018-11-27
9959,경기,의왕시,1,0,0,1,1,0,2018-12-27
9960,경기,의정부시,6,0,0,6,5,0,2018-01-27
9961,경기,의정부시,3,1,2,6,4,1,2018-02-27
9962,경기,의정부시,4,0,0,4,1,0,2018-03-27
9963,경기,의정부시,1,1,0,2,2,0,2018-04-27
9964,경기,의정부시,4,1,1,6,4,0,2018-05-27
9965,경기,의정부시,3,0,2,5,5,0,2018-06-27
9966,경기,의정부시,6,3,0,9,4,0,2018-07-27
9967,경기,의정부시,6,0,0,6,5,0,2018-08-27
9968,경기,의정부시,3,0,5,8,5,0,2018-09-27
9969,경기,의정부시,2,2,1,5,4,0,2018-10-27
9970,경기,의정부시,7,1,2,10,7,0,2018-11-27
9971,경기,의정부시,4,0,1,5,4,0,2018-12-27
9972,경기,이천시,6,0,0,6,4,1,2018-01-27
9973,경기,이천시,1,0,0,1,1,0,2018-02-27
9974,경기,이천시,3,0,0,3,3,0,2018-03-27
9975,경기,이천시,1,0,1,2,2,0,2018-04-27
9976,경기,이천시,5,0,0,5,2,0,2018-05-27
9977,경기,이천시,12,0,2,14,6,0,2018-06-27
9978,경기,이천시,6,0,4,10,4,0,2018-07-27
9979,경기,이천시,4,0,0,4,3,0,2018-08-27
9980,경기,이천시,2,0,4,6,6,0,2018-09-27
9981,경기,이천시,8,1,4,13,6,0,2018-10-27
9982,경기,이천시,6,1,0,7,3,0,2018-11-27
9983,경기,이천시,1,1,0,2,1,0,2018-12-27
9984,경기,파주시,7,0,0,7,6,0,2018-01-27
9985,경기,파주시,6,0,3,9,5,0,2018-02-27
9986,경기,파주시,2,0,0,2,2,0,2018-03-27
9987,경기,파주시,13,2,4,19,9,0,2018-04-27
9988,경기,파주시,4,0,0,4,3,0,2018-05-27
9989,경기,파주시,3,0,1,4,3,0,2018-06-27
9990,경기,파주시,12,0,5,17,7,0,2018-07-27
9991,경기,파주시,4,0,0,4,4,0,2018-08-27
9992,경기,파주시,1,0,0,1,1,0,2018-09-27
9993,경기,파주시,6,0,3,9,7,0,2018-10-27
9994,경기,파주시,7,0,2,9,7,0,2018-11-27
9995,경기,파주시,5,0,2,7,4,0,2018-12-27
9996,경기,평택시,11,0,0,11,5,0,2018-01-27
9997,경기,평택시,21,2,0,23,11,1,2018-02-27
9998,경기,평택시,13,0,5,18,12,1,2018-03-27
9999,경기,평택시,5,0,2,7,6,0,2018-04-27
10000,경기,평택시,8,1,2,11,6,0,2018-05-27
10001,경기,평택시,7,6,0,13,12,1,2018-06-27
10002,경기,평택시,22,1,1,24,11,0,2018-07-27
10003,경기,평택시,6,0,3,9,7,0,2018-08-27
10004,경기,평택시,12,2,2,16,9,0,2018-09-27
10005,경기,평택시,8,1,3,12,10,0,2018-10-27
10006,경기,평택시,7,0,3,10,7,0,2018-11-27
10007,경기,평택시,12,3,2,17,12,0,2018-12-27
10008,경기,포천시,0,0,0,0,0,0,2018-01-27
10009,경기,포천시,2,0,0,2,2,0,2018-02-27
10010,경기,포천시,1,0,1,2,2,0,2018-03-27
10011,경기,포천시,4,0,0,4,3,0,2018-04-27
10012,경기,포천시,7,0,2,9,3,0,2018-05-27
10013,경기,포천시,3,1,1,5,4,0,2018-06-27
10014,경기,포천시,2,0,0,2,2,0,2018-07-27
10015,경기,포천시,3,3,0,6,3,0,2018-08-27
10016,경기,포천시,2,0,0,2,1,0,2018-09-27
10017,경기,포천시,0,0,0,0,0,0,2018-10-27
10018,경기,포천시,1,0,2,3,3,0,2018-11-27
10019,경기,포천시,2,0,1,3,1,0,2018-12-27
10020,경기,하남시,0,0,1,1,1,0,2018-01-27
10021,경기,하남시,2,0,1,3,3,0,2018-02-27
10022,경기,하남시,4,0,0,4,2,0,2018-03-27
10023,경기,하남시,3,0,2,5,4,0,2018-04-27
10024,경기,하남시,2,1,1,4,4,0,2018-05-27
10025,경기,하남시,0,0,0,0,0,0,2018-06-27
10026,경기,하남시,6,0,0,6,3,0,2018-07-27
10027,경기,하남시,0,0,0,0,0,0,2018-08-27
10028,경기,하남시,1,0,0,1,1,0,2018-09-27
10029,경기,하남시,5,1,0,6,3,0,2018-10-27
10030,경기,하남시,3,0,0,3,2,0,2018-11-27
10031,경기,하남시,2,0,0,2,1,0,2018-12-27
10032,경기,화성시,7,1,1,9,7,0,2018-01-27
10033,경기,화성시,8,1,4,13,10,0,2018-02-27
10034,경기,화성시,6,1,0,7,5,0,2018-03-27
10035,경기,화성시,12,2,5,19,14,0,2018-04-27
10036,경기,화성시,15,0,2,17,9,0,2018-05-27
10037,경기,화성시,15,1,2,18,11,0,2018-06-27
10038,경기,화성시,12,0,5,17,12,0,2018-07-27
10039,경기,화성시,1,1,2,4,4,0,2018-08-27
10040,경기,화성시,13,0,3,16,11,1,2018-09-27
10041,경기,화성시,2,0,2,4,4,0,2018-10-27
10042,경기,화성시,8,0,2,10,10,0,2018-11-27
10043,경기,화성시,8,0,2,10,7,0,2018-12-27
10044,경기,가평군,0,0,0,0,0,0,2018-01-28
10045,경기,가평군,7,0,0,7,3,0,2018-02-28
10046,경기,가평군,0,0,0,0,0,0,2018-03-28
10047,경기,가평군,5,0,0,5,3,0,2018-04-28
10048,경기,가평군,4,0,0,4,1,0,2018-05-28
10049,경기,가평군,1,0,0,1,1,0,2018-06-28
10050,경기,가평군,7,1,0,8,4,0,2018-07-28
10051,경기,가평군,4,0,1,5,3,0,2018-08-28
10052,경기,가평군,0,0,0,0,0,0,2018-09-28
10053,경기,가평군,0,0,1,1,1,0,2018-10-28
10054,경기,가평군,0,0,0,0,0,0,2018-11-28
10055,경기,가평군,0,0,0,0,0,0,2018-12-28
10056,경기,고양시,14,3,2,19,8,0,2018-01-28
10057,경기,고양시,5,1,2,8,5,0,2018-02-28
10058,경기,고양시,13,2,5,20,16,0,2018-03-28
10059,경기,고양시,10,3,3,16,11,0,2018-04-28
10060,경기,고양시,6,2,3,11,11,0,2018-05-28
10061,경기,고양시,3,0,4,7,5,0,2018-06-28
10062,경기,고양시,22,0,0,22,12,1,2018-07-28
10063,경기,고양시,7,0,0,7,7,0,2018-08-28
10064,경기,고양시,7,0,4,11,10,0,2018-09-28
10065,경기,고양시,3,1,2,6,4,0,2018-10-28
10066,경기,고양시,9,0,2,11,10,0,2018-11-28
10067,경기,고양시,18,0,4,22,15,0,2018-12-28
10068,경기,과천시,0,0,0,0,0,0,2018-01-28
10069,경기,과천시,0,0,0,0,0,0,2018-02-28
10070,경기,과천시,0,0,0,0,0,0,2018-03-28
10071,경기,과천시,0,0,0,0,0,0,2018-04-28
10072,경기,과천시,1,0,0,1,1,0,2018-05-28
10073,경기,과천시,0,0,0,0,0,0,2018-06-28
10074,경기,과천시,0,0,0,0,0,0,2018-07-28
10075,경기,과천시,0,0,0,0,0,0,2018-08-28
10076,경기,과천시,0,1,1,2,2,0,2018-09-28
10077,경기,과천시,0,0,0,0,0,0,2018-10-28
10078,경기,과천시,4,0,0,4,1,0,2018-11-28
10079,경기,과천시,0,0,0,0,0,0,2018-12-28
10080,경기,광명시,1,1,0,2,1,0,2018-01-28
10081,경기,광명시,1,0,1,2,2,0,2018-02-28
10082,경기,광명시,1,0,0,1,1,0,2018-03-28
10083,경기,광명시,1,0,2,3,3,0,2018-04-28
10084,경기,광명시,5,0,0,5,5,0,2018-05-28
10085,경기,광명시,0,0,0,0,0,0,2018-06-28
10086,경기,광명시,0,2,0,2,1,0,2018-07-28
10087,경기,광명시,5,0,1,6,3,0,2018-08-28
10088,경기,광명시,2,1,0,3,3,0,2018-09-28
10089,경기,광명시,1,0,1,2,2,0,2018-10-28
10090,경기,광명시,0,1,0,1,1,0,2018-11-28
10091,경기,광명시,1,1,2,4,2,0,2018-12-28
10092,경기,광주시,9,1,1,11,6,0,2018-01-28
10093,경기,광주시,2,0,1,3,3,0,2018-02-28
10094,경기,광주시,1,0,0,1,2,1,2018-03-28
10095,경기,광주시,3,0,0,3,3,0,2018-04-28
10096,경기,광주시,13,5,3,21,11,0,2018-05-28
10097,경기,광주시,2,1,1,4,4,0,2018-06-28
10098,경기,광주시,3,0,3,6,6,1,2018-07-28
10099,경기,광주시,8,0,1,9,5,0,2018-08-28
10100,경기,광주시,3,0,3,6,5,0,2018-09-28
10101,경기,광주시,3,0,0,3,3,0,2018-10-28
10102,경기,광주시,2,0,4,6,4,0,2018-11-28
10103,경기,광주시,10,0,0,10,9,0,2018-12-28
10104,경기,구리시,0,0,1,1,1,0,2018-01-28
10105,경기,구리시,2,0,1,3,2,0,2018-02-28
10106,경기,구리시,1,0,0,1,1,0,2018-03-28
10107,경기,구리시,9,0,0,9,2,0,2018-04-28
10108,경기,구리시,2,1,0,3,2,0,2018-05-28
10109,경기,구리시,3,0,1,4,2,0,2018-06-28
10110,경기,구리시,5,0,2,7,3,0,2018-07-28
10111,경기,구리시,0,0,1,1,1,0,2018-08-28
10112,경기,구리시,0,0,0,0,0,0,2018-09-28
10113,경기,구리시,0,0,0,0,0,0,2018-10-28
10114,경기,구리시,0,0,0,0,0,0,2018-11-28
10115,경기,구리시,3,0,1,4,2,2,2018-12-28
10116,경기,군포시,2,2,0,4,1,0,2018-01-28
10117,경기,군포시,2,0,1,3,2,0,2018-02-28
10118,경기,군포시,1,1,1,3,3,0,2018-03-28
10119,경기,군포시,6,0,0,6,4,0,2018-04-28
10120,경기,군포시,2,1,1,4,3,0,2018-05-28
10121,경기,군포시,0,0,0,0,0,0,2018-06-28
10122,경기,군포시,1,0,1,2,1,0,2018-07-28
10123,경기,군포시,2,0,0,2,2,0,2018-08-28
10124,경기,군포시,2,0,1,3,3,0,2018-09-28
10125,경기,군포시,1,1,0,2,2,0,2018-10-28
10126,경기,군포시,1,0,0,1,1,0,2018-11-28
10127,경기,군포시,6,0,0,6,4,0,2018-12-28
10128,경기,김포시,7,0,1,8,4,0,2018-01-28
10129,경기,김포시,2,0,1,3,3,0,2018-02-28
10130,경기,김포시,2,0,2,4,3,0,2018-03-28
10131,경기,김포시,4,0,0,4,5,1,2018-04-28
10132,경기,김포시,0,0,1,1,1,0,2018-05-28
10133,경기,김포시,1,0,1,2,2,0,2018-06-28
10134,경기,김포시,6,5,1,12,6,0,2018-07-28
10135,경기,김포시,9,1,3,13,8,0,2018-08-28
10136,경기,김포시,5,0,1,6,4,0,2018-09-28
10137,경기,김포시,3,0,2,5,4,0,2018-10-28
10138,경기,김포시,7,0,1,8,4,0,2018-11-28
10139,경기,김포시,10,1,1,12,4,0,2018-12-28
10140,경기,남양주시,10,0,1,11,6,0,2018-01-28
10141,경기,남양주시,3,0,4,7,6,0,2018-02-28
10142,경기,남양주시,7,1,0,8,5,0,2018-03-28
10143,경기,남양주시,12,1,0,13,8,0,2018-04-28
10144,경기,남양주시,3,0,1,4,3,0,2018-05-28
10145,경기,남양주시,9,0,2,11,8,0,2018-06-28
10146,경기,남양주시,16,0,1,17,10,0,2018-07-28
10147,경기,남양주시,6,0,1,7,5,0,2018-08-28
10148,경기,남양주시,8,3,0,11,7,0,2018-09-28
10149,경기,남양주시,3,0,0,3,2,0,2018-10-28
10150,경기,남양주시,1,0,1,2,2,0,2018-11-28
10151,경기,남양주시,1,0,3,4,3,0,2018-12-28
10152,경기,동두천시,0,1,0,1,1,0,2018-01-28
10153,경기,동두천시,2,0,0,2,2,0,2018-02-28
10154,경기,동두천시,1,0,0,1,1,0,2018-03-28
10155,경기,동두천시,1,0,0,1,1,0,2018-04-28
10156,경기,동두천시,1,0,0,1,1,0,2018-05-28
10157,경기,동두천시,0,0,0,0,0,0,2018-06-28
10158,경기,동두천시,0,0,1,1,1,0,2018-07-28
10159,경기,동두천시,0,0,0,0,0,0,2018-08-28
10160,경기,동두천시,0,0,0,0,0,0,2018-09-28
10161,경기,동두천시,3,0,0,3,1,0,2018-10-28
10162,경기,동두천시,1,0,0,1,1,0,2018-11-28
10163,경기,동두천시,1,0,1,2,2,0,2018-12-28
10164,경기,부천시,7,0,2,9,5,0,2018-01-28
10165,경기,부천시,12,0,7,19,9,0,2018-02-28
10166,경기,부천시,13,3,2,18,12,1,2018-03-28
10167,경기,부천시,12,1,6,19,12,0,2018-04-28
10168,경기,부천시,15,0,4,19,15,0,2018-05-28
10169,경기,부천시,14,1,3,18,11,0,2018-06-28
10170,경기,부천시,8,5,2,15,10,0,2018-07-28
10171,경기,부천시,5,0,5,10,10,0,2018-08-28
10172,경기,부천시,9,2,2,13,13,0,2018-09-28
10173,경기,부천시,6,1,3,10,8,0,2018-10-28
10174,경기,부천시,10,0,1,11,6,0,2018-11-28
10175,경기,부천시,8,0,4,12,10,0,2018-12-28
10176,경기,성남시,17,2,7,26,12,0,2018-01-28
10177,경기,성남시,15,1,0,16,16,0,2018-02-28
10178,경기,성남시,4,0,1,5,4,0,2018-03-28
10179,경기,성남시,12,2,3,17,12,0,2018-04-28
10180,경기,성남시,18,0,4,22,11,0,2018-05-28
10181,경기,성남시,11,0,8,19,15,1,2018-06-28
10182,경기,성남시,5,0,6,11,9,0,2018-07-28
10183,경기,성남시,10,2,0,12,9,0,2018-08-28
10184,경기,성남시,6,0,1,7,6,0,2018-09-28
10185,경기,성남시,8,1,2,11,9,0,2018-10-28
10186,경기,성남시,15,4,4,23,11,0,2018-11-28
10187,경기,성남시,8,1,5,14,13,0,2018-12-28
10188,경기,수원시,5,4,2,11,7,0,2018-01-28
10189,경기,수원시,26,3,6,35,26,1,2018-02-28
10190,경기,수원시,13,3,5,21,16,0,2018-03-28
10191,경기,수원시,17,1,1,19,13,0,2018-04-28
10192,경기,수원시,19,1,3,23,16,1,2018-05-28
10193,경기,수원시,11,4,7,22,18,0,2018-06-28
10194,경기,수원시,14,0,1,15,12,0,2018-07-28
10195,경기,수원시,16,1,4,21,16,0,2018-08-28
10196,경기,수원시,14,0,3,17,13,0,2018-09-28
10197,경기,수원시,28,2,8,38,20,0,2018-10-28
10198,경기,수원시,29,2,7,38,19,0,2018-11-28
10199,경기,수원시,13,5,7,25,16,1,2018-12-28
10200,경기,시흥시,7,1,0,8,3,0,2018-01-28
10201,경기,시흥시,14,1,2,17,11,0,2018-02-28
10202,경기,시흥시,6,0,4,10,5,0,2018-03-28
10203,경기,시흥시,18,2,3,23,15,0,2018-04-28
10204,경기,시흥시,3,0,4,7,7,0,2018-05-28
10205,경기,시흥시,27,0,1,28,13,0,2018-06-28
10206,경기,시흥시,5,0,5,10,6,0,2018-07-28
10207,경기,시흥시,3,0,1,4,4,0,2018-08-28
10208,경기,시흥시,4,0,2,6,3,0,2018-09-28
10209,경기,시흥시,8,2,2,12,6,0,2018-10-28
10210,경기,시흥시,13,0,2,15,11,0,2018-11-28
10211,경기,시흥시,10,3,3,16,10,0,2018-12-28
10212,경기,안산시,11,0,4,15,9,0,2018-01-28
10213,경기,안산시,15,3,2,20,14,0,2018-02-28
10214,경기,안산시,13,0,1,14,5,0,2018-03-28
10215,경기,안산시,18,1,5,24,11,0,2018-04-28
10216,경기,안산시,13,1,2,16,15,1,2018-05-28
10217,경기,안산시,9,1,4,14,10,0,2018-06-28
10218,경기,안산시,8,0,2,10,7,0,2018-07-28
10219,경기,안산시,17,0,2,19,9,0,2018-08-28
10220,경기,안산시,7,1,1,9,8,0,2018-09-28
10221,경기,안산시,11,2,1,14,7,0,2018-10-28
10222,경기,안산시,9,1,3,13,11,0,2018-11-28
10223,경기,안산시,9,3,0,12,9,0,2018-12-28
10224,경기,안성시,4,1,1,6,3,1,2018-01-28
10225,경기,안성시,1,1,1,3,3,0,2018-02-28
10226,경기,안성시,3,0,0,3,1,0,2018-03-28
10227,경기,안성시,9,0,7,16,4,0,2018-04-28
10228,경기,안성시,1,0,1,2,2,0,2018-05-28
10229,경기,안성시,3,0,1,4,2,0,2018-06-28
10230,경기,안성시,5,0,0,5,1,0,2018-07-28
10231,경기,안성시,2,0,2,4,2,0,2018-08-28
10232,경기,안성시,12,0,5,17,7,0,2018-09-28
10233,경기,안성시,0,0,1,1,1,0,2018-10-28
10234,경기,안성시,2,0,0,2,1,0,2018-11-28
10235,경기,안성시,5,0,2,7,5,0,2018-12-28
10236,경기,안양시,6,2,0,8,3,0,2018-01-28
10237,경기,안양시,3,0,0,3,3,0,2018-02-28
10238,경기,안양시,8,1,0,9,6,0,2018-03-28
10239,경기,안양시,3,0,0,3,3,0,2018-04-28
10240,경기,안양시,5,0,0,5,5,0,2018-05-28
10241,경기,안양시,8,0,2,10,6,0,2018-06-28
10242,경기,안양시,7,3,0,10,4,0,2018-07-28
10243,경기,안양시,9,0,2,11,7,0,2018-08-28
10244,경기,안양시,2,0,2,4,4,0,2018-09-28
10245,경기,안양시,10,0,0,10,5,0,2018-10-28
10246,경기,안양시,7,0,1,8,6,0,2018-11-28
10247,경기,안양시,11,0,0,11,7,0,2018-12-28
10248,경기,양주시,1,0,0,1,1,0,2018-01-28
10249,경기,양주시,2,0,0,2,2,0,2018-02-28
10250,경기,양주시,3,0,1,4,2,0,2018-03-28
10251,경기,양주시,1,0,0,1,1,0,2018-04-28
10252,경기,양주시,2,0,0,2,1,0,2018-05-28
10253,경기,양주시,7,1,0,8,6,0,2018-06-28
10254,경기,양주시,3,1,1,5,4,0,2018-07-28
10255,경기,양주시,2,0,0,2,2,0,2018-08-28
10256,경기,양주시,6,0,1,7,4,0,2018-09-28
10257,경기,양주시,5,0,0,5,3,0,2018-10-28
10258,경기,양주시,4,4,1,9,4,0,2018-11-28
10259,경기,양주시,4,0,4,8,5,0,2018-12-28
10260,경기,양평군,0,0,0,0,0,0,2018-01-28
10261,경기,양평군,1,1,0,2,2,0,2018-02-28
10262,경기,양평군,0,0,0,0,0,0,2018-03-28
10263,경기,양평군,4,2,1,7,2,0,2018-04-28
10264,경기,양평군,0,0,1,1,1,0,2018-05-28
10265,경기,양평군,0,0,0,0,0,0,2018-06-28
10266,경기,양평군,2,0,0,2,1,0,2018-07-28
10267,경기,양평군,1,0,0,1,1,0,2018-08-28
10268,경기,양평군,3,0,1,4,2,0,2018-09-28
10269,경기,양평군,3,0,1,4,3,0,2018-10-28
10270,경기,양평군,1,0,0,1,1,0,2018-11-28
10271,경기,양평군,0,0,0,0,0,0,2018-12-28
10272,경기,여주시,1,0,1,2,1,0,2018-01-28
10273,경기,여주시,0,0,0,0,0,0,2018-02-28
10274,경기,여주시,0,0,1,1,1,0,2018-03-28
10275,경기,여주시,1,0,0,1,1,0,2018-04-28
10276,경기,여주시,0,0,0,0,0,0,2018-05-28
10277,경기,여주시,0,0,0,0,0,0,2018-06-28
10278,경기,여주시,3,0,0,3,2,0,2018-07-28
10279,경기,여주시,1,0,0,1,1,0,2018-08-28
10280,경기,여주시,4,0,0,4,2,0,2018-09-28
10281,경기,여주시,1,0,0,1,1,0,2018-10-28
10282,경기,여주시,2,0,0,2,2,0,2018-11-28
10283,경기,여주시,2,0,1,3,1,0,2018-12-28
10284,경기,연천군,0,0,0,0,0,0,2018-01-28
10285,경기,연천군,1,0,0,1,1,0,2018-02-28
10286,경기,연천군,1,0,0,1,1,0,2018-03-28
10287,경기,연천군,3,0,3,6,1,0,2018-04-28
10288,경기,연천군,1,0,1,2,2,0,2018-05-28
10289,경기,연천군,0,0,0,0,0,0,2018-06-28
10290,경기,연천군,3,0,0,3,2,0,2018-07-28
10291,경기,연천군,0,0,3,3,1,0,2018-08-28
10292,경기,연천군,0,0,0,0,0,0,2018-09-28
10293,경기,연천군,0,0,0,0,0,0,2018-10-28
10294,경기,연천군,2,0,0,2,1,0,2018-11-28
10295,경기,연천군,0,0,1,1,1,0,2018-12-28
10296,경기,오산시,3,0,0,3,1,0,2018-01-28
10297,경기,오산시,6,1,4,11,4,0,2018-02-28
10298,경기,오산시,2,0,1,3,2,0,2018-03-28
10299,경기,오산시,4,0,0,4,4,0,2018-04-28
10300,경기,오산시,11,0,1,12,8,0,2018-05-28
10301,경기,오산시,1,0,1,2,2,0,2018-06-28
10302,경기,오산시,4,2,4,10,6,0,2018-07-28
10303,경기,오산시,1,4,1,6,3,0,2018-08-28
10304,경기,오산시,3,0,0,3,2,0,2018-09-28
10305,경기,오산시,6,0,1,7,6,0,2018-10-28
10306,경기,오산시,1,0,1,2,2,0,2018-11-28
10307,경기,오산시,5,2,1,8,5,0,2018-12-28
10308,경기,용인시,1,1,1,3,2,0,2018-01-28
10309,경기,용인시,16,5,10,31,16,0,2018-02-28
10310,경기,용인시,7,2,4,13,9,0,2018-03-28
10311,경기,용인시,19,3,6,28,14,2,2018-04-28
10312,경기,용인시,4,3,4,11,8,0,2018-05-28
10313,경기,용인시,5,4,4,13,8,1,2018-06-28
10314,경기,용인시,7,0,2,9,4,1,2018-07-28
10315,경기,용인시,14,1,2,17,13,0,2018-08-28
10316,경기,용인시,15,0,9,24,12,0,2018-09-28
10317,경기,용인시,5,0,4,9,6,0,2018-10-28
10318,경기,용인시,6,1,0,7,5,0,2018-11-28
10319,경기,용인시,10,3,2,15,11,1,2018-12-28
10320,경기,의왕시,0,0,0,0,0,0,2018-01-28
10321,경기,의왕시,0,0,1,1,1,0,2018-02-28
10322,경기,의왕시,1,0,1,2,2,0,2018-03-28
10323,경기,의왕시,5,0,0,5,2,0,2018-04-28
10324,경기,의왕시,1,0,0,1,1,0,2018-05-28
10325,경기,의왕시,0,0,0,0,0,0,2018-06-28
10326,경기,의왕시,1,0,0,1,1,0,2018-07-28
10327,경기,의왕시,6,0,1,7,4,0,2018-08-28
10328,경기,의왕시,2,0,2,4,3,0,2018-09-28
10329,경기,의왕시,0,0,0,0,0,0,2018-10-28
10330,경기,의왕시,0,0,0,0,1,1,2018-11-28
10331,경기,의왕시,1,0,0,1,1,0,2018-12-28
10332,경기,의정부시,11,1,3,15,10,0,2018-01-28
10333,경기,의정부시,6,11,2,19,9,0,2018-02-28
10334,경기,의정부시,1,0,1,2,2,0,2018-03-28
10335,경기,의정부시,1,2,1,4,4,0,2018-04-28
10336,경기,의정부시,0,2,3,5,4,0,2018-05-28
10337,경기,의정부시,7,0,1,8,5,0,2018-06-28
10338,경기,의정부시,2,0,4,6,4,0,2018-07-28
10339,경기,의정부시,1,0,0,1,1,0,2018-08-28
10340,경기,의정부시,1,2,0,3,3,1,2018-09-28
10341,경기,의정부시,7,1,2,10,6,0,2018-10-28
10342,경기,의정부시,2,1,3,6,6,0,2018-11-28
10343,경기,의정부시,3,0,0,3,3,0,2018-12-28
10344,경기,이천시,1,0,0,1,1,0,2018-01-28
10345,경기,이천시,8,0,5,13,7,0,2018-02-28
10346,경기,이천시,3,0,2,5,3,0,2018-03-28
10347,경기,이천시,12,0,2,14,4,1,2018-04-28
10348,경기,이천시,2,1,0,3,2,0,2018-05-28
10349,경기,이천시,2,1,0,3,2,0,2018-06-28
10350,경기,이천시,1,0,1,2,2,0,2018-07-28
10351,경기,이천시,3,2,1,6,3,0,2018-08-28
10352,경기,이천시,0,0,0,0,0,0,2018-09-28
10353,경기,이천시,4,0,0,4,3,0,2018-10-28
10354,경기,이천시,4,0,0,4,4,0,2018-11-28
10355,경기,이천시,0,0,1,1,1,0,2018-12-28
10356,경기,파주시,2,0,0,2,2,0,2018-01-28
10357,경기,파주시,5,2,3,10,7,1,2018-02-28
10358,경기,파주시,2,1,2,5,4,0,2018-03-28
10359,경기,파주시,2,0,0,2,2,0,2018-04-28
10360,경기,파주시,0,0,0,0,0,0,2018-05-28
10361,경기,파주시,2,0,1,3,3,0,2018-06-28
10362,경기,파주시,6,0,1,7,5,1,2018-07-28
10363,경기,파주시,4,0,1,5,4,0,2018-08-28
10364,경기,파주시,3,0,0,3,3,0,2018-09-28
10365,경기,파주시,5,0,1,6,3,0,2018-10-28
10366,경기,파주시,1,0,1,2,2,0,2018-11-28
10367,경기,파주시,2,1,2,5,4,1,2018-12-28
10368,경기,평택시,6,4,1,11,6,0,2018-01-28
10369,경기,평택시,12,0,6,18,12,0,2018-02-28
10370,경기,평택시,11,1,4,16,12,1,2018-03-28
10371,경기,평택시,18,26,3,47,14,0,2018-04-28
10372,경기,평택시,12,1,3,16,9,0,2018-05-28
10373,경기,평택시,13,0,3,16,11,0,2018-06-28
10374,경기,평택시,7,0,3,10,6,0,2018-07-28
10375,경기,평택시,9,3,1,13,7,0,2018-08-28
10376,경기,평택시,7,0,2,9,7,1,2018-09-28
10377,경기,평택시,4,1,3,8,6,0,2018-10-28
10378,경기,평택시,9,2,8,19,9,0,2018-11-28
10379,경기,평택시,9,1,7,17,11,0,2018-12-28
10380,경기,포천시,0,0,0,0,0,0,2018-01-28
10381,경기,포천시,1,2,0,3,3,0,2018-02-28
10382,경기,포천시,5,0,1,6,4,0,2018-03-28
10383,경기,포천시,2,1,1,4,4,0,2018-04-28
10384,경기,포천시,1,3,1,5,3,0,2018-05-28
10385,경기,포천시,3,0,0,3,1,0,2018-06-28
10386,경기,포천시,2,0,0,2,2,0,2018-07-28
10387,경기,포천시,3,0,0,3,2,0,2018-08-28
10388,경기,포천시,1,0,0,1,1,0,2018-09-28
10389,경기,포천시,1,1,0,2,1,0,2018-10-28
10390,경기,포천시,2,2,0,4,3,0,2018-11-28
10391,경기,포천시,1,0,1,2,1,0,2018-12-28
10392,경기,하남시,1,1,0,2,2,0,2018-01-28
10393,경기,하남시,1,0,2,3,3,0,2018-02-28
10394,경기,하남시,0,2,0,2,2,0,2018-03-28
10395,경기,하남시,4,0,2,6,4,0,2018-04-28
10396,경기,하남시,1,0,1,2,2,0,2018-05-28
10397,경기,하남시,5,0,0,5,4,0,2018-06-28
10398,경기,하남시,1,0,0,1,1,0,2018-07-28
10399,경기,하남시,4,0,0,4,4,0,2018-08-28
10400,경기,하남시,3,0,6,9,3,0,2018-09-28
10401,경기,하남시,4,5,2,11,3,0,2018-10-28
10402,경기,하남시,2,0,0,2,2,0,2018-11-28
10403,경기,하남시,0,0,0,0,0,0,2018-12-28
10404,경기,화성시,2,0,0,2,2,0,2018-01-28
10405,경기,화성시,11,0,7,18,15,0,2018-02-28
10406,경기,화성시,2,0,1,3,4,1,2018-03-28
10407,경기,화성시,3,0,2,5,4,0,2018-04-28
10408,경기,화성시,7,1,5,13,10,0,2018-05-28
10409,경기,화성시,19,0,6,25,9,0,2018-06-28
10410,경기,화성시,8,0,1,9,7,0,2018-07-28
10411,경기,화성시,2,0,0,2,2,0,2018-08-28
10412,경기,화성시,4,0,3,7,5,1,2018-09-28
10413,경기,화성시,5,0,6,11,5,0,2018-10-28
10414,경기,화성시,6,0,3,9,8,1,2018-11-28
10415,경기,화성시,17,0,4,21,10,0,2018-12-28
10416,경기,가평군,0,0,0,0,0,0,2018-01-29
10418,경기,가평군,1,0,4,5,2,1,2018-03-29
10419,경기,가평군,0,1,2,3,2,0,2018-04-29
10420,경기,가평군,6,0,0,6,1,0,2018-05-29
10421,경기,가평군,3,1,0,4,3,0,2018-06-29
10422,경기,가평군,6,11,0,17,4,0,2018-07-29
10423,경기,가평군,0,0,0,0,0,0,2018-08-29
10424,경기,가평군,2,0,0,2,2,0,2018-09-29
10425,경기,가평군,1,0,0,1,1,0,2018-10-29
10426,경기,가평군,0,0,0,0,0,0,2018-11-29
10427,경기,가평군,0,0,0,0,0,0,2018-12-29
10428,경기,고양시,18,3,7,28,18,0,2018-01-29
10430,경기,고양시,15,0,4,19,14,0,2018-03-29
10431,경기,고양시,1,0,3,4,4,0,2018-04-29
10432,경기,고양시,13,1,2,16,13,0,2018-05-29
10433,경기,고양시,8,0,2,10,8,0,2018-06-29
10434,경기,고양시,7,2,1,10,5,0,2018-07-29
10435,경기,고양시,7,0,2,9,4,0,2018-08-29
10436,경기,고양시,13,1,1,15,8,0,2018-09-29
10437,경기,고양시,8,2,0,10,7,0,2018-10-29
10438,경기,고양시,7,0,2,9,7,0,2018-11-29
10439,경기,고양시,4,2,4,10,9,0,2018-12-29
10440,경기,과천시,0,0,0,0,0,0,2018-01-29
10442,경기,과천시,0,0,0,0,0,0,2018-03-29
10443,경기,과천시,0,0,0,0,0,0,2018-04-29
10444,경기,과천시,0,0,0,0,0,0,2018-05-29
10445,경기,과천시,1,0,0,1,1,0,2018-06-29
10446,경기,과천시,0,0,0,0,0,0,2018-07-29
10447,경기,과천시,2,0,1,3,1,0,2018-08-29
10448,경기,과천시,0,0,0,0,0,0,2018-09-29
10449,경기,과천시,3,0,0,3,1,0,2018-10-29
10450,경기,과천시,0,0,1,1,1,0,2018-11-29
10451,경기,과천시,0,0,0,0,0,0,2018-12-29
10452,경기,광명시,0,0,1,1,1,0,2018-01-29
10454,경기,광명시,2,0,0,2,2,0,2018-03-29
10455,경기,광명시,2,1,0,3,2,0,2018-04-29
10456,경기,광명시,1,0,2,3,3,0,2018-05-29
10457,경기,광명시,3,0,2,5,5,0,2018-06-29
10458,경기,광명시,2,0,0,2,2,0,2018-07-29
10459,경기,광명시,3,0,1,4,4,0,2018-08-29
10460,경기,광명시,0,1,1,2,2,0,2018-09-29
10461,경기,광명시,3,1,0,4,4,0,2018-10-29
10462,경기,광명시,1,1,2,4,4,0,2018-11-29
10463,경기,광명시,8,3,0,11,5,0,2018-12-29
10464,경기,광주시,6,0,1,7,5,0,2018-01-29
10466,경기,광주시,8,0,4,12,7,0,2018-03-29
10467,경기,광주시,2,0,1,3,3,0,2018-04-29
10468,경기,광주시,3,0,2,5,4,0,2018-05-29
10469,경기,광주시,4,1,5,10,7,0,2018-06-29
10470,경기,광주시,4,0,0,4,3,0,2018-07-29
10471,경기,광주시,5,0,2,7,3,0,2018-08-29
10472,경기,광주시,5,2,2,9,7,0,2018-09-29
10473,경기,광주시,3,0,2,5,5,0,2018-10-29
10474,경기,광주시,5,0,2,7,5,0,2018-11-29
10475,경기,광주시,6,0,1,7,4,0,2018-12-29
10476,경기,구리시,4,0,1,5,4,0,2018-01-29
10478,경기,구리시,2,0,0,2,2,0,2018-03-29
10479,경기,구리시,2,0,0,2,2,0,2018-04-29
10480,경기,구리시,2,0,1,3,3,0,2018-05-29
10481,경기,구리시,11,1,2,14,2,0,2018-06-29
10482,경기,구리시,1,0,0,1,1,0,2018-07-29
10483,경기,구리시,2,0,1,3,3,0,2018-08-29
10484,경기,구리시,0,0,1,1,1,0,2018-09-29
10485,경기,구리시,2,1,0,3,3,0,2018-10-29
10486,경기,구리시,3,3,3,9,4,0,2018-11-29
10487,경기,구리시,0,0,1,1,1,0,2018-12-29
10488,경기,군포시,3,0,0,3,1,0,2018-01-29
10490,경기,군포시,1,0,2,3,1,0,2018-03-29
10491,경기,군포시,6,1,0,7,3,0,2018-04-29
10492,경기,군포시,1,0,0,1,1,0,2018-05-29
10493,경기,군포시,8,1,5,14,3,0,2018-06-29
10494,경기,군포시,0,1,4,5,3,0,2018-07-29
10495,경기,군포시,3,0,1,4,3,0,2018-08-29
10496,경기,군포시,0,0,0,0,0,0,2018-09-29
10497,경기,군포시,0,0,0,0,0,0,2018-10-29
10498,경기,군포시,0,0,1,1,1,0,2018-11-29
10499,경기,군포시,1,0,0,1,1,0,2018-12-29
10500,경기,김포시,4,0,4,8,6,0,2018-01-29
10502,경기,김포시,5,0,1,6,4,0,2018-03-29
10503,경기,김포시,3,0,2,5,4,0,2018-04-29
10504,경기,김포시,6,3,4,13,9,0,2018-05-29
10505,경기,김포시,5,0,0,5,3,0,2018-06-29
10506,경기,김포시,7,1,1,9,6,0,2018-07-29
10507,경기,김포시,4,0,1,5,5,0,2018-08-29
10508,경기,김포시,6,0,2,8,5,0,2018-09-29
10509,경기,김포시,7,0,4,11,11,0,2018-10-29
10510,경기,김포시,5,0,0,5,2,0,2018-11-29
10511,경기,김포시,1,1,0,2,2,0,2018-12-29
10512,경기,남양주시,7,0,1,8,6,0,2018-01-29
10514,경기,남양주시,6,1,1,8,6,0,2018-03-29
10515,경기,남양주시,11,2,2,15,9,0,2018-04-29
10516,경기,남양주시,4,1,2,7,6,0,2018-05-29
10517,경기,남양주시,5,0,2,7,8,1,2018-06-29
10518,경기,남양주시,6,0,0,6,3,0,2018-07-29
10519,경기,남양주시,12,1,2,15,12,0,2018-08-29
10520,경기,남양주시,10,0,1,11,6,0,2018-09-29
10521,경기,남양주시,9,0,2,11,6,0,2018-10-29
10522,경기,남양주시,5,0,1,6,5,0,2018-11-29
10523,경기,남양주시,3,1,1,5,5,0,2018-12-29
10524,경기,동두천시,0,0,0,0,0,0,2018-01-29
10526,경기,동두천시,1,0,0,1,1,0,2018-03-29
10527,경기,동두천시,0,0,0,0,0,0,2018-04-29
10528,경기,동두천시,0,0,1,1,1,0,2018-05-29
10529,경기,동두천시,0,0,0,0,0,0,2018-06-29
10530,경기,동두천시,0,0,0,0,0,0,2018-07-29
10531,경기,동두천시,3,0,1,4,1,0,2018-08-29
10532,경기,동두천시,2,1,1,4,2,0,2018-09-29
10533,경기,동두천시,4,0,1,5,2,0,2018-10-29
10534,경기,동두천시,1,0,1,2,2,0,2018-11-29
10535,경기,동두천시,0,1,2,3,2,0,2018-12-29
10536,경기,부천시,6,1,3,10,8,0,2018-01-29
10538,경기,부천시,8,3,1,12,8,0,2018-03-29
10539,경기,부천시,14,1,1,16,8,0,2018-04-29
10540,경기,부천시,13,0,5,18,14,0,2018-05-29
10541,경기,부천시,6,1,1,8,5,0,2018-06-29
10542,경기,부천시,9,2,2,13,9,0,2018-07-29
10543,경기,부천시,9,2,4,15,13,0,2018-08-29
10544,경기,부천시,5,1,3,9,7,0,2018-09-29
10545,경기,부천시,4,1,2,7,6,0,2018-10-29
10546,경기,부천시,7,1,1,9,7,0,2018-11-29
10547,경기,부천시,8,0,1,9,6,1,2018-12-29
10548,경기,성남시,9,2,5,16,12,0,2018-01-29
10550,경기,성남시,9,1,1,11,9,0,2018-03-29
10551,경기,성남시,16,1,1,18,9,0,2018-04-29
10552,경기,성남시,18,2,3,23,19,0,2018-05-29
10553,경기,성남시,14,0,5,19,10,0,2018-06-29
10554,경기,성남시,5,0,2,7,4,0,2018-07-29
10555,경기,성남시,7,2,4,13,9,0,2018-08-29
10556,경기,성남시,16,0,6,22,15,0,2018-09-29
10557,경기,성남시,15,5,6,26,16,0,2018-10-29
10558,경기,성남시,6,1,7,14,13,0,2018-11-29
10559,경기,성남시,10,1,2,13,8,0,2018-12-29
10560,경기,수원시,6,1,3,10,7,0,2018-01-29
10562,경기,수원시,11,1,4,16,12,0,2018-03-29
10563,경기,수원시,12,2,3,17,13,0,2018-04-29
10564,경기,수원시,18,2,1,21,16,0,2018-05-29
10565,경기,수원시,22,1,6,29,17,0,2018-06-29
10566,경기,수원시,11,1,2,14,8,0,2018-07-29
10567,경기,수원시,18,3,6,27,16,1,2018-08-29
10568,경기,수원시,15,1,5,21,15,0,2018-09-29
10569,경기,수원시,19,2,2,23,16,0,2018-10-29
10570,경기,수원시,18,2,6,26,15,0,2018-11-29
10571,경기,수원시,11,1,1,13,9,0,2018-12-29
10572,경기,시흥시,2,0,0,2,2,0,2018-01-29
10574,경기,시흥시,5,1,1,7,3,0,2018-03-29
10575,경기,시흥시,4,0,2,6,5,0,2018-04-29
10576,경기,시흥시,4,0,3,7,6,1,2018-05-29
10577,경기,시흥시,12,2,6,20,12,0,2018-06-29
10578,경기,시흥시,6,0,3,9,5,0,2018-07-29
10579,경기,시흥시,6,0,2,8,7,0,2018-08-29
10580,경기,시흥시,2,0,2,4,4,0,2018-09-29
10581,경기,시흥시,10,0,4,14,7,0,2018-10-29
10582,경기,시흥시,12,1,0,13,8,0,2018-11-29
10583,경기,시흥시,5,1,1,7,6,0,2018-12-29
10584,경기,안산시,12,0,4,16,6,2,2018-01-29
10586,경기,안산시,8,1,3,12,8,0,2018-03-29
10587,경기,안산시,6,0,1,7,5,0,2018-04-29
10588,경기,안산시,11,1,2,14,9,0,2018-05-29
10589,경기,안산시,16,4,0,20,13,0,2018-06-29
10590,경기,안산시,12,1,2,15,10,0,2018-07-29
10591,경기,안산시,16,1,4,21,15,0,2018-08-29
10592,경기,안산시,10,0,2,12,9,0,2018-09-29
10593,경기,안산시,15,0,7,22,10,0,2018-10-29
10594,경기,안산시,6,0,3,9,6,0,2018-11-29
10595,경기,안산시,6,0,2,8,8,0,2018-12-29
10596,경기,안성시,3,0,1,4,3,0,2018-01-29
10598,경기,안성시,3,0,2,5,5,0,2018-03-29
10599,경기,안성시,0,0,0,0,0,0,2018-04-29
10600,경기,안성시,0,0,2,2,2,0,2018-05-29
10601,경기,안성시,6,1,0,7,4,0,2018-06-29
10602,경기,안성시,9,0,1,10,5,0,2018-07-29
10603,경기,안성시,2,0,1,3,2,0,2018-08-29
10604,경기,안성시,1,1,1,3,2,0,2018-09-29
10605,경기,안성시,3,0,1,4,3,0,2018-10-29
10606,경기,안성시,1,0,1,2,2,0,2018-11-29
10607,경기,안성시,0,1,3,4,3,0,2018-12-29
10608,경기,안양시,2,0,1,3,3,0,2018-01-29
10610,경기,안양시,3,0,0,3,3,0,2018-03-29
10611,경기,안양시,2,0,1,3,3,0,2018-04-29
10612,경기,안양시,11,1,3,15,7,0,2018-05-29
10613,경기,안양시,6,0,0,6,4,0,2018-06-29
10614,경기,안양시,4,0,1,5,2,0,2018-07-29
10615,경기,안양시,9,0,0,9,7,0,2018-08-29
10616,경기,안양시,4,1,3,8,4,0,2018-09-29
10617,경기,안양시,2,0,2,4,2,0,2018-10-29
10618,경기,안양시,0,1,1,2,2,0,2018-11-29
10619,경기,안양시,0,0,2,2,2,0,2018-12-29
10620,경기,양주시,2,0,2,4,4,2,2018-01-29
10622,경기,양주시,2,0,0,2,2,0,2018-03-29
10623,경기,양주시,9,0,1,10,4,0,2018-04-29
10624,경기,양주시,2,0,0,2,2,0,2018-05-29
10625,경기,양주시,3,0,1,4,4,0,2018-06-29
10626,경기,양주시,4,1,1,6,4,0,2018-07-29
10627,경기,양주시,2,0,2,4,3,0,2018-08-29
10628,경기,양주시,3,0,0,3,2,0,2018-09-29
10629,경기,양주시,8,0,0,8,5,0,2018-10-29
10630,경기,양주시,2,0,0,2,1,0,2018-11-29
10631,경기,양주시,2,0,2,4,3,0,2018-12-29
10632,경기,양평군,0,0,0,0,0,0,2018-01-29
10634,경기,양평군,0,0,0,0,0,0,2018-03-29
10635,경기,양평군,1,0,1,2,2,0,2018-04-29
10636,경기,양평군,1,0,0,1,2,1,2018-05-29
10637,경기,양평군,0,0,1,1,2,1,2018-06-29
10638,경기,양평군,0,0,1,1,1,0,2018-07-29
10639,경기,양평군,0,0,0,0,0,0,2018-08-29
10640,경기,양평군,2,0,0,2,1,0,2018-09-29
10641,경기,양평군,1,0,0,1,1,0,2018-10-29
10642,경기,양평군,1,0,1,2,2,0,2018-11-29
10643,경기,양평군,1,0,0,1,1,1,2018-12-29
10644,경기,여주시,1,0,1,2,2,0,2018-01-29
10646,경기,여주시,0,0,0,0,0,0,2018-03-29
10647,경기,여주시,2,0,1,3,2,0,2018-04-29
10648,경기,여주시,1,0,0,1,1,0,2018-05-29
10649,경기,여주시,0,0,0,0,0,0,2018-06-29
10650,경기,여주시,1,0,1,2,2,0,2018-07-29
10651,경기,여주시,2,0,1,3,1,0,2018-08-29
10652,경기,여주시,6,0,3,9,3,0,2018-09-29
10653,경기,여주시,2,0,1,3,3,1,2018-10-29
10654,경기,여주시,1,0,1,2,1,0,2018-11-29
10655,경기,여주시,2,0,0,2,2,0,2018-12-29
10656,경기,연천군,0,0,0,0,0,0,2018-01-29
10658,경기,연천군,0,0,0,0,0,0,2018-03-29
10659,경기,연천군,0,0,2,2,1,0,2018-04-29
10660,경기,연천군,0,0,0,0,0,0,2018-05-29
10661,경기,연천군,0,0,0,0,0,0,2018-06-29
10662,경기,연천군,0,0,0,0,0,0,2018-07-29
10663,경기,연천군,0,0,0,0,0,0,2018-08-29
10664,경기,연천군,0,0,0,0,0,0,2018-09-29
10665,경기,연천군,0,0,0,0,0,0,2018-10-29
10666,경기,연천군,0,0,0,0,0,0,2018-11-29
10667,경기,연천군,0,0,0,0,0,0,2018-12-29
10668,경기,오산시,2,0,0,2,2,1,2018-01-29
10670,경기,오산시,4,0,0,4,2,0,2018-03-29
10671,경기,오산시,0,0,1,1,1,0,2018-04-29
10672,경기,오산시,0,0,1,1,1,0,2018-05-29
10673,경기,오산시,0,0,1,1,1,0,2018-06-29
10674,경기,오산시,0,0,0,0,1,1,2018-07-29
10675,경기,오산시,4,0,2,6,5,0,2018-08-29
10676,경기,오산시,0,0,1,1,1,0,2018-09-29
10677,경기,오산시,3,0,0,3,3,0,2018-10-29
10678,경기,오산시,0,0,1,1,1,0,2018-11-29
10679,경기,오산시,1,0,1,2,2,1,2018-12-29
10680,경기,용인시,3,0,2,5,5,0,2018-01-29
10682,경기,용인시,9,1,2,12,9,0,2018-03-29
10683,경기,용인시,8,3,6,17,6,0,2018-04-29
10684,경기,용인시,3,1,4,8,8,1,2018-05-29
10685,경기,용인시,7,2,4,13,9,0,2018-06-29
10686,경기,용인시,6,0,1,7,5,0,2018-07-29
10687,경기,용인시,6,3,1,10,8,0,2018-08-29
10688,경기,용인시,13,2,1,16,8,0,2018-09-29
10689,경기,용인시,5,0,2,7,5,0,2018-10-29
10690,경기,용인시,6,0,0,6,5,1,2018-11-29
10691,경기,용인시,8,3,6,17,10,0,2018-12-29
10692,경기,의왕시,0,0,0,0,0,0,2018-01-29
10694,경기,의왕시,0,0,0,0,0,0,2018-03-29
10695,경기,의왕시,0,4,0,4,1,0,2018-04-29
10696,경기,의왕시,3,0,0,3,1,0,2018-05-29
10697,경기,의왕시,1,0,0,1,1,0,2018-06-29
10698,경기,의왕시,2,0,0,2,1,0,2018-07-29
10699,경기,의왕시,2,0,1,3,2,0,2018-08-29
10700,경기,의왕시,3,1,0,4,1,0,2018-09-29
10701,경기,의왕시,0,0,0,0,0,0,2018-10-29
10702,경기,의왕시,3,1,0,4,2,0,2018-11-29
10703,경기,의왕시,0,0,0,0,0,0,2018-12-29
10704,경기,의정부시,11,0,2,13,8,0,2018-01-29
10706,경기,의정부시,3,1,0,4,3,0,2018-03-29
10707,경기,의정부시,4,0,3,7,5,0,2018-04-29
10708,경기,의정부시,3,0,2,5,5,0,2018-05-29
10709,경기,의정부시,4,4,3,11,7,0,2018-06-29
10710,경기,의정부시,5,0,0,5,4,0,2018-07-29
10711,경기,의정부시,4,0,0,4,3,0,2018-08-29
10712,경기,의정부시,6,0,1,7,5,0,2018-09-29
10713,경기,의정부시,3,2,1,6,5,0,2018-10-29
10714,경기,의정부시,8,0,2,10,7,0,2018-11-29
10715,경기,의정부시,4,0,0,4,1,0,2018-12-29
10716,경기,이천시,5,0,0,5,2,0,2018-01-29
10718,경기,이천시,11,0,0,11,6,0,2018-03-29
10719,경기,이천시,7,0,2,9,5,0,2018-04-29
10720,경기,이천시,1,1,1,3,3,0,2018-05-29
10721,경기,이천시,4,0,1,5,4,0,2018-06-29
10722,경기,이천시,2,0,1,3,2,0,2018-07-29
10723,경기,이천시,0,0,0,0,0,0,2018-08-29
10724,경기,이천시,7,0,1,8,1,0,2018-09-29
10725,경기,이천시,14,1,4,19,2,1,2018-10-29
10726,경기,이천시,2,0,0,2,3,1,2018-11-29
10727,경기,이천시,7,0,3,10,3,0,2018-12-29
10728,경기,파주시,7,2,4,13,9,0,2018-01-29
10730,경기,파주시,5,0,3,8,6,1,2018-03-29
10731,경기,파주시,3,0,0,3,3,0,2018-04-29
10732,경기,파주시,5,1,2,8,6,0,2018-05-29
10733,경기,파주시,2,1,2,5,3,0,2018-06-29
10734,경기,파주시,5,1,1,7,5,0,2018-07-29
10735,경기,파주시,5,2,1,8,6,0,2018-08-29
10736,경기,파주시,10,0,2,12,6,0,2018-09-29
10737,경기,파주시,8,0,1,9,8,0,2018-10-29
10738,경기,파주시,9,2,0,11,7,1,2018-11-29
10739,경기,파주시,5,1,1,7,6,0,2018-12-29
10740,경기,평택시,9,0,1,10,7,0,2018-01-29
10742,경기,평택시,19,1,1,21,12,0,2018-03-29
10743,경기,평택시,11,0,3,14,6,0,2018-04-29
10744,경기,평택시,12,0,1,13,10,0,2018-05-29
10745,경기,평택시,17,1,2,20,11,0,2018-06-29
10746,경기,평택시,9,0,2,11,7,1,2018-07-29
10747,경기,평택시,13,0,3,16,8,0,2018-08-29
10748,경기,평택시,4,4,4,12,7,0,2018-09-29
10749,경기,평택시,14,2,3,19,10,0,2018-10-29
10750,경기,평택시,10,0,1,11,5,0,2018-11-29
10751,경기,평택시,9,0,3,12,9,0,2018-12-29
10752,경기,포천시,3,0,0,3,3,0,2018-01-29
10754,경기,포천시,5,1,4,10,7,0,2018-03-29
10755,경기,포천시,0,0,0,0,0,0,2018-04-29
10756,경기,포천시,0,0,0,0,0,0,2018-05-29
10757,경기,포천시,0,0,0,0,0,0,2018-06-29
10758,경기,포천시,0,0,1,1,1,0,2018-07-29
10759,경기,포천시,2,0,0,2,1,0,2018-08-29
10760,경기,포천시,1,0,1,2,3,2,2018-09-29
10761,경기,포천시,1,0,1,2,1,0,2018-10-29
10762,경기,포천시,1,0,0,1,1,0,2018-11-29
10763,경기,포천시,2,0,3,5,4,0,2018-12-29
10764,경기,하남시,0,0,1,1,1,0,2018-01-29
10766,경기,하남시,1,0,0,1,1,0,2018-03-29
10767,경기,하남시,0,0,0,0,0,0,2018-04-29
10768,경기,하남시,3,1,3,7,5,0,2018-05-29
10769,경기,하남시,2,1,0,3,3,0,2018-06-29
10770,경기,하남시,7,2,0,9,3,0,2018-07-29
10771,경기,하남시,1,1,0,2,1,0,2018-08-29
10772,경기,하남시,5,0,1,6,1,0,2018-09-29
10773,경기,하남시,3,0,2,5,5,0,2018-10-29
10774,경기,하남시,1,0,1,2,2,0,2018-11-29
10775,경기,하남시,1,1,0,2,2,0,2018-12-29
10776,경기,화성시,6,1,2,9,5,0,2018-01-29
10778,경기,화성시,13,1,3,17,13,0,2018-03-29
10779,경기,화성시,5,2,8,15,9,2,2018-04-29
10780,경기,화성시,18,1,4,23,19,2,2018-05-29
10781,경기,화성시,10,3,4,17,10,0,2018-06-29
10782,경기,화성시,15,0,3,18,10,0,2018-07-29
10783,경기,화성시,8,1,2,11,7,0,2018-08-29
10784,경기,화성시,11,0,3,14,8,0,2018-09-29
10785,경기,화성시,17,1,1,19,13,0,2018-10-29
10786,경기,화성시,10,0,4,14,9,0,2018-11-29
10787,경기,화성시,9,0,3,12,5,0,2018-12-29
10788,경기,가평군,0,0,0,0,0,0,2018-01-30
10790,경기,가평군,0,2,0,2,2,0,2018-03-30
10791,경기,가평군,0,0,0,0,0,0,2018-04-30
10792,경기,가평군,0,0,1,1,1,0,2018-05-30
10793,경기,가평군,5,0,1,6,2,0,2018-06-30
10794,경기,가평군,6,0,1,7,3,0,2018-07-30
10795,경기,가평군,0,0,0,0,0,0,2018-08-30
10796,경기,가평군,4,0,0,4,2,0,2018-09-30
10797,경기,가평군,1,0,1,2,2,0,2018-10-30
10798,경기,가평군,0,0,0,0,0,0,2018-11-30
10799,경기,가평군,0,0,0,0,0,0,2018-12-30
10800,경기,고양시,11,2,1,14,14,0,2018-01-30
10802,경기,고양시,14,0,1,15,10,0,2018-03-30
10803,경기,고양시,12,2,11,25,17,1,2018-04-30
10804,경기,고양시,9,0,2,11,8,0,2018-05-30
10805,경기,고양시,7,1,3,11,9,0,2018-06-30
10806,경기,고양시,11,0,1,12,6,0,2018-07-30
10807,경기,고양시,5,2,4,11,9,0,2018-08-30
10808,경기,고양시,14,1,1,16,9,0,2018-09-30
10809,경기,고양시,4,2,5,11,8,0,2018-10-30
10810,경기,고양시,18,2,8,28,21,1,2018-11-30
10811,경기,고양시,7,1,2,10,7,0,2018-12-30
10812,경기,과천시,4,0,4,8,3,0,2018-01-30
10814,경기,과천시,0,1,0,1,1,0,2018-03-30
10815,경기,과천시,0,0,0,0,0,0,2018-04-30
10816,경기,과천시,0,1,0,1,1,0,2018-05-30
10817,경기,과천시,0,0,0,0,0,0,2018-06-30
10818,경기,과천시,1,0,0,1,1,0,2018-07-30
10819,경기,과천시,0,0,0,0,0,0,2018-08-30
10820,경기,과천시,0,0,0,0,0,0,2018-09-30
10821,경기,과천시,0,0,1,1,1,0,2018-10-30
10822,경기,과천시,0,0,0,0,0,0,2018-11-30
10823,경기,과천시,0,0,0,0,0,0,2018-12-30
10824,경기,광명시,1,0,0,1,1,0,2018-01-30
10826,경기,광명시,1,3,0,4,2,0,2018-03-30
10827,경기,광명시,1,0,0,1,1,0,2018-04-30
10828,경기,광명시,2,0,0,2,1,0,2018-05-30
10829,경기,광명시,4,0,1,5,4,0,2018-06-30
10830,경기,광명시,3,1,0,4,4,0,2018-07-30
10831,경기,광명시,1,2,0,3,3,0,2018-08-30
10832,경기,광명시,1,1,2,4,3,0,2018-09-30
10833,경기,광명시,4,3,0,7,5,1,2018-10-30
10834,경기,광명시,2,0,2,4,2,0,2018-11-30
10835,경기,광명시,3,0,0,3,2,0,2018-12-30
10836,경기,광주시,13,3,1,17,9,0,2018-01-30
10838,경기,광주시,5,0,3,8,6,0,2018-03-30
10839,경기,광주시,6,0,0,6,5,0,2018-04-30
10840,경기,광주시,4,0,0,4,4,0,2018-05-30
10841,경기,광주시,0,0,0,0,0,0,2018-06-30
10842,경기,광주시,10,3,7,20,10,0,2018-07-30
10843,경기,광주시,6,0,1,7,4,1,2018-08-30
10844,경기,광주시,13,0,1,14,7,0,2018-09-30
10845,경기,광주시,2,0,0,2,2,0,2018-10-30
10846,경기,광주시,5,0,3,8,6,0,2018-11-30
10847,경기,광주시,2,2,0,4,4,0,2018-12-30
10848,경기,구리시,5,0,0,5,3,0,2018-01-30
10850,경기,구리시,0,0,0,0,0,0,2018-03-30
10851,경기,구리시,0,0,1,1,1,0,2018-04-30
10852,경기,구리시,0,0,3,3,2,1,2018-05-30
10853,경기,구리시,2,0,0,2,2,0,2018-06-30
10854,경기,구리시,5,0,0,5,4,0,2018-07-30
10855,경기,구리시,2,0,0,2,2,0,2018-08-30
10856,경기,구리시,1,0,1,2,2,0,2018-09-30
10857,경기,구리시,0,0,2,2,2,0,2018-10-30
10858,경기,구리시,5,1,0,6,5,0,2018-11-30
10859,경기,구리시,0,0,0,0,0,0,2018-12-30
10860,경기,군포시,0,2,2,4,3,0,2018-01-30
10862,경기,군포시,0,0,1,1,1,0,2018-03-30
10863,경기,군포시,0,0,0,0,0,0,2018-04-30
10864,경기,군포시,1,0,1,2,2,0,2018-05-30
10865,경기,군포시,2,0,1,3,3,0,2018-06-30
10866,경기,군포시,1,0,0,1,1,0,2018-07-30
10867,경기,군포시,0,0,2,2,2,0,2018-08-30
10868,경기,군포시,1,0,1,2,2,0,2018-09-30
10869,경기,군포시,3,1,0,4,2,0,2018-10-30
10870,경기,군포시,2,1,0,3,3,0,2018-11-30
10871,경기,군포시,3,1,2,6,4,0,2018-12-30
10872,경기,김포시,2,0,0,2,2,0,2018-01-30
10874,경기,김포시,2,0,0,2,2,0,2018-03-30
10875,경기,김포시,2,0,0,2,1,0,2018-04-30
10876,경기,김포시,5,0,1,6,5,0,2018-05-30
10877,경기,김포시,6,1,0,7,6,0,2018-06-30
10878,경기,김포시,6,0,2,8,6,0,2018-07-30
10879,경기,김포시,5,0,1,6,5,0,2018-08-30
10880,경기,김포시,1,1,1,3,4,1,2018-09-30
10881,경기,김포시,1,2,0,3,1,0,2018-10-30
10882,경기,김포시,9,1,1,11,7,0,2018-11-30
10883,경기,김포시,3,0,2,5,4,0,2018-12-30
10884,경기,남양주시,14,3,1,18,12,0,2018-01-30
10886,경기,남양주시,12,0,2,14,10,0,2018-03-30
10887,경기,남양주시,12,1,0,13,8,0,2018-04-30
10888,경기,남양주시,8,11,4,23,13,1,2018-05-30
10889,경기,남양주시,6,2,3,11,8,1,2018-06-30
10890,경기,남양주시,6,4,7,17,11,0,2018-07-30
10891,경기,남양주시,7,1,2,10,7,0,2018-08-30
10892,경기,남양주시,11,1,2,14,7,0,2018-09-30
10893,경기,남양주시,9,1,2,12,6,0,2018-10-30
10894,경기,남양주시,6,3,3,12,10,0,2018-11-30
10895,경기,남양주시,4,1,2,7,5,0,2018-12-30
10896,경기,동두천시,6,1,1,8,5,0,2018-01-30
10898,경기,동두천시,0,0,1,1,1,0,2018-03-30
10899,경기,동두천시,2,0,0,2,1,0,2018-04-30
10900,경기,동두천시,0,0,0,0,0,0,2018-05-30
10901,경기,동두천시,0,0,0,0,0,0,2018-06-30
10902,경기,동두천시,4,0,1,5,3,0,2018-07-30
10903,경기,동두천시,1,0,0,1,1,0,2018-08-30
10904,경기,동두천시,0,0,2,2,2,0,2018-09-30
10905,경기,동두천시,1,1,1,3,2,0,2018-10-30
10906,경기,동두천시,0,0,1,1,1,0,2018-11-30
10907,경기,동두천시,0,0,0,0,0,0,2018-12-30
10908,경기,부천시,6,1,3,10,7,0,2018-01-30
10910,경기,부천시,7,0,3,10,8,0,2018-03-30
10911,경기,부천시,6,0,0,6,6,0,2018-04-30
10912,경기,부천시,6,0,2,8,7,0,2018-05-30
10913,경기,부천시,6,1,2,9,6,0,2018-06-30
10914,경기,부천시,8,0,0,8,7,0,2018-07-30
10915,경기,부천시,5,0,1,6,5,0,2018-08-30
10916,경기,부천시,4,1,1,6,5,0,2018-09-30
10917,경기,부천시,9,5,1,15,11,0,2018-10-30
10918,경기,부천시,10,1,1,12,9,0,2018-11-30
10919,경기,부천시,2,1,1,4,3,0,2018-12-30
10920,경기,성남시,16,1,3,20,12,0,2018-01-30
10922,경기,성남시,6,10,5,21,8,0,2018-03-30
10923,경기,성남시,11,3,3,17,11,0,2018-04-30
10924,경기,성남시,13,1,1,15,12,0,2018-05-30
10925,경기,성남시,2,0,4,6,5,0,2018-06-30
10926,경기,성남시,20,1,3,24,12,0,2018-07-30
10927,경기,성남시,6,0,1,7,7,0,2018-08-30
10928,경기,성남시,2,1,3,6,5,0,2018-09-30
10929,경기,성남시,7,1,3,11,8,0,2018-10-30
10930,경기,성남시,11,2,3,16,8,0,2018-11-30
10931,경기,성남시,10,0,1,11,7,0,2018-12-30
10932,경기,수원시,12,0,7,19,14,0,2018-01-30
10934,경기,수원시,18,1,4,23,15,0,2018-03-30
10935,경기,수원시,3,4,3,10,7,0,2018-04-30
10936,경기,수원시,13,0,7,20,12,0,2018-05-30
10937,경기,수원시,25,3,4,32,20,1,2018-06-30
10938,경기,수원시,14,4,3,21,16,0,2018-07-30
10939,경기,수원시,10,2,2,14,9,0,2018-08-30
10940,경기,수원시,13,0,2,15,10,0,2018-09-30
10941,경기,수원시,12,1,1,14,10,0,2018-10-30
10942,경기,수원시,12,2,3,17,11,0,2018-11-30
10943,경기,수원시,12,1,5,18,14,0,2018-12-30
10944,경기,시흥시,9,0,4,13,9,0,2018-01-30
10946,경기,시흥시,13,0,1,14,11,0,2018-03-30
10947,경기,시흥시,9,0,2,11,9,0,2018-04-30
10948,경기,시흥시,4,0,2,6,5,0,2018-05-30
10949,경기,시흥시,8,0,1,9,5,0,2018-06-30
10950,경기,시흥시,19,3,1,23,8,0,2018-07-30
10951,경기,시흥시,7,0,1,8,5,0,2018-08-30
10952,경기,시흥시,13,2,2,17,9,0,2018-09-30
10953,경기,시흥시,10,1,1,12,7,0,2018-10-30
10954,경기,시흥시,11,0,2,13,9,0,2018-11-30
10955,경기,시흥시,3,1,0,4,3,0,2018-12-30
10956,경기,안산시,15,0,2,17,11,0,2018-01-30
10958,경기,안산시,11,1,3,15,8,0,2018-03-30
10959,경기,안산시,11,0,4,15,12,0,2018-04-30
10960,경기,안산시,13,1,1,15,11,0,2018-05-30
10961,경기,안산시,20,1,5,26,17,0,2018-06-30
10962,경기,안산시,12,1,5,18,7,0,2018-07-30
10963,경기,안산시,16,1,1,18,13,0,2018-08-30
10964,경기,안산시,21,1,7,29,17,0,2018-09-30
10965,경기,안산시,12,1,4,17,15,1,2018-10-30
10966,경기,안산시,14,0,4,18,13,0,2018-11-30
10967,경기,안산시,2,1,1,4,3,0,2018-12-30
10968,경기,안성시,2,0,1,3,2,0,2018-01-30
10970,경기,안성시,3,0,1,4,2,0,2018-03-30
10971,경기,안성시,4,1,3,8,6,0,2018-04-30
10972,경기,안성시,3,1,0,4,3,0,2018-05-30
10973,경기,안성시,0,0,2,2,2,0,2018-06-30
10974,경기,안성시,3,1,1,5,4,0,2018-07-30
10975,경기,안성시,9,0,0,9,3,0,2018-08-30
10976,경기,안성시,0,0,1,1,1,0,2018-09-30
10977,경기,안성시,5,2,2,9,5,0,2018-10-30
10978,경기,안성시,5,0,0,5,4,0,2018-11-30
10979,경기,안성시,3,0,1,4,3,0,2018-12-30
10980,경기,안양시,3,0,2,5,4,0,2018-01-30
10982,경기,안양시,5,0,0,5,5,0,2018-03-30
10983,경기,안양시,6,1,1,8,5,0,2018-04-30
10984,경기,안양시,6,0,4,10,5,0,2018-05-30
10985,경기,안양시,2,1,1,4,4,0,2018-06-30
10986,경기,안양시,10,0,0,10,5,0,2018-07-30
10987,경기,안양시,4,0,1,5,4,0,2018-08-30
10988,경기,안양시,4,0,7,11,4,0,2018-09-30
10989,경기,안양시,5,0,3,8,6,0,2018-10-30
10990,경기,안양시,8,0,3,11,8,0,2018-11-30
10991,경기,안양시,7,0,1,8,5,0,2018-12-30
10992,경기,양주시,1,0,0,1,1,0,2018-01-30
10994,경기,양주시,1,1,2,4,4,0,2018-03-30
10995,경기,양주시,9,1,1,11,4,0,2018-04-30
10996,경기,양주시,0,0,1,1,1,0,2018-05-30
10997,경기,양주시,4,0,1,5,2,0,2018-06-30
10998,경기,양주시,1,0,0,1,1,0,2018-07-30
10999,경기,양주시,4,0,2,6,3,0,2018-08-30
11000,경기,양주시,6,0,0,6,2,0,2018-09-30
11001,경기,양주시,5,2,0,7,6,1,2018-10-30
11002,경기,양주시,7,0,0,7,4,0,2018-11-30
11003,경기,양주시,3,0,0,3,2,0,2018-12-30
11004,경기,양평군,0,0,0,0,0,0,2018-01-30
11006,경기,양평군,0,0,0,0,0,0,2018-03-30
11007,경기,양평군,1,0,0,1,1,0,2018-04-30
11008,경기,양평군,1,0,3,4,4,0,2018-05-30
11009,경기,양평군,3,0,1,4,3,0,2018-06-30
11010,경기,양평군,7,0,0,7,2,0,2018-07-30
11011,경기,양평군,0,0,1,1,1,0,2018-08-30
11012,경기,양평군,5,0,2,7,3,0,2018-09-30
11013,경기,양평군,0,0,0,0,0,0,2018-10-30
11014,경기,양평군,4,0,1,5,1,0,2018-11-30
11015,경기,양평군,0,0,0,0,0,0,2018-12-30
11016,경기,여주시,2,0,0,2,1,0,2018-01-30
11018,경기,여주시,0,2,0,2,2,0,2018-03-30
11019,경기,여주시,0,0,0,0,0,0,2018-04-30
11020,경기,여주시,6,0,0,6,2,0,2018-05-30
11021,경기,여주시,0,0,2,2,2,0,2018-06-30
11022,경기,여주시,0,0,0,0,0,0,2018-07-30
11023,경기,여주시,2,0,0,2,2,0,2018-08-30
11024,경기,여주시,1,0,1,2,1,0,2018-09-30
11025,경기,여주시,3,1,1,5,4,0,2018-10-30
11026,경기,여주시,4,0,0,4,2,0,2018-11-30
11027,경기,여주시,0,0,0,0,0,0,2018-12-30
11028,경기,연천군,1,0,0,1,1,0,2018-01-30
11030,경기,연천군,0,0,0,0,0,0,2018-03-30
11031,경기,연천군,0,0,0,0,0,0,2018-04-30
11032,경기,연천군,2,0,1,3,2,0,2018-05-30
11033,경기,연천군,0,0,0,0,0,0,2018-06-30
11034,경기,연천군,0,0,1,1,1,0,2018-07-30
11035,경기,연천군,0,0,0,0,0,0,2018-08-30
11036,경기,연천군,0,0,0,0,0,0,2018-09-30
11037,경기,연천군,0,0,0,0,0,0,2018-10-30
11038,경기,연천군,0,0,0,0,0,0,2018-11-30
11039,경기,연천군,0,0,0,0,0,0,2018-12-30
11040,경기,오산시,1,0,1,2,2,0,2018-01-30
11042,경기,오산시,2,0,0,2,1,0,2018-03-30
11043,경기,오산시,2,1,0,3,3,0,2018-04-30
11044,경기,오산시,2,0,2,4,4,0,2018-05-30
11045,경기,오산시,5,0,1,6,3,0,2018-06-30
11046,경기,오산시,5,0,2,7,5,0,2018-07-30
11047,경기,오산시,0,1,1,2,2,0,2018-08-30
11048,경기,오산시,2,0,1,3,3,0,2018-09-30
11049,경기,오산시,3,0,0,3,2,0,2018-10-30
11050,경기,오산시,1,0,3,4,4,0,2018-11-30
11051,경기,오산시,0,0,0,0,0,0,2018-12-30
11052,경기,용인시,10,2,7,19,12,0,2018-01-30
11054,경기,용인시,10,3,2,15,9,0,2018-03-30
11055,경기,용인시,4,0,5,9,5,0,2018-04-30
11056,경기,용인시,25,5,4,34,16,1,2018-05-30
11057,경기,용인시,5,9,1,15,4,0,2018-06-30
11058,경기,용인시,14,1,4,19,10,0,2018-07-30
11059,경기,용인시,13,4,0,17,7,0,2018-08-30
11060,경기,용인시,10,1,1,12,10,0,2018-09-30
11061,경기,용인시,17,1,4,22,16,1,2018-10-30
11062,경기,용인시,10,5,4,19,15,0,2018-11-30
11063,경기,용인시,2,0,0,2,2,0,2018-12-30
11064,경기,의왕시,6,0,0,6,2,0,2018-01-30
11066,경기,의왕시,0,0,0,0,0,0,2018-03-30
11067,경기,의왕시,1,0,1,2,2,0,2018-04-30
11068,경기,의왕시,0,0,0,0,0,0,2018-05-30
11069,경기,의왕시,0,0,1,1,1,0,2018-06-30
11070,경기,의왕시,0,0,0,0,0,0,2018-07-30
11071,경기,의왕시,0,0,0,0,0,0,2018-08-30
11072,경기,의왕시,1,0,0,1,1,0,2018-09-30
11073,경기,의왕시,1,0,0,1,1,0,2018-10-30
11074,경기,의왕시,1,0,1,2,1,0,2018-11-30
11075,경기,의왕시,0,0,0,0,0,0,2018-12-30
11076,경기,의정부시,8,4,1,13,6,0,2018-01-30
11078,경기,의정부시,3,1,0,4,4,1,2018-03-30
11079,경기,의정부시,5,4,0,9,7,0,2018-04-30
11080,경기,의정부시,4,0,3,7,5,0,2018-05-30
11081,경기,의정부시,0,0,0,0,0,0,2018-06-30
11082,경기,의정부시,4,1,2,7,6,1,2018-07-30
11083,경기,의정부시,7,1,1,9,5,0,2018-08-30
11084,경기,의정부시,1,1,1,3,1,0,2018-09-30
11085,경기,의정부시,5,0,1,6,6,0,2018-10-30
11086,경기,의정부시,1,1,1,3,3,0,2018-11-30
11087,경기,의정부시,6,0,0,6,4,0,2018-12-30
11088,경기,이천시,0,0,0,0,0,0,2018-01-30
11090,경기,이천시,0,0,1,1,1,0,2018-03-30
11091,경기,이천시,3,0,0,3,2,0,2018-04-30
11092,경기,이천시,1,0,0,1,1,0,2018-05-30
11093,경기,이천시,6,1,1,8,4,0,2018-06-30
11094,경기,이천시,3,0,1,4,4,0,2018-07-30
11095,경기,이천시,1,1,0,2,2,0,2018-08-30
11096,경기,이천시,6,0,0,6,3,0,2018-09-30
11097,경기,이천시,5,0,0,5,4,0,2018-10-30
11098,경기,이천시,2,0,0,2,1,0,2018-11-30
11099,경기,이천시,1,0,1,2,2,0,2018-12-30
11100,경기,파주시,3,0,1,4,3,0,2018-01-30
11102,경기,파주시,11,2,1,14,3,0,2018-03-30
11103,경기,파주시,4,0,2,6,4,0,2018-04-30
11104,경기,파주시,5,0,2,7,4,0,2018-05-30
11105,경기,파주시,2,0,1,3,3,0,2018-06-30
11106,경기,파주시,3,0,1,4,4,0,2018-07-30
11107,경기,파주시,2,2,1,5,5,0,2018-08-30
11108,경기,파주시,2,0,1,3,3,0,2018-09-30
11109,경기,파주시,7,0,2,9,7,0,2018-10-30
11110,경기,파주시,3,0,0,3,3,0,2018-11-30
11111,경기,파주시,5,0,0,5,2,0,2018-12-30
11112,경기,평택시,13,6,2,21,10,0,2018-01-30
11114,경기,평택시,10,5,2,17,13,0,2018-03-30
11115,경기,평택시,10,2,3,15,12,0,2018-04-30
11116,경기,평택시,8,4,5,17,10,0,2018-05-30
11117,경기,평택시,12,4,2,18,11,0,2018-06-30
11118,경기,평택시,11,0,3,14,7,0,2018-07-30
11119,경기,평택시,6,1,3,10,10,2,2018-08-30
11120,경기,평택시,7,0,5,12,4,0,2018-09-30
11121,경기,평택시,3,0,2,5,5,0,2018-10-30
11122,경기,평택시,14,4,2,20,13,1,2018-11-30
11123,경기,평택시,5,3,5,13,8,1,2018-12-30
11124,경기,포천시,3,2,1,6,4,0,2018-01-30
11126,경기,포천시,4,6,5,15,7,1,2018-03-30
11127,경기,포천시,4,0,1,5,3,0,2018-04-30
11128,경기,포천시,5,0,2,7,6,0,2018-05-30
11129,경기,포천시,1,0,0,1,1,0,2018-06-30
11130,경기,포천시,0,2,0,2,1,0,2018-07-30
11131,경기,포천시,6,1,0,7,5,0,2018-08-30
11132,경기,포천시,0,0,0,0,0,0,2018-09-30
11133,경기,포천시,0,1,1,2,2,0,2018-10-30
11134,경기,포천시,4,0,3,7,7,0,2018-11-30
11135,경기,포천시,6,0,1,7,3,0,2018-12-30
11136,경기,하남시,2,0,3,5,3,0,2018-01-30
11138,경기,하남시,7,1,1,9,5,0,2018-03-30
11139,경기,하남시,3,0,0,3,2,0,2018-04-30
11140,경기,하남시,3,1,0,4,4,0,2018-05-30
11141,경기,하남시,1,1,0,2,2,0,2018-06-30
11142,경기,하남시,9,0,0,9,3,0,2018-07-30
11143,경기,하남시,1,0,0,1,1,0,2018-08-30
11144,경기,하남시,0,0,1,1,1,0,2018-09-30
11145,경기,하남시,7,3,3,13,7,0,2018-10-30
11146,경기,하남시,1,0,2,3,3,0,2018-11-30
11147,경기,하남시,1,0,0,1,1,0,2018-12-30
11148,경기,화성시,9,0,2,11,6,0,2018-01-30
11150,경기,화성시,11,0,8,19,12,0,2018-03-30
11151,경기,화성시,7,0,4,11,8,0,2018-04-30
11152,경기,화성시,10,2,2,14,7,0,2018-05-30
11153,경기,화성시,4,3,4,11,6,0,2018-06-30
11154,경기,화성시,10,0,7,17,12,0,2018-07-30
11155,경기,화성시,5,1,4,10,8,0,2018-08-30
11156,경기,화성시,10,0,1,11,6,0,2018-09-30
11157,경기,화성시,14,8,5,27,10,0,2018-10-30
11158,경기,화성시,10,0,4,14,10,0,2018-11-30
11159,경기,화성시,1,0,1,2,2,0,2018-12-30
11160,경기,가평군,0,0,0,0,0,0,2018-01-31
11162,경기,가평군,0,1,1,2,2,0,2018-03-31
11164,경기,가평군,4,3,1,8,3,0,2018-05-31
11166,경기,가평군,3,1,1,5,3,0,2018-07-31
11167,경기,가평군,0,0,0,0,0,0,2018-08-31
11169,경기,가평군,0,0,0,0,0,0,2018-10-31
11171,경기,가평군,4,0,0,4,1,0,2018-12-31
11172,경기,고양시,18,0,4,22,15,0,2018-01-31
11174,경기,고양시,7,1,0,8,7,0,2018-03-31
11176,경기,고양시,9,4,7,20,14,0,2018-05-31
11178,경기,고양시,11,0,2,13,9,0,2018-07-31
11179,경기,고양시,7,0,3,10,7,0,2018-08-31
11181,경기,고양시,17,2,5,24,14,0,2018-10-31
11183,경기,고양시,12,0,1,13,9,0,2018-12-31
11184,경기,과천시,2,0,0,2,2,0,2018-01-31
11186,경기,과천시,1,1,1,3,2,0,2018-03-31
11188,경기,과천시,3,0,1,4,2,0,2018-05-31
11190,경기,과천시,1,0,0,1,1,0,2018-07-31
11191,경기,과천시,0,0,1,1,1,0,2018-08-31
11193,경기,과천시,0,0,0,0,0,0,2018-10-31
11195,경기,과천시,0,0,0,0,0,0,2018-12-31
11196,경기,광명시,3,0,0,3,2,0,2018-01-31
11198,경기,광명시,2,0,0,2,2,1,2018-03-31
11200,경기,광명시,0,3,0,3,2,0,2018-05-31
11202,경기,광명시,3,0,0,3,3,0,2018-07-31
11203,경기,광명시,2,1,1,4,4,0,2018-08-31
11205,경기,광명시,0,0,1,1,1,0,2018-10-31
11207,경기,광명시,1,0,2,3,3,0,2018-12-31
11208,경기,광주시,3,0,1,4,3,0,2018-01-31
11210,경기,광주시,1,0,1,2,2,0,2018-03-31
11212,경기,광주시,3,0,2,5,4,0,2018-05-31
11214,경기,광주시,4,2,1,7,4,0,2018-07-31
11215,경기,광주시,6,0,2,8,5,0,2018-08-31
11217,경기,광주시,2,0,0,2,2,0,2018-10-31
11219,경기,광주시,9,0,1,10,6,0,2018-12-31
11220,경기,구리시,2,1,0,3,3,0,2018-01-31
11222,경기,구리시,0,0,0,0,0,0,2018-03-31
11224,경기,구리시,4,0,1,5,3,0,2018-05-31
11226,경기,구리시,2,0,0,2,1,0,2018-07-31
11227,경기,구리시,1,0,0,1,1,0,2018-08-31
11229,경기,구리시,0,0,0,0,0,0,2018-10-31
11231,경기,구리시,1,1,0,2,2,0,2018-12-31
11232,경기,군포시,12,1,2,15,5,0,2018-01-31
11234,경기,군포시,1,0,1,2,2,0,2018-03-31
11236,경기,군포시,1,1,1,3,2,0,2018-05-31
11238,경기,군포시,0,0,1,1,1,0,2018-07-31
11239,경기,군포시,1,0,0,1,1,0,2018-08-31
11241,경기,군포시,2,0,1,3,2,0,2018-10-31
11243,경기,군포시,0,0,0,0,0,0,2018-12-31
11244,경기,김포시,7,0,3,10,8,0,2018-01-31
11246,경기,김포시,18,0,2,20,10,0,2018-03-31
11248,경기,김포시,2,0,2,4,4,0,2018-05-31
11250,경기,김포시,7,0,2,9,6,0,2018-07-31
11251,경기,김포시,6,0,4,10,8,0,2018-08-31
11253,경기,김포시,2,3,0,5,4,1,2018-10-31
11255,경기,김포시,5,1,1,7,4,0,2018-12-31
11256,경기,남양주시,12,0,3,15,9,1,2018-01-31
11258,경기,남양주시,9,2,1,12,7,0,2018-03-31
11260,경기,남양주시,3,0,1,4,2,0,2018-05-31
11262,경기,남양주시,9,0,0,9,5,0,2018-07-31
11263,경기,남양주시,9,0,3,12,10,0,2018-08-31
11265,경기,남양주시,5,0,1,6,4,0,2018-10-31
11267,경기,남양주시,4,0,0,4,3,0,2018-12-31
11268,경기,동두천시,2,0,1,3,1,0,2018-01-31
11270,경기,동두천시,3,0,2,5,3,0,2018-03-31
11272,경기,동두천시,3,0,2,5,2,0,2018-05-31
11274,경기,동두천시,0,0,1,1,1,0,2018-07-31
11275,경기,동두천시,1,0,0,1,1,0,2018-08-31
11277,경기,동두천시,3,0,0,3,2,0,2018-10-31
11279,경기,동두천시,1,0,0,1,1,0,2018-12-31
11280,경기,부천시,7,0,0,7,4,0,2018-01-31
11282,경기,부천시,7,0,0,7,6,0,2018-03-31
11284,경기,부천시,12,1,2,15,10,0,2018-05-31
11286,경기,부천시,9,0,1,10,8,0,2018-07-31
11287,경기,부천시,5,4,1,10,7,1,2018-08-31
11289,경기,부천시,11,1,3,15,12,0,2018-10-31
11291,경기,부천시,7,1,1,9,8,0,2018-12-31
11292,경기,성남시,12,0,5,17,14,0,2018-01-31
11294,경기,성남시,11,1,2,14,9,0,2018-03-31
11296,경기,성남시,10,0,4,14,12,0,2018-05-31
11298,경기,성남시,10,0,4,14,10,0,2018-07-31
11299,경기,성남시,7,0,1,8,8,0,2018-08-31
11301,경기,성남시,7,2,1,10,7,0,2018-10-31
11303,경기,성남시,12,2,4,18,15,0,2018-12-31
11304,경기,수원시,18,2,5,25,21,0,2018-01-31
11306,경기,수원시,20,2,2,24,16,0,2018-03-31
11308,경기,수원시,11,3,3,17,16,0,2018-05-31
11310,경기,수원시,19,4,7,30,13,0,2018-07-31
11311,경기,수원시,15,3,1,19,13,1,2018-08-31
11313,경기,수원시,24,1,3,28,21,1,2018-10-31
11315,경기,수원시,21,1,3,25,16,0,2018-12-31
11316,경기,시흥시,4,0,2,6,5,0,2018-01-31
11318,경기,시흥시,10,1,1,12,7,0,2018-03-31
11320,경기,시흥시,6,0,0,6,6,0,2018-05-31
11322,경기,시흥시,12,0,0,12,7,1,2018-07-31
11323,경기,시흥시,6,0,1,7,7,0,2018-08-31
11325,경기,시흥시,3,0,0,3,3,0,2018-10-31
11327,경기,시흥시,14,3,4,21,8,0,2018-12-31
11328,경기,안산시,22,1,2,25,17,1,2018-01-31
11330,경기,안산시,9,2,0,11,9,0,2018-03-31
11332,경기,안산시,8,3,0,11,8,0,2018-05-31
11334,경기,안산시,12,3,3,18,10,0,2018-07-31
11335,경기,안산시,18,0,6,24,17,0,2018-08-31
11337,경기,안산시,7,2,4,13,8,0,2018-10-31
11339,경기,안산시,17,0,4,21,15,0,2018-12-31
11340,경기,안성시,3,0,1,4,2,0,2018-01-31
11342,경기,안성시,12,1,2,15,3,0,2018-03-31
11344,경기,안성시,3,0,1,4,3,0,2018-05-31
11346,경기,안성시,6,2,0,8,5,0,2018-07-31
11347,경기,안성시,6,0,0,6,3,0,2018-08-31
11349,경기,안성시,2,0,1,3,2,0,2018-10-31
11351,경기,안성시,1,0,0,1,1,0,2018-12-31
11352,경기,안양시,4,0,1,5,5,0,2018-01-31
11354,경기,안양시,2,1,2,5,4,0,2018-03-31
11356,경기,안양시,7,0,1,8,6,0,2018-05-31
11358,경기,안양시,1,2,0,3,3,0,2018-07-31
11359,경기,안양시,1,0,1,2,2,0,2018-08-31
11361,경기,안양시,3,1,4,8,8,0,2018-10-31
11363,경기,안양시,2,0,1,3,3,0,2018-12-31
11364,경기,양주시,2,0,0,2,2,0,2018-01-31
11366,경기,양주시,3,0,0,3,3,0,2018-03-31
11368,경기,양주시,4,0,6,10,4,0,2018-05-31
11370,경기,양주시,1,4,0,5,1,0,2018-07-31
11371,경기,양주시,6,0,1,7,5,1,2018-08-31
11373,경기,양주시,6,0,1,7,4,0,2018-10-31
11375,경기,양주시,4,0,0,4,4,0,2018-12-31
11376,경기,양평군,2,1,0,3,3,0,2018-01-31
11378,경기,양평군,0,0,0,0,0,0,2018-03-31
11380,경기,양평군,0,0,1,1,1,0,2018-05-31
11382,경기,양평군,0,0,2,2,2,0,2018-07-31
11383,경기,양평군,4,0,0,4,2,0,2018-08-31
11385,경기,양평군,2,0,1,3,3,0,2018-10-31
11387,경기,양평군,1,1,1,3,3,0,2018-12-31
11388,경기,여주시,9,2,1,12,6,0,2018-01-31
11390,경기,여주시,1,0,0,1,1,0,2018-03-31
11392,경기,여주시,2,0,2,4,1,0,2018-05-31
11394,경기,여주시,0,0,0,0,0,0,2018-07-31
11395,경기,여주시,3,0,1,4,4,1,2018-08-31
11397,경기,여주시,5,0,0,5,4,0,2018-10-31
11399,경기,여주시,2,0,0,2,1,0,2018-12-31
11400,경기,연천군,0,0,0,0,0,0,2018-01-31
11402,경기,연천군,0,0,0,0,0,0,2018-03-31
11404,경기,연천군,0,0,0,0,0,0,2018-05-31
11406,경기,연천군,0,0,0,0,0,0,2018-07-31
11407,경기,연천군,0,0,0,0,0,0,2018-08-31
11409,경기,연천군,0,0,0,0,0,0,2018-10-31
11411,경기,연천군,1,0,0,1,1,0,2018-12-31
11412,경기,오산시,4,1,0,5,3,0,2018-01-31
11414,경기,오산시,1,0,0,1,1,0,2018-03-31
11416,경기,오산시,3,0,2,5,4,0,2018-05-31
11418,경기,오산시,9,1,1,11,6,0,2018-07-31
11419,경기,오산시,2,1,1,4,4,0,2018-08-31
11421,경기,오산시,0,1,2,3,3,0,2018-10-31
11423,경기,오산시,5,0,0,5,2,0,2018-12-31
11424,경기,용인시,11,3,1,15,9,0,2018-01-31
11426,경기,용인시,12,0,4,16,10,0,2018-03-31
11428,경기,용인시,3,3,0,6,5,0,2018-05-31
11430,경기,용인시,6,1,4,11,8,0,2018-07-31
11431,경기,용인시,6,0,7,13,11,1,2018-08-31
11433,경기,용인시,13,2,1,16,12,0,2018-10-31
11435,경기,용인시,13,1,6,20,10,0,2018-12-31
11436,경기,의왕시,3,0,0,3,2,0,2018-01-31
11438,경기,의왕시,0,0,1,1,1,0,2018-03-31
11440,경기,의왕시,1,0,0,1,1,0,2018-05-31
11442,경기,의왕시,4,0,0,4,3,0,2018-07-31
11443,경기,의왕시,2,0,0,2,1,0,2018-08-31
11445,경기,의왕시,0,0,0,0,0,0,2018-10-31
11447,경기,의왕시,1,0,0,1,1,0,2018-12-31
11448,경기,의정부시,10,4,6,20,5,0,2018-01-31
11450,경기,의정부시,7,0,1,8,5,0,2018-03-31
11452,경기,의정부시,4,1,1,6,6,0,2018-05-31
11454,경기,의정부시,3,0,5,8,6,0,2018-07-31
11455,경기,의정부시,7,0,2,9,6,0,2018-08-31
11457,경기,의정부시,4,0,3,7,5,0,2018-10-31
11459,경기,의정부시,2,1,0,3,3,0,2018-12-31
11460,경기,이천시,4,0,4,8,5,0,2018-01-31
11462,경기,이천시,2,0,0,2,1,0,2018-03-31
11464,경기,이천시,2,1,1,4,3,0,2018-05-31
11466,경기,이천시,5,0,2,7,4,0,2018-07-31
11467,경기,이천시,4,0,1,5,4,1,2018-08-31
11469,경기,이천시,2,1,0,3,3,0,2018-10-31
11471,경기,이천시,0,0,1,1,1,0,2018-12-31
11472,경기,파주시,4,3,0,7,5,0,2018-01-31
11474,경기,파주시,4,2,3,9,6,0,2018-03-31
11476,경기,파주시,7,0,3,10,7,0,2018-05-31
11478,경기,파주시,4,2,1,7,5,0,2018-07-31
11479,경기,파주시,4,1,4,9,6,0,2018-08-31
11481,경기,파주시,1,1,1,3,3,0,2018-10-31
11483,경기,파주시,4,1,0,5,3,0,2018-12-31
11484,경기,평택시,5,0,0,5,3,0,2018-01-31
11486,경기,평택시,6,0,3,9,9,0,2018-03-31
11488,경기,평택시,7,1,3,11,6,0,2018-05-31
11490,경기,평택시,9,5,2,16,9,0,2018-07-31
11491,경기,평택시,4,1,1,6,5,0,2018-08-31
11493,경기,평택시,7,3,3,13,10,0,2018-10-31
11495,경기,평택시,10,1,4,15,10,0,2018-12-31
11496,경기,포천시,0,2,3,5,4,0,2018-01-31
11498,경기,포천시,6,0,4,10,3,0,2018-03-31
11500,경기,포천시,1,0,0,1,1,0,2018-05-31
11502,경기,포천시,3,2,1,6,3,0,2018-07-31
11503,경기,포천시,0,0,0,0,0,0,2018-08-31
11505,경기,포천시,4,0,2,6,4,0,2018-10-31
11507,경기,포천시,14,0,0,14,4,0,2018-12-31
11508,경기,하남시,9,0,0,9,4,0,2018-01-31
11510,경기,하남시,0,0,0,0,0,0,2018-03-31
11512,경기,하남시,4,1,0,5,5,0,2018-05-31
11514,경기,하남시,1,0,0,1,1,0,2018-07-31
11515,경기,하남시,3,0,1,4,4,0,2018-08-31
11517,경기,하남시,3,0,3,6,4,0,2018-10-31
11519,경기,하남시,1,0,1,2,2,0,2018-12-31
11520,경기,화성시,5,1,2,8,6,0,2018-01-31
11522,경기,화성시,8,4,5,17,7,0,2018-03-31
11524,경기,화성시,26,4,1,31,11,1,2018-05-31
11526,경기,화성시,3,0,1,4,4,0,2018-07-31
11527,경기,화성시,11,0,1,12,8,0,2018-08-31
11529,경기,화성시,3,1,2,6,6,0,2018-10-31
11531,경기,화성시,5,1,2,8,6,0,2018-12-31
0,경기,가평군,2,0,0,2,1,0,2019-01-01
1,경기,가평군,0,0,0,0,0,0,2019-02-01
2,경기,가평군,3,0,5,8,2,0,2019-03-01
3,경기,가평군,0,0,0,0,1,1,2019-04-01
4,경기,가평군,1,0,0,1,1,0,2019-05-01
5,경기,가평군,0,0,0,0,0,0,2019-06-01
6,경기,가평군,5,0,1,6,1,0,2019-07-01
7,경기,가평군,3,2,0,5,2,0,2019-08-01
8,경기,가평군,0,0,1,1,1,0,2019-09-01
9,경기,가평군,0,0,0,0,0,0,2019-10-01
10,경기,가평군,0,0,1,1,1,0,2019-11-01
11,경기,가평군,2,0,0,2,2,0,2019-12-01
12,경기,고양시,4,0,1,5,4,0,2019-01-01
13,경기,고양시,25,0,1,26,15,0,2019-02-01
14,경기,고양시,24,1,4,29,14,0,2019-03-01
15,경기,고양시,8,2,3,13,9,0,2019-04-01
16,경기,고양시,6,1,3,10,7,0,2019-05-01
17,경기,고양시,13,3,1,17,10,0,2019-06-01
18,경기,고양시,14,0,3,17,14,0,2019-07-01
19,경기,고양시,14,2,3,19,11,0,2019-08-01
20,경기,고양시,6,0,2,8,7,0,2019-09-01
21,경기,고양시,9,0,4,13,12,0,2019-10-01
22,경기,고양시,18,0,3,21,15,0,2019-11-01
23,경기,고양시,6,0,2,8,4,0,2019-12-01
24,경기,과천시,0,0,0,0,0,0,2019-01-01
25,경기,과천시,2,1,0,3,2,0,2019-02-01
26,경기,과천시,0,1,0,1,1,0,2019-03-01
27,경기,과천시,0,0,0,0,0,0,2019-04-01
28,경기,과천시,8,1,4,13,2,0,2019-05-01
29,경기,과천시,1,0,0,1,1,0,2019-06-01
30,경기,과천시,0,0,0,0,0,0,2019-07-01
31,경기,과천시,2,0,0,2,2,0,2019-08-01
32,경기,과천시,0,0,0,0,0,0,2019-09-01
33,경기,과천시,2,0,0,2,2,0,2019-10-01
34,경기,과천시,0,0,0,0,0,0,2019-11-01
35,경기,과천시,2,1,0,3,1,0,2019-12-01
36,경기,광명시,0,1,1,2,2,0,2019-01-01
37,경기,광명시,1,0,1,2,2,0,2019-02-01
38,경기,광명시,0,1,0,1,1,0,2019-03-01
39,경기,광명시,3,2,0,5,3,0,2019-04-01
40,경기,광명시,2,1,0,3,3,0,2019-05-01
41,경기,광명시,1,0,0,1,1,0,2019-06-01
42,경기,광명시,1,1,0,2,1,0,2019-07-01
43,경기,광명시,0,0,0,0,0,0,2019-08-01
44,경기,광명시,1,0,1,2,2,0,2019-09-01
45,경기,광명시,0,0,1,1,1,0,2019-10-01
46,경기,광명시,0,1,1,2,2,0,2019-11-01
47,경기,광명시,1,1,0,2,2,0,2019-12-01
48,경기,광주시,2,0,0,2,1,0,2019-01-01
49,경기,광주시,14,0,1,15,8,0,2019-02-01
50,경기,광주시,1,0,1,2,2,0,2019-03-01
51,경기,광주시,8,1,2,11,8,0,2019-04-01
52,경기,광주시,7,0,1,8,4,0,2019-05-01
53,경기,광주시,8,1,3,12,10,0,2019-06-01
54,경기,광주시,3,0,1,4,3,0,2019-07-01
55,경기,광주시,7,1,2,10,8,0,2019-08-01
56,경기,광주시,4,3,0,7,4,0,2019-09-01
57,경기,광주시,8,3,6,17,10,0,2019-10-01
58,경기,광주시,7,0,3,10,8,0,2019-11-01
59,경기,광주시,2,0,0,2,2,0,2019-12-01
60,경기,구리시,0,0,0,0,0,0,2019-01-01
61,경기,구리시,3,0,0,3,3,0,2019-02-01
62,경기,구리시,3,0,3,6,2,0,2019-03-01
63,경기,구리시,1,0,0,1,1,0,2019-04-01
64,경기,구리시,2,0,1,3,3,0,2019-05-01
65,경기,구리시,1,0,2,3,3,0,2019-06-01
66,경기,구리시,5,0,0,5,3,0,2019-07-01
67,경기,구리시,1,0,5,6,2,0,2019-08-01
68,경기,구리시,0,0,0,0,0,0,2019-09-01
69,경기,구리시,0,0,0,0,0,0,2019-10-01
70,경기,구리시,1,0,0,1,1,0,2019-11-01
71,경기,구리시,1,0,1,2,2,0,2019-12-01
72,경기,군포시,3,0,0,3,2,0,2019-01-01
73,경기,군포시,1,0,0,1,1,0,2019-02-01
74,경기,군포시,0,0,0,0,0,0,2019-03-01
75,경기,군포시,2,0,1,3,2,0,2019-04-01
76,경기,군포시,8,0,0,8,4,0,2019-05-01
77,경기,군포시,2,0,0,2,1,0,2019-06-01
78,경기,군포시,11,0,2,13,2,0,2019-07-01
79,경기,군포시,3,1,0,4,3,0,2019-08-01
80,경기,군포시,2,1,0,3,2,0,2019-09-01
81,경기,군포시,0,0,0,0,0,0,2019-10-01
82,경기,군포시,2,0,0,2,2,0,2019-11-01
83,경기,군포시,4,0,2,6,5,0,2019-12-01
84,경기,김포시,2,2,0,4,3,0,2019-01-01
85,경기,김포시,1,0,2,3,3,0,2019-02-01
86,경기,김포시,7,1,3,11,5,0,2019-03-01
87,경기,김포시,3,0,1,4,4,0,2019-04-01
88,경기,김포시,6,2,2,10,7,0,2019-05-01
89,경기,김포시,3,1,1,5,4,0,2019-06-01
90,경기,김포시,5,0,2,7,6,0,2019-07-01
91,경기,김포시,1,1,3,5,5,0,2019-08-01
92,경기,김포시,6,0,2,8,6,0,2019-09-01
93,경기,김포시,9,1,1,11,7,0,2019-10-01
94,경기,김포시,9,0,2,11,6,0,2019-11-01
95,경기,김포시,3,0,0,3,2,0,2019-12-01
96,경기,남양주시,5,3,5,13,9,0,2019-01-01
97,경기,남양주시,7,0,1,8,7,0,2019-02-01
98,경기,남양주시,14,0,2,16,6,0,2019-03-01
99,경기,남양주시,5,0,1,6,6,0,2019-04-01
100,경기,남양주시,13,1,3,17,12,0,2019-05-01
101,경기,남양주시,5,0,0,5,3,0,2019-06-01
102,경기,남양주시,5,0,1,6,5,0,2019-07-01
103,경기,남양주시,7,0,2,9,4,0,2019-08-01
104,경기,남양주시,2,0,5,7,3,0,2019-09-01
105,경기,남양주시,17,0,2,19,12,0,2019-10-01
106,경기,남양주시,6,0,2,8,6,0,2019-11-01
107,경기,남양주시,8,1,2,11,6,0,2019-12-01
108,경기,동두천시,0,0,0,0,0,0,2019-01-01
109,경기,동두천시,3,0,0,3,2,0,2019-02-01
110,경기,동두천시,0,0,0,0,0,0,2019-03-01
111,경기,동두천시,1,0,0,1,1,0,2019-04-01
112,경기,동두천시,1,0,1,2,2,0,2019-05-01
113,경기,동두천시,1,1,0,2,2,0,2019-06-01
114,경기,동두천시,1,0,0,1,1,0,2019-07-01
115,경기,동두천시,0,0,0,0,0,0,2019-08-01
116,경기,동두천시,1,1,1,3,2,0,2019-09-01
117,경기,동두천시,3,0,0,3,2,0,2019-10-01
118,경기,동두천시,0,0,1,1,1,0,2019-11-01
119,경기,동두천시,0,0,0,0,0,0,2019-12-01
120,경기,부천시,7,2,4,13,10,0,2019-01-01
121,경기,부천시,11,4,1,16,12,0,2019-02-01
122,경기,부천시,11,0,4,15,10,0,2019-03-01
123,경기,부천시,9,0,3,12,10,0,2019-04-01
124,경기,부천시,16,0,7,23,15,0,2019-05-01
125,경기,부천시,8,0,2,10,9,0,2019-06-01
126,경기,부천시,6,1,2,9,7,0,2019-07-01
127,경기,부천시,13,0,2,15,11,0,2019-08-01
128,경기,부천시,10,2,1,13,9,0,2019-09-01
129,경기,부천시,8,1,1,10,10,0,2019-10-01
130,경기,부천시,8,0,2,10,9,0,2019-11-01
131,경기,부천시,7,0,4,11,9,0,2019-12-01
132,경기,성남시,6,1,1,8,4,0,2019-01-01
133,경기,성남시,10,2,2,14,12,0,2019-02-01
134,경기,성남시,12,0,4,16,11,0,2019-03-01
135,경기,성남시,11,0,2,13,9,0,2019-04-01
136,경기,성남시,16,0,10,26,12,0,2019-05-01
137,경기,성남시,14,3,0,17,11,0,2019-06-01
138,경기,성남시,11,1,2,14,10,0,2019-07-01
139,경기,성남시,11,2,3,16,10,0,2019-08-01
140,경기,성남시,16,5,6,27,15,0,2019-09-01
141,경기,성남시,9,1,0,10,6,0,2019-10-01
142,경기,성남시,14,1,4,19,14,0,2019-11-01
143,경기,성남시,9,1,3,13,8,0,2019-12-01
144,경기,수원시,10,0,2,12,9,0,2019-01-01
145,경기,수원시,15,2,3,20,14,0,2019-02-01
146,경기,수원시,4,2,2,8,8,0,2019-03-01
147,경기,수원시,13,2,1,16,8,0,2019-04-01
148,경기,수원시,7,2,1,10,7,0,2019-05-01
149,경기,수원시,17,0,5,22,15,0,2019-06-01
150,경기,수원시,20,0,2,22,13,0,2019-07-01
151,경기,수원시,18,0,1,19,12,0,2019-08-01
152,경기,수원시,10,3,5,18,12,0,2019-09-01
153,경기,수원시,11,1,2,14,13,0,2019-10-01
154,경기,수원시,20,1,4,25,19,0,2019-11-01
155,경기,수원시,15,2,2,19,15,0,2019-12-01
156,경기,시흥시,8,0,1,9,6,0,2019-01-01
157,경기,시흥시,8,0,3,11,8,0,2019-02-01
158,경기,시흥시,4,1,0,5,4,1,2019-03-01
159,경기,시흥시,11,2,0,13,8,0,2019-04-01
160,경기,시흥시,15,0,1,16,9,0,2019-05-01
161,경기,시흥시,16,1,2,19,11,0,2019-06-01
162,경기,시흥시,15,2,4,21,13,1,2019-07-01
163,경기,시흥시,11,1,1,13,6,0,2019-08-01
164,경기,시흥시,2,0,1,3,3,0,2019-09-01
165,경기,시흥시,8,1,3,12,9,0,2019-10-01
166,경기,시흥시,5,1,2,8,5,0,2019-11-01
167,경기,시흥시,7,0,3,10,8,1,2019-12-01
168,경기,안산시,11,0,1,12,7,1,2019-01-01
169,경기,안산시,13,1,2,16,11,0,2019-02-01
170,경기,안산시,6,0,1,7,4,0,2019-03-01
171,경기,안산시,19,0,1,20,13,0,2019-04-01
172,경기,안산시,16,2,3,21,11,0,2019-05-01
173,경기,안산시,8,0,2,10,6,0,2019-06-01
174,경기,안산시,18,2,4,24,13,0,2019-07-01
175,경기,안산시,10,0,4,14,8,0,2019-08-01
176,경기,안산시,8,3,4,15,10,0,2019-09-01
177,경기,안산시,16,0,4,20,17,0,2019-10-01
178,경기,안산시,12,1,3,16,11,0,2019-11-01
179,경기,안산시,10,0,2,12,9,0,2019-12-01
180,경기,안성시,0,0,0,0,0,0,2019-01-01
181,경기,안성시,2,0,0,2,2,0,2019-02-01
182,경기,안성시,3,0,0,3,2,0,2019-03-01
183,경기,안성시,1,0,1,2,2,0,2019-04-01
184,경기,안성시,4,0,0,4,2,0,2019-05-01
185,경기,안성시,1,4,2,7,3,0,2019-06-01
186,경기,안성시,8,5,2,15,7,0,2019-07-01
187,경기,안성시,7,0,0,7,4,0,2019-08-01
188,경기,안성시,10,2,5,17,3,0,2019-09-01
189,경기,안성시,6,0,0,6,5,0,2019-10-01
190,경기,안성시,2,0,2,4,5,1,2019-11-01
191,경기,안성시,4,2,1,7,5,0,2019-12-01
192,경기,안양시,3,0,1,4,3,0,2019-01-01
193,경기,안양시,7,0,2,9,5,0,2019-02-01
194,경기,안양시,0,0,0,0,0,0,2019-03-01
195,경기,안양시,6,2,2,10,6,0,2019-04-01
196,경기,안양시,8,1,0,9,5,0,2019-05-01
197,경기,안양시,7,3,1,11,4,0,2019-06-01
198,경기,안양시,3,0,0,3,3,0,2019-07-01
199,경기,안양시,3,0,0,3,3,0,2019-08-01
200,경기,안양시,4,1,1,6,5,0,2019-09-01
201,경기,안양시,7,1,0,8,5,0,2019-10-01
202,경기,안양시,2,0,0,2,2,0,2019-11-01
203,경기,안양시,14,0,1,15,7,0,2019-12-01
204,경기,양주시,1,0,1,2,2,0,2019-01-01
205,경기,양주시,3,1,0,4,3,0,2019-02-01
206,경기,양주시,2,0,0,2,1,0,2019-03-01
207,경기,양주시,1,0,1,2,2,0,2019-04-01
208,경기,양주시,1,0,0,1,1,0,2019-05-01
209,경기,양주시,8,0,6,14,7,0,2019-06-01
210,경기,양주시,3,0,0,3,3,0,2019-07-01
211,경기,양주시,3,2,2,7,3,0,2019-08-01
212,경기,양주시,2,0,0,2,1,0,2019-09-01
213,경기,양주시,3,0,2,5,4,0,2019-10-01
214,경기,양주시,5,1,1,7,6,0,2019-11-01
215,경기,양주시,5,0,0,5,4,0,2019-12-01
216,경기,양평군,0,0,0,0,0,0,2019-01-01
217,경기,양평군,1,0,2,3,2,0,2019-02-01
218,경기,양평군,1,0,0,1,1,0,2019-03-01
219,경기,양평군,3,0,0,3,3,0,2019-04-01
220,경기,양평군,0,0,0,0,0,0,2019-05-01
221,경기,양평군,1,0,2,3,1,0,2019-06-01
222,경기,양평군,0,0,0,0,0,0,2019-07-01
223,경기,양평군,3,0,0,3,3,0,2019-08-01
224,경기,양평군,0,0,0,0,0,0,2019-09-01
225,경기,양평군,4,0,1,5,1,0,2019-10-01
226,경기,양평군,4,0,0,4,2,0,2019-11-01
227,경기,양평군,0,0,0,0,0,0,2019-12-01
228,경기,여주시,2,0,0,2,1,0,2019-01-01
229,경기,여주시,0,0,0,0,0,0,2019-02-01
230,경기,여주시,3,1,0,4,2,0,2019-03-01
231,경기,여주시,0,0,0,0,0,0,2019-04-01
232,경기,여주시,0,0,0,0,0,0,2019-05-01
233,경기,여주시,1,0,0,1,1,0,2019-06-01
234,경기,여주시,1,0,0,1,1,0,2019-07-01
235,경기,여주시,1,1,2,4,3,0,2019-08-01
236,경기,여주시,3,0,1,4,2,0,2019-09-01
237,경기,여주시,1,0,0,1,1,0,2019-10-01
238,경기,여주시,2,0,0,2,2,0,2019-11-01
239,경기,여주시,2,0,0,2,1,0,2019-12-01
240,경기,연천군,0,0,2,2,1,0,2019-01-01
241,경기,연천군,1,0,0,1,1,0,2019-02-01
242,경기,연천군,1,0,0,1,1,0,2019-03-01
243,경기,연천군,0,0,0,0,0,0,2019-04-01
244,경기,연천군,0,0,0,0,0,0,2019-05-01
245,경기,연천군,0,0,1,1,1,0,2019-06-01
246,경기,연천군,0,0,0,0,0,0,2019-07-01
247,경기,연천군,1,0,0,1,1,0,2019-08-01
248,경기,연천군,0,0,0,0,0,0,2019-09-01
249,경기,연천군,0,0,1,1,1,0,2019-10-01
250,경기,연천군,2,0,0,2,1,0,2019-11-01
251,경기,연천군,0,0,0,0,1,1,2019-12-01
252,경기,오산시,1,0,0,1,1,0,2019-01-01
253,경기,오산시,6,0,0,6,5,0,2019-02-01
254,경기,오산시,3,0,0,3,1,0,2019-03-01
255,경기,오산시,2,0,1,3,2,0,2019-04-01
256,경기,오산시,2,0,0,2,2,0,2019-05-01
257,경기,오산시,2,0,0,2,2,0,2019-06-01
258,경기,오산시,2,0,0,2,2,0,2019-07-01
259,경기,오산시,1,0,1,2,2,0,2019-08-01
260,경기,오산시,1,0,0,1,1,0,2019-09-01
261,경기,오산시,5,1,1,7,5,0,2019-10-01
262,경기,오산시,8,1,3,12,5,0,2019-11-01
263,경기,오산시,2,0,0,2,2,0,2019-12-01
264,경기,용인시,4,0,4,8,3,0,2019-01-01
265,경기,용인시,9,0,4,13,10,0,2019-02-01
266,경기,용인시,8,1,3,12,8,0,2019-03-01
267,경기,용인시,12,1,2,15,9,0,2019-04-01
268,경기,용인시,5,2,4,11,7,1,2019-05-01
269,경기,용인시,23,5,2,30,10,0,2019-06-01
270,경기,용인시,10,1,6,17,13,0,2019-07-01
271,경기,용인시,14,2,2,18,11,0,2019-08-01
272,경기,용인시,3,7,0,10,3,0,2019-09-01
273,경기,용인시,11,3,4,18,12,0,2019-10-01
274,경기,용인시,22,6,3,31,20,0,2019-11-01
275,경기,용인시,6,1,4,11,5,0,2019-12-01
276,경기,의왕시,0,0,0,0,0,0,2019-01-01
277,경기,의왕시,0,1,0,1,1,0,2019-02-01
278,경기,의왕시,1,0,3,4,1,0,2019-03-01
279,경기,의왕시,0,0,0,0,0,0,2019-04-01
280,경기,의왕시,5,0,1,6,2,0,2019-05-01
281,경기,의왕시,0,0,0,0,0,0,2019-06-01
282,경기,의왕시,0,0,0,0,0,0,2019-07-01
283,경기,의왕시,0,0,0,0,0,0,2019-08-01
284,경기,의왕시,0,0,0,0,0,0,2019-09-01
285,경기,의왕시,10,0,0,10,3,0,2019-10-01
286,경기,의왕시,0,1,0,1,1,0,2019-11-01
287,경기,의왕시,1,0,0,1,1,0,2019-12-01
288,경기,의정부시,1,0,0,1,1,0,2019-01-01
289,경기,의정부시,7,0,0,7,3,0,2019-02-01
290,경기,의정부시,1,0,2,3,3,0,2019-03-01
291,경기,의정부시,1,1,1,3,2,0,2019-04-01
292,경기,의정부시,10,1,3,14,7,0,2019-05-01
293,경기,의정부시,5,3,1,9,5,0,2019-06-01
294,경기,의정부시,5,0,0,5,3,0,2019-07-01
295,경기,의정부시,8,0,1,9,5,0,2019-08-01
296,경기,의정부시,5,1,0,6,4,0,2019-09-01
297,경기,의정부시,10,1,0,11,5,0,2019-10-01
298,경기,의정부시,1,0,2,3,3,0,2019-11-01
299,경기,의정부시,8,0,2,10,6,0,2019-12-01
300,경기,이천시,2,0,0,2,1,0,2019-01-01
301,경기,이천시,1,0,0,1,1,0,2019-02-01
302,경기,이천시,0,0,0,0,0,0,2019-03-01
303,경기,이천시,3,0,0,3,4,1,2019-04-01
304,경기,이천시,1,0,0,1,1,0,2019-05-01
305,경기,이천시,1,0,2,3,3,0,2019-06-01
306,경기,이천시,19,0,1,20,8,0,2019-07-01
307,경기,이천시,5,1,1,7,3,0,2019-08-01
308,경기,이천시,3,0,1,4,3,0,2019-09-01
309,경기,이천시,0,0,0,0,0,0,2019-10-01
310,경기,이천시,4,0,0,4,3,0,2019-11-01
311,경기,이천시,0,1,2,3,3,0,2019-12-01
312,경기,파주시,2,0,0,2,1,0,2019-01-01
313,경기,파주시,7,2,3,12,9,0,2019-02-01
314,경기,파주시,2,0,1,3,3,0,2019-03-01
315,경기,파주시,4,0,1,5,3,0,2019-04-01
316,경기,파주시,2,0,0,2,2,0,2019-05-01
317,경기,파주시,4,0,1,5,3,0,2019-06-01
318,경기,파주시,4,1,1,6,6,0,2019-07-01
319,경기,파주시,6,0,2,8,6,0,2019-08-01
320,경기,파주시,7,0,2,9,4,0,2019-09-01
321,경기,파주시,4,5,0,9,4,0,2019-10-01
322,경기,파주시,5,0,0,5,4,0,2019-11-01
323,경기,파주시,5,1,1,7,3,0,2019-12-01
324,경기,평택시,3,0,2,5,5,0,2019-01-01
325,경기,평택시,14,4,9,27,17,0,2019-02-01
326,경기,평택시,5,3,2,10,6,0,2019-03-01
327,경기,평택시,11,1,0,12,6,0,2019-04-01
328,경기,평택시,11,0,4,15,12,0,2019-05-01
329,경기,평택시,9,3,0,12,4,0,2019-06-01
330,경기,평택시,7,0,2,9,8,0,2019-07-01
331,경기,평택시,10,0,2,12,7,0,2019-08-01
332,경기,평택시,5,1,3,9,7,0,2019-09-01
333,경기,평택시,9,1,3,13,9,0,2019-10-01
334,경기,평택시,9,1,2,12,5,0,2019-11-01
335,경기,평택시,16,4,4,24,13,0,2019-12-01
336,경기,포천시,4,0,0,4,3,0,2019-01-01
337,경기,포천시,6,0,4,10,4,0,2019-02-01
338,경기,포천시,4,0,0,4,3,0,2019-03-01
339,경기,포천시,1,0,1,2,2,0,2019-04-01
340,경기,포천시,3,1,5,9,3,0,2019-05-01
341,경기,포천시,4,0,0,4,3,0,2019-06-01
342,경기,포천시,0,0,1,1,1,0,2019-07-01
343,경기,포천시,0,1,0,1,1,0,2019-08-01
344,경기,포천시,2,0,0,2,2,0,2019-09-01
345,경기,포천시,6,1,0,7,4,0,2019-10-01
346,경기,포천시,4,0,1,5,4,0,2019-11-01
347,경기,포천시,0,0,1,1,1,0,2019-12-01
348,경기,하남시,0,0,0,0,0,0,2019-01-01
349,경기,하남시,1,0,2,3,3,0,2019-02-01
350,경기,하남시,2,1,0,3,2,0,2019-03-01
351,경기,하남시,5,4,2,11,5,0,2019-04-01
352,경기,하남시,0,0,0,0,1,1,2019-05-01
353,경기,하남시,1,0,2,3,3,0,2019-06-01
354,경기,하남시,5,1,2,8,4,0,2019-07-01
355,경기,하남시,0,0,1,1,1,0,2019-08-01
356,경기,하남시,9,0,2,11,7,0,2019-09-01
357,경기,하남시,2,3,2,7,3,0,2019-10-01
358,경기,하남시,9,3,2,14,6,0,2019-11-01
359,경기,하남시,5,0,1,6,4,0,2019-12-01
360,경기,화성시,1,0,2,3,3,0,2019-01-01
361,경기,화성시,7,1,2,10,9,0,2019-02-01
362,경기,화성시,7,0,1,8,3,0,2019-03-01
363,경기,화성시,5,1,4,10,8,0,2019-04-01
364,경기,화성시,11,0,3,14,10,0,2019-05-01
365,경기,화성시,18,0,1,19,6,0,2019-06-01
366,경기,화성시,20,6,2,28,13,0,2019-07-01
367,경기,화성시,6,1,0,7,5,0,2019-08-01
368,경기,화성시,1,2,3,6,4,0,2019-09-01
369,경기,화성시,11,0,1,12,6,0,2019-10-01
370,경기,화성시,7,4,3,14,11,0,2019-11-01
371,경기,화성시,10,1,0,11,5,0,2019-12-01
372,경기,가평군,0,0,1,1,1,0,2019-01-02
373,경기,가평군,0,0,0,0,0,0,2019-02-02
374,경기,가평군,2,1,0,3,2,0,2019-03-02
375,경기,가평군,0,0,0,0,0,0,2019-04-02
376,경기,가평군,0,0,1,1,1,0,2019-05-02
377,경기,가평군,1,0,1,2,2,0,2019-06-02
378,경기,가평군,0,0,0,0,0,0,2019-07-02
379,경기,가평군,4,0,0,4,1,0,2019-08-02
380,경기,가평군,1,0,0,1,1,1,2019-09-02
381,경기,가평군,0,0,1,1,1,0,2019-10-02
382,경기,가평군,1,0,0,1,1,1,2019-11-02
383,경기,가평군,0,0,2,2,1,0,2019-12-02
384,경기,고양시,5,1,2,8,8,0,2019-01-02
385,경기,고양시,28,0,7,35,15,1,2019-02-02
386,경기,고양시,6,0,8,14,8,1,2019-03-02
387,경기,고양시,9,1,7,17,8,0,2019-04-02
388,경기,고양시,12,1,5,18,17,0,2019-05-02
389,경기,고양시,3,2,2,7,5,0,2019-06-02
390,경기,고양시,3,0,2,5,5,0,2019-07-02
391,경기,고양시,6,1,0,7,4,0,2019-08-02
392,경기,고양시,12,1,2,15,11,1,2019-09-02
393,경기,고양시,17,2,3,22,17,0,2019-10-02
394,경기,고양시,13,1,2,16,9,0,2019-11-02
395,경기,고양시,7,1,2,10,8,0,2019-12-02
396,경기,과천시,1,1,0,2,1,0,2019-01-02
397,경기,과천시,0,0,0,0,0,0,2019-02-02
398,경기,과천시,0,0,0,0,0,0,2019-03-02
399,경기,과천시,0,0,0,0,0,0,2019-04-02
400,경기,과천시,0,0,0,0,0,0,2019-05-02
401,경기,과천시,0,0,0,0,0,0,2019-06-02
402,경기,과천시,1,1,0,2,2,0,2019-07-02
403,경기,과천시,1,0,0,1,1,0,2019-08-02
404,경기,과천시,0,0,0,0,0,0,2019-09-02
405,경기,과천시,1,0,0,1,1,0,2019-10-02
406,경기,과천시,1,3,0,4,1,0,2019-11-02
407,경기,과천시,0,0,0,0,0,0,2019-12-02
408,경기,광명시,3,1,0,4,4,0,2019-01-02
409,경기,광명시,1,1,1,3,3,0,2019-02-02
410,경기,광명시,5,1,0,6,4,0,2019-03-02
411,경기,광명시,2,2,0,4,4,0,2019-04-02
412,경기,광명시,1,0,0,1,1,0,2019-05-02
413,경기,광명시,0,2,1,3,3,0,2019-06-02
414,경기,광명시,3,0,2,5,3,0,2019-07-02
415,경기,광명시,0,2,4,6,5,0,2019-08-02
416,경기,광명시,1,2,0,3,3,0,2019-09-02
417,경기,광명시,1,0,0,1,1,0,2019-10-02
418,경기,광명시,2,0,1,3,3,0,2019-11-02
419,경기,광명시,1,1,3,5,6,1,2019-12-02
420,경기,광주시,6,0,1,7,6,1,2019-01-02
421,경기,광주시,7,0,2,9,7,0,2019-02-02
422,경기,광주시,7,1,2,10,8,0,2019-03-02
423,경기,광주시,1,0,0,1,1,0,2019-04-02
424,경기,광주시,9,0,2,11,7,0,2019-05-02
425,경기,광주시,13,0,0,13,6,0,2019-06-02
426,경기,광주시,7,2,0,9,4,0,2019-07-02
427,경기,광주시,6,0,1,7,7,1,2019-08-02
428,경기,광주시,5,0,2,7,5,0,2019-09-02
429,경기,광주시,8,1,1,10,7,0,2019-10-02
430,경기,광주시,1,0,0,1,1,0,2019-11-02
431,경기,광주시,6,0,0,6,5,0,2019-12-02
432,경기,구리시,2,0,2,4,1,0,2019-01-02
433,경기,구리시,9,0,2,11,4,0,2019-02-02
434,경기,구리시,3,0,4,7,3,0,2019-03-02
435,경기,구리시,1,0,0,1,1,0,2019-04-02
436,경기,구리시,1,0,0,1,1,0,2019-05-02
437,경기,구리시,0,0,0,0,0,0,2019-06-02
438,경기,구리시,1,0,0,1,1,0,2019-07-02
439,경기,구리시,3,1,0,4,3,0,2019-08-02
440,경기,구리시,6,0,1,7,3,0,2019-09-02
441,경기,구리시,2,0,2,4,3,0,2019-10-02
442,경기,구리시,1,1,0,2,2,0,2019-11-02
443,경기,구리시,1,0,0,1,1,0,2019-12-02
444,경기,군포시,1,0,0,1,1,0,2019-01-02
445,경기,군포시,1,1,0,2,2,0,2019-02-02
446,경기,군포시,1,1,3,5,4,0,2019-03-02
447,경기,군포시,1,0,1,2,2,0,2019-04-02
448,경기,군포시,0,2,1,3,2,0,2019-05-02
449,경기,군포시,0,0,1,1,1,0,2019-06-02
450,경기,군포시,1,0,0,1,1,0,2019-07-02
451,경기,군포시,7,5,1,13,3,0,2019-08-02
452,경기,군포시,1,2,0,3,3,0,2019-09-02
453,경기,군포시,2,0,1,3,2,0,2019-10-02
454,경기,군포시,1,0,0,1,1,0,2019-11-02
455,경기,군포시,2,0,0,2,2,0,2019-12-02
456,경기,김포시,2,0,2,4,4,0,2019-01-02
457,경기,김포시,3,1,3,7,5,0,2019-02-02
458,경기,김포시,16,1,3,20,6,0,2019-03-02
459,경기,김포시,7,0,2,9,6,0,2019-04-02
460,경기,김포시,10,0,1,11,8,0,2019-05-02
461,경기,김포시,0,0,0,0,0,0,2019-06-02
462,경기,김포시,9,0,2,11,5,0,2019-07-02
463,경기,김포시,2,2,1,5,3,0,2019-08-02
464,경기,김포시,8,3,0,11,5,0,2019-09-02
465,경기,김포시,10,0,4,14,7,0,2019-10-02
466,경기,김포시,4,0,1,5,4,0,2019-11-02
467,경기,김포시,3,1,1,5,3,0,2019-12-02
468,경기,남양주시,4,2,1,7,5,0,2019-01-02
469,경기,남양주시,12,0,1,13,9,0,2019-02-02
470,경기,남양주시,14,3,5,22,8,0,2019-03-02
471,경기,남양주시,10,0,2,12,7,0,2019-04-02
472,경기,남양주시,10,0,5,15,9,0,2019-05-02
473,경기,남양주시,1,1,1,3,3,0,2019-06-02
474,경기,남양주시,3,3,3,9,8,0,2019-07-02
475,경기,남양주시,4,2,2,8,4,0,2019-08-02
476,경기,남양주시,6,1,3,10,8,0,2019-09-02
477,경기,남양주시,6,3,0,9,5,0,2019-10-02
478,경기,남양주시,2,0,2,4,4,0,2019-11-02
479,경기,남양주시,5,0,4,9,4,0,2019-12-02
480,경기,동두천시,0,0,0,0,0,0,2019-01-02
481,경기,동두천시,0,0,1,1,1,0,2019-02-02
482,경기,동두천시,0,0,0,0,0,0,2019-03-02
483,경기,동두천시,2,0,0,2,2,0,2019-04-02
484,경기,동두천시,0,0,0,0,0,0,2019-05-02
485,경기,동두천시,0,0,0,0,0,0,2019-06-02
486,경기,동두천시,1,0,0,1,1,0,2019-07-02
487,경기,동두천시,0,0,0,0,0,0,2019-08-02
488,경기,동두천시,2,0,0,2,2,0,2019-09-02
489,경기,동두천시,0,0,1,1,1,0,2019-10-02
490,경기,동두천시,3,0,2,5,2,0,2019-11-02
491,경기,동두천시,1,0,0,1,1,0,2019-12-02
492,경기,부천시,6,0,2,8,8,0,2019-01-02
493,경기,부천시,3,0,5,8,8,0,2019-02-02
494,경기,부천시,3,1,1,5,5,0,2019-03-02
495,경기,부천시,16,2,5,23,14,0,2019-04-02
496,경기,부천시,13,0,4,17,12,1,2019-05-02
497,경기,부천시,9,0,4,13,8,0,2019-06-02
498,경기,부천시,9,1,0,10,10,0,2019-07-02
499,경기,부천시,3,1,8,12,10,0,2019-08-02
500,경기,부천시,16,2,4,22,15,0,2019-09-02
501,경기,부천시,11,1,4,16,13,0,2019-10-02
502,경기,부천시,16,0,4,20,16,0,2019-11-02
503,경기,부천시,7,0,1,8,9,1,2019-12-02
504,경기,성남시,7,1,5,13,11,0,2019-01-02
505,경기,성남시,8,1,4,13,9,1,2019-02-02
506,경기,성남시,20,0,2,22,9,0,2019-03-02
507,경기,성남시,9,1,7,17,11,0,2019-04-02
508,경기,성남시,16,3,1,20,10,0,2019-05-02
509,경기,성남시,15,2,9,26,9,0,2019-06-02
510,경기,성남시,5,0,1,6,6,0,2019-07-02
511,경기,성남시,7,1,6,14,10,0,2019-08-02
512,경기,성남시,13,0,1,14,8,0,2019-09-02
513,경기,성남시,13,1,4,18,14,0,2019-10-02
514,경기,성남시,6,3,8,17,8,0,2019-11-02
515,경기,성남시,3,4,8,15,12,0,2019-12-02
516,경기,수원시,7,0,3,10,7,0,2019-01-02
517,경기,수원시,9,0,2,11,10,0,2019-02-02
518,경기,수원시,14,2,5,21,12,0,2019-03-02
519,경기,수원시,14,6,3,23,20,0,2019-04-02
520,경기,수원시,9,1,1,11,10,0,2019-05-02
521,경기,수원시,15,0,4,19,13,0,2019-06-02
522,경기,수원시,12,1,3,16,12,0,2019-07-02
523,경기,수원시,20,1,3,24,19,0,2019-08-02
524,경기,수원시,10,1,5,16,12,0,2019-09-02
525,경기,수원시,29,2,4,35,28,0,2019-10-02
526,경기,수원시,17,4,7,28,21,0,2019-11-02
527,경기,수원시,9,1,2,12,10,0,2019-12-02
528,경기,시흥시,8,0,1,9,6,0,2019-01-02
529,경기,시흥시,8,1,2,11,8,0,2019-02-02
530,경기,시흥시,4,0,0,4,4,0,2019-03-02
531,경기,시흥시,13,0,6,19,11,0,2019-04-02
532,경기,시흥시,6,0,2,8,6,0,2019-05-02
533,경기,시흥시,3,0,0,3,2,0,2019-06-02
534,경기,시흥시,3,6,5,14,7,0,2019-07-02
535,경기,시흥시,13,0,1,14,5,0,2019-08-02
536,경기,시흥시,8,1,3,12,10,0,2019-09-02
537,경기,시흥시,6,0,5,11,8,0,2019-10-02
538,경기,시흥시,11,0,2,13,11,1,2019-11-02
539,경기,시흥시,4,3,2,9,6,0,2019-12-02
540,경기,안산시,8,1,3,12,8,0,2019-01-02
541,경기,안산시,16,0,1,17,12,0,2019-02-02
542,경기,안산시,15,1,0,16,9,0,2019-03-02
543,경기,안산시,12,1,5,18,12,0,2019-04-02
544,경기,안산시,19,1,6,26,16,0,2019-05-02
545,경기,안산시,12,4,6,22,16,1,2019-06-02
546,경기,안산시,7,1,3,11,7,1,2019-07-02
547,경기,안산시,10,0,3,13,9,0,2019-08-02
548,경기,안산시,25,0,1,26,16,0,2019-09-02
549,경기,안산시,16,0,6,22,17,0,2019-10-02
550,경기,안산시,11,0,3,14,12,0,2019-11-02
551,경기,안산시,10,0,6,16,11,0,2019-12-02
552,경기,안성시,2,0,1,3,3,0,2019-01-02
553,경기,안성시,3,0,0,3,2,0,2019-02-02
554,경기,안성시,8,0,4,12,4,0,2019-03-02
555,경기,안성시,6,0,3,9,6,0,2019-04-02
556,경기,안성시,3,1,0,4,4,0,2019-05-02
557,경기,안성시,6,1,0,7,5,0,2019-06-02
558,경기,안성시,0,0,1,1,1,0,2019-07-02
559,경기,안성시,18,12,0,30,5,0,2019-08-02
560,경기,안성시,0,0,2,2,2,0,2019-09-02
561,경기,안성시,6,0,1,7,5,0,2019-10-02
562,경기,안성시,2,0,0,2,1,0,2019-11-02
563,경기,안성시,0,0,1,1,1,0,2019-12-02
564,경기,안양시,6,0,0,6,5,0,2019-01-02
565,경기,안양시,9,0,0,9,5,0,2019-02-02
566,경기,안양시,6,0,1,7,4,0,2019-03-02
567,경기,안양시,6,2,0,8,6,0,2019-04-02
568,경기,안양시,1,0,1,2,2,0,2019-05-02
569,경기,안양시,9,1,2,12,6,0,2019-06-02
570,경기,안양시,3,0,0,3,3,0,2019-07-02
571,경기,안양시,3,0,1,4,4,0,2019-08-02
572,경기,안양시,0,0,2,2,2,0,2019-09-02
573,경기,안양시,7,0,1,8,6,0,2019-10-02
574,경기,안양시,2,0,2,4,3,0,2019-11-02
575,경기,안양시,4,0,3,7,5,0,2019-12-02
576,경기,양주시,2,0,0,2,2,0,2019-01-02
577,경기,양주시,2,0,1,3,2,0,2019-02-02
578,경기,양주시,3,0,0,3,2,0,2019-03-02
579,경기,양주시,2,0,0,2,2,0,2019-04-02
580,경기,양주시,1,0,0,1,1,0,2019-05-02
581,경기,양주시,7,0,0,7,4,0,2019-06-02
582,경기,양주시,1,0,2,3,2,0,2019-07-02
583,경기,양주시,3,0,1,4,3,0,2019-08-02
584,경기,양주시,1,0,2,3,3,0,2019-09-02
585,경기,양주시,10,1,1,12,7,0,2019-10-02
586,경기,양주시,7,0,2,9,5,0,2019-11-02
587,경기,양주시,4,0,1,5,3,0,2019-12-02
588,경기,양평군,2,0,0,2,1,0,2019-01-02
589,경기,양평군,0,0,0,0,0,0,2019-02-02
590,경기,양평군,4,0,0,4,3,0,2019-03-02
591,경기,양평군,0,0,3,3,1,0,2019-04-02
592,경기,양평군,0,1,0,1,1,0,2019-05-02
593,경기,양평군,1,0,0,1,1,0,2019-06-02
594,경기,양평군,6,1,1,8,4,0,2019-07-02
595,경기,양평군,5,0,1,6,2,0,2019-08-02
596,경기,양평군,1,0,0,1,1,0,2019-09-02
597,경기,양평군,1,1,0,2,2,0,2019-10-02
598,경기,양평군,1,0,2,3,2,0,2019-11-02
599,경기,양평군,1,2,0,3,3,0,2019-12-02
600,경기,여주시,0,0,0,0,0,0,2019-01-02
601,경기,여주시,0,0,0,0,0,0,2019-02-02
602,경기,여주시,0,0,0,0,0,0,2019-03-02
603,경기,여주시,1,0,2,3,2,0,2019-04-02
604,경기,여주시,2,0,1,3,2,0,2019-05-02
605,경기,여주시,0,0,0,0,0,0,2019-06-02
606,경기,여주시,3,0,0,3,1,0,2019-07-02
607,경기,여주시,2,0,2,4,3,0,2019-08-02
608,경기,여주시,4,0,2,6,5,0,2019-09-02
609,경기,여주시,4,0,0,4,2,0,2019-10-02
610,경기,여주시,1,0,2,3,2,0,2019-11-02
611,경기,여주시,2,0,0,2,1,0,2019-12-02
612,경기,연천군,0,0,0,0,0,0,2019-01-02
613,경기,연천군,0,0,0,0,0,0,2019-02-02
614,경기,연천군,0,0,0,0,0,0,2019-03-02
615,경기,연천군,0,0,2,2,1,0,2019-04-02
616,경기,연천군,0,0,0,0,0,0,2019-05-02
617,경기,연천군,0,0,0,0,0,0,2019-06-02
618,경기,연천군,0,0,0,0,0,0,2019-07-02
619,경기,연천군,2,0,0,2,2,0,2019-08-02
620,경기,연천군,0,0,0,0,0,0,2019-09-02
621,경기,연천군,1,0,1,2,2,0,2019-10-02
622,경기,연천군,10,1,2,13,1,0,2019-11-02
623,경기,연천군,0,0,0,0,0,0,2019-12-02
624,경기,오산시,0,0,1,1,1,0,2019-01-02
625,경기,오산시,2,0,0,2,2,0,2019-02-02
626,경기,오산시,3,0,1,4,3,0,2019-03-02
627,경기,오산시,0,0,0,0,0,0,2019-04-02
628,경기,오산시,4,0,2,6,6,0,2019-05-02
629,경기,오산시,1,0,0,1,1,0,2019-06-02
630,경기,오산시,5,1,0,6,5,0,2019-07-02
631,경기,오산시,2,0,0,2,1,0,2019-08-02
632,경기,오산시,0,0,0,0,0,0,2019-09-02
633,경기,오산시,5,0,0,5,4,0,2019-10-02
634,경기,오산시,1,3,0,4,1,0,2019-11-02
635,경기,오산시,0,0,0,0,0,0,2019-12-02
636,경기,용인시,6,0,0,6,5,0,2019-01-02
637,경기,용인시,9,1,0,10,8,0,2019-02-02
638,경기,용인시,2,0,1,3,3,0,2019-03-02
639,경기,용인시,6,1,1,8,6,1,2019-04-02
640,경기,용인시,16,6,5,27,12,0,2019-05-02
641,경기,용인시,5,1,0,6,3,0,2019-06-02
642,경기,용인시,5,1,5,11,10,0,2019-07-02
643,경기,용인시,9,1,1,11,7,0,2019-08-02
644,경기,용인시,11,2,1,14,10,0,2019-09-02
645,경기,용인시,36,12,5,53,22,0,2019-10-02
646,경기,용인시,27,0,0,27,11,0,2019-11-02
647,경기,용인시,11,1,5,17,12,0,2019-12-02
648,경기,의왕시,1,0,1,2,1,0,2019-01-02
649,경기,의왕시,0,0,1,1,1,0,2019-02-02
650,경기,의왕시,0,0,0,0,0,0,2019-03-02
651,경기,의왕시,4,1,2,7,5,0,2019-04-02
652,경기,의왕시,5,0,1,6,3,0,2019-05-02
653,경기,의왕시,3,1,0,4,1,0,2019-06-02
654,경기,의왕시,1,1,0,2,1,0,2019-07-02
655,경기,의왕시,2,1,0,3,2,0,2019-08-02
656,경기,의왕시,2,3,1,6,3,0,2019-09-02
657,경기,의왕시,5,0,1,6,4,0,2019-10-02
658,경기,의왕시,2,0,0,2,1,0,2019-11-02
659,경기,의왕시,0,0,0,0,0,0,2019-12-02
660,경기,의정부시,4,0,0,4,3,0,2019-01-02
661,경기,의정부시,1,1,1,3,4,1,2019-02-02
662,경기,의정부시,5,0,1,6,5,0,2019-03-02
663,경기,의정부시,1,0,0,1,1,0,2019-04-02
664,경기,의정부시,4,1,1,6,6,0,2019-05-02
665,경기,의정부시,2,1,1,4,3,0,2019-06-02
666,경기,의정부시,4,0,1,5,4,0,2019-07-02
667,경기,의정부시,5,0,1,6,5,0,2019-08-02
668,경기,의정부시,8,0,2,10,5,0,2019-09-02
669,경기,의정부시,9,1,1,11,10,1,2019-10-02
670,경기,의정부시,6,3,0,9,7,0,2019-11-02
671,경기,의정부시,1,0,3,4,4,0,2019-12-02
672,경기,이천시,1,0,0,1,1,0,2019-01-02
673,경기,이천시,3,1,1,5,4,0,2019-02-02
674,경기,이천시,2,0,0,2,2,0,2019-03-02
675,경기,이천시,2,0,0,2,2,0,2019-04-02
676,경기,이천시,2,0,0,2,2,0,2019-05-02
677,경기,이천시,7,1,1,9,5,0,2019-06-02
678,경기,이천시,7,0,0,7,6,0,2019-07-02
679,경기,이천시,4,0,1,5,3,0,2019-08-02
680,경기,이천시,2,0,0,2,2,0,2019-09-02
681,경기,이천시,7,0,1,8,6,0,2019-10-02
682,경기,이천시,1,0,0,1,1,0,2019-11-02
683,경기,이천시,5,0,2,7,5,0,2019-12-02
684,경기,파주시,1,1,1,3,3,0,2019-01-02
685,경기,파주시,2,2,2,6,5,0,2019-02-02
686,경기,파주시,1,0,0,1,1,0,2019-03-02
687,경기,파주시,2,0,3,5,4,0,2019-04-02
688,경기,파주시,8,0,1,9,4,0,2019-05-02
689,경기,파주시,4,0,1,5,3,0,2019-06-02
690,경기,파주시,6,0,1,7,5,0,2019-07-02
691,경기,파주시,9,1,4,14,7,0,2019-08-02
692,경기,파주시,4,0,0,4,4,0,2019-09-02
693,경기,파주시,6,0,4,10,8,0,2019-10-02
694,경기,파주시,8,1,4,13,4,0,2019-11-02
695,경기,파주시,7,0,0,7,4,0,2019-12-02
696,경기,평택시,8,3,3,14,11,1,2019-01-02
697,경기,평택시,5,0,1,6,3,0,2019-02-02
698,경기,평택시,9,0,1,10,7,0,2019-03-02
699,경기,평택시,4,3,4,11,8,0,2019-04-02
700,경기,평택시,7,0,0,7,5,0,2019-05-02
701,경기,평택시,13,1,4,18,6,0,2019-06-02
702,경기,평택시,8,1,4,13,11,1,2019-07-02
703,경기,평택시,8,1,2,11,10,0,2019-08-02
704,경기,평택시,6,2,3,11,8,0,2019-09-02
705,경기,평택시,12,1,6,19,12,0,2019-10-02
706,경기,평택시,6,0,3,9,6,0,2019-11-02
707,경기,평택시,10,0,2,12,8,0,2019-12-02
708,경기,포천시,1,0,0,1,1,0,2019-01-02
709,경기,포천시,4,2,1,7,2,0,2019-02-02
710,경기,포천시,1,0,0,1,1,0,2019-03-02
711,경기,포천시,4,1,1,6,4,0,2019-04-02
712,경기,포천시,5,0,2,7,3,0,2019-05-02
713,경기,포천시,2,0,0,2,1,0,2019-06-02
714,경기,포천시,2,0,2,4,2,0,2019-07-02
715,경기,포천시,1,0,0,1,1,0,2019-08-02
716,경기,포천시,1,0,0,1,1,0,2019-09-02
717,경기,포천시,0,0,1,1,1,0,2019-10-02
718,경기,포천시,4,0,0,4,3,0,2019-11-02
719,경기,포천시,3,0,2,5,4,0,2019-12-02
720,경기,하남시,0,0,0,0,0,0,2019-01-02
721,경기,하남시,1,0,0,1,1,0,2019-02-02
722,경기,하남시,2,2,0,4,3,0,2019-03-02
723,경기,하남시,1,0,3,4,1,0,2019-04-02
724,경기,하남시,4,0,0,4,4,0,2019-05-02
725,경기,하남시,1,0,0,1,1,0,2019-06-02
726,경기,하남시,3,0,1,4,3,0,2019-07-02
727,경기,하남시,3,0,0,3,2,0,2019-08-02
728,경기,하남시,1,1,1,3,2,0,2019-09-02
729,경기,하남시,8,0,6,14,9,0,2019-10-02
730,경기,하남시,4,2,1,7,4,1,2019-11-02
731,경기,하남시,1,0,0,1,1,0,2019-12-02
732,경기,화성시,4,1,6,11,7,0,2019-01-02
733,경기,화성시,5,0,0,5,3,0,2019-02-02
734,경기,화성시,2,0,0,2,2,0,2019-03-02
735,경기,화성시,12,1,8,21,14,0,2019-04-02
736,경기,화성시,7,2,3,12,10,0,2019-05-02
737,경기,화성시,11,0,6,17,9,0,2019-06-02
738,경기,화성시,6,0,1,7,6,0,2019-07-02
739,경기,화성시,7,0,4,11,7,0,2019-08-02
740,경기,화성시,8,1,5,14,13,0,2019-09-02
741,경기,화성시,20,0,8,28,23,0,2019-10-02
742,경기,화성시,7,1,3,11,6,0,2019-11-02
743,경기,화성시,13,3,1,17,8,0,2019-12-02
744,경기,가평군,3,0,0,3,1,0,2019-01-03
745,경기,가평군,3,0,2,5,2,0,2019-02-03
746,경기,가평군,0,0,0,0,0,0,2019-03-03
747,경기,가평군,1,0,0,1,1,0,2019-04-03
748,경기,가평군,1,0,0,1,1,0,2019-05-03
749,경기,가평군,1,0,0,1,1,0,2019-06-03
750,경기,가평군,1,0,0,1,1,0,2019-07-03
751,경기,가평군,11,0,2,13,4,0,2019-08-03
752,경기,가평군,3,0,3,6,1,0,2019-09-03
753,경기,가평군,0,0,0,0,0,0,2019-10-03
754,경기,가평군,4,1,1,6,3,0,2019-11-03
755,경기,가평군,0,0,0,0,0,0,2019-12-03
756,경기,고양시,4,2,3,9,7,0,2019-01-03
757,경기,고양시,12,0,0,12,8,0,2019-02-03
758,경기,고양시,10,1,4,15,7,0,2019-03-03
759,경기,고양시,10,1,4,15,10,0,2019-04-03
760,경기,고양시,14,1,0,15,13,0,2019-05-03
761,경기,고양시,3,2,2,7,4,0,2019-06-03
762,경기,고양시,6,2,2,10,8,0,2019-07-03
763,경기,고양시,18,3,3,24,12,0,2019-08-03
764,경기,고양시,11,3,1,15,12,1,2019-09-03
765,경기,고양시,11,2,3,16,9,0,2019-10-03
766,경기,고양시,7,1,3,11,8,0,2019-11-03
767,경기,고양시,15,0,1,16,11,0,2019-12-03
768,경기,과천시,0,0,0,0,0,0,2019-01-03
769,경기,과천시,0,0,0,0,0,0,2019-02-03
770,경기,과천시,3,0,0,3,1,0,2019-03-03
771,경기,과천시,2,0,0,2,1,0,2019-04-03
772,경기,과천시,0,0,0,0,0,0,2019-05-03
773,경기,과천시,0,0,0,0,0,0,2019-06-03
774,경기,과천시,0,0,1,1,1,0,2019-07-03
775,경기,과천시,2,0,0,2,1,0,2019-08-03
776,경기,과천시,0,0,0,0,0,0,2019-09-03
777,경기,과천시,0,0,0,0,0,0,2019-10-03
778,경기,과천시,0,0,0,0,0,0,2019-11-03
779,경기,과천시,2,0,0,2,2,0,2019-12-03
780,경기,광명시,3,0,2,5,3,0,2019-01-03
781,경기,광명시,0,0,0,0,0,0,2019-02-03
782,경기,광명시,1,0,0,1,1,0,2019-03-03
783,경기,광명시,1,2,0,3,1,0,2019-04-03
784,경기,광명시,1,1,1,3,3,0,2019-05-03
785,경기,광명시,0,0,0,0,0,0,2019-06-03
786,경기,광명시,2,0,0,2,2,0,2019-07-03
787,경기,광명시,3,2,1,6,5,0,2019-08-03
788,경기,광명시,1,0,0,1,1,0,2019-09-03
789,경기,광명시,3,0,0,3,2,0,2019-10-03
790,경기,광명시,0,1,0,1,1,0,2019-11-03
791,경기,광명시,4,0,1,5,4,0,2019-12-03
792,경기,광주시,3,1,1,5,5,0,2019-01-03
793,경기,광주시,5,0,0,5,3,0,2019-02-03
794,경기,광주시,5,0,0,5,2,0,2019-03-03
795,경기,광주시,11,0,8,19,7,0,2019-04-03
796,경기,광주시,2,2,4,8,4,0,2019-05-03
797,경기,광주시,2,0,1,3,3,0,2019-06-03
798,경기,광주시,0,0,1,1,1,0,2019-07-03
799,경기,광주시,22,5,6,33,4,1,2019-08-03
800,경기,광주시,7,0,1,8,7,0,2019-09-03
801,경기,광주시,7,0,3,10,6,0,2019-10-03
802,경기,광주시,7,0,1,8,4,0,2019-11-03
803,경기,광주시,5,1,1,7,5,0,2019-12-03
804,경기,구리시,1,0,1,2,2,0,2019-01-03
805,경기,구리시,1,1,1,3,2,0,2019-02-03
806,경기,구리시,1,0,1,2,2,0,2019-03-03
807,경기,구리시,4,0,2,6,5,0,2019-04-03
808,경기,구리시,2,0,0,2,2,0,2019-05-03
809,경기,구리시,1,0,0,1,1,0,2019-06-03
810,경기,구리시,3,2,0,5,3,0,2019-07-03
811,경기,구리시,7,0,0,7,4,0,2019-08-03
812,경기,구리시,1,0,0,1,1,0,2019-09-03
813,경기,구리시,5,1,0,6,4,0,2019-10-03
814,경기,구리시,1,0,0,1,1,0,2019-11-03
815,경기,구리시,1,0,3,4,3,0,2019-12-03
816,경기,군포시,2,0,0,2,2,0,2019-01-03
817,경기,군포시,5,0,0,5,3,0,2019-02-03
818,경기,군포시,1,0,0,1,1,0,2019-03-03
819,경기,군포시,0,1,0,1,1,0,2019-04-03
820,경기,군포시,0,0,1,1,1,0,2019-05-03
821,경기,군포시,2,0,0,2,2,0,2019-06-03
822,경기,군포시,6,0,0,6,3,0,2019-07-03
823,경기,군포시,1,0,0,1,1,0,2019-08-03
824,경기,군포시,2,0,0,2,2,0,2019-09-03
825,경기,군포시,1,0,0,1,1,0,2019-10-03
826,경기,군포시,0,0,0,0,0,0,2019-11-03
827,경기,군포시,0,0,0,0,0,0,2019-12-03
828,경기,김포시,3,0,0,3,2,0,2019-01-03
829,경기,김포시,6,2,2,10,6,0,2019-02-03
830,경기,김포시,1,0,1,2,2,0,2019-03-03
831,경기,김포시,7,0,0,7,4,0,2019-04-03
832,경기,김포시,6,2,0,8,6,0,2019-05-03
833,경기,김포시,1,0,0,1,1,0,2019-06-03
834,경기,김포시,5,3,0,8,6,0,2019-07-03
835,경기,김포시,2,0,0,2,2,0,2019-08-03
836,경기,김포시,3,0,0,3,2,0,2019-09-03
837,경기,김포시,5,1,1,7,6,0,2019-10-03
838,경기,김포시,9,0,2,11,3,0,2019-11-03
839,경기,김포시,7,0,1,8,6,0,2019-12-03
840,경기,남양주시,3,0,0,3,3,0,2019-01-03
841,경기,남양주시,6,0,1,7,3,0,2019-02-03
842,경기,남양주시,17,0,6,23,9,0,2019-03-03
843,경기,남양주시,13,2,3,18,11,0,2019-04-03
844,경기,남양주시,3,2,4,9,8,0,2019-05-03
845,경기,남양주시,10,1,3,14,9,0,2019-06-03
846,경기,남양주시,11,0,2,13,7,0,2019-07-03
847,경기,남양주시,13,3,1,17,7,0,2019-08-03
848,경기,남양주시,4,1,2,7,7,0,2019-09-03
849,경기,남양주시,7,1,1,9,5,0,2019-10-03
850,경기,남양주시,8,0,3,11,6,0,2019-11-03
851,경기,남양주시,6,1,1,8,6,0,2019-12-03
852,경기,동두천시,0,0,0,0,0,0,2019-01-03
853,경기,동두천시,2,0,0,2,2,0,2019-02-03
854,경기,동두천시,1,0,1,2,2,0,2019-03-03
855,경기,동두천시,0,0,0,0,0,0,2019-04-03
856,경기,동두천시,0,0,1,1,1,0,2019-05-03
857,경기,동두천시,3,0,1,4,2,0,2019-06-03
858,경기,동두천시,2,0,0,2,2,0,2019-07-03
859,경기,동두천시,2,0,1,3,2,0,2019-08-03
860,경기,동두천시,0,0,0,0,0,0,2019-09-03
861,경기,동두천시,1,0,0,1,1,0,2019-10-03
862,경기,동두천시,2,0,0,2,1,0,2019-11-03
863,경기,동두천시,1,0,0,1,1,0,2019-12-03
864,경기,부천시,4,1,3,8,7,0,2019-01-03
865,경기,부천시,10,1,2,13,12,0,2019-02-03
866,경기,부천시,4,0,2,6,4,0,2019-03-03
867,경기,부천시,15,0,0,15,12,0,2019-04-03
868,경기,부천시,6,1,0,7,5,0,2019-05-03
869,경기,부천시,8,1,0,9,6,0,2019-06-03
870,경기,부천시,5,1,1,7,5,0,2019-07-03
871,경기,부천시,12,0,5,17,11,1,2019-08-03
872,경기,부천시,4,1,3,8,8,0,2019-09-03
873,경기,부천시,10,0,3,13,7,0,2019-10-03
874,경기,부천시,9,2,3,14,11,0,2019-11-03
875,경기,부천시,6,1,0,7,5,0,2019-12-03
876,경기,성남시,7,1,3,11,11,0,2019-01-03
877,경기,성남시,2,0,1,3,3,0,2019-02-03
878,경기,성남시,7,1,3,11,7,0,2019-03-03
879,경기,성남시,11,0,1,12,11,0,2019-04-03
880,경기,성남시,17,1,2,20,15,0,2019-05-03
881,경기,성남시,15,1,2,18,12,0,2019-06-03
882,경기,성남시,3,0,1,4,4,0,2019-07-03
883,경기,성남시,5,1,2,8,6,0,2019-08-03
884,경기,성남시,9,0,1,10,8,0,2019-09-03
885,경기,성남시,12,0,4,16,12,0,2019-10-03
886,경기,성남시,10,3,5,18,10,0,2019-11-03
887,경기,성남시,9,2,3,14,14,1,2019-12-03
888,경기,수원시,17,0,5,22,18,0,2019-01-03
889,경기,수원시,9,1,1,11,7,0,2019-02-03
890,경기,수원시,11,2,2,15,7,0,2019-03-03
891,경기,수원시,13,0,1,14,9,0,2019-04-03
892,경기,수원시,7,0,4,11,11,1,2019-05-03
893,경기,수원시,9,1,1,11,11,0,2019-06-03
894,경기,수원시,14,1,3,18,8,0,2019-07-03
895,경기,수원시,11,5,1,17,7,0,2019-08-03
896,경기,수원시,13,1,7,21,15,0,2019-09-03
897,경기,수원시,16,0,3,19,11,0,2019-10-03
898,경기,수원시,14,4,2,20,13,0,2019-11-03
899,경기,수원시,16,1,4,21,18,0,2019-12-03
900,경기,시흥시,8,0,1,9,6,0,2019-01-03
901,경기,시흥시,4,0,0,4,1,0,2019-02-03
902,경기,시흥시,3,1,0,4,2,0,2019-03-03
903,경기,시흥시,11,0,0,11,6,0,2019-04-03
904,경기,시흥시,4,2,3,9,3,0,2019-05-03
905,경기,시흥시,8,0,5,13,7,0,2019-06-03
906,경기,시흥시,2,0,4,6,5,0,2019-07-03
907,경기,시흥시,0,0,0,0,0,0,2019-08-03
908,경기,시흥시,4,1,2,7,6,0,2019-09-03
909,경기,시흥시,0,0,0,0,0,0,2019-10-03
910,경기,시흥시,3,0,0,3,3,0,2019-11-03
911,경기,시흥시,8,1,4,13,11,0,2019-12-03
912,경기,안산시,5,1,2,8,7,0,2019-01-03
913,경기,안산시,12,0,3,15,12,0,2019-02-03
914,경기,안산시,6,2,1,9,7,0,2019-03-03
915,경기,안산시,5,0,1,6,5,0,2019-04-03
916,경기,안산시,12,0,2,14,11,0,2019-05-03
917,경기,안산시,8,0,2,10,8,0,2019-06-03
918,경기,안산시,20,0,11,31,20,0,2019-07-03
919,경기,안산시,9,0,5,14,8,0,2019-08-03
920,경기,안산시,11,1,7,19,17,0,2019-09-03
921,경기,안산시,7,2,5,14,11,0,2019-10-03
922,경기,안산시,10,3,0,13,9,0,2019-11-03
923,경기,안산시,16,0,2,18,11,2,2019-12-03
924,경기,안성시,1,0,1,2,2,0,2019-01-03
925,경기,안성시,0,0,0,0,0,0,2019-02-03
926,경기,안성시,0,0,0,0,0,0,2019-03-03
927,경기,안성시,0,0,0,0,0,0,2019-04-03
928,경기,안성시,5,0,0,5,3,0,2019-05-03
929,경기,안성시,4,0,1,5,4,0,2019-06-03
930,경기,안성시,3,1,1,5,3,1,2019-07-03
931,경기,안성시,6,0,3,9,4,0,2019-08-03
932,경기,안성시,3,1,0,4,2,0,2019-09-03
933,경기,안성시,2,0,0,2,2,0,2019-10-03
934,경기,안성시,8,2,1,11,6,0,2019-11-03
935,경기,안성시,3,0,0,3,3,0,2019-12-03
936,경기,안양시,3,0,1,4,3,0,2019-01-03
937,경기,안양시,9,0,1,10,5,1,2019-02-03
938,경기,안양시,2,0,2,4,3,0,2019-03-03
939,경기,안양시,2,0,0,2,2,0,2019-04-03
940,경기,안양시,3,2,0,5,4,0,2019-05-03
941,경기,안양시,3,0,1,4,3,0,2019-06-03
942,경기,안양시,4,0,1,5,4,0,2019-07-03
943,경기,안양시,7,0,0,7,4,0,2019-08-03
944,경기,안양시,3,0,1,4,4,0,2019-09-03
945,경기,안양시,2,1,1,4,3,0,2019-10-03
946,경기,안양시,12,1,2,15,7,0,2019-11-03
947,경기,안양시,4,0,0,4,4,0,2019-12-03
948,경기,양주시,0,0,0,0,0,0,2019-01-03
949,경기,양주시,10,0,0,10,4,0,2019-02-03
950,경기,양주시,3,0,0,3,2,0,2019-03-03
951,경기,양주시,2,0,1,3,3,0,2019-04-03
952,경기,양주시,1,1,1,3,3,0,2019-05-03
953,경기,양주시,1,1,0,2,2,0,2019-06-03
954,경기,양주시,8,0,0,8,4,0,2019-07-03
955,경기,양주시,0,0,0,0,0,0,2019-08-03
956,경기,양주시,2,0,2,4,3,0,2019-09-03
957,경기,양주시,4,0,1,5,4,0,2019-10-03
958,경기,양주시,0,0,0,0,0,0,2019-11-03
959,경기,양주시,1,1,4,6,6,0,2019-12-03
960,경기,양평군,2,0,0,2,1,0,2019-01-03
961,경기,양평군,1,0,0,1,1,0,2019-02-03
962,경기,양평군,0,1,2,3,1,0,2019-03-03
963,경기,양평군,0,0,0,0,0,0,2019-04-03
964,경기,양평군,3,0,1,4,3,0,2019-05-03
965,경기,양평군,3,0,1,4,3,0,2019-06-03
966,경기,양평군,1,0,0,1,1,0,2019-07-03
967,경기,양평군,3,0,2,5,3,0,2019-08-03
968,경기,양평군,3,0,0,3,2,0,2019-09-03
969,경기,양평군,0,0,0,0,0,0,2019-10-03
970,경기,양평군,5,0,0,5,5,0,2019-11-03
971,경기,양평군,2,0,0,2,1,0,2019-12-03
972,경기,여주시,0,0,0,0,0,0,2019-01-03
973,경기,여주시,2,0,1,3,2,0,2019-02-03
974,경기,여주시,2,0,0,2,1,0,2019-03-03
975,경기,여주시,0,0,1,1,1,0,2019-04-03
976,경기,여주시,1,0,1,2,1,0,2019-05-03
977,경기,여주시,4,0,1,5,4,0,2019-06-03
978,경기,여주시,0,1,1,2,2,0,2019-07-03
979,경기,여주시,0,0,1,1,1,0,2019-08-03
980,경기,여주시,4,0,1,5,3,0,2019-09-03
981,경기,여주시,0,0,0,0,0,0,2019-10-03
982,경기,여주시,7,0,0,7,5,0,2019-11-03
983,경기,여주시,0,0,0,0,0,0,2019-12-03
984,경기,연천군,0,0,0,0,0,0,2019-01-03
985,경기,연천군,1,0,0,1,1,0,2019-02-03
986,경기,연천군,0,0,0,0,0,0,2019-03-03
987,경기,연천군,0,0,0,0,0,0,2019-04-03
988,경기,연천군,0,0,0,0,0,0,2019-05-03
989,경기,연천군,0,0,0,0,0,0,2019-06-03
990,경기,연천군,0,0,0,0,0,0,2019-07-03
991,경기,연천군,0,0,0,0,0,0,2019-08-03
992,경기,연천군,0,0,0,0,0,0,2019-09-03
993,경기,연천군,4,0,1,5,3,0,2019-10-03
994,경기,연천군,0,0,0,0,0,0,2019-11-03
995,경기,연천군,0,0,1,1,1,0,2019-12-03
996,경기,오산시,3,0,2,5,3,0,2019-01-03
997,경기,오산시,0,0,2,2,1,0,2019-02-03
998,경기,오산시,3,2,0,5,5,0,2019-03-03
999,경기,오산시,3,1,2,6,4,0,2019-04-03
1000,경기,오산시,10,1,0,11,8,0,2019-05-03
1001,경기,오산시,5,0,0,5,3,0,2019-06-03
1002,경기,오산시,2,1,0,3,2,0,2019-07-03
1003,경기,오산시,10,2,1,13,6,1,2019-08-03
1004,경기,오산시,6,0,3,9,6,0,2019-09-03
1005,경기,오산시,3,2,1,6,4,0,2019-10-03
1006,경기,오산시,5,0,0,5,4,0,2019-11-03
1007,경기,오산시,9,0,1,10,5,0,2019-12-03
1008,경기,용인시,7,0,4,11,7,0,2019-01-03
1009,경기,용인시,20,5,4,29,8,0,2019-02-03
1010,경기,용인시,13,0,4,17,9,0,2019-03-03
1011,경기,용인시,6,2,4,12,10,0,2019-04-03
1012,경기,용인시,10,1,2,13,9,1,2019-05-03
1013,경기,용인시,11,1,3,15,12,0,2019-06-03
1014,경기,용인시,6,3,7,16,10,0,2019-07-03
1015,경기,용인시,4,2,2,8,7,0,2019-08-03
1016,경기,용인시,4,0,1,5,5,0,2019-09-03
1017,경기,용인시,30,13,7,50,11,1,2019-10-03
1018,경기,용인시,6,2,0,8,4,0,2019-11-03
1019,경기,용인시,18,2,3,23,17,0,2019-12-03
1020,경기,의왕시,6,1,1,8,4,0,2019-01-03
1021,경기,의왕시,1,1,0,2,1,0,2019-02-03
1022,경기,의왕시,3,1,2,6,1,0,2019-03-03
1023,경기,의왕시,1,0,1,2,2,0,2019-04-03
1024,경기,의왕시,2,0,0,2,2,0,2019-05-03
1025,경기,의왕시,1,0,0,1,1,0,2019-06-03
1026,경기,의왕시,2,0,2,4,2,0,2019-07-03
1027,경기,의왕시,0,0,0,0,0,0,2019-08-03
1028,경기,의왕시,1,0,0,1,1,0,2019-09-03
1029,경기,의왕시,0,0,1,1,1,0,2019-10-03
1030,경기,의왕시,0,0,3,3,1,0,2019-11-03
1031,경기,의왕시,3,0,2,5,3,0,2019-12-03
1032,경기,의정부시,1,0,1,2,2,0,2019-01-03
1033,경기,의정부시,1,0,0,1,1,0,2019-02-03
1034,경기,의정부시,5,1,0,6,3,0,2019-03-03
1035,경기,의정부시,3,0,0,3,3,0,2019-04-03
1036,경기,의정부시,2,1,0,3,3,0,2019-05-03
1037,경기,의정부시,3,1,2,6,6,0,2019-06-03
1038,경기,의정부시,2,0,0,2,2,0,2019-07-03
1039,경기,의정부시,8,2,1,11,6,0,2019-08-03
1040,경기,의정부시,2,1,1,4,4,0,2019-09-03
1041,경기,의정부시,6,1,1,8,7,0,2019-10-03
1042,경기,의정부시,8,0,1,9,5,0,2019-11-03
1043,경기,의정부시,5,0,4,9,8,0,2019-12-03
1044,경기,이천시,0,0,1,1,1,0,2019-01-03
1045,경기,이천시,4,0,0,4,2,0,2019-02-03
1046,경기,이천시,3,0,0,3,2,0,2019-03-03
1047,경기,이천시,0,0,0,0,0,0,2019-04-03
1048,경기,이천시,1,1,0,2,2,0,2019-05-03
1049,경기,이천시,5,0,0,5,5,0,2019-06-03
1050,경기,이천시,7,1,0,8,5,0,2019-07-03
1051,경기,이천시,4,0,0,4,2,0,2019-08-03
1052,경기,이천시,5,0,1,6,5,0,2019-09-03
1053,경기,이천시,6,0,1,7,3,0,2019-10-03
1054,경기,이천시,2,0,1,3,2,0,2019-11-03
1055,경기,이천시,3,0,2,5,3,0,2019-12-03
1056,경기,파주시,2,0,0,2,2,0,2019-01-03
1057,경기,파주시,5,0,1,6,3,0,2019-02-03
1058,경기,파주시,2,0,0,2,3,1,2019-03-03
1059,경기,파주시,3,1,1,5,5,0,2019-04-03
1060,경기,파주시,3,0,1,4,3,0,2019-05-03
1061,경기,파주시,5,0,0,5,4,0,2019-06-03
1062,경기,파주시,1,1,0,2,2,0,2019-07-03
1063,경기,파주시,3,0,0,3,3,0,2019-08-03
1064,경기,파주시,8,1,1,10,5,0,2019-09-03
1065,경기,파주시,8,0,0,8,4,0,2019-10-03
1066,경기,파주시,6,0,8,14,7,0,2019-11-03
1067,경기,파주시,2,0,1,3,4,1,2019-12-03
1068,경기,평택시,3,4,3,10,7,0,2019-01-03
1069,경기,평택시,14,4,1,19,10,0,2019-02-03
1070,경기,평택시,9,0,0,9,6,0,2019-03-03
1071,경기,평택시,21,2,3,26,14,0,2019-04-03
1072,경기,평택시,28,7,10,45,11,0,2019-05-03
1073,경기,평택시,4,0,2,6,5,0,2019-06-03
1074,경기,평택시,10,1,3,14,7,0,2019-07-03
1075,경기,평택시,8,1,3,12,10,0,2019-08-03
1076,경기,평택시,9,0,5,14,13,1,2019-09-03
1077,경기,평택시,4,0,7,11,8,0,2019-10-03
1078,경기,평택시,5,2,2,9,7,0,2019-11-03
1079,경기,평택시,8,2,1,11,12,1,2019-12-03
1080,경기,포천시,0,1,0,1,1,0,2019-01-03
1081,경기,포천시,0,0,0,0,0,0,2019-02-03
1082,경기,포천시,3,0,1,4,1,0,2019-03-03
1083,경기,포천시,2,0,3,5,4,0,2019-04-03
1084,경기,포천시,3,0,0,3,2,0,2019-05-03
1085,경기,포천시,2,0,1,3,3,0,2019-06-03
1086,경기,포천시,0,0,4,4,3,0,2019-07-03
1087,경기,포천시,3,0,0,3,2,0,2019-08-03
1088,경기,포천시,0,0,0,0,0,0,2019-09-03
1089,경기,포천시,0,0,0,0,0,0,2019-10-03
1090,경기,포천시,0,0,0,0,0,0,2019-11-03
1091,경기,포천시,2,0,0,2,2,0,2019-12-03
1092,경기,하남시,3,1,3,7,5,0,2019-01-03
1093,경기,하남시,0,0,0,0,0,0,2019-02-03
1094,경기,하남시,2,1,0,3,2,0,2019-03-03
1095,경기,하남시,0,1,0,1,1,0,2019-04-03
1096,경기,하남시,6,1,0,7,5,0,2019-05-03
1097,경기,하남시,3,1,0,4,4,0,2019-06-03
1098,경기,하남시,2,0,2,4,3,0,2019-07-03
1099,경기,하남시,4,0,1,5,4,0,2019-08-03
1100,경기,하남시,4,0,1,5,4,0,2019-09-03
1101,경기,하남시,0,1,0,1,1,0,2019-10-03
1102,경기,하남시,1,0,0,1,1,0,2019-11-03
1103,경기,하남시,1,0,0,1,1,0,2019-12-03
1104,경기,화성시,5,0,5,10,6,0,2019-01-03
1105,경기,화성시,1,0,0,1,1,0,2019-02-03
1106,경기,화성시,3,0,0,3,2,0,2019-03-03
1107,경기,화성시,7,1,3,11,5,0,2019-04-03
1108,경기,화성시,10,0,4,14,11,0,2019-05-03
1109,경기,화성시,11,1,3,15,11,0,2019-06-03
1110,경기,화성시,5,0,1,6,5,0,2019-07-03
1111,경기,화성시,5,0,1,6,4,0,2019-08-03
1112,경기,화성시,2,0,5,7,4,0,2019-09-03
1113,경기,화성시,9,0,0,9,3,0,2019-10-03
1114,경기,화성시,3,1,5,9,8,0,2019-11-03
1115,경기,화성시,7,1,1,9,7,0,2019-12-03
1116,경기,가평군,1,0,1,2,1,0,2019-01-04
1117,경기,가평군,1,0,0,1,1,0,2019-02-04
1118,경기,가평군,0,0,0,0,0,0,2019-03-04
1119,경기,가평군,1,0,0,1,1,0,2019-04-04
1120,경기,가평군,2,0,2,4,1,0,2019-05-04
1121,경기,가평군,2,0,0,2,1,0,2019-06-04
1122,경기,가평군,0,0,1,1,1,0,2019-07-04
1123,경기,가평군,3,0,1,4,2,0,2019-08-04
1124,경기,가평군,2,0,2,4,3,0,2019-09-04
1125,경기,가평군,0,0,1,1,1,0,2019-10-04
1126,경기,가평군,1,0,0,1,1,0,2019-11-04
1127,경기,가평군,0,0,0,0,0,0,2019-12-04
1128,경기,고양시,5,3,5,13,10,0,2019-01-04
1129,경기,고양시,6,2,0,8,7,0,2019-02-04
1130,경기,고양시,4,2,1,7,6,0,2019-03-04
1131,경기,고양시,3,1,0,4,4,0,2019-04-04
1132,경기,고양시,18,3,2,23,15,0,2019-05-04
1133,경기,고양시,10,3,2,15,11,0,2019-06-04
1134,경기,고양시,16,3,5,24,16,0,2019-07-04
1135,경기,고양시,12,3,1,16,11,0,2019-08-04
1136,경기,고양시,17,4,3,24,15,0,2019-09-04
1137,경기,고양시,17,3,3,23,13,1,2019-10-04
1138,경기,고양시,9,4,4,17,10,0,2019-11-04
1139,경기,고양시,4,1,3,8,7,0,2019-12-04
1140,경기,과천시,1,0,0,1,1,0,2019-01-04
1141,경기,과천시,0,0,0,0,0,0,2019-02-04
1142,경기,과천시,0,1,0,1,1,0,2019-03-04
1143,경기,과천시,2,0,2,4,1,0,2019-04-04
1144,경기,과천시,1,0,0,1,1,0,2019-05-04
1145,경기,과천시,2,0,0,2,2,0,2019-06-04
1146,경기,과천시,1,0,0,1,1,0,2019-07-04
1147,경기,과천시,0,0,0,0,0,0,2019-08-04
1148,경기,과천시,0,0,0,0,0,0,2019-09-04
1149,경기,과천시,2,0,0,2,1,0,2019-10-04
1150,경기,과천시,1,0,1,2,2,0,2019-11-04
1151,경기,과천시,0,0,0,0,0,0,2019-12-04
1152,경기,광명시,2,0,3,5,5,0,2019-01-04
1153,경기,광명시,0,1,0,1,1,0,2019-02-04
1154,경기,광명시,4,0,2,6,5,0,2019-03-04
1155,경기,광명시,4,0,1,5,4,0,2019-04-04
1156,경기,광명시,1,0,0,1,1,0,2019-05-04
1157,경기,광명시,2,0,2,4,3,0,2019-06-04
1158,경기,광명시,0,1,1,2,2,0,2019-07-04
1159,경기,광명시,5,3,0,8,4,0,2019-08-04
1160,경기,광명시,10,0,3,13,7,0,2019-09-04
1161,경기,광명시,0,1,0,1,1,0,2019-10-04
1162,경기,광명시,2,0,0,2,2,0,2019-11-04
1163,경기,광명시,0,0,0,0,0,0,2019-12-04
1164,경기,광주시,2,0,1,3,3,0,2019-01-04
1165,경기,광주시,10,0,0,10,3,0,2019-02-04
1166,경기,광주시,4,0,0,4,3,0,2019-03-04
1167,경기,광주시,10,2,1,13,8,0,2019-04-04
1168,경기,광주시,11,5,3,19,9,0,2019-05-04
1169,경기,광주시,8,0,2,10,6,0,2019-06-04
1170,경기,광주시,5,0,0,5,3,0,2019-07-04
1171,경기,광주시,1,0,2,3,1,0,2019-08-04
1172,경기,광주시,5,0,4,9,5,0,2019-09-04
1173,경기,광주시,11,0,4,15,11,0,2019-10-04
1174,경기,광주시,9,2,3,14,10,0,2019-11-04
1175,경기,광주시,18,6,0,24,15,0,2019-12-04
1176,경기,구리시,2,0,0,2,2,0,2019-01-04
1177,경기,구리시,0,0,0,0,0,0,2019-02-04
1178,경기,구리시,2,0,0,2,2,0,2019-03-04
1179,경기,구리시,3,0,0,3,3,0,2019-04-04
1180,경기,구리시,1,0,3,4,2,0,2019-05-04
1181,경기,구리시,0,0,1,1,1,0,2019-06-04
1182,경기,구리시,3,0,2,5,4,0,2019-07-04
1183,경기,구리시,0,0,1,1,1,0,2019-08-04
1184,경기,구리시,4,0,0,4,3,0,2019-09-04
1185,경기,구리시,0,0,0,0,0,0,2019-10-04
1186,경기,구리시,2,0,0,2,2,0,2019-11-04
1187,경기,구리시,1,0,0,1,1,0,2019-12-04
1188,경기,군포시,2,0,1,3,3,0,2019-01-04
1189,경기,군포시,0,0,0,0,0,0,2019-02-04
1190,경기,군포시,0,0,0,0,0,0,2019-03-04
1191,경기,군포시,0,0,2,2,2,0,2019-04-04
1192,경기,군포시,1,0,1,2,1,0,2019-05-04
1193,경기,군포시,0,0,0,0,0,0,2019-06-04
1194,경기,군포시,8,2,0,10,5,0,2019-07-04
1195,경기,군포시,0,1,0,1,1,0,2019-08-04
1196,경기,군포시,13,0,0,13,2,0,2019-09-04
1197,경기,군포시,2,0,0,2,2,0,2019-10-04
1198,경기,군포시,12,3,3,18,4,0,2019-11-04
1199,경기,군포시,1,0,2,3,2,0,2019-12-04
1200,경기,김포시,5,1,0,6,5,0,2019-01-04
1201,경기,김포시,5,0,0,5,1,0,2019-02-04
1202,경기,김포시,4,0,1,5,3,0,2019-03-04
1203,경기,김포시,4,0,3,7,7,0,2019-04-04
1204,경기,김포시,11,3,3,17,6,0,2019-05-04
1205,경기,김포시,19,0,1,20,5,0,2019-06-04
1206,경기,김포시,3,0,1,4,3,0,2019-07-04
1207,경기,김포시,1,0,4,5,3,0,2019-08-04
1208,경기,김포시,5,0,2,7,6,0,2019-09-04
1209,경기,김포시,8,5,2,15,9,0,2019-10-04
1210,경기,김포시,8,0,0,8,5,0,2019-11-04
1211,경기,김포시,0,1,5,6,4,0,2019-12-04
1212,경기,남양주시,2,0,2,4,3,0,2019-01-04
1213,경기,남양주시,2,6,2,10,5,0,2019-02-04
1214,경기,남양주시,3,0,4,7,6,0,2019-03-04
1215,경기,남양주시,8,0,3,11,3,0,2019-04-04
1216,경기,남양주시,5,0,1,6,5,0,2019-05-04
1217,경기,남양주시,6,0,2,8,5,0,2019-06-04
1218,경기,남양주시,10,2,3,15,10,0,2019-07-04
1219,경기,남양주시,8,0,3,11,4,0,2019-08-04
1220,경기,남양주시,6,2,1,9,6,0,2019-09-04
1221,경기,남양주시,11,2,3,16,15,1,2019-10-04
1222,경기,남양주시,4,1,2,7,5,0,2019-11-04
1223,경기,남양주시,9,0,1,10,7,0,2019-12-04
1224,경기,동두천시,0,0,0,0,0,0,2019-01-04
1225,경기,동두천시,1,0,0,1,1,0,2019-02-04
1226,경기,동두천시,2,0,0,2,1,0,2019-03-04
1227,경기,동두천시,3,0,0,3,2,0,2019-04-04
1228,경기,동두천시,3,0,0,3,1,0,2019-05-04
1229,경기,동두천시,1,0,0,1,1,0,2019-06-04
1230,경기,동두천시,6,2,0,8,4,0,2019-07-04
1231,경기,동두천시,0,0,3,3,2,0,2019-08-04
1232,경기,동두천시,1,0,0,1,1,0,2019-09-04
1233,경기,동두천시,1,0,0,1,1,0,2019-10-04
1234,경기,동두천시,3,2,1,6,4,0,2019-11-04
1235,경기,동두천시,0,0,1,1,1,0,2019-12-04
1236,경기,부천시,4,0,3,7,6,0,2019-01-04
1237,경기,부천시,10,2,1,13,6,0,2019-02-04
1238,경기,부천시,1,0,0,1,2,1,2019-03-04
1239,경기,부천시,8,0,1,9,6,0,2019-04-04
1240,경기,부천시,14,0,1,15,11,0,2019-05-04
1241,경기,부천시,4,0,1,5,5,0,2019-06-04
1242,경기,부천시,9,2,4,15,15,0,2019-07-04
1243,경기,부천시,14,1,1,16,10,0,2019-08-04
1244,경기,부천시,16,1,1,18,10,0,2019-09-04
1245,경기,부천시,11,0,4,15,13,0,2019-10-04
1246,경기,부천시,8,1,6,15,12,0,2019-11-04
1247,경기,부천시,19,3,5,27,18,0,2019-12-04
1248,경기,성남시,10,2,8,20,16,0,2019-01-04
1249,경기,성남시,4,0,2,6,4,0,2019-02-04
1250,경기,성남시,6,1,7,14,9,0,2019-03-04
1251,경기,성남시,7,1,4,12,10,0,2019-04-04
1252,경기,성남시,9,3,5,17,11,0,2019-05-04
1253,경기,성남시,4,2,5,11,10,0,2019-06-04
1254,경기,성남시,18,0,2,20,13,0,2019-07-04
1255,경기,성남시,3,1,4,8,5,0,2019-08-04
1256,경기,성남시,16,3,3,22,15,0,2019-09-04
1257,경기,성남시,4,0,3,7,6,0,2019-10-04
1258,경기,성남시,18,7,10,35,15,0,2019-11-04
1259,경기,성남시,21,4,8,33,23,1,2019-12-04
1260,경기,수원시,12,1,3,16,9,0,2019-01-04
1261,경기,수원시,3,0,1,4,2,0,2019-02-04
1262,경기,수원시,15,1,2,18,12,0,2019-03-04
1263,경기,수원시,11,0,4,15,11,0,2019-04-04
1264,경기,수원시,22,6,2,30,15,0,2019-05-04
1265,경기,수원시,14,4,4,22,11,0,2019-06-04
1266,경기,수원시,14,1,2,17,9,0,2019-07-04
1267,경기,수원시,7,0,1,8,7,0,2019-08-04
1268,경기,수원시,12,1,8,21,16,0,2019-09-04
1269,경기,수원시,12,2,4,18,13,0,2019-10-04
1270,경기,수원시,19,1,1,21,14,0,2019-11-04
1271,경기,수원시,31,3,7,41,25,0,2019-12-04
1272,경기,시흥시,14,0,1,15,9,0,2019-01-04
1273,경기,시흥시,0,2,0,2,2,0,2019-02-04
1274,경기,시흥시,6,1,0,7,5,1,2019-03-04
1275,경기,시흥시,2,0,3,5,6,1,2019-04-04
1276,경기,시흥시,16,0,3,19,10,0,2019-05-04
1277,경기,시흥시,11,0,2,13,11,0,2019-06-04
1278,경기,시흥시,10,0,4,14,10,0,2019-07-04
1279,경기,시흥시,9,0,0,9,4,0,2019-08-04
1280,경기,시흥시,6,0,0,6,4,0,2019-09-04
1281,경기,시흥시,12,1,1,14,11,0,2019-10-04
1282,경기,시흥시,2,1,0,3,4,1,2019-11-04
1283,경기,시흥시,6,1,5,12,10,1,2019-12-04
1284,경기,안산시,15,2,4,21,17,1,2019-01-04
1285,경기,안산시,6,0,1,7,5,0,2019-02-04
1286,경기,안산시,7,0,0,7,6,0,2019-03-04
1287,경기,안산시,15,0,1,16,9,0,2019-04-04
1288,경기,안산시,11,0,5,16,8,0,2019-05-04
1289,경기,안산시,16,2,4,22,16,0,2019-06-04
1290,경기,안산시,10,0,4,14,12,0,2019-07-04
1291,경기,안산시,14,0,4,18,12,0,2019-08-04
1292,경기,안산시,17,0,6,23,15,0,2019-09-04
1293,경기,안산시,23,1,8,32,11,0,2019-10-04
1294,경기,안산시,17,1,4,22,14,0,2019-11-04
1295,경기,안산시,41,3,4,48,29,0,2019-12-04
1296,경기,안성시,3,0,0,3,3,0,2019-01-04
1297,경기,안성시,3,0,0,3,2,0,2019-02-04
1298,경기,안성시,2,1,0,3,2,0,2019-03-04
1299,경기,안성시,4,0,2,6,5,1,2019-04-04
1300,경기,안성시,2,0,0,2,2,0,2019-05-04
1301,경기,안성시,4,0,4,8,5,0,2019-06-04
1302,경기,안성시,5,0,0,5,3,0,2019-07-04
1303,경기,안성시,0,0,0,0,0,0,2019-08-04
1304,경기,안성시,7,0,1,8,3,0,2019-09-04
1305,경기,안성시,9,0,3,12,5,0,2019-10-04
1306,경기,안성시,2,0,1,3,2,0,2019-11-04
1307,경기,안성시,1,1,0,2,1,0,2019-12-04
1308,경기,안양시,3,2,0,5,4,0,2019-01-04
1309,경기,안양시,0,0,0,0,0,0,2019-02-04
1310,경기,안양시,10,3,1,14,7,0,2019-03-04
1311,경기,안양시,12,1,2,15,11,0,2019-04-04
1312,경기,안양시,3,1,1,5,6,1,2019-05-04
1313,경기,안양시,0,1,0,1,1,0,2019-06-04
1314,경기,안양시,5,0,0,5,5,0,2019-07-04
1315,경기,안양시,2,0,0,2,2,0,2019-08-04
1316,경기,안양시,5,0,1,6,3,0,2019-09-04
1317,경기,안양시,5,0,3,8,6,0,2019-10-04
1318,경기,안양시,3,0,1,4,3,0,2019-11-04
1319,경기,안양시,11,1,5,17,7,0,2019-12-04
1320,경기,양주시,0,0,1,1,1,0,2019-01-04
1321,경기,양주시,1,0,0,1,1,0,2019-02-04
1322,경기,양주시,5,0,0,5,3,0,2019-03-04
1323,경기,양주시,1,0,1,2,1,0,2019-04-04
1324,경기,양주시,1,0,0,1,1,0,2019-05-04
1325,경기,양주시,1,0,0,1,1,0,2019-06-04
1326,경기,양주시,2,0,0,2,2,0,2019-07-04
1327,경기,양주시,1,0,1,2,2,0,2019-08-04
1328,경기,양주시,0,0,1,1,1,0,2019-09-04
1329,경기,양주시,2,0,0,2,2,0,2019-10-04
1330,경기,양주시,5,0,1,6,7,1,2019-11-04
1331,경기,양주시,4,0,1,5,5,0,2019-12-04
1332,경기,양평군,0,0,0,0,0,0,2019-01-04
1333,경기,양평군,7,0,1,8,3,0,2019-02-04
1334,경기,양평군,1,0,0,1,1,0,2019-03-04
1335,경기,양평군,1,0,0,1,1,0,2019-04-04
1336,경기,양평군,3,2,1,6,3,0,2019-05-04
1337,경기,양평군,0,0,1,1,1,0,2019-06-04
1338,경기,양평군,1,0,2,3,1,0,2019-07-04
1339,경기,양평군,2,1,0,3,3,1,2019-08-04
1340,경기,양평군,2,0,1,3,2,1,2019-09-04
1341,경기,양평군,6,1,3,10,4,0,2019-10-04
1342,경기,양평군,4,0,1,5,2,0,2019-11-04
1343,경기,양평군,0,0,1,1,1,0,2019-12-04
1344,경기,여주시,0,0,0,0,1,1,2019-01-04
1345,경기,여주시,2,0,0,2,1,0,2019-02-04
1346,경기,여주시,2,0,0,2,1,0,2019-03-04
1347,경기,여주시,1,1,0,2,1,0,2019-04-04
1348,경기,여주시,4,1,1,6,3,0,2019-05-04
1349,경기,여주시,0,0,0,0,0,0,2019-06-04
1350,경기,여주시,2,0,0,2,2,0,2019-07-04
1351,경기,여주시,1,0,0,1,1,0,2019-08-04
1352,경기,여주시,0,0,0,0,0,0,2019-09-04
1353,경기,여주시,1,0,1,2,2,0,2019-10-04
1354,경기,여주시,1,0,0,1,1,0,2019-11-04
1355,경기,여주시,3,1,0,4,2,0,2019-12-04
1356,경기,연천군,1,0,1,2,2,0,2019-01-04
1357,경기,연천군,1,0,0,1,1,0,2019-02-04
1358,경기,연천군,0,0,0,0,0,0,2019-03-04
1359,경기,연천군,0,0,0,0,0,0,2019-04-04
1360,경기,연천군,3,0,0,3,1,0,2019-05-04
1361,경기,연천군,2,0,0,2,1,0,2019-06-04
1362,경기,연천군,1,0,0,1,1,0,2019-07-04
1363,경기,연천군,0,0,0,0,0,0,2019-08-04
1364,경기,연천군,1,0,0,1,1,0,2019-09-04
1365,경기,연천군,0,0,0,0,0,0,2019-10-04
1366,경기,연천군,2,0,0,2,2,0,2019-11-04
1367,경기,연천군,2,0,0,2,1,0,2019-12-04
1368,경기,오산시,1,0,0,1,1,0,2019-01-04
1369,경기,오산시,0,0,1,1,1,0,2019-02-04
1370,경기,오산시,8,0,1,9,5,0,2019-03-04
1371,경기,오산시,2,1,0,3,2,0,2019-04-04
1372,경기,오산시,9,1,3,13,7,0,2019-05-04
1373,경기,오산시,5,0,1,6,5,0,2019-06-04
1374,경기,오산시,3,0,0,3,3,0,2019-07-04
1375,경기,오산시,0,1,0,1,1,0,2019-08-04
1376,경기,오산시,2,0,1,3,3,0,2019-09-04
1377,경기,오산시,6,1,1,8,6,0,2019-10-04
1378,경기,오산시,4,0,0,4,3,0,2019-11-04
1379,경기,오산시,8,1,0,9,6,0,2019-12-04
1380,경기,용인시,8,3,3,14,12,0,2019-01-04
1381,경기,용인시,0,0,0,0,0,0,2019-02-04
1382,경기,용인시,13,1,6,20,12,0,2019-03-04
1383,경기,용인시,5,5,5,15,9,1,2019-04-04
1384,경기,용인시,13,5,2,20,12,1,2019-05-04
1385,경기,용인시,1,1,1,3,3,0,2019-06-04
1386,경기,용인시,12,1,1,14,11,0,2019-07-04
1387,경기,용인시,13,2,3,18,9,0,2019-08-04
1388,경기,용인시,10,1,2,13,11,0,2019-09-04
1389,경기,용인시,18,4,4,26,11,0,2019-10-04
1390,경기,용인시,13,2,3,18,15,1,2019-11-04
1391,경기,용인시,31,1,8,40,22,0,2019-12-04
1392,경기,의왕시,3,0,0,3,3,0,2019-01-04
1393,경기,의왕시,0,0,0,0,0,0,2019-02-04
1394,경기,의왕시,5,0,1,6,2,0,2019-03-04
1395,경기,의왕시,0,0,0,0,0,0,2019-04-04
1396,경기,의왕시,3,0,0,3,1,0,2019-05-04
1397,경기,의왕시,1,0,0,1,1,0,2019-06-04
1398,경기,의왕시,1,0,0,1,1,0,2019-07-04
1399,경기,의왕시,4,0,1,5,2,0,2019-08-04
1400,경기,의왕시,3,1,1,5,3,0,2019-09-04
1401,경기,의왕시,0,0,0,0,0,0,2019-10-04
1402,경기,의왕시,10,0,2,12,4,0,2019-11-04
1403,경기,의왕시,0,0,1,1,1,0,2019-12-04
1404,경기,의정부시,6,1,2,9,8,0,2019-01-04
1405,경기,의정부시,5,0,0,5,3,0,2019-02-04
1406,경기,의정부시,3,0,2,5,2,0,2019-03-04
1407,경기,의정부시,5,2,4,11,8,0,2019-04-04
1408,경기,의정부시,9,1,6,16,7,0,2019-05-04
1409,경기,의정부시,2,2,1,5,4,0,2019-06-04
1410,경기,의정부시,4,0,2,6,6,0,2019-07-04
1411,경기,의정부시,4,0,0,4,3,0,2019-08-04
1412,경기,의정부시,3,0,1,4,4,0,2019-09-04
1413,경기,의정부시,5,1,1,7,6,0,2019-10-04
1414,경기,의정부시,4,0,3,7,7,0,2019-11-04
1415,경기,의정부시,6,0,0,6,4,0,2019-12-04
1416,경기,이천시,9,0,0,9,5,0,2019-01-04
1417,경기,이천시,0,0,0,0,0,0,2019-02-04
1418,경기,이천시,1,0,1,2,2,0,2019-03-04
1419,경기,이천시,0,0,0,0,0,0,2019-04-04
1420,경기,이천시,1,0,0,1,1,0,2019-05-04
1421,경기,이천시,2,0,0,2,2,0,2019-06-04
1422,경기,이천시,0,0,0,0,0,0,2019-07-04
1423,경기,이천시,6,0,2,8,3,0,2019-08-04
1424,경기,이천시,11,0,0,11,6,0,2019-09-04
1425,경기,이천시,6,0,0,6,3,0,2019-10-04
1426,경기,이천시,7,0,1,8,5,0,2019-11-04
1427,경기,이천시,5,0,2,7,5,0,2019-12-04
1428,경기,파주시,0,0,3,3,2,0,2019-01-04
1429,경기,파주시,7,0,3,10,8,0,2019-02-04
1430,경기,파주시,5,0,2,7,5,0,2019-03-04
1431,경기,파주시,5,0,2,7,6,0,2019-04-04
1432,경기,파주시,2,0,0,2,1,0,2019-05-04
1433,경기,파주시,6,1,2,9,6,0,2019-06-04
1434,경기,파주시,2,0,1,3,3,0,2019-07-04
1435,경기,파주시,6,1,1,8,5,0,2019-08-04
1436,경기,파주시,3,0,4,7,3,0,2019-09-04
1437,경기,파주시,6,1,2,9,8,0,2019-10-04
1438,경기,파주시,2,0,0,2,2,0,2019-11-04
1439,경기,파주시,6,0,1,7,6,0,2019-12-04
1440,경기,평택시,6,1,2,9,5,1,2019-01-04
1441,경기,평택시,11,7,1,19,9,0,2019-02-04
1442,경기,평택시,4,0,4,8,6,0,2019-03-04
1443,경기,평택시,19,1,4,24,13,0,2019-04-04
1444,경기,평택시,17,4,4,25,11,0,2019-05-04
1445,경기,평택시,10,3,5,18,12,1,2019-06-04
1446,경기,평택시,10,2,5,17,8,0,2019-07-04
1447,경기,평택시,7,2,2,11,5,0,2019-08-04
1448,경기,평택시,14,3,3,20,13,0,2019-09-04
1449,경기,평택시,8,1,1,10,8,0,2019-10-04
1450,경기,평택시,13,2,1,16,13,0,2019-11-04
1451,경기,평택시,20,2,6,28,16,1,2019-12-04
1452,경기,포천시,0,0,1,1,1,0,2019-01-04
1453,경기,포천시,0,0,0,0,0,0,2019-02-04
1454,경기,포천시,0,0,2,2,2,0,2019-03-04
1455,경기,포천시,2,5,0,7,3,0,2019-04-04
1456,경기,포천시,1,3,0,4,3,0,2019-05-04
1457,경기,포천시,0,0,0,0,0,0,2019-06-04
1458,경기,포천시,1,0,0,1,1,0,2019-07-04
1459,경기,포천시,0,2,0,2,1,0,2019-08-04
1460,경기,포천시,1,0,0,1,1,0,2019-09-04
1461,경기,포천시,6,0,1,7,4,0,2019-10-04
1462,경기,포천시,4,0,3,7,6,0,2019-11-04
1463,경기,포천시,6,2,1,9,5,0,2019-12-04
1464,경기,하남시,7,1,1,9,3,0,2019-01-04
1465,경기,하남시,0,0,0,0,0,0,2019-02-04
1466,경기,하남시,0,0,1,1,1,0,2019-03-04
1467,경기,하남시,2,0,0,2,2,0,2019-04-04
1468,경기,하남시,1,0,0,1,1,0,2019-05-04
1469,경기,하남시,6,0,2,8,7,0,2019-06-04
1470,경기,하남시,1,2,2,5,5,0,2019-07-04
1471,경기,하남시,1,0,1,2,1,0,2019-08-04
1472,경기,하남시,0,0,2,2,2,0,2019-09-04
1473,경기,하남시,4,0,1,5,3,0,2019-10-04
1474,경기,하남시,0,0,0,0,0,0,2019-11-04
1475,경기,하남시,0,0,0,0,0,0,2019-12-04
1476,경기,화성시,6,0,2,8,5,0,2019-01-04
1477,경기,화성시,4,0,2,6,4,0,2019-02-04
1478,경기,화성시,12,1,5,18,11,0,2019-03-04
1479,경기,화성시,9,1,6,16,10,0,2019-04-04
1480,경기,화성시,11,1,2,14,9,0,2019-05-04
1481,경기,화성시,5,0,3,8,7,0,2019-06-04
1482,경기,화성시,7,1,1,9,7,0,2019-07-04
1483,경기,화성시,0,0,1,1,1,0,2019-08-04
1484,경기,화성시,15,0,2,17,9,0,2019-09-04
1485,경기,화성시,23,1,11,35,11,0,2019-10-04
1486,경기,화성시,5,4,2,11,7,0,2019-11-04
1487,경기,화성시,17,1,5,23,15,2,2019-12-04
1488,경기,가평군,3,0,0,3,2,0,2019-01-05
1489,경기,가평군,0,0,1,1,1,0,2019-02-05
1490,경기,가평군,0,0,0,0,0,0,2019-03-05
1491,경기,가평군,0,0,0,0,0,0,2019-04-05
1492,경기,가평군,2,0,1,3,2,0,2019-05-05
1493,경기,가평군,3,0,0,3,2,0,2019-06-05
1494,경기,가평군,1,0,0,1,1,0,2019-07-05
1495,경기,가평군,0,0,0,0,0,0,2019-08-05
1496,경기,가평군,0,0,0,0,0,0,2019-09-05
1497,경기,가평군,1,0,0,1,1,0,2019-10-05
1498,경기,가평군,0,0,0,0,0,0,2019-11-05
1499,경기,가평군,0,0,0,0,0,0,2019-12-05
1500,경기,고양시,7,1,1,9,6,0,2019-01-05
1501,경기,고양시,3,2,1,6,3,0,2019-02-05
1502,경기,고양시,12,1,1,14,10,0,2019-03-05
1503,경기,고양시,12,1,5,18,15,0,2019-04-05
1504,경기,고양시,13,1,4,18,11,0,2019-05-05
1505,경기,고양시,7,0,1,8,7,0,2019-06-05
1506,경기,고양시,5,1,0,6,6,0,2019-07-05
1507,경기,고양시,12,1,6,19,13,0,2019-08-05
1508,경기,고양시,16,1,0,17,11,0,2019-09-05
1509,경기,고양시,17,0,3,20,14,0,2019-10-05
1510,경기,고양시,12,2,6,20,11,0,2019-11-05
1511,경기,고양시,10,0,4,14,11,0,2019-12-05
1512,경기,과천시,3,0,0,3,2,0,2019-01-05
1513,경기,과천시,0,0,0,0,0,0,2019-02-05
1514,경기,과천시,0,0,0,0,0,0,2019-03-05
1515,경기,과천시,1,0,0,1,1,0,2019-04-05
1516,경기,과천시,0,0,0,0,0,0,2019-05-05
1517,경기,과천시,0,0,0,0,0,0,2019-06-05
1518,경기,과천시,0,0,0,0,0,0,2019-07-05
1519,경기,과천시,1,1,0,2,2,0,2019-08-05
1520,경기,과천시,4,0,1,5,5,0,2019-09-05
1521,경기,과천시,0,0,0,0,0,0,2019-10-05
1522,경기,과천시,0,0,0,0,0,0,2019-11-05
1523,경기,과천시,1,0,1,2,2,0,2019-12-05
1524,경기,광명시,0,1,2,3,3,0,2019-01-05
1525,경기,광명시,1,0,0,1,1,0,2019-02-05
1526,경기,광명시,3,1,0,4,3,0,2019-03-05
1527,경기,광명시,5,1,1,7,4,0,2019-04-05
1528,경기,광명시,1,2,2,5,3,0,2019-05-05
1529,경기,광명시,4,3,1,8,5,0,2019-06-05
1530,경기,광명시,2,3,0,5,4,0,2019-07-05
1531,경기,광명시,2,0,4,6,4,0,2019-08-05
1532,경기,광명시,4,1,0,5,4,0,2019-09-05
1533,경기,광명시,2,6,1,9,2,0,2019-10-05
1534,경기,광명시,4,0,0,4,4,0,2019-11-05
1535,경기,광명시,3,4,2,9,4,0,2019-12-05
1536,경기,광주시,3,1,1,5,4,0,2019-01-05
1537,경기,광주시,11,0,3,14,4,0,2019-02-05
1538,경기,광주시,3,0,2,5,3,0,2019-03-05
1539,경기,광주시,14,5,1,20,7,0,2019-04-05
1540,경기,광주시,10,0,1,11,4,0,2019-05-05
1541,경기,광주시,7,1,3,11,9,0,2019-06-05
1542,경기,광주시,12,0,3,15,7,0,2019-07-05
1543,경기,광주시,1,0,3,4,3,0,2019-08-05
1544,경기,광주시,6,1,1,8,5,0,2019-09-05
1545,경기,광주시,5,3,3,11,5,0,2019-10-05
1546,경기,광주시,8,0,1,9,5,0,2019-11-05
1547,경기,광주시,5,3,1,9,5,0,2019-12-05
1548,경기,구리시,0,0,0,0,0,0,2019-01-05
1549,경기,구리시,2,0,0,2,2,0,2019-02-05
1550,경기,구리시,2,0,0,2,2,0,2019-03-05
1551,경기,구리시,2,1,0,3,1,0,2019-04-05
1552,경기,구리시,0,0,0,0,0,0,2019-05-05
1553,경기,구리시,3,0,1,4,3,0,2019-06-05
1554,경기,구리시,3,0,0,3,1,0,2019-07-05
1555,경기,구리시,0,0,0,0,0,0,2019-08-05
1556,경기,구리시,0,0,1,1,1,0,2019-09-05
1557,경기,구리시,2,0,0,2,1,0,2019-10-05
1558,경기,구리시,1,0,0,1,1,0,2019-11-05
1559,경기,구리시,2,0,1,3,3,0,2019-12-05
1560,경기,군포시,0,0,1,1,1,0,2019-01-05
1561,경기,군포시,0,0,0,0,0,0,2019-02-05
1562,경기,군포시,3,0,0,3,3,0,2019-03-05
1563,경기,군포시,1,0,0,1,1,0,2019-04-05
1564,경기,군포시,1,1,0,2,2,0,2019-05-05
1565,경기,군포시,1,0,1,2,2,0,2019-06-05
1566,경기,군포시,0,0,0,0,0,0,2019-07-05
1567,경기,군포시,1,0,0,1,1,0,2019-08-05
1568,경기,군포시,1,0,0,1,1,0,2019-09-05
1569,경기,군포시,0,0,0,0,0,0,2019-10-05
1570,경기,군포시,1,1,0,2,1,0,2019-11-05
1571,경기,군포시,0,0,1,1,1,0,2019-12-05
1572,경기,김포시,3,1,1,5,3,0,2019-01-05
1573,경기,김포시,2,1,0,3,2,0,2019-02-05
1574,경기,김포시,3,0,0,3,3,0,2019-03-05
1575,경기,김포시,5,1,3,9,7,0,2019-04-05
1576,경기,김포시,12,0,0,12,5,0,2019-05-05
1577,경기,김포시,2,1,1,4,4,0,2019-06-05
1578,경기,김포시,4,0,2,6,5,0,2019-07-05
1579,경기,김포시,11,0,2,13,5,0,2019-08-05
1580,경기,김포시,2,0,3,5,3,0,2019-09-05
1581,경기,김포시,7,0,2,9,5,0,2019-10-05
1582,경기,김포시,6,1,1,8,7,0,2019-11-05
1583,경기,김포시,2,0,1,3,2,0,2019-12-05
1584,경기,남양주시,6,0,1,7,5,0,2019-01-05
1585,경기,남양주시,6,0,1,7,2,0,2019-02-05
1586,경기,남양주시,5,0,0,5,4,0,2019-03-05
1587,경기,남양주시,8,0,3,11,6,1,2019-04-05
1588,경기,남양주시,7,0,3,10,7,0,2019-05-05
1589,경기,남양주시,9,0,3,12,8,0,2019-06-05
1590,경기,남양주시,5,2,1,8,7,0,2019-07-05
1591,경기,남양주시,9,0,2,11,6,0,2019-08-05
1592,경기,남양주시,7,0,2,9,6,0,2019-09-05
1593,경기,남양주시,7,2,1,10,7,0,2019-10-05
1594,경기,남양주시,3,1,1,5,4,0,2019-11-05
1595,경기,남양주시,7,0,0,7,4,1,2019-12-05
1596,경기,동두천시,0,0,2,2,2,0,2019-01-05
1597,경기,동두천시,2,0,0,2,1,0,2019-02-05
1598,경기,동두천시,1,0,0,1,1,0,2019-03-05
1599,경기,동두천시,2,0,2,4,3,0,2019-04-05
1600,경기,동두천시,3,0,0,3,3,0,2019-05-05
1601,경기,동두천시,0,0,0,0,0,0,2019-06-05
1602,경기,동두천시,0,1,1,2,2,0,2019-07-05
1603,경기,동두천시,3,0,0,3,2,0,2019-08-05
1604,경기,동두천시,0,0,0,0,0,0,2019-09-05
1605,경기,동두천시,3,1,0,4,2,0,2019-10-05
1606,경기,동두천시,2,0,1,3,3,0,2019-11-05
1607,경기,동두천시,0,0,0,0,0,0,2019-12-05
1608,경기,부천시,17,2,2,21,10,0,2019-01-05
1609,경기,부천시,2,2,0,4,4,0,2019-02-05
1610,경기,부천시,5,1,5,11,10,0,2019-03-05
1611,경기,부천시,6,0,1,7,6,0,2019-04-05
1612,경기,부천시,20,1,4,25,15,0,2019-05-05
1613,경기,부천시,5,1,5,11,9,0,2019-06-05
1614,경기,부천시,9,1,9,19,12,0,2019-07-05
1615,경기,부천시,10,2,1,13,9,0,2019-08-05
1616,경기,부천시,11,0,0,11,9,0,2019-09-05
1617,경기,부천시,11,2,2,15,12,0,2019-10-05
1618,경기,부천시,5,1,1,7,7,0,2019-11-05
1619,경기,부천시,12,0,3,15,11,0,2019-12-05
1620,경기,성남시,6,2,3,11,8,0,2019-01-05
1621,경기,성남시,12,0,2,14,5,0,2019-02-05
1622,경기,성남시,7,0,4,11,9,0,2019-03-05
1623,경기,성남시,13,2,8,23,16,0,2019-04-05
1624,경기,성남시,13,0,1,14,6,0,2019-05-05
1625,경기,성남시,7,2,3,12,10,0,2019-06-05
1626,경기,성남시,10,1,0,11,9,0,2019-07-05
1627,경기,성남시,5,0,3,8,7,1,2019-08-05
1628,경기,성남시,8,3,2,13,10,0,2019-09-05
1629,경기,성남시,6,0,4,10,10,0,2019-10-05
1630,경기,성남시,17,2,5,24,18,0,2019-11-05
1631,경기,성남시,16,4,0,20,11,0,2019-12-05
1632,경기,수원시,4,2,6,12,10,0,2019-01-05
1633,경기,수원시,11,0,6,17,6,0,2019-02-05
1634,경기,수원시,6,2,1,9,6,0,2019-03-05
1635,경기,수원시,25,3,2,30,19,2,2019-04-05
1636,경기,수원시,11,2,0,13,10,0,2019-05-05
1637,경기,수원시,10,4,3,17,11,0,2019-06-05
1638,경기,수원시,14,1,1,16,11,0,2019-07-05
1639,경기,수원시,19,0,6,25,16,0,2019-08-05
1640,경기,수원시,20,2,5,27,22,0,2019-09-05
1641,경기,수원시,8,1,1,10,9,1,2019-10-05
1642,경기,수원시,16,3,4,23,17,0,2019-11-05
1643,경기,수원시,14,0,5,19,14,1,2019-12-05
1644,경기,시흥시,6,0,5,11,7,0,2019-01-05
1645,경기,시흥시,4,0,0,4,2,0,2019-02-05
1646,경기,시흥시,3,1,2,6,4,0,2019-03-05
1647,경기,시흥시,8,1,2,11,7,0,2019-04-05
1648,경기,시흥시,10,0,1,11,6,0,2019-05-05
1649,경기,시흥시,9,1,4,14,10,0,2019-06-05
1650,경기,시흥시,16,0,1,17,5,0,2019-07-05
1651,경기,시흥시,12,1,0,13,7,0,2019-08-05
1652,경기,시흥시,10,5,3,18,10,0,2019-09-05
1653,경기,시흥시,9,4,3,16,8,0,2019-10-05
1654,경기,시흥시,8,1,4,13,7,0,2019-11-05
1655,경기,시흥시,11,2,3,16,10,0,2019-12-05
1656,경기,안산시,15,0,4,19,10,0,2019-01-05
1657,경기,안산시,3,0,0,3,3,0,2019-02-05
1658,경기,안산시,11,0,0,11,8,0,2019-03-05
1659,경기,안산시,11,2,2,15,11,0,2019-04-05
1660,경기,안산시,10,2,6,18,12,1,2019-05-05
1661,경기,안산시,11,3,4,18,13,0,2019-06-05
1662,경기,안산시,21,1,4,26,15,0,2019-07-05
1663,경기,안산시,7,2,2,11,7,1,2019-08-05
1664,경기,안산시,9,0,4,13,10,0,2019-09-05
1665,경기,안산시,15,1,1,17,8,0,2019-10-05
1666,경기,안산시,5,0,1,6,6,0,2019-11-05
1667,경기,안산시,10,0,5,15,11,0,2019-12-05
1668,경기,안성시,3,0,0,3,3,1,2019-01-05
1669,경기,안성시,2,0,0,2,1,0,2019-02-05
1670,경기,안성시,3,0,2,5,3,0,2019-03-05
1671,경기,안성시,12,0,2,14,7,0,2019-04-05
1672,경기,안성시,5,1,0,6,2,0,2019-05-05
1673,경기,안성시,7,0,3,10,4,0,2019-06-05
1674,경기,안성시,0,0,2,2,1,0,2019-07-05
1675,경기,안성시,6,0,1,7,2,0,2019-08-05
1676,경기,안성시,7,0,0,7,6,0,2019-09-05
1677,경기,안성시,0,1,1,2,2,0,2019-10-05
1678,경기,안성시,4,0,0,4,4,0,2019-11-05
1679,경기,안성시,2,0,1,3,1,0,2019-12-05
1680,경기,안양시,3,0,1,4,3,0,2019-01-05
1681,경기,안양시,2,0,3,5,2,0,2019-02-05
1682,경기,안양시,5,1,2,8,5,0,2019-03-05
1683,경기,안양시,5,0,0,5,3,0,2019-04-05
1684,경기,안양시,12,1,1,14,6,0,2019-05-05
1685,경기,안양시,5,2,2,9,6,0,2019-06-05
1686,경기,안양시,6,0,2,8,6,0,2019-07-05
1687,경기,안양시,8,1,1,10,6,0,2019-08-05
1688,경기,안양시,4,0,1,5,3,0,2019-09-05
1689,경기,안양시,3,0,2,5,2,0,2019-10-05
1690,경기,안양시,0,1,1,2,2,0,2019-11-05
1691,경기,안양시,4,0,0,4,3,0,2019-12-05
1692,경기,양주시,7,0,1,8,5,0,2019-01-05
1693,경기,양주시,4,0,0,4,2,0,2019-02-05
1694,경기,양주시,1,0,0,1,1,0,2019-03-05
1695,경기,양주시,2,0,1,3,3,0,2019-04-05
1696,경기,양주시,4,0,1,5,1,0,2019-05-05
1697,경기,양주시,3,0,2,5,5,0,2019-06-05
1698,경기,양주시,3,0,1,4,3,1,2019-07-05
1699,경기,양주시,4,0,1,5,2,0,2019-08-05
1700,경기,양주시,9,0,0,9,6,0,2019-09-05
1701,경기,양주시,0,0,0,0,0,0,2019-10-05
1702,경기,양주시,3,2,1,6,6,0,2019-11-05
1703,경기,양주시,9,0,3,12,5,0,2019-12-05
1704,경기,양평군,2,0,0,2,1,0,2019-01-05
1705,경기,양평군,3,0,0,3,1,0,2019-02-05
1706,경기,양평군,0,0,0,0,0,0,2019-03-05
1707,경기,양평군,3,1,1,5,2,0,2019-04-05
1708,경기,양평군,5,0,0,5,2,0,2019-05-05
1709,경기,양평군,4,1,0,5,3,0,2019-06-05
1710,경기,양평군,0,0,0,0,0,0,2019-07-05
1711,경기,양평군,1,1,1,3,1,0,2019-08-05
1712,경기,양평군,1,1,0,2,2,0,2019-09-05
1713,경기,양평군,2,1,0,3,2,0,2019-10-05
1714,경기,양평군,1,0,0,1,1,0,2019-11-05
1715,경기,양평군,2,0,0,2,2,0,2019-12-05
1716,경기,여주시,2,0,3,5,3,0,2019-01-05
1717,경기,여주시,4,0,0,4,1,0,2019-02-05
1718,경기,여주시,4,0,1,5,1,0,2019-03-05
1719,경기,여주시,3,0,0,3,2,0,2019-04-05
1720,경기,여주시,2,0,1,3,2,0,2019-05-05
1721,경기,여주시,1,0,2,3,3,0,2019-06-05
1722,경기,여주시,2,1,0,3,2,0,2019-07-05
1723,경기,여주시,3,0,2,5,3,0,2019-08-05
1724,경기,여주시,0,0,0,0,0,0,2019-09-05
1725,경기,여주시,5,0,1,6,5,1,2019-10-05
1726,경기,여주시,1,0,0,1,1,0,2019-11-05
1727,경기,여주시,0,1,2,3,3,0,2019-12-05
1728,경기,연천군,0,0,0,0,0,0,2019-01-05
1729,경기,연천군,0,0,0,0,0,0,2019-02-05
1730,경기,연천군,0,0,0,0,0,0,2019-03-05
1731,경기,연천군,0,0,0,0,0,0,2019-04-05
1732,경기,연천군,0,0,0,0,1,1,2019-05-05
1733,경기,연천군,0,0,0,0,0,0,2019-06-05
1734,경기,연천군,2,0,1,3,2,0,2019-07-05
1735,경기,연천군,4,0,0,4,2,0,2019-08-05
1736,경기,연천군,0,0,0,0,0,0,2019-09-05
1737,경기,연천군,0,1,0,1,1,0,2019-10-05
1738,경기,연천군,2,0,0,2,1,0,2019-11-05
1739,경기,연천군,0,0,0,0,0,0,2019-12-05
1740,경기,오산시,2,0,0,2,1,0,2019-01-05
1741,경기,오산시,1,0,1,2,2,0,2019-02-05
1742,경기,오산시,0,1,0,1,1,0,2019-03-05
1743,경기,오산시,0,0,1,1,1,0,2019-04-05
1744,경기,오산시,0,0,0,0,0,0,2019-05-05
1745,경기,오산시,1,0,2,3,3,0,2019-06-05
1746,경기,오산시,3,1,2,6,3,0,2019-07-05
1747,경기,오산시,2,0,1,3,3,0,2019-08-05
1748,경기,오산시,0,1,2,3,2,0,2019-09-05
1749,경기,오산시,0,1,0,1,1,0,2019-10-05
1750,경기,오산시,2,2,1,5,5,0,2019-11-05
1751,경기,오산시,2,0,2,4,3,0,2019-12-05
1752,경기,용인시,10,3,3,16,10,0,2019-01-05
1753,경기,용인시,10,0,0,10,3,0,2019-02-05
1754,경기,용인시,5,0,1,6,5,0,2019-03-05
1755,경기,용인시,4,16,2,22,7,1,2019-04-05
1756,경기,용인시,3,0,4,7,3,0,2019-05-05
1757,경기,용인시,10,6,1,17,15,0,2019-06-05
1758,경기,용인시,6,0,1,7,6,0,2019-07-05
1759,경기,용인시,16,1,0,17,8,0,2019-08-05
1760,경기,용인시,4,1,2,7,7,0,2019-09-05
1761,경기,용인시,16,1,2,19,6,0,2019-10-05
1762,경기,용인시,23,4,6,33,16,1,2019-11-05
1763,경기,용인시,8,0,5,13,10,1,2019-12-05
1764,경기,의왕시,0,0,1,1,1,0,2019-01-05
1765,경기,의왕시,1,0,0,1,1,0,2019-02-05
1766,경기,의왕시,0,0,1,1,1,0,2019-03-05
1767,경기,의왕시,1,1,1,3,1,0,2019-04-05
1768,경기,의왕시,1,0,0,1,1,0,2019-05-05
1769,경기,의왕시,1,0,0,1,1,0,2019-06-05
1770,경기,의왕시,1,0,1,2,1,0,2019-07-05
1771,경기,의왕시,1,0,0,1,1,0,2019-08-05
1772,경기,의왕시,0,1,0,1,2,1,2019-09-05
1773,경기,의왕시,1,0,0,1,1,0,2019-10-05
1774,경기,의왕시,1,0,1,2,2,0,2019-11-05
1775,경기,의왕시,0,0,0,0,1,1,2019-12-05
1776,경기,의정부시,6,1,0,7,6,0,2019-01-05
1777,경기,의정부시,14,0,0,14,6,0,2019-02-05
1778,경기,의정부시,9,0,1,10,7,0,2019-03-05
1779,경기,의정부시,1,1,2,4,4,0,2019-04-05
1780,경기,의정부시,14,2,0,16,5,0,2019-05-05
1781,경기,의정부시,3,0,0,3,3,0,2019-06-05
1782,경기,의정부시,0,0,1,1,1,0,2019-07-05
1783,경기,의정부시,9,2,2,13,8,0,2019-08-05
1784,경기,의정부시,4,0,3,7,6,0,2019-09-05
1785,경기,의정부시,4,1,1,6,5,0,2019-10-05
1786,경기,의정부시,4,1,1,6,5,0,2019-11-05
1787,경기,의정부시,2,3,3,8,8,0,2019-12-05
1788,경기,이천시,4,2,1,7,5,0,2019-01-05
1789,경기,이천시,0,0,0,0,0,0,2019-02-05
1790,경기,이천시,1,0,0,1,1,0,2019-03-05
1791,경기,이천시,2,0,0,2,2,0,2019-04-05
1792,경기,이천시,4,0,1,5,5,0,2019-05-05
1793,경기,이천시,4,0,0,4,2,0,2019-06-05
1794,경기,이천시,4,0,0,4,3,0,2019-07-05
1795,경기,이천시,1,2,4,7,5,0,2019-08-05
1796,경기,이천시,15,0,2,17,9,0,2019-09-05
1797,경기,이천시,0,0,0,0,0,0,2019-10-05
1798,경기,이천시,6,0,1,7,4,0,2019-11-05
1799,경기,이천시,1,0,1,2,2,0,2019-12-05
1800,경기,파주시,4,2,2,8,4,0,2019-01-05
1801,경기,파주시,1,0,0,1,1,0,2019-02-05
1802,경기,파주시,0,1,1,2,2,0,2019-03-05
1803,경기,파주시,3,0,3,6,5,1,2019-04-05
1804,경기,파주시,5,0,0,5,3,0,2019-05-05
1805,경기,파주시,4,0,7,11,8,2,2019-06-05
1806,경기,파주시,4,2,5,11,7,0,2019-07-05
1807,경기,파주시,8,0,0,8,5,0,2019-08-05
1808,경기,파주시,4,3,0,7,5,0,2019-09-05
1809,경기,파주시,1,1,0,2,2,0,2019-10-05
1810,경기,파주시,0,1,1,2,2,0,2019-11-05
1811,경기,파주시,8,1,1,10,7,0,2019-12-05
1812,경기,평택시,4,1,2,7,6,0,2019-01-05
1813,경기,평택시,8,3,4,15,4,0,2019-02-05
1814,경기,평택시,13,0,1,14,8,0,2019-03-05
1815,경기,평택시,22,0,3,25,15,0,2019-04-05
1816,경기,평택시,9,2,2,13,11,0,2019-05-05
1817,경기,평택시,4,4,0,8,7,1,2019-06-05
1818,경기,평택시,13,3,4,20,12,0,2019-07-05
1819,경기,평택시,12,0,0,12,8,0,2019-08-05
1820,경기,평택시,9,5,2,16,12,0,2019-09-05
1821,경기,평택시,10,1,2,13,11,0,2019-10-05
1822,경기,평택시,19,2,3,24,17,0,2019-11-05
1823,경기,평택시,4,1,6,11,8,0,2019-12-05
1824,경기,포천시,3,1,1,5,1,0,2019-01-05
1825,경기,포천시,6,1,2,9,3,0,2019-02-05
1826,경기,포천시,5,3,2,10,4,0,2019-03-05
1827,경기,포천시,0,2,3,5,3,0,2019-04-05
1828,경기,포천시,0,0,0,0,0,0,2019-05-05
1829,경기,포천시,6,0,0,6,5,0,2019-06-05
1830,경기,포천시,1,1,0,2,1,0,2019-07-05
1831,경기,포천시,0,1,6,7,3,0,2019-08-05
1832,경기,포천시,2,0,1,3,2,0,2019-09-05
1833,경기,포천시,2,0,0,2,1,0,2019-10-05
1834,경기,포천시,4,0,0,4,3,0,2019-11-05
1835,경기,포천시,1,0,0,1,1,0,2019-12-05
1836,경기,하남시,2,0,0,2,1,0,2019-01-05
1837,경기,하남시,6,0,0,6,3,0,2019-02-05
1838,경기,하남시,2,0,0,2,1,0,2019-03-05
1839,경기,하남시,3,1,1,5,5,0,2019-04-05
1840,경기,하남시,2,2,2,6,4,0,2019-05-05
1841,경기,하남시,1,0,2,3,3,0,2019-06-05
1842,경기,하남시,5,1,1,7,5,0,2019-07-05
1843,경기,하남시,2,1,0,3,2,0,2019-08-05
1844,경기,하남시,5,0,1,6,3,0,2019-09-05
1845,경기,하남시,2,0,1,3,1,0,2019-10-05
1846,경기,하남시,6,1,0,7,5,0,2019-11-05
1847,경기,하남시,0,0,0,0,0,0,2019-12-05
1848,경기,화성시,14,3,2,19,9,0,2019-01-05
1849,경기,화성시,2,0,0,2,2,0,2019-02-05
1850,경기,화성시,12,1,4,17,10,0,2019-03-05
1851,경기,화성시,16,2,3,21,14,0,2019-04-05
1852,경기,화성시,9,1,1,11,4,1,2019-05-05
1853,경기,화성시,17,0,0,17,7,0,2019-06-05
1854,경기,화성시,6,1,1,8,7,0,2019-07-05
1855,경기,화성시,18,1,2,21,9,0,2019-08-05
1856,경기,화성시,16,0,0,16,9,0,2019-09-05
1857,경기,화성시,5,2,0,7,7,0,2019-10-05
1858,경기,화성시,3,0,1,4,3,0,2019-11-05
1859,경기,화성시,12,1,5,18,13,0,2019-12-05
1860,경기,가평군,0,0,0,0,0,0,2019-01-06
1861,경기,가평군,0,0,0,0,0,0,2019-02-06
1862,경기,가평군,0,0,0,0,0,0,2019-03-06
1863,경기,가평군,2,0,0,2,2,0,2019-04-06
1864,경기,가평군,1,0,0,1,1,0,2019-05-06
1865,경기,가평군,1,0,0,1,1,0,2019-06-06
1866,경기,가평군,0,0,0,0,0,0,2019-07-06
1867,경기,가평군,1,0,2,3,3,0,2019-08-06
1868,경기,가평군,1,0,0,1,1,0,2019-09-06
1869,경기,가평군,1,0,1,2,1,0,2019-10-06
1870,경기,가평군,1,0,0,1,1,0,2019-11-06
1871,경기,가평군,2,0,3,5,3,0,2019-12-06
1872,경기,고양시,16,1,8,25,9,0,2019-01-06
1873,경기,고양시,5,0,2,7,6,1,2019-02-06
1874,경기,고양시,12,0,1,13,8,0,2019-03-06
1875,경기,고양시,7,1,4,12,12,1,2019-04-06
1876,경기,고양시,19,2,5,26,16,0,2019-05-06
1877,경기,고양시,8,1,1,10,7,0,2019-06-06
1878,경기,고양시,15,2,4,21,13,0,2019-07-06
1879,경기,고양시,12,4,4,20,13,0,2019-08-06
1880,경기,고양시,6,0,2,8,5,0,2019-09-06
1881,경기,고양시,23,0,3,26,11,0,2019-10-06
1882,경기,고양시,11,2,3,16,13,0,2019-11-06
1883,경기,고양시,9,1,2,12,8,0,2019-12-06
1884,경기,과천시,0,0,0,0,0,0,2019-01-06
1885,경기,과천시,0,0,0,0,0,0,2019-02-06
1886,경기,과천시,0,0,0,0,0,0,2019-03-06
1887,경기,과천시,1,0,0,1,1,0,2019-04-06
1888,경기,과천시,0,0,0,0,0,0,2019-05-06
1889,경기,과천시,1,0,1,2,2,0,2019-06-06
1890,경기,과천시,1,1,1,3,2,0,2019-07-06
1891,경기,과천시,1,0,1,2,1,0,2019-08-06
1892,경기,과천시,1,0,0,1,1,0,2019-09-06
1893,경기,과천시,0,0,0,0,0,0,2019-10-06
1894,경기,과천시,2,0,0,2,1,0,2019-11-06
1895,경기,과천시,1,0,0,1,1,0,2019-12-06
1896,경기,광명시,0,1,1,2,2,0,2019-01-06
1897,경기,광명시,6,4,1,11,5,0,2019-02-06
1898,경기,광명시,2,1,0,3,2,0,2019-03-06
1899,경기,광명시,0,2,0,2,2,0,2019-04-06
1900,경기,광명시,1,0,0,1,1,0,2019-05-06
1901,경기,광명시,4,0,0,4,3,0,2019-06-06
1902,경기,광명시,1,0,2,3,3,0,2019-07-06
1903,경기,광명시,6,0,1,7,4,0,2019-08-06
1904,경기,광명시,1,2,0,3,2,0,2019-09-06
1905,경기,광명시,0,0,0,0,0,0,2019-10-06
1906,경기,광명시,0,4,1,5,4,0,2019-11-06
1907,경기,광명시,3,5,0,8,3,0,2019-12-06
1908,경기,광주시,2,1,3,6,5,0,2019-01-06
1909,경기,광주시,1,1,1,3,2,0,2019-02-06
1910,경기,광주시,6,0,2,8,6,0,2019-03-06
1911,경기,광주시,2,0,1,3,3,0,2019-04-06
1912,경기,광주시,2,0,1,3,2,0,2019-05-06
1913,경기,광주시,10,1,0,11,6,0,2019-06-06
1914,경기,광주시,7,0,0,7,5,0,2019-07-06
1915,경기,광주시,9,0,0,9,6,0,2019-08-06
1916,경기,광주시,7,0,0,7,5,0,2019-09-06
1917,경기,광주시,3,1,0,4,2,0,2019-10-06
1918,경기,광주시,0,0,1,1,1,0,2019-11-06
1919,경기,광주시,3,0,0,3,2,0,2019-12-06
1920,경기,구리시,3,1,1,5,1,0,2019-01-06
1921,경기,구리시,0,0,0,0,0,0,2019-02-06
1922,경기,구리시,0,1,0,1,1,0,2019-03-06
1923,경기,구리시,0,0,0,0,0,0,2019-04-06
1924,경기,구리시,1,0,0,1,1,0,2019-05-06
1925,경기,구리시,2,0,0,2,2,0,2019-06-06
1926,경기,구리시,2,0,0,2,2,0,2019-07-06
1927,경기,구리시,4,0,2,6,5,0,2019-08-06
1928,경기,구리시,5,1,1,7,5,0,2019-09-06
1929,경기,구리시,3,1,0,4,2,0,2019-10-06
1930,경기,구리시,4,0,0,4,3,0,2019-11-06
1931,경기,구리시,2,0,1,3,3,0,2019-12-06
1932,경기,군포시,0,0,0,0,0,0,2019-01-06
1933,경기,군포시,0,0,0,0,0,0,2019-02-06
1934,경기,군포시,1,0,0,1,1,0,2019-03-06
1935,경기,군포시,0,0,0,0,0,0,2019-04-06
1936,경기,군포시,2,0,0,2,2,0,2019-05-06
1937,경기,군포시,3,0,0,3,2,0,2019-06-06
1938,경기,군포시,5,0,0,5,2,0,2019-07-06
1939,경기,군포시,0,0,1,1,1,0,2019-08-06
1940,경기,군포시,0,1,0,1,1,0,2019-09-06
1941,경기,군포시,1,1,3,5,1,0,2019-10-06
1942,경기,군포시,1,0,1,2,2,0,2019-11-06
1943,경기,군포시,0,0,1,1,1,0,2019-12-06
1944,경기,김포시,7,1,1,9,6,0,2019-01-06
1945,경기,김포시,2,0,0,2,1,0,2019-02-06
1946,경기,김포시,8,4,4,16,7,0,2019-03-06
1947,경기,김포시,4,0,0,4,2,0,2019-04-06
1948,경기,김포시,5,0,3,8,7,1,2019-05-06
1949,경기,김포시,8,0,0,8,4,0,2019-06-06
1950,경기,김포시,7,0,5,12,10,1,2019-07-06
1951,경기,김포시,7,0,0,7,5,0,2019-08-06
1952,경기,김포시,10,0,3,13,11,0,2019-09-06
1953,경기,김포시,12,0,2,14,6,0,2019-10-06
1954,경기,김포시,4,1,1,6,6,0,2019-11-06
1955,경기,김포시,3,0,0,3,3,0,2019-12-06
1956,경기,남양주시,1,0,1,2,2,0,2019-01-06
1957,경기,남양주시,12,8,3,23,5,0,2019-02-06
1958,경기,남양주시,6,0,0,6,4,0,2019-03-06
1959,경기,남양주시,2,0,5,7,5,0,2019-04-06
1960,경기,남양주시,10,0,0,10,6,0,2019-05-06
1961,경기,남양주시,14,5,4,23,7,0,2019-06-06
1962,경기,남양주시,4,1,4,9,7,0,2019-07-06
1963,경기,남양주시,3,0,0,3,2,0,2019-08-06
1964,경기,남양주시,4,2,2,8,7,0,2019-09-06
1965,경기,남양주시,6,1,0,7,6,1,2019-10-06
1966,경기,남양주시,5,1,2,8,5,0,2019-11-06
1967,경기,남양주시,8,2,1,11,8,0,2019-12-06
1968,경기,동두천시,2,0,0,2,2,0,2019-01-06
1969,경기,동두천시,1,0,0,1,1,0,2019-02-06
1970,경기,동두천시,0,1,0,1,1,0,2019-03-06
1971,경기,동두천시,1,0,1,2,2,0,2019-04-06
1972,경기,동두천시,1,0,0,1,1,0,2019-05-06
1973,경기,동두천시,0,0,0,0,0,0,2019-06-06
1974,경기,동두천시,1,0,1,2,2,0,2019-07-06
1975,경기,동두천시,3,0,2,5,3,0,2019-08-06
1976,경기,동두천시,0,0,1,1,1,0,2019-09-06
1977,경기,동두천시,0,0,0,0,0,0,2019-10-06
1978,경기,동두천시,0,0,0,0,0,0,2019-11-06
1979,경기,동두천시,1,0,2,3,3,0,2019-12-06
1980,경기,부천시,3,1,0,4,4,0,2019-01-06
1981,경기,부천시,7,0,2,9,5,0,2019-02-06
1982,경기,부천시,12,0,3,15,9,0,2019-03-06
1983,경기,부천시,11,1,1,13,11,0,2019-04-06
1984,경기,부천시,18,1,4,23,16,0,2019-05-06
1985,경기,부천시,6,0,4,10,8,0,2019-06-06
1986,경기,부천시,7,1,3,11,8,0,2019-07-06
1987,경기,부천시,7,1,2,10,6,0,2019-08-06
1988,경기,부천시,13,3,0,16,14,0,2019-09-06
1989,경기,부천시,18,1,3,22,16,0,2019-10-06
1990,경기,부천시,15,0,1,16,15,0,2019-11-06
1991,경기,부천시,13,0,2,15,15,0,2019-12-06
1992,경기,성남시,15,4,2,21,7,0,2019-01-06
1993,경기,성남시,2,0,1,3,3,0,2019-02-06
1994,경기,성남시,8,1,3,12,9,0,2019-03-06
1995,경기,성남시,1,2,6,9,7,0,2019-04-06
1996,경기,성남시,17,0,5,22,15,1,2019-05-06
1997,경기,성남시,11,1,6,18,12,0,2019-06-06
1998,경기,성남시,6,4,2,12,8,0,2019-07-06
1999,경기,성남시,12,2,2,16,11,0,2019-08-06
2000,경기,성남시,14,1,5,20,14,0,2019-09-06
2001,경기,성남시,7,0,2,9,6,0,2019-10-06
2002,경기,성남시,10,0,3,13,9,0,2019-11-06
2003,경기,성남시,10,0,4,14,10,0,2019-12-06
2004,경기,수원시,9,0,4,13,9,0,2019-01-06
2005,경기,수원시,7,0,4,11,8,0,2019-02-06
2006,경기,수원시,9,1,3,13,11,0,2019-03-06
2007,경기,수원시,11,1,4,16,10,0,2019-04-06
2008,경기,수원시,18,4,4,26,16,0,2019-05-06
2009,경기,수원시,13,2,0,15,7,0,2019-06-06
2010,경기,수원시,17,0,1,18,13,0,2019-07-06
2011,경기,수원시,14,1,0,15,12,0,2019-08-06
2012,경기,수원시,12,4,5,21,16,0,2019-09-06
2013,경기,수원시,5,1,2,8,7,0,2019-10-06
2014,경기,수원시,15,14,6,35,16,0,2019-11-06
2015,경기,수원시,15,3,5,23,13,0,2019-12-06
2016,경기,시흥시,2,0,1,3,3,0,2019-01-06
2017,경기,시흥시,0,0,0,0,0,0,2019-02-06
2018,경기,시흥시,7,0,6,13,10,0,2019-03-06
2019,경기,시흥시,7,2,0,9,7,0,2019-04-06
2020,경기,시흥시,14,1,2,17,8,0,2019-05-06
2021,경기,시흥시,9,0,0,9,4,0,2019-06-06
2022,경기,시흥시,9,1,2,12,6,0,2019-07-06
2023,경기,시흥시,13,0,3,16,9,0,2019-08-06
2024,경기,시흥시,2,0,2,4,3,0,2019-09-06
2025,경기,시흥시,9,1,0,10,6,0,2019-10-06
2026,경기,시흥시,5,0,2,7,7,0,2019-11-06
2027,경기,시흥시,13,0,4,17,13,0,2019-12-06
2028,경기,안산시,8,0,2,10,6,0,2019-01-06
2029,경기,안산시,5,0,0,5,2,0,2019-02-06
2030,경기,안산시,12,1,2,15,11,0,2019-03-06
2031,경기,안산시,11,1,7,19,13,0,2019-04-06
2032,경기,안산시,26,0,2,28,18,0,2019-05-06
2033,경기,안산시,7,2,1,10,10,0,2019-06-06
2034,경기,안산시,12,0,4,16,9,0,2019-07-06
2035,경기,안산시,8,0,0,8,8,0,2019-08-06
2036,경기,안산시,14,6,5,25,10,0,2019-09-06
2037,경기,안산시,11,1,5,17,12,0,2019-10-06
2038,경기,안산시,16,1,4,21,15,0,2019-11-06
2039,경기,안산시,16,0,3,19,15,0,2019-12-06
2040,경기,안성시,7,0,0,7,2,0,2019-01-06
2041,경기,안성시,3,1,1,5,1,0,2019-02-06
2042,경기,안성시,3,1,1,5,3,0,2019-03-06
2043,경기,안성시,1,0,0,1,1,0,2019-04-06
2044,경기,안성시,0,0,0,0,0,0,2019-05-06
2045,경기,안성시,6,0,0,6,4,0,2019-06-06
2046,경기,안성시,4,0,0,4,4,0,2019-07-06
2047,경기,안성시,0,0,0,0,0,0,2019-08-06
2048,경기,안성시,0,0,0,0,0,0,2019-09-06
2049,경기,안성시,8,0,1,9,3,0,2019-10-06
2050,경기,안성시,8,0,0,8,5,0,2019-11-06
2051,경기,안성시,4,2,4,10,5,0,2019-12-06
2052,경기,안양시,4,0,1,5,4,0,2019-01-06
2053,경기,안양시,2,1,0,3,3,0,2019-02-06
2054,경기,안양시,3,0,2,5,3,0,2019-03-06
2055,경기,안양시,2,0,0,2,2,0,2019-04-06
2056,경기,안양시,2,0,0,2,1,0,2019-05-06
2057,경기,안양시,2,0,1,3,3,0,2019-06-06
2058,경기,안양시,11,1,3,15,10,0,2019-07-06
2059,경기,안양시,5,0,0,5,3,0,2019-08-06
2060,경기,안양시,6,0,2,8,7,0,2019-09-06
2061,경기,안양시,7,0,3,10,4,0,2019-10-06
2062,경기,안양시,7,0,0,7,6,0,2019-11-06
2063,경기,안양시,2,1,4,7,6,0,2019-12-06
2064,경기,양주시,1,0,1,2,1,0,2019-01-06
2065,경기,양주시,6,0,1,7,3,0,2019-02-06
2066,경기,양주시,1,0,1,2,2,0,2019-03-06
2067,경기,양주시,6,0,0,6,4,1,2019-04-06
2068,경기,양주시,2,0,1,3,3,0,2019-05-06
2069,경기,양주시,4,0,2,6,3,0,2019-06-06
2070,경기,양주시,0,0,1,1,1,0,2019-07-06
2071,경기,양주시,1,0,1,2,2,0,2019-08-06
2072,경기,양주시,2,0,0,2,2,0,2019-09-06
2073,경기,양주시,1,0,0,1,1,0,2019-10-06
2074,경기,양주시,2,0,0,2,1,0,2019-11-06
2075,경기,양주시,0,0,0,0,0,0,2019-12-06
2076,경기,양평군,3,0,2,5,3,0,2019-01-06
2077,경기,양평군,2,0,0,2,1,0,2019-02-06
2078,경기,양평군,1,0,0,1,1,0,2019-03-06
2079,경기,양평군,4,0,2,6,3,0,2019-04-06
2080,경기,양평군,3,0,0,3,2,0,2019-05-06
2081,경기,양평군,3,0,1,4,3,0,2019-06-06
2082,경기,양평군,2,0,0,2,2,0,2019-07-06
2083,경기,양평군,0,0,1,1,1,0,2019-08-06
2084,경기,양평군,1,1,0,2,1,0,2019-09-06
2085,경기,양평군,4,0,1,5,4,0,2019-10-06
2086,경기,양평군,1,0,0,1,1,0,2019-11-06
2087,경기,양평군,0,0,0,0,0,0,2019-12-06
2088,경기,여주시,6,0,4,10,1,0,2019-01-06
2089,경기,여주시,0,0,0,0,0,0,2019-02-06
2090,경기,여주시,4,0,1,5,2,0,2019-03-06
2091,경기,여주시,0,0,0,0,0,0,2019-04-06
2092,경기,여주시,3,0,0,3,1,0,2019-05-06
2093,경기,여주시,4,0,0,4,2,0,2019-06-06
2094,경기,여주시,0,0,0,0,0,0,2019-07-06
2095,경기,여주시,2,0,1,3,3,0,2019-08-06
2096,경기,여주시,3,1,0,4,2,0,2019-09-06
2097,경기,여주시,0,0,1,1,2,1,2019-10-06
2098,경기,여주시,6,1,0,7,4,0,2019-11-06
2099,경기,여주시,0,0,0,0,0,0,2019-12-06
2100,경기,연천군,0,0,0,0,0,0,2019-01-06
2101,경기,연천군,0,0,0,0,0,0,2019-02-06
2102,경기,연천군,0,0,1,1,1,0,2019-03-06
2103,경기,연천군,0,0,0,0,0,0,2019-04-06
2104,경기,연천군,0,0,0,0,0,0,2019-05-06
2105,경기,연천군,1,0,0,1,1,0,2019-06-06
2106,경기,연천군,0,0,1,1,1,0,2019-07-06
2107,경기,연천군,0,0,3,3,1,0,2019-08-06
2108,경기,연천군,1,0,0,1,1,0,2019-09-06
2109,경기,연천군,3,1,0,4,1,0,2019-10-06
2110,경기,연천군,0,0,0,0,0,0,2019-11-06
2111,경기,연천군,0,0,0,0,0,0,2019-12-06
2112,경기,오산시,0,0,0,0,0,0,2019-01-06
2113,경기,오산시,2,0,0,2,1,0,2019-02-06
2114,경기,오산시,7,3,2,12,7,0,2019-03-06
2115,경기,오산시,0,0,0,0,0,0,2019-04-06
2116,경기,오산시,2,0,0,2,2,0,2019-05-06
2117,경기,오산시,6,0,3,9,4,0,2019-06-06
2118,경기,오산시,2,0,1,3,3,0,2019-07-06
2119,경기,오산시,1,0,0,1,1,0,2019-08-06
2120,경기,오산시,4,2,0,6,5,0,2019-09-06
2121,경기,오산시,3,0,0,3,3,0,2019-10-06
2122,경기,오산시,4,0,4,8,7,0,2019-11-06
2123,경기,오산시,11,0,1,12,6,0,2019-12-06
2124,경기,용인시,2,0,3,5,4,0,2019-01-06
2125,경기,용인시,4,0,3,7,5,0,2019-02-06
2126,경기,용인시,9,0,1,10,6,0,2019-03-06
2127,경기,용인시,10,11,0,21,6,0,2019-04-06
2128,경기,용인시,10,3,3,16,10,0,2019-05-06
2129,경기,용인시,14,2,5,21,15,1,2019-06-06
2130,경기,용인시,12,3,8,23,10,0,2019-07-06
2131,경기,용인시,3,6,2,11,6,0,2019-08-06
2132,경기,용인시,9,6,2,17,12,0,2019-09-06
2133,경기,용인시,7,4,3,14,10,0,2019-10-06
2134,경기,용인시,16,3,4,23,16,0,2019-11-06
2135,경기,용인시,9,4,2,15,11,0,2019-12-06
2136,경기,의왕시,3,0,0,3,1,0,2019-01-06
2137,경기,의왕시,0,0,0,0,0,0,2019-02-06
2138,경기,의왕시,2,1,0,3,3,0,2019-03-06
2139,경기,의왕시,2,0,0,2,2,0,2019-04-06
2140,경기,의왕시,4,0,0,4,4,0,2019-05-06
2141,경기,의왕시,2,0,1,3,2,0,2019-06-06
2142,경기,의왕시,0,0,1,1,1,0,2019-07-06
2143,경기,의왕시,1,0,2,3,2,0,2019-08-06
2144,경기,의왕시,3,1,1,5,2,0,2019-09-06
2145,경기,의왕시,3,0,2,5,2,0,2019-10-06
2146,경기,의왕시,5,0,0,5,3,0,2019-11-06
2147,경기,의왕시,2,1,2,5,3,0,2019-12-06
2148,경기,의정부시,3,0,1,4,4,0,2019-01-06
2149,경기,의정부시,4,3,0,7,4,0,2019-02-06
2150,경기,의정부시,8,0,2,10,8,0,2019-03-06
2151,경기,의정부시,7,0,0,7,4,0,2019-04-06
2152,경기,의정부시,3,0,1,4,3,0,2019-05-06
2153,경기,의정부시,4,0,2,6,4,0,2019-06-06
2154,경기,의정부시,9,1,0,10,4,1,2019-07-06
2155,경기,의정부시,3,1,1,5,3,0,2019-08-06
2156,경기,의정부시,7,1,3,11,8,0,2019-09-06
2157,경기,의정부시,0,2,0,2,1,0,2019-10-06
2158,경기,의정부시,6,2,4,12,6,0,2019-11-06
2159,경기,의정부시,10,3,11,24,6,0,2019-12-06
2160,경기,이천시,4,0,0,4,2,0,2019-01-06
2161,경기,이천시,6,0,0,6,1,0,2019-02-06
2162,경기,이천시,2,0,1,3,3,0,2019-03-06
2163,경기,이천시,2,0,0,2,2,0,2019-04-06
2164,경기,이천시,8,0,0,8,3,0,2019-05-06
2165,경기,이천시,1,0,0,1,1,0,2019-06-06
2166,경기,이천시,3,0,1,4,3,0,2019-07-06
2167,경기,이천시,2,1,1,4,4,1,2019-08-06
2168,경기,이천시,3,1,1,5,5,0,2019-09-06
2169,경기,이천시,2,0,0,2,2,0,2019-10-06
2170,경기,이천시,8,0,3,11,5,0,2019-11-06
2171,경기,이천시,1,0,0,1,1,0,2019-12-06
2172,경기,파주시,3,0,1,4,2,0,2019-01-06
2173,경기,파주시,2,0,1,3,3,0,2019-02-06
2174,경기,파주시,4,1,1,6,3,0,2019-03-06
2175,경기,파주시,3,0,0,3,2,0,2019-04-06
2176,경기,파주시,5,0,5,10,7,0,2019-05-06
2177,경기,파주시,5,1,2,8,6,0,2019-06-06
2178,경기,파주시,4,1,0,5,4,0,2019-07-06
2179,경기,파주시,6,0,2,8,6,0,2019-08-06
2180,경기,파주시,10,0,1,11,7,0,2019-09-06
2181,경기,파주시,3,0,2,5,5,0,2019-10-06
2182,경기,파주시,1,0,2,3,3,0,2019-11-06
2183,경기,파주시,8,1,1,10,7,0,2019-12-06
2184,경기,평택시,5,0,1,6,6,0,2019-01-06
2185,경기,평택시,5,0,4,9,8,0,2019-02-06
2186,경기,평택시,14,1,4,19,13,0,2019-03-06
2187,경기,평택시,0,1,2,3,3,0,2019-04-06
2188,경기,평택시,14,0,0,14,8,0,2019-05-06
2189,경기,평택시,18,2,4,24,11,0,2019-06-06
2190,경기,평택시,5,1,2,8,8,1,2019-07-06
2191,경기,평택시,26,1,5,32,16,0,2019-08-06
2192,경기,평택시,6,0,1,7,5,0,2019-09-06
2193,경기,평택시,2,0,1,3,2,0,2019-10-06
2194,경기,평택시,11,0,4,15,6,0,2019-11-06
2195,경기,평택시,15,8,2,25,15,1,2019-12-06
2196,경기,포천시,0,0,0,0,0,0,2019-01-06
2197,경기,포천시,0,0,0,0,0,0,2019-02-06
2198,경기,포천시,0,0,1,1,1,0,2019-03-06
2199,경기,포천시,3,3,0,6,3,0,2019-04-06
2200,경기,포천시,7,3,0,10,3,0,2019-05-06
2201,경기,포천시,1,0,0,1,1,0,2019-06-06
2202,경기,포천시,1,0,0,1,1,0,2019-07-06
2203,경기,포천시,1,1,1,3,1,0,2019-08-06
2204,경기,포천시,2,0,1,3,1,0,2019-09-06
2205,경기,포천시,0,0,1,1,1,0,2019-10-06
2206,경기,포천시,1,0,2,3,2,0,2019-11-06
2207,경기,포천시,2,0,3,5,4,0,2019-12-06
2208,경기,하남시,0,0,0,0,0,0,2019-01-06
2209,경기,하남시,0,0,0,0,0,0,2019-02-06
2210,경기,하남시,3,1,1,5,3,0,2019-03-06
2211,경기,하남시,7,0,2,9,7,0,2019-04-06
2212,경기,하남시,3,1,2,6,4,0,2019-05-06
2213,경기,하남시,0,0,0,0,0,0,2019-06-06
2214,경기,하남시,0,1,0,1,1,0,2019-07-06
2215,경기,하남시,2,0,0,2,2,0,2019-08-06
2216,경기,하남시,6,0,1,7,5,0,2019-09-06
2217,경기,하남시,5,1,1,7,4,0,2019-10-06
2218,경기,하남시,5,1,1,7,4,0,2019-11-06
2219,경기,하남시,7,1,0,8,5,0,2019-12-06
2220,경기,화성시,12,3,1,16,10,0,2019-01-06
2221,경기,화성시,6,0,2,8,5,0,2019-02-06
2222,경기,화성시,6,0,1,7,6,0,2019-03-06
2223,경기,화성시,12,0,4,16,9,0,2019-04-06
2224,경기,화성시,23,0,3,26,9,0,2019-05-06
2225,경기,화성시,6,0,0,6,5,0,2019-06-06
2226,경기,화성시,7,1,1,9,7,0,2019-07-06
2227,경기,화성시,10,0,4,14,11,0,2019-08-06
2228,경기,화성시,17,2,6,25,20,0,2019-09-06
2229,경기,화성시,2,0,1,3,3,0,2019-10-06
2230,경기,화성시,17,1,3,21,14,0,2019-11-06
2231,경기,화성시,14,0,4,18,11,0,2019-12-06
2232,경기,가평군,2,0,1,3,3,0,2019-01-07
2233,경기,가평군,0,0,0,0,0,0,2019-02-07
2234,경기,가평군,0,0,0,0,0,0,2019-03-07
2235,경기,가평군,0,0,0,0,0,0,2019-04-07
2236,경기,가평군,7,0,1,8,5,0,2019-05-07
2237,경기,가평군,0,0,0,0,0,0,2019-06-07
2238,경기,가평군,2,0,1,3,3,0,2019-07-07
2239,경기,가평군,0,0,1,1,1,0,2019-08-07
2240,경기,가평군,1,0,1,2,2,0,2019-09-07
2241,경기,가평군,0,0,0,0,0,0,2019-10-07
2242,경기,가평군,1,0,1,2,1,0,2019-11-07
2243,경기,가평군,5,0,4,9,4,0,2019-12-07
2244,경기,고양시,6,1,3,10,10,1,2019-01-07
2245,경기,고양시,4,0,2,6,6,0,2019-02-07
2246,경기,고양시,10,1,2,13,10,0,2019-03-07
2247,경기,고양시,12,0,3,15,10,0,2019-04-07
2248,경기,고양시,4,0,1,5,5,0,2019-05-07
2249,경기,고양시,10,1,1,12,9,0,2019-06-07
2250,경기,고양시,16,1,2,19,11,0,2019-07-07
2251,경기,고양시,10,2,1,13,11,0,2019-08-07
2252,경기,고양시,5,1,4,10,8,0,2019-09-07
2253,경기,고양시,14,2,6,22,17,0,2019-10-07
2254,경기,고양시,5,5,2,12,11,0,2019-11-07
2255,경기,고양시,7,0,1,8,6,0,2019-12-07
2256,경기,과천시,1,0,0,1,1,0,2019-01-07
2257,경기,과천시,0,0,0,0,0,0,2019-02-07
2258,경기,과천시,0,0,0,0,0,0,2019-03-07
2259,경기,과천시,0,0,0,0,0,0,2019-04-07
2260,경기,과천시,0,0,0,0,0,0,2019-05-07
2261,경기,과천시,0,0,0,0,0,0,2019-06-07
2262,경기,과천시,0,0,0,0,0,0,2019-07-07
2263,경기,과천시,3,0,0,3,2,0,2019-08-07
2264,경기,과천시,0,0,0,0,0,0,2019-09-07
2265,경기,과천시,0,0,0,0,0,0,2019-10-07
2266,경기,과천시,1,0,0,1,1,0,2019-11-07
2267,경기,과천시,0,0,0,0,0,0,2019-12-07
2268,경기,광명시,5,0,1,6,5,0,2019-01-07
2269,경기,광명시,6,0,0,6,5,0,2019-02-07
2270,경기,광명시,4,3,1,8,7,0,2019-03-07
2271,경기,광명시,2,0,0,2,2,0,2019-04-07
2272,경기,광명시,2,0,1,3,2,0,2019-05-07
2273,경기,광명시,3,0,1,4,3,0,2019-06-07
2274,경기,광명시,2,1,0,3,2,0,2019-07-07
2275,경기,광명시,1,1,1,3,3,0,2019-08-07
2276,경기,광명시,1,1,0,2,2,0,2019-09-07
2277,경기,광명시,5,2,1,8,4,0,2019-10-07
2278,경기,광명시,2,3,1,6,3,0,2019-11-07
2279,경기,광명시,2,0,2,4,3,0,2019-12-07
2280,경기,광주시,4,0,0,4,3,0,2019-01-07
2281,경기,광주시,4,0,2,6,5,0,2019-02-07
2282,경기,광주시,6,0,0,6,4,0,2019-03-07
2283,경기,광주시,1,0,0,1,2,1,2019-04-07
2284,경기,광주시,4,0,0,4,3,0,2019-05-07
2285,경기,광주시,5,0,0,5,3,0,2019-06-07
2286,경기,광주시,18,4,2,24,9,0,2019-07-07
2287,경기,광주시,2,1,1,4,4,0,2019-08-07
2288,경기,광주시,5,0,1,6,5,0,2019-09-07
2289,경기,광주시,1,2,1,4,4,0,2019-10-07
2290,경기,광주시,11,1,2,14,12,0,2019-11-07
2291,경기,광주시,9,0,2,11,5,0,2019-12-07
2292,경기,구리시,0,0,1,1,1,0,2019-01-07
2293,경기,구리시,1,0,0,1,1,0,2019-02-07
2294,경기,구리시,4,0,0,4,3,0,2019-03-07
2295,경기,구리시,0,0,0,0,0,0,2019-04-07
2296,경기,구리시,2,2,2,6,6,1,2019-05-07
2297,경기,구리시,0,0,1,1,1,0,2019-06-07
2298,경기,구리시,4,0,0,4,2,0,2019-07-07
2299,경기,구리시,2,0,0,2,2,0,2019-08-07
2300,경기,구리시,0,0,0,0,0,0,2019-09-07
2301,경기,구리시,0,0,1,1,1,0,2019-10-07
2302,경기,구리시,0,0,1,1,1,0,2019-11-07
2303,경기,구리시,1,0,0,1,1,0,2019-12-07
2304,경기,군포시,0,0,1,1,1,0,2019-01-07
2305,경기,군포시,7,1,0,8,3,0,2019-02-07
2306,경기,군포시,0,0,2,2,2,0,2019-03-07
2307,경기,군포시,0,0,0,0,0,0,2019-04-07
2308,경기,군포시,1,0,0,1,1,0,2019-05-07
2309,경기,군포시,4,2,0,6,4,0,2019-06-07
2310,경기,군포시,1,0,0,1,1,0,2019-07-07
2311,경기,군포시,0,0,0,0,0,0,2019-08-07
2312,경기,군포시,7,0,0,7,4,0,2019-09-07
2313,경기,군포시,2,0,1,3,3,0,2019-10-07
2314,경기,군포시,1,1,1,3,3,0,2019-11-07
2315,경기,군포시,0,0,0,0,0,0,2019-12-07
2316,경기,김포시,5,1,0,6,4,0,2019-01-07
2317,경기,김포시,6,0,2,8,5,0,2019-02-07
2318,경기,김포시,7,0,2,9,7,0,2019-03-07
2319,경기,김포시,4,0,1,5,5,0,2019-04-07
2320,경기,김포시,6,2,2,10,8,1,2019-05-07
2321,경기,김포시,2,0,2,4,2,0,2019-06-07
2322,경기,김포시,7,2,2,11,4,0,2019-07-07
2323,경기,김포시,7,0,1,8,6,0,2019-08-07
2324,경기,김포시,5,1,0,6,6,1,2019-09-07
2325,경기,김포시,6,0,3,9,7,0,2019-10-07
2326,경기,김포시,4,1,1,6,5,0,2019-11-07
2327,경기,김포시,6,0,1,7,3,0,2019-12-07
2328,경기,남양주시,8,0,1,9,4,0,2019-01-07
2329,경기,남양주시,13,7,4,24,9,1,2019-02-07
2330,경기,남양주시,4,1,1,6,5,0,2019-03-07
2331,경기,남양주시,9,0,8,17,7,0,2019-04-07
2332,경기,남양주시,8,2,5,15,9,0,2019-05-07
2333,경기,남양주시,2,14,2,18,4,0,2019-06-07
2334,경기,남양주시,2,0,1,3,3,1,2019-07-07
2335,경기,남양주시,9,0,2,11,9,0,2019-08-07
2336,경기,남양주시,5,0,1,6,6,1,2019-09-07
2337,경기,남양주시,4,4,0,8,6,0,2019-10-07
2338,경기,남양주시,18,2,2,22,16,0,2019-11-07
2339,경기,남양주시,10,1,0,11,7,0,2019-12-07
2340,경기,동두천시,1,0,0,1,1,0,2019-01-07
2341,경기,동두천시,1,0,2,3,2,0,2019-02-07
2342,경기,동두천시,0,0,1,1,1,0,2019-03-07
2343,경기,동두천시,4,0,0,4,1,0,2019-04-07
2344,경기,동두천시,0,0,0,0,1,1,2019-05-07
2345,경기,동두천시,2,0,0,2,2,0,2019-06-07
2346,경기,동두천시,1,0,0,1,1,0,2019-07-07
2347,경기,동두천시,1,0,0,1,1,0,2019-08-07
2348,경기,동두천시,0,0,0,0,0,0,2019-09-07
2349,경기,동두천시,0,0,1,1,1,0,2019-10-07
2350,경기,동두천시,3,0,1,4,2,0,2019-11-07
2351,경기,동두천시,3,0,0,3,1,0,2019-12-07
2352,경기,부천시,15,0,4,19,13,0,2019-01-07
2353,경기,부천시,11,2,0,13,11,0,2019-02-07
2354,경기,부천시,6,1,1,8,6,0,2019-03-07
2355,경기,부천시,8,0,0,8,7,0,2019-04-07
2356,경기,부천시,9,0,5,14,10,0,2019-05-07
2357,경기,부천시,17,1,2,20,10,0,2019-06-07
2358,경기,부천시,7,3,1,11,8,0,2019-07-07
2359,경기,부천시,15,1,4,20,16,0,2019-08-07
2360,경기,부천시,12,0,2,14,6,0,2019-09-07
2361,경기,부천시,7,2,0,9,6,0,2019-10-07
2362,경기,부천시,9,0,4,13,12,0,2019-11-07
2363,경기,부천시,26,0,6,32,18,0,2019-12-07
2364,경기,성남시,4,3,1,8,6,0,2019-01-07
2365,경기,성남시,12,1,3,16,13,0,2019-02-07
2366,경기,성남시,9,1,3,13,8,0,2019-03-07
2367,경기,성남시,4,3,0,7,6,0,2019-04-07
2368,경기,성남시,18,1,1,20,14,0,2019-05-07
2369,경기,성남시,15,0,0,15,7,0,2019-06-07
2370,경기,성남시,6,0,1,7,5,0,2019-07-07
2371,경기,성남시,5,1,1,7,5,0,2019-08-07
2372,경기,성남시,11,0,2,13,9,0,2019-09-07
2373,경기,성남시,11,1,6,18,12,0,2019-10-07
2374,경기,성남시,11,4,5,20,13,0,2019-11-07
2375,경기,성남시,8,3,3,14,11,0,2019-12-07
2376,경기,수원시,14,0,2,16,11,0,2019-01-07
2377,경기,수원시,9,1,4,14,11,0,2019-02-07
2378,경기,수원시,11,1,3,15,13,0,2019-03-07
2379,경기,수원시,14,0,1,15,9,0,2019-04-07
2380,경기,수원시,19,3,3,25,19,0,2019-05-07
2381,경기,수원시,7,3,1,11,11,0,2019-06-07
2382,경기,수원시,8,3,3,14,9,0,2019-07-07
2383,경기,수원시,11,1,4,16,12,0,2019-08-07
2384,경기,수원시,11,1,1,13,12,0,2019-09-07
2385,경기,수원시,13,3,2,18,13,0,2019-10-07
2386,경기,수원시,23,2,6,31,13,0,2019-11-07
2387,경기,수원시,15,3,2,20,15,0,2019-12-07
2388,경기,시흥시,9,0,3,12,8,0,2019-01-07
2389,경기,시흥시,5,1,2,8,4,0,2019-02-07
2390,경기,시흥시,5,0,3,8,8,0,2019-03-07
2391,경기,시흥시,4,0,0,4,2,0,2019-04-07
2392,경기,시흥시,2,0,1,3,3,0,2019-05-07
2393,경기,시흥시,9,0,6,15,7,0,2019-06-07
2394,경기,시흥시,10,0,1,11,7,0,2019-07-07
2395,경기,시흥시,16,4,4,24,9,0,2019-08-07
2396,경기,시흥시,3,0,4,7,5,0,2019-09-07
2397,경기,시흥시,18,1,3,22,8,0,2019-10-07
2398,경기,시흥시,9,0,0,9,5,0,2019-11-07
2399,경기,시흥시,8,2,3,13,10,0,2019-12-07
2400,경기,안산시,15,1,0,16,8,0,2019-01-07
2401,경기,안산시,6,0,3,9,8,1,2019-02-07
2402,경기,안산시,15,1,3,19,12,1,2019-03-07
2403,경기,안산시,13,3,0,16,9,0,2019-04-07
2404,경기,안산시,11,0,3,14,11,0,2019-05-07
2405,경기,안산시,14,0,6,20,13,0,2019-06-07
2406,경기,안산시,16,2,2,20,12,0,2019-07-07
2407,경기,안산시,3,0,4,7,7,0,2019-08-07
2408,경기,안산시,14,1,2,17,12,0,2019-09-07
2409,경기,안산시,17,0,1,18,15,0,2019-10-07
2410,경기,안산시,12,0,5,17,13,0,2019-11-07
2411,경기,안산시,9,0,1,10,8,0,2019-12-07
2412,경기,안성시,5,0,0,5,1,0,2019-01-07
2413,경기,안성시,1,0,0,1,1,0,2019-02-07
2414,경기,안성시,1,0,0,1,1,0,2019-03-07
2415,경기,안성시,3,0,2,5,2,0,2019-04-07
2416,경기,안성시,0,0,2,2,2,0,2019-05-07
2417,경기,안성시,2,0,2,4,3,0,2019-06-07
2418,경기,안성시,2,1,0,3,3,0,2019-07-07
2419,경기,안성시,3,0,0,3,2,0,2019-08-07
2420,경기,안성시,0,0,0,0,0,0,2019-09-07
2421,경기,안성시,11,0,2,13,4,0,2019-10-07
2422,경기,안성시,3,0,0,3,3,0,2019-11-07
2423,경기,안성시,1,0,0,1,1,0,2019-12-07
2424,경기,안양시,0,0,3,3,3,0,2019-01-07
2425,경기,안양시,0,0,1,1,1,0,2019-02-07
2426,경기,안양시,2,0,2,4,3,0,2019-03-07
2427,경기,안양시,9,0,1,10,4,0,2019-04-07
2428,경기,안양시,4,0,0,4,4,0,2019-05-07
2429,경기,안양시,6,1,4,11,8,0,2019-06-07
2430,경기,안양시,2,0,1,3,3,0,2019-07-07
2431,경기,안양시,3,0,0,3,3,0,2019-08-07
2432,경기,안양시,7,0,3,10,8,2,2019-09-07
2433,경기,안양시,2,0,2,4,3,0,2019-10-07
2434,경기,안양시,4,0,2,6,5,0,2019-11-07
2435,경기,안양시,0,0,1,1,1,0,2019-12-07
2436,경기,양주시,1,0,1,2,2,0,2019-01-07
2437,경기,양주시,3,0,2,5,5,1,2019-02-07
2438,경기,양주시,2,0,1,3,3,1,2019-03-07
2439,경기,양주시,2,0,0,2,2,0,2019-04-07
2440,경기,양주시,4,0,0,4,3,0,2019-05-07
2441,경기,양주시,0,0,0,0,1,1,2019-06-07
2442,경기,양주시,0,0,1,1,1,0,2019-07-07
2443,경기,양주시,7,0,0,7,3,0,2019-08-07
2444,경기,양주시,1,0,0,1,1,0,2019-09-07
2445,경기,양주시,0,0,0,0,0,0,2019-10-07
2446,경기,양주시,2,0,0,2,1,0,2019-11-07
2447,경기,양주시,4,0,1,5,4,0,2019-12-07
2448,경기,양평군,0,0,2,2,2,0,2019-01-07
2449,경기,양평군,1,0,0,1,1,0,2019-02-07
2450,경기,양평군,1,0,2,3,2,0,2019-03-07
2451,경기,양평군,2,0,0,2,1,0,2019-04-07
2452,경기,양평군,0,0,0,0,0,0,2019-05-07
2453,경기,양평군,0,0,1,1,1,0,2019-06-07
2454,경기,양평군,1,0,0,1,1,0,2019-07-07
2455,경기,양평군,1,0,0,1,1,0,2019-08-07
2456,경기,양평군,1,0,0,1,1,0,2019-09-07
2457,경기,양평군,0,0,0,0,0,0,2019-10-07
2458,경기,양평군,1,0,0,1,1,0,2019-11-07
2459,경기,양평군,0,0,0,0,0,0,2019-12-07
2460,경기,여주시,1,0,0,1,1,0,2019-01-07
2461,경기,여주시,4,1,0,5,1,0,2019-02-07
2462,경기,여주시,2,0,1,3,2,0,2019-03-07
2463,경기,여주시,4,0,1,5,4,0,2019-04-07
2464,경기,여주시,0,0,0,0,0,0,2019-05-07
2465,경기,여주시,5,0,0,5,2,0,2019-06-07
2466,경기,여주시,5,0,1,6,3,0,2019-07-07
2467,경기,여주시,1,0,3,4,3,0,2019-08-07
2468,경기,여주시,1,0,0,1,1,0,2019-09-07
2469,경기,여주시,0,0,0,0,0,0,2019-10-07
2470,경기,여주시,2,0,0,2,1,0,2019-11-07
2471,경기,여주시,0,0,0,0,0,0,2019-12-07
2472,경기,연천군,0,0,0,0,0,0,2019-01-07
2473,경기,연천군,0,0,0,0,0,0,2019-02-07
2474,경기,연천군,0,0,1,1,1,0,2019-03-07
2475,경기,연천군,0,0,0,0,0,0,2019-04-07
2476,경기,연천군,1,0,0,1,1,0,2019-05-07
2477,경기,연천군,1,0,0,1,1,0,2019-06-07
2478,경기,연천군,0,0,0,0,0,0,2019-07-07
2479,경기,연천군,0,0,0,0,0,0,2019-08-07
2480,경기,연천군,0,0,0,0,0,0,2019-09-07
2481,경기,연천군,2,0,0,2,1,0,2019-10-07
2482,경기,연천군,1,0,2,3,1,0,2019-11-07
2483,경기,연천군,4,0,0,4,1,0,2019-12-07
2484,경기,오산시,5,0,0,5,5,0,2019-01-07
2485,경기,오산시,3,0,0,3,2,0,2019-02-07
2486,경기,오산시,1,0,1,2,1,0,2019-03-07
2487,경기,오산시,1,1,0,2,2,0,2019-04-07
2488,경기,오산시,0,1,1,2,2,0,2019-05-07
2489,경기,오산시,9,0,0,9,3,0,2019-06-07
2490,경기,오산시,2,0,1,3,3,0,2019-07-07
2491,경기,오산시,9,0,2,11,5,0,2019-08-07
2492,경기,오산시,0,1,0,1,1,0,2019-09-07
2493,경기,오산시,2,0,0,2,1,0,2019-10-07
2494,경기,오산시,3,0,0,3,2,0,2019-11-07
2495,경기,오산시,0,0,1,1,1,0,2019-12-07
2496,경기,용인시,11,4,3,18,9,0,2019-01-07
2497,경기,용인시,1,1,2,4,4,0,2019-02-07
2498,경기,용인시,6,2,6,14,11,0,2019-03-07
2499,경기,용인시,3,4,4,11,9,0,2019-04-07
2500,경기,용인시,7,1,1,9,9,0,2019-05-07
2501,경기,용인시,8,0,2,10,9,0,2019-06-07
2502,경기,용인시,1,1,0,2,2,0,2019-07-07
2503,경기,용인시,13,1,1,15,8,0,2019-08-07
2504,경기,용인시,14,0,3,17,10,1,2019-09-07
2505,경기,용인시,10,2,4,16,15,0,2019-10-07
2506,경기,용인시,12,2,2,16,13,0,2019-11-07
2507,경기,용인시,9,1,3,13,10,0,2019-12-07
2508,경기,의왕시,1,0,0,1,1,0,2019-01-07
2509,경기,의왕시,2,0,3,5,5,0,2019-02-07
2510,경기,의왕시,4,0,0,4,2,0,2019-03-07
2511,경기,의왕시,1,1,1,3,2,0,2019-04-07
2512,경기,의왕시,1,0,0,1,1,0,2019-05-07
2513,경기,의왕시,2,0,1,3,2,0,2019-06-07
2514,경기,의왕시,1,2,0,3,2,1,2019-07-07
2515,경기,의왕시,0,0,0,0,0,0,2019-08-07
2516,경기,의왕시,0,0,2,2,1,0,2019-09-07
2517,경기,의왕시,0,0,0,0,0,0,2019-10-07
2518,경기,의왕시,0,0,1,1,1,0,2019-11-07
2519,경기,의왕시,0,0,0,0,0,0,2019-12-07
2520,경기,의정부시,5,0,1,6,3,0,2019-01-07
2521,경기,의정부시,4,1,1,6,6,0,2019-02-07
2522,경기,의정부시,9,0,1,10,7,0,2019-03-07
2523,경기,의정부시,1,0,1,2,2,0,2019-04-07
2524,경기,의정부시,6,0,2,8,4,0,2019-05-07
2525,경기,의정부시,5,0,1,6,5,0,2019-06-07
2526,경기,의정부시,2,0,1,3,3,0,2019-07-07
2527,경기,의정부시,6,1,0,7,6,0,2019-08-07
2528,경기,의정부시,5,0,0,5,4,0,2019-09-07
2529,경기,의정부시,5,1,2,8,6,0,2019-10-07
2530,경기,의정부시,5,0,0,5,4,0,2019-11-07
2531,경기,의정부시,7,1,1,9,5,0,2019-12-07
2532,경기,이천시,2,0,0,2,2,1,2019-01-07
2533,경기,이천시,1,0,1,2,2,0,2019-02-07
2534,경기,이천시,2,0,0,2,1,0,2019-03-07
2535,경기,이천시,2,0,1,3,3,0,2019-04-07
2536,경기,이천시,0,1,0,1,1,0,2019-05-07
2537,경기,이천시,5,2,0,7,5,0,2019-06-07
2538,경기,이천시,9,0,2,11,5,0,2019-07-07
2539,경기,이천시,7,0,1,8,4,0,2019-08-07
2540,경기,이천시,2,0,0,2,2,0,2019-09-07
2541,경기,이천시,2,0,1,3,3,0,2019-10-07
2542,경기,이천시,8,0,0,8,6,0,2019-11-07
2543,경기,이천시,0,0,0,0,0,0,2019-12-07
2544,경기,파주시,4,0,0,4,3,0,2019-01-07
2545,경기,파주시,5,1,1,7,2,0,2019-02-07
2546,경기,파주시,5,2,0,7,6,0,2019-03-07
2547,경기,파주시,5,1,0,6,4,0,2019-04-07
2548,경기,파주시,4,1,1,6,6,0,2019-05-07
2549,경기,파주시,9,2,0,11,7,0,2019-06-07
2550,경기,파주시,1,0,3,4,2,0,2019-07-07
2551,경기,파주시,0,1,0,1,1,0,2019-08-07
2552,경기,파주시,3,0,0,3,3,0,2019-09-07
2553,경기,파주시,8,4,3,15,7,0,2019-10-07
2554,경기,파주시,5,0,1,6,6,0,2019-11-07
2555,경기,파주시,10,2,3,15,7,0,2019-12-07
2556,경기,평택시,14,3,3,20,10,0,2019-01-07
2557,경기,평택시,7,3,2,12,10,0,2019-02-07
2558,경기,평택시,6,0,5,11,9,0,2019-03-07
2559,경기,평택시,8,0,1,9,7,0,2019-04-07
2560,경기,평택시,8,0,5,13,11,0,2019-05-07
2561,경기,평택시,25,3,5,33,15,1,2019-06-07
2562,경기,평택시,4,2,0,6,3,0,2019-07-07
2563,경기,평택시,18,7,7,32,20,0,2019-08-07
2564,경기,평택시,8,0,4,12,7,0,2019-09-07
2565,경기,평택시,3,2,3,8,5,0,2019-10-07
2566,경기,평택시,15,4,3,22,11,0,2019-11-07
2567,경기,평택시,13,2,4,19,13,0,2019-12-07
2568,경기,포천시,0,0,0,0,0,0,2019-01-07
2569,경기,포천시,1,1,2,4,3,0,2019-02-07
2570,경기,포천시,1,0,0,1,2,1,2019-03-07
2571,경기,포천시,4,0,0,4,2,0,2019-04-07
2572,경기,포천시,1,0,2,3,3,0,2019-05-07
2573,경기,포천시,4,1,2,7,4,0,2019-06-07
2574,경기,포천시,12,1,3,16,6,0,2019-07-07
2575,경기,포천시,3,0,1,4,3,0,2019-08-07
2576,경기,포천시,0,0,0,0,0,0,2019-09-07
2577,경기,포천시,1,0,0,1,1,0,2019-10-07
2578,경기,포천시,2,0,1,3,2,0,2019-11-07
2579,경기,포천시,12,4,0,16,7,0,2019-12-07
2580,경기,하남시,1,0,0,1,1,0,2019-01-07
2581,경기,하남시,1,0,1,2,1,0,2019-02-07
2582,경기,하남시,1,0,0,1,1,0,2019-03-07
2583,경기,하남시,4,0,1,5,2,0,2019-04-07
2584,경기,하남시,3,2,0,5,6,1,2019-05-07
2585,경기,하남시,1,0,0,1,2,1,2019-06-07
2586,경기,하남시,3,0,0,3,2,0,2019-07-07
2587,경기,하남시,0,0,3,3,2,0,2019-08-07
2588,경기,하남시,0,0,0,0,0,0,2019-09-07
2589,경기,하남시,0,0,1,1,1,0,2019-10-07
2590,경기,하남시,3,2,0,5,3,0,2019-11-07
2591,경기,하남시,3,0,0,3,2,0,2019-12-07
2592,경기,화성시,3,0,2,5,4,0,2019-01-07
2593,경기,화성시,5,0,4,9,9,0,2019-02-07
2594,경기,화성시,17,0,5,22,11,0,2019-03-07
2595,경기,화성시,8,0,1,9,5,0,2019-04-07
2596,경기,화성시,4,2,1,7,6,0,2019-05-07
2597,경기,화성시,11,0,2,13,10,0,2019-06-07
2598,경기,화성시,4,0,1,5,4,0,2019-07-07
2599,경기,화성시,9,6,2,17,11,0,2019-08-07
2600,경기,화성시,3,0,1,4,3,0,2019-09-07
2601,경기,화성시,17,3,5,25,11,0,2019-10-07
2602,경기,화성시,9,1,6,16,11,0,2019-11-07
2603,경기,화성시,12,0,1,13,8,0,2019-12-07
2604,경기,가평군,0,0,0,0,0,0,2019-01-08
2605,경기,가평군,0,0,0,0,0,0,2019-02-08
2606,경기,가평군,3,0,1,4,1,0,2019-03-08
2607,경기,가평군,1,0,0,1,1,0,2019-04-08
2608,경기,가평군,0,0,0,0,0,0,2019-05-08
2609,경기,가평군,2,0,0,2,1,0,2019-06-08
2610,경기,가평군,4,0,0,4,2,0,2019-07-08
2611,경기,가평군,0,0,0,0,0,0,2019-08-08
2612,경기,가평군,0,0,0,0,0,0,2019-09-08
2613,경기,가평군,2,0,0,2,2,0,2019-10-08
2614,경기,가평군,0,0,0,0,0,0,2019-11-08
2615,경기,가평군,0,0,0,0,0,0,2019-12-08
2616,경기,고양시,12,2,2,16,10,0,2019-01-08
2617,경기,고양시,4,0,4,8,5,0,2019-02-08
2618,경기,고양시,10,0,1,11,10,0,2019-03-08
2619,경기,고양시,18,0,3,21,10,0,2019-04-08
2620,경기,고양시,12,1,2,15,14,1,2019-05-08
2621,경기,고양시,11,3,3,17,8,0,2019-06-08
2622,경기,고양시,8,0,2,10,10,1,2019-07-08
2623,경기,고양시,12,0,4,16,14,0,2019-08-08
2624,경기,고양시,8,0,0,8,5,0,2019-09-08
2625,경기,고양시,19,3,4,26,19,0,2019-10-08
2626,경기,고양시,10,1,6,17,14,0,2019-11-08
2627,경기,고양시,9,0,1,10,7,0,2019-12-08
2628,경기,과천시,0,0,0,0,0,0,2019-01-08
2629,경기,과천시,0,0,0,0,0,0,2019-02-08
2630,경기,과천시,0,0,0,0,0,0,2019-03-08
2631,경기,과천시,1,0,0,1,1,0,2019-04-08
2632,경기,과천시,0,0,0,0,0,0,2019-05-08
2633,경기,과천시,0,0,0,0,0,0,2019-06-08
2634,경기,과천시,2,0,1,3,2,0,2019-07-08
2635,경기,과천시,0,0,0,0,0,0,2019-08-08
2636,경기,과천시,1,0,0,1,1,0,2019-09-08
2637,경기,과천시,0,0,1,1,1,0,2019-10-08
2638,경기,과천시,0,0,0,0,0,0,2019-11-08
2639,경기,과천시,2,0,0,2,1,0,2019-12-08
2640,경기,광명시,0,0,1,1,1,0,2019-01-08
2641,경기,광명시,0,0,0,0,0,0,2019-02-08
2642,경기,광명시,6,0,0,6,4,0,2019-03-08
2643,경기,광명시,0,1,1,2,2,0,2019-04-08
2644,경기,광명시,0,0,1,1,1,0,2019-05-08
2645,경기,광명시,1,1,0,2,2,0,2019-06-08
2646,경기,광명시,0,2,0,2,1,0,2019-07-08
2647,경기,광명시,1,0,0,1,1,0,2019-08-08
2648,경기,광명시,5,1,0,6,2,0,2019-09-08
2649,경기,광명시,4,0,0,4,4,0,2019-10-08
2650,경기,광명시,2,1,0,3,3,0,2019-11-08
2651,경기,광명시,0,0,0,0,0,0,2019-12-08
2652,경기,광주시,6,0,0,6,4,0,2019-01-08
2653,경기,광주시,3,0,0,3,2,0,2019-02-08
2654,경기,광주시,3,0,3,6,5,0,2019-03-08
2655,경기,광주시,11,0,0,11,5,0,2019-04-08
2656,경기,광주시,11,0,1,12,6,0,2019-05-08
2657,경기,광주시,3,1,0,4,3,0,2019-06-08
2658,경기,광주시,4,0,2,6,5,0,2019-07-08
2659,경기,광주시,4,0,0,4,3,0,2019-08-08
2660,경기,광주시,5,1,1,7,7,0,2019-09-08
2661,경기,광주시,8,4,0,12,7,0,2019-10-08
2662,경기,광주시,5,1,1,7,7,0,2019-11-08
2663,경기,광주시,5,0,1,6,4,0,2019-12-08
2664,경기,구리시,3,2,1,6,3,0,2019-01-08
2665,경기,구리시,6,2,0,8,6,0,2019-02-08
2666,경기,구리시,5,0,2,7,4,0,2019-03-08
2667,경기,구리시,3,0,0,3,3,0,2019-04-08
2668,경기,구리시,0,0,0,0,0,0,2019-05-08
2669,경기,구리시,1,0,1,2,2,0,2019-06-08
2670,경기,구리시,2,0,1,3,3,0,2019-07-08
2671,경기,구리시,2,0,0,2,2,0,2019-08-08
2672,경기,구리시,0,0,0,0,0,0,2019-09-08
2673,경기,구리시,2,0,0,2,1,0,2019-10-08
2674,경기,구리시,1,0,0,1,1,0,2019-11-08
2675,경기,구리시,2,0,0,2,2,0,2019-12-08
2676,경기,군포시,0,0,1,1,1,0,2019-01-08
2677,경기,군포시,6,1,0,7,5,0,2019-02-08
2678,경기,군포시,4,3,0,7,3,0,2019-03-08
2679,경기,군포시,3,2,0,5,4,0,2019-04-08
2680,경기,군포시,1,0,0,1,1,0,2019-05-08
2681,경기,군포시,2,0,0,2,1,0,2019-06-08
2682,경기,군포시,1,0,1,2,2,0,2019-07-08
2683,경기,군포시,1,0,0,1,1,0,2019-08-08
2684,경기,군포시,3,1,0,4,3,0,2019-09-08
2685,경기,군포시,0,0,0,0,0,0,2019-10-08
2686,경기,군포시,5,0,0,5,4,0,2019-11-08
2687,경기,군포시,2,0,0,2,2,0,2019-12-08
2688,경기,김포시,2,1,2,5,6,1,2019-01-08
2689,경기,김포시,2,0,0,2,1,0,2019-02-08
2690,경기,김포시,6,0,0,6,5,0,2019-03-08
2691,경기,김포시,6,0,1,7,6,0,2019-04-08
2692,경기,김포시,9,0,0,9,5,0,2019-05-08
2693,경기,김포시,1,1,3,5,4,0,2019-06-08
2694,경기,김포시,5,0,3,8,6,0,2019-07-08
2695,경기,김포시,3,0,0,3,3,0,2019-08-08
2696,경기,김포시,1,1,1,3,3,0,2019-09-08
2697,경기,김포시,4,0,3,7,6,0,2019-10-08
2698,경기,김포시,6,1,5,12,6,0,2019-11-08
2699,경기,김포시,3,1,1,5,5,0,2019-12-08
2700,경기,남양주시,2,1,0,3,2,0,2019-01-08
2701,경기,남양주시,2,0,1,3,2,0,2019-02-08
2702,경기,남양주시,9,0,3,12,9,1,2019-03-08
2703,경기,남양주시,6,0,2,8,4,0,2019-04-08
2704,경기,남양주시,6,4,5,15,9,0,2019-05-08
2705,경기,남양주시,10,2,4,16,10,1,2019-06-08
2706,경기,남양주시,5,1,2,8,7,0,2019-07-08
2707,경기,남양주시,5,0,4,9,8,0,2019-08-08
2708,경기,남양주시,5,1,2,8,4,0,2019-09-08
2709,경기,남양주시,16,1,2,19,9,0,2019-10-08
2710,경기,남양주시,8,1,3,12,4,0,2019-11-08
2711,경기,남양주시,8,0,1,9,5,0,2019-12-08
2712,경기,동두천시,4,0,0,4,3,0,2019-01-08
2713,경기,동두천시,0,0,0,0,0,0,2019-02-08
2714,경기,동두천시,0,0,1,1,1,0,2019-03-08
2715,경기,동두천시,0,0,0,0,0,0,2019-04-08
2716,경기,동두천시,0,0,1,1,1,0,2019-05-08
2717,경기,동두천시,0,0,0,0,0,0,2019-06-08
2718,경기,동두천시,2,0,1,3,2,0,2019-07-08
2719,경기,동두천시,5,0,1,6,3,0,2019-08-08
2720,경기,동두천시,0,0,0,0,0,0,2019-09-08
2721,경기,동두천시,1,0,1,2,2,0,2019-10-08
2722,경기,동두천시,0,0,0,0,0,0,2019-11-08
2723,경기,동두천시,1,1,3,5,2,0,2019-12-08
2724,경기,부천시,11,1,2,14,8,0,2019-01-08
2725,경기,부천시,6,0,2,8,5,0,2019-02-08
2726,경기,부천시,7,0,2,9,7,0,2019-03-08
2727,경기,부천시,9,1,3,13,9,1,2019-04-08
2728,경기,부천시,11,1,4,16,14,0,2019-05-08
2729,경기,부천시,17,1,2,20,14,0,2019-06-08
2730,경기,부천시,5,1,1,7,7,0,2019-07-08
2731,경기,부천시,11,0,2,13,10,0,2019-08-08
2732,경기,부천시,8,1,1,10,7,0,2019-09-08
2733,경기,부천시,5,2,0,7,7,0,2019-10-08
2734,경기,부천시,19,4,8,31,19,0,2019-11-08
2735,경기,부천시,22,3,4,29,13,0,2019-12-08
2736,경기,성남시,11,3,5,19,9,0,2019-01-08
2737,경기,성남시,3,0,3,6,5,0,2019-02-08
2738,경기,성남시,7,1,3,11,7,0,2019-03-08
2739,경기,성남시,8,1,3,12,8,0,2019-04-08
2740,경기,성남시,9,5,2,16,13,0,2019-05-08
2741,경기,성남시,12,1,6,19,10,0,2019-06-08
2742,경기,성남시,11,4,2,17,8,0,2019-07-08
2743,경기,성남시,9,0,3,12,11,0,2019-08-08
2744,경기,성남시,8,1,1,10,7,0,2019-09-08
2745,경기,성남시,17,0,7,24,18,0,2019-10-08
2746,경기,성남시,16,1,1,18,14,0,2019-11-08
2747,경기,성남시,12,1,3,16,13,0,2019-12-08
2748,경기,수원시,9,1,3,13,9,0,2019-01-08
2749,경기,수원시,5,1,1,7,6,0,2019-02-08
2750,경기,수원시,13,2,2,17,12,0,2019-03-08
2751,경기,수원시,11,0,1,12,12,0,2019-04-08
2752,경기,수원시,11,4,3,18,10,0,2019-05-08
2753,경기,수원시,26,5,1,32,17,0,2019-06-08
2754,경기,수원시,6,2,2,10,8,0,2019-07-08
2755,경기,수원시,15,2,1,18,10,0,2019-08-08
2756,경기,수원시,12,2,1,15,12,0,2019-09-08
2757,경기,수원시,8,1,2,11,11,0,2019-10-08
2758,경기,수원시,14,0,5,19,17,0,2019-11-08
2759,경기,수원시,20,4,3,27,16,0,2019-12-08
2760,경기,시흥시,8,0,0,8,5,0,2019-01-08
2761,경기,시흥시,3,0,3,6,4,0,2019-02-08
2762,경기,시흥시,13,1,2,16,11,0,2019-03-08
2763,경기,시흥시,7,0,4,11,9,0,2019-04-08
2764,경기,시흥시,3,2,5,10,8,0,2019-05-08
2765,경기,시흥시,5,0,2,7,3,0,2019-06-08
2766,경기,시흥시,6,1,2,9,6,0,2019-07-08
2767,경기,시흥시,12,4,2,18,9,0,2019-08-08
2768,경기,시흥시,3,2,2,7,4,0,2019-09-08
2769,경기,시흥시,7,0,3,10,5,0,2019-10-08
2770,경기,시흥시,10,2,3,15,10,0,2019-11-08
2771,경기,시흥시,11,1,2,14,9,0,2019-12-08
2772,경기,안산시,19,0,4,23,15,0,2019-01-08
2773,경기,안산시,7,0,0,7,6,0,2019-02-08
2774,경기,안산시,26,2,4,32,20,0,2019-03-08
2775,경기,안산시,12,0,0,12,8,0,2019-04-08
2776,경기,안산시,14,0,0,14,11,0,2019-05-08
2777,경기,안산시,11,0,1,12,9,0,2019-06-08
2778,경기,안산시,5,2,1,8,6,0,2019-07-08
2779,경기,안산시,8,1,6,15,11,0,2019-08-08
2780,경기,안산시,10,0,7,17,10,0,2019-09-08
2781,경기,안산시,7,1,3,11,8,0,2019-10-08
2782,경기,안산시,20,2,2,24,15,1,2019-11-08
2783,경기,안산시,12,1,0,13,9,0,2019-12-08
2784,경기,안성시,2,1,2,5,4,1,2019-01-08
2785,경기,안성시,2,0,0,2,2,0,2019-02-08
2786,경기,안성시,13,8,1,22,5,0,2019-03-08
2787,경기,안성시,3,0,2,5,4,0,2019-04-08
2788,경기,안성시,1,0,1,2,2,0,2019-05-08
2789,경기,안성시,4,0,0,4,2,0,2019-06-08
2790,경기,안성시,2,0,0,2,1,0,2019-07-08
2791,경기,안성시,5,0,1,6,2,0,2019-08-08
2792,경기,안성시,3,0,1,4,4,0,2019-09-08
2793,경기,안성시,3,0,0,3,2,0,2019-10-08
2794,경기,안성시,9,2,0,11,5,0,2019-11-08
2795,경기,안성시,0,0,0,0,0,0,2019-12-08
2796,경기,안양시,4,0,3,7,5,0,2019-01-08
2797,경기,안양시,4,0,0,4,2,0,2019-02-08
2798,경기,안양시,10,3,3,16,9,0,2019-03-08
2799,경기,안양시,2,0,4,6,3,0,2019-04-08
2800,경기,안양시,6,1,1,8,5,0,2019-05-08
2801,경기,안양시,6,0,4,10,5,0,2019-06-08
2802,경기,안양시,4,0,2,6,3,0,2019-07-08
2803,경기,안양시,5,0,0,5,4,0,2019-08-08
2804,경기,안양시,3,0,4,7,7,1,2019-09-08
2805,경기,안양시,1,2,2,5,5,0,2019-10-08
2806,경기,안양시,6,0,4,10,7,0,2019-11-08
2807,경기,안양시,5,0,4,9,4,0,2019-12-08
2808,경기,양주시,1,1,2,4,3,0,2019-01-08
2809,경기,양주시,5,0,0,5,4,0,2019-02-08
2810,경기,양주시,0,1,1,2,2,0,2019-03-08
2811,경기,양주시,3,1,0,4,4,0,2019-04-08
2812,경기,양주시,1,0,1,2,2,0,2019-05-08
2813,경기,양주시,3,1,1,5,3,0,2019-06-08
2814,경기,양주시,2,0,1,3,2,0,2019-07-08
2815,경기,양주시,3,0,0,3,3,0,2019-08-08
2816,경기,양주시,0,1,1,2,2,0,2019-09-08
2817,경기,양주시,7,1,1,9,7,0,2019-10-08
2818,경기,양주시,0,0,0,0,0,0,2019-11-08
2819,경기,양주시,0,0,0,0,0,0,2019-12-08
2820,경기,양평군,1,0,1,2,3,1,2019-01-08
2821,경기,양평군,0,0,0,0,0,0,2019-02-08
2822,경기,양평군,0,0,0,0,0,0,2019-03-08
2823,경기,양평군,0,0,0,0,0,0,2019-04-08
2824,경기,양평군,1,1,0,2,2,0,2019-05-08
2825,경기,양평군,1,1,1,3,3,0,2019-06-08
2826,경기,양평군,0,0,0,0,0,0,2019-07-08
2827,경기,양평군,2,0,2,4,3,0,2019-08-08
2828,경기,양평군,0,1,0,1,1,0,2019-09-08
2829,경기,양평군,0,0,0,0,0,0,2019-10-08
2830,경기,양평군,2,2,1,5,5,0,2019-11-08
2831,경기,양평군,5,0,0,5,3,0,2019-12-08
2832,경기,여주시,0,0,0,0,0,0,2019-01-08
2833,경기,여주시,1,0,0,1,2,1,2019-02-08
2834,경기,여주시,0,0,0,0,0,0,2019-03-08
2835,경기,여주시,2,0,1,3,3,0,2019-04-08
2836,경기,여주시,0,0,0,0,0,0,2019-05-08
2837,경기,여주시,2,0,1,3,2,0,2019-06-08
2838,경기,여주시,2,0,0,2,1,0,2019-07-08
2839,경기,여주시,1,1,0,2,1,0,2019-08-08
2840,경기,여주시,1,0,1,2,2,0,2019-09-08
2841,경기,여주시,5,0,0,5,2,0,2019-10-08
2842,경기,여주시,1,0,0,1,1,0,2019-11-08
2843,경기,여주시,1,0,0,1,1,0,2019-12-08
2844,경기,연천군,0,0,0,0,0,0,2019-01-08
2845,경기,연천군,0,0,0,0,0,0,2019-02-08
2846,경기,연천군,0,0,0,0,0,0,2019-03-08
2847,경기,연천군,0,0,0,0,0,0,2019-04-08
2848,경기,연천군,0,0,1,1,1,0,2019-05-08
2849,경기,연천군,0,0,0,0,0,0,2019-06-08
2850,경기,연천군,0,0,0,0,0,0,2019-07-08
2851,경기,연천군,1,0,0,1,1,0,2019-08-08
2852,경기,연천군,0,0,0,0,0,0,2019-09-08
2853,경기,연천군,0,0,0,0,0,0,2019-10-08
2854,경기,연천군,0,0,0,0,0,0,2019-11-08
2855,경기,연천군,0,0,0,0,0,0,2019-12-08
2856,경기,오산시,2,0,1,3,2,0,2019-01-08
2857,경기,오산시,0,1,1,2,2,0,2019-02-08
2858,경기,오산시,4,0,0,4,3,0,2019-03-08
2859,경기,오산시,3,1,0,4,3,0,2019-04-08
2860,경기,오산시,10,1,3,14,6,0,2019-05-08
2861,경기,오산시,3,0,0,3,1,0,2019-06-08
2862,경기,오산시,3,1,1,5,4,0,2019-07-08
2863,경기,오산시,2,2,0,4,4,0,2019-08-08
2864,경기,오산시,10,0,0,10,4,0,2019-09-08
2865,경기,오산시,4,1,1,6,3,0,2019-10-08
2866,경기,오산시,1,1,1,3,3,0,2019-11-08
2867,경기,오산시,1,0,1,2,2,0,2019-12-08
2868,경기,용인시,1,0,5,6,3,0,2019-01-08
2869,경기,용인시,12,0,4,16,12,0,2019-02-08
2870,경기,용인시,13,1,8,22,15,0,2019-03-08
2871,경기,용인시,8,1,0,9,8,0,2019-04-08
2872,경기,용인시,8,1,3,12,10,0,2019-05-08
2873,경기,용인시,9,2,4,15,11,0,2019-06-08
2874,경기,용인시,9,1,2,12,8,0,2019-07-08
2875,경기,용인시,18,2,2,22,13,0,2019-08-08
2876,경기,용인시,5,0,5,10,9,0,2019-09-08
2877,경기,용인시,11,6,3,20,12,0,2019-10-08
2878,경기,용인시,17,1,0,18,10,1,2019-11-08
2879,경기,용인시,9,3,2,14,8,1,2019-12-08
2880,경기,의왕시,0,0,1,1,1,0,2019-01-08
2881,경기,의왕시,1,0,2,3,1,0,2019-02-08
2882,경기,의왕시,0,0,1,1,1,0,2019-03-08
2883,경기,의왕시,0,0,0,0,0,0,2019-04-08
2884,경기,의왕시,1,0,0,1,1,0,2019-05-08
2885,경기,의왕시,0,1,0,1,1,0,2019-06-08
2886,경기,의왕시,3,0,0,3,2,0,2019-07-08
2887,경기,의왕시,0,0,0,0,0,0,2019-08-08
2888,경기,의왕시,0,0,0,0,0,0,2019-09-08
2889,경기,의왕시,2,0,1,3,1,0,2019-10-08
2890,경기,의왕시,1,0,0,1,1,0,2019-11-08
2891,경기,의왕시,3,0,0,3,2,0,2019-12-08
2892,경기,의정부시,5,0,0,5,4,0,2019-01-08
2893,경기,의정부시,6,0,1,7,4,0,2019-02-08
2894,경기,의정부시,4,1,2,7,6,0,2019-03-08
2895,경기,의정부시,4,1,0,5,3,0,2019-04-08
2896,경기,의정부시,4,3,1,8,5,0,2019-05-08
2897,경기,의정부시,4,1,3,8,5,0,2019-06-08
2898,경기,의정부시,4,0,0,4,4,0,2019-07-08
2899,경기,의정부시,3,0,0,3,3,0,2019-08-08
2900,경기,의정부시,9,4,0,13,7,0,2019-09-08
2901,경기,의정부시,5,0,3,8,7,0,2019-10-08
2902,경기,의정부시,6,0,2,8,8,0,2019-11-08
2903,경기,의정부시,5,1,2,8,4,0,2019-12-08
2904,경기,이천시,2,0,0,2,2,0,2019-01-08
2905,경기,이천시,1,0,0,1,1,0,2019-02-08
2906,경기,이천시,4,0,0,4,3,0,2019-03-08
2907,경기,이천시,3,1,2,6,3,0,2019-04-08
2908,경기,이천시,5,0,6,11,7,0,2019-05-08
2909,경기,이천시,4,0,0,4,3,0,2019-06-08
2910,경기,이천시,1,0,0,1,1,0,2019-07-08
2911,경기,이천시,3,0,0,3,2,0,2019-08-08
2912,경기,이천시,2,0,0,2,2,0,2019-09-08
2913,경기,이천시,8,1,1,10,4,0,2019-10-08
2914,경기,이천시,5,0,1,6,6,2,2019-11-08
2915,경기,이천시,6,0,0,6,4,0,2019-12-08
2916,경기,파주시,3,0,1,4,2,0,2019-01-08
2917,경기,파주시,0,0,0,0,0,0,2019-02-08
2918,경기,파주시,0,0,0,0,0,0,2019-03-08
2919,경기,파주시,2,0,1,3,3,0,2019-04-08
2920,경기,파주시,0,0,0,0,0,0,2019-05-08
2921,경기,파주시,5,1,0,6,3,0,2019-06-08
2922,경기,파주시,5,0,0,5,5,0,2019-07-08
2923,경기,파주시,4,0,0,4,4,0,2019-08-08
2924,경기,파주시,8,1,1,10,6,0,2019-09-08
2925,경기,파주시,7,1,2,10,5,0,2019-10-08
2926,경기,파주시,3,1,2,6,3,0,2019-11-08
2927,경기,파주시,1,0,0,1,1,0,2019-12-08
2928,경기,평택시,4,2,1,7,8,1,2019-01-08
2929,경기,평택시,11,3,1,15,11,0,2019-02-08
2930,경기,평택시,4,5,1,10,6,0,2019-03-08
2931,경기,평택시,9,0,8,17,11,0,2019-04-08
2932,경기,평택시,24,5,4,33,17,0,2019-05-08
2933,경기,평택시,12,0,2,14,7,0,2019-06-08
2934,경기,평택시,0,0,3,3,2,0,2019-07-08
2935,경기,평택시,17,2,1,20,14,0,2019-08-08
2936,경기,평택시,1,3,4,8,5,0,2019-09-08
2937,경기,평택시,9,5,6,20,11,0,2019-10-08
2938,경기,평택시,7,0,2,9,7,0,2019-11-08
2939,경기,평택시,15,0,1,16,8,0,2019-12-08
2940,경기,포천시,3,0,0,3,2,0,2019-01-08
2941,경기,포천시,2,1,0,3,2,0,2019-02-08
2942,경기,포천시,1,0,1,2,2,0,2019-03-08
2943,경기,포천시,5,0,4,9,7,0,2019-04-08
2944,경기,포천시,0,0,1,1,2,1,2019-05-08
2945,경기,포천시,0,0,0,0,0,0,2019-06-08
2946,경기,포천시,1,2,1,4,2,0,2019-07-08
2947,경기,포천시,4,1,1,6,4,0,2019-08-08
2948,경기,포천시,0,1,1,2,2,0,2019-09-08
2949,경기,포천시,3,0,4,7,5,0,2019-10-08
2950,경기,포천시,4,0,2,6,6,0,2019-11-08
2951,경기,포천시,1,0,0,1,1,0,2019-12-08
2952,경기,하남시,1,0,3,4,2,0,2019-01-08
2953,경기,하남시,1,0,1,2,2,0,2019-02-08
2954,경기,하남시,1,0,0,1,1,0,2019-03-08
2955,경기,하남시,2,0,1,3,3,0,2019-04-08
2956,경기,하남시,1,1,0,2,2,0,2019-05-08
2957,경기,하남시,3,0,0,3,2,0,2019-06-08
2958,경기,하남시,3,2,1,6,6,0,2019-07-08
2959,경기,하남시,4,0,1,5,4,0,2019-08-08
2960,경기,하남시,7,0,1,8,4,0,2019-09-08
2961,경기,하남시,2,1,2,5,3,0,2019-10-08
2962,경기,하남시,2,0,1,3,3,0,2019-11-08
2963,경기,하남시,3,1,0,4,2,0,2019-12-08
2964,경기,화성시,14,1,1,16,9,0,2019-01-08
2965,경기,화성시,3,0,1,4,4,0,2019-02-08
2966,경기,화성시,11,0,2,13,9,1,2019-03-08
2967,경기,화성시,6,1,1,8,8,1,2019-04-08
2968,경기,화성시,7,1,4,12,8,0,2019-05-08
2969,경기,화성시,6,3,5,14,10,1,2019-06-08
2970,경기,화성시,7,0,3,10,9,0,2019-07-08
2971,경기,화성시,4,0,0,4,3,0,2019-08-08
2972,경기,화성시,6,0,3,9,6,0,2019-09-08
2973,경기,화성시,22,1,6,29,11,0,2019-10-08
2974,경기,화성시,7,1,0,8,6,0,2019-11-08
2975,경기,화성시,2,2,4,8,5,0,2019-12-08
2976,경기,가평군,0,0,2,2,1,0,2019-01-09
2977,경기,가평군,2,0,0,2,2,0,2019-02-09
2978,경기,가평군,1,0,0,1,1,0,2019-03-09
2979,경기,가평군,0,0,0,0,0,0,2019-04-09
2980,경기,가평군,1,0,0,1,1,0,2019-05-09
2981,경기,가평군,0,0,0,0,0,0,2019-06-09
2982,경기,가평군,1,0,0,1,1,0,2019-07-09
2983,경기,가평군,6,0,1,7,4,0,2019-08-09
2984,경기,가평군,0,0,0,0,0,0,2019-09-09
2985,경기,가평군,0,0,0,0,0,0,2019-10-09
2986,경기,가평군,1,0,0,1,1,0,2019-11-09
2987,경기,가평군,0,0,0,0,0,0,2019-12-09
2988,경기,고양시,12,3,3,18,16,0,2019-01-09
2989,경기,고양시,18,0,1,19,9,0,2019-02-09
2990,경기,고양시,4,2,1,7,5,0,2019-03-09
2991,경기,고양시,10,2,0,12,10,0,2019-04-09
2992,경기,고양시,13,3,4,20,13,0,2019-05-09
2993,경기,고양시,11,0,3,14,6,0,2019-06-09
2994,경기,고양시,12,9,4,25,19,0,2019-07-09
2995,경기,고양시,12,1,4,17,12,0,2019-08-09
2996,경기,고양시,14,2,3,19,13,0,2019-09-09
2997,경기,고양시,7,4,1,12,9,0,2019-10-09
2998,경기,고양시,22,1,4,27,14,0,2019-11-09
2999,경기,고양시,12,2,2,16,13,0,2019-12-09
3000,경기,과천시,0,0,0,0,0,0,2019-01-09
3001,경기,과천시,3,0,0,3,1,0,2019-02-09
3002,경기,과천시,0,0,1,1,1,0,2019-03-09
3003,경기,과천시,0,0,0,0,0,0,2019-04-09
3004,경기,과천시,0,0,0,0,0,0,2019-05-09
3005,경기,과천시,0,0,0,0,0,0,2019-06-09
3006,경기,과천시,1,0,0,1,1,0,2019-07-09
3007,경기,과천시,1,0,0,1,1,0,2019-08-09
3008,경기,과천시,1,0,0,1,1,0,2019-09-09
3009,경기,과천시,0,0,0,0,0,0,2019-10-09
3010,경기,과천시,2,1,1,4,2,0,2019-11-09
3011,경기,과천시,1,0,0,1,1,0,2019-12-09
3012,경기,광명시,2,2,1,5,5,0,2019-01-09
3013,경기,광명시,2,1,1,4,4,0,2019-02-09
3014,경기,광명시,2,0,0,2,2,0,2019-03-09
3015,경기,광명시,1,0,1,2,2,0,2019-04-09
3016,경기,광명시,1,0,0,1,1,0,2019-05-09
3017,경기,광명시,2,3,1,6,3,0,2019-06-09
3018,경기,광명시,1,1,4,6,4,0,2019-07-09
3019,경기,광명시,3,2,4,9,5,0,2019-08-09
3020,경기,광명시,2,4,1,7,4,0,2019-09-09
3021,경기,광명시,3,1,1,5,5,0,2019-10-09
3022,경기,광명시,2,0,2,4,3,0,2019-11-09
3023,경기,광명시,2,0,0,2,2,0,2019-12-09
3024,경기,광주시,2,0,2,4,4,0,2019-01-09
3025,경기,광주시,6,3,0,9,5,0,2019-02-09
3026,경기,광주시,5,0,0,5,3,0,2019-03-09
3027,경기,광주시,5,0,0,5,4,0,2019-04-09
3028,경기,광주시,9,1,1,11,9,1,2019-05-09
3029,경기,광주시,3,0,0,3,2,0,2019-06-09
3030,경기,광주시,8,1,1,10,6,0,2019-07-09
3031,경기,광주시,24,2,1,27,12,0,2019-08-09
3032,경기,광주시,5,3,1,9,9,0,2019-09-09
3033,경기,광주시,8,0,2,10,7,0,2019-10-09
3034,경기,광주시,7,0,0,7,4,0,2019-11-09
3035,경기,광주시,5,1,1,7,5,0,2019-12-09
3036,경기,구리시,1,0,1,2,2,0,2019-01-09
3037,경기,구리시,2,0,1,3,2,0,2019-02-09
3038,경기,구리시,5,0,0,5,2,0,2019-03-09
3039,경기,구리시,1,0,0,1,1,0,2019-04-09
3040,경기,구리시,5,1,1,7,3,0,2019-05-09
3041,경기,구리시,1,0,0,1,1,0,2019-06-09
3042,경기,구리시,0,1,1,2,2,0,2019-07-09
3043,경기,구리시,5,0,0,5,2,0,2019-08-09
3044,경기,구리시,1,0,0,1,1,0,2019-09-09
3045,경기,구리시,8,0,0,8,3,0,2019-10-09
3046,경기,구리시,2,0,0,2,2,0,2019-11-09
3047,경기,구리시,1,1,0,2,2,0,2019-12-09
3048,경기,군포시,3,1,0,4,3,0,2019-01-09
3049,경기,군포시,0,0,0,0,0,0,2019-02-09
3050,경기,군포시,1,0,0,1,1,0,2019-03-09
3051,경기,군포시,2,0,1,3,3,0,2019-04-09
3052,경기,군포시,0,0,1,1,1,0,2019-05-09
3053,경기,군포시,1,0,1,2,2,0,2019-06-09
3054,경기,군포시,3,0,0,3,2,0,2019-07-09
3055,경기,군포시,1,0,0,1,1,0,2019-08-09
3056,경기,군포시,4,0,0,4,3,0,2019-09-09
3057,경기,군포시,0,0,0,0,0,0,2019-10-09
3058,경기,군포시,0,0,0,0,0,0,2019-11-09
3059,경기,군포시,1,0,0,1,1,0,2019-12-09
3060,경기,김포시,6,0,1,7,4,0,2019-01-09
3061,경기,김포시,1,0,1,2,2,0,2019-02-09
3062,경기,김포시,1,1,3,5,3,0,2019-03-09
3063,경기,김포시,6,0,2,8,6,0,2019-04-09
3064,경기,김포시,2,2,0,4,4,0,2019-05-09
3065,경기,김포시,1,0,0,1,1,0,2019-06-09
3066,경기,김포시,8,0,0,8,3,0,2019-07-09
3067,경기,김포시,15,0,8,23,16,1,2019-08-09
3068,경기,김포시,6,0,0,6,5,0,2019-09-09
3069,경기,김포시,13,0,1,14,6,0,2019-10-09
3070,경기,김포시,3,1,0,4,3,0,2019-11-09
3071,경기,김포시,1,0,0,1,1,0,2019-12-09
3072,경기,남양주시,6,0,1,7,6,0,2019-01-09
3073,경기,남양주시,4,0,2,6,5,0,2019-02-09
3074,경기,남양주시,8,0,2,10,7,0,2019-03-09
3075,경기,남양주시,18,1,5,24,13,1,2019-04-09
3076,경기,남양주시,7,0,3,10,8,0,2019-05-09
3077,경기,남양주시,2,1,2,5,3,0,2019-06-09
3078,경기,남양주시,9,0,3,12,9,0,2019-07-09
3079,경기,남양주시,5,0,2,7,6,0,2019-08-09
3080,경기,남양주시,2,0,1,3,3,0,2019-09-09
3081,경기,남양주시,6,4,1,11,9,0,2019-10-09
3082,경기,남양주시,11,0,1,12,7,0,2019-11-09
3083,경기,남양주시,9,3,2,14,12,0,2019-12-09
3084,경기,동두천시,0,0,0,0,0,0,2019-01-09
3085,경기,동두천시,0,0,0,0,0,0,2019-02-09
3086,경기,동두천시,1,0,0,1,1,0,2019-03-09
3087,경기,동두천시,0,0,0,0,0,0,2019-04-09
3088,경기,동두천시,2,1,1,4,2,0,2019-05-09
3089,경기,동두천시,0,0,0,0,1,1,2019-06-09
3090,경기,동두천시,1,0,0,1,1,0,2019-07-09
3091,경기,동두천시,1,0,0,1,1,0,2019-08-09
3092,경기,동두천시,0,0,0,0,0,0,2019-09-09
3093,경기,동두천시,0,0,0,0,0,0,2019-10-09
3094,경기,동두천시,0,0,0,0,0,0,2019-11-09
3095,경기,동두천시,1,1,0,2,1,0,2019-12-09
3096,경기,부천시,3,0,3,6,6,0,2019-01-09
3097,경기,부천시,11,1,0,12,7,0,2019-02-09
3098,경기,부천시,7,1,5,13,12,0,2019-03-09
3099,경기,부천시,24,0,5,29,20,0,2019-04-09
3100,경기,부천시,13,1,5,19,14,0,2019-05-09
3101,경기,부천시,3,1,2,6,5,0,2019-06-09
3102,경기,부천시,13,0,2,15,10,0,2019-07-09
3103,경기,부천시,5,1,4,10,8,0,2019-08-09
3104,경기,부천시,8,2,4,14,10,0,2019-09-09
3105,경기,부천시,13,0,2,15,9,0,2019-10-09
3106,경기,부천시,10,0,0,10,10,0,2019-11-09
3107,경기,부천시,9,0,2,11,8,0,2019-12-09
3108,경기,성남시,12,4,2,18,12,0,2019-01-09
3109,경기,성남시,9,0,3,12,6,0,2019-02-09
3110,경기,성남시,12,1,2,15,9,1,2019-03-09
3111,경기,성남시,15,0,1,16,12,0,2019-04-09
3112,경기,성남시,20,2,3,25,17,0,2019-05-09
3113,경기,성남시,5,1,3,9,8,0,2019-06-09
3114,경기,성남시,6,1,2,9,7,0,2019-07-09
3115,경기,성남시,15,0,7,22,14,0,2019-08-09
3116,경기,성남시,25,4,13,42,21,0,2019-09-09
3117,경기,성남시,5,2,0,7,7,1,2019-10-09
3118,경기,성남시,10,2,2,14,9,0,2019-11-09
3119,경기,성남시,12,4,8,24,18,0,2019-12-09
3120,경기,수원시,12,0,3,15,14,0,2019-01-09
3121,경기,수원시,14,2,4,20,10,0,2019-02-09
3122,경기,수원시,13,0,3,16,12,0,2019-03-09
3123,경기,수원시,14,0,2,16,14,0,2019-04-09
3124,경기,수원시,11,1,2,14,11,0,2019-05-09
3125,경기,수원시,8,1,0,9,8,0,2019-06-09
3126,경기,수원시,12,0,4,16,10,0,2019-07-09
3127,경기,수원시,16,2,3,21,19,0,2019-08-09
3128,경기,수원시,21,1,3,25,14,0,2019-09-09
3129,경기,수원시,20,0,4,24,11,0,2019-10-09
3130,경기,수원시,23,3,6,32,20,0,2019-11-09
3131,경기,수원시,12,3,1,16,14,0,2019-12-09
3132,경기,시흥시,8,1,2,11,7,0,2019-01-09
3133,경기,시흥시,2,0,2,4,4,0,2019-02-09
3134,경기,시흥시,6,1,5,12,7,0,2019-03-09
3135,경기,시흥시,13,2,3,18,9,0,2019-04-09
3136,경기,시흥시,7,1,0,8,5,0,2019-05-09
3137,경기,시흥시,10,5,0,15,6,0,2019-06-09
3138,경기,시흥시,7,1,0,8,5,0,2019-07-09
3139,경기,시흥시,4,0,4,8,8,0,2019-08-09
3140,경기,시흥시,6,1,2,9,7,0,2019-09-09
3141,경기,시흥시,5,0,2,7,6,0,2019-10-09
3142,경기,시흥시,11,1,0,12,7,0,2019-11-09
3143,경기,시흥시,7,2,2,11,5,0,2019-12-09
3144,경기,안산시,11,3,3,17,12,0,2019-01-09
3145,경기,안산시,8,1,2,11,6,0,2019-02-09
3146,경기,안산시,12,0,0,12,6,0,2019-03-09
3147,경기,안산시,11,1,1,13,8,0,2019-04-09
3148,경기,안산시,18,0,4,22,17,0,2019-05-09
3149,경기,안산시,13,0,3,16,10,0,2019-06-09
3150,경기,안산시,9,1,0,10,7,0,2019-07-09
3151,경기,안산시,7,3,1,11,9,0,2019-08-09
3152,경기,안산시,17,2,3,22,15,1,2019-09-09
3153,경기,안산시,17,2,4,23,10,0,2019-10-09
3154,경기,안산시,10,2,2,14,9,0,2019-11-09
3155,경기,안산시,10,1,1,12,10,0,2019-12-09
3156,경기,안성시,0,0,0,0,0,0,2019-01-09
3157,경기,안성시,6,0,0,6,4,0,2019-02-09
3158,경기,안성시,12,2,0,14,7,0,2019-03-09
3159,경기,안성시,0,1,0,1,1,0,2019-04-09
3160,경기,안성시,7,0,0,7,5,0,2019-05-09
3161,경기,안성시,0,0,0,0,0,0,2019-06-09
3162,경기,안성시,5,0,4,9,4,0,2019-07-09
3163,경기,안성시,10,1,1,12,5,0,2019-08-09
3164,경기,안성시,0,1,1,2,2,0,2019-09-09
3165,경기,안성시,3,0,0,3,1,0,2019-10-09
3166,경기,안성시,4,0,1,5,3,0,2019-11-09
3167,경기,안성시,0,0,2,2,2,0,2019-12-09
3168,경기,안양시,4,0,1,5,5,0,2019-01-09
3169,경기,안양시,5,0,2,7,6,0,2019-02-09
3170,경기,안양시,3,0,3,6,7,1,2019-03-09
3171,경기,안양시,7,0,1,8,8,1,2019-04-09
3172,경기,안양시,3,1,3,7,6,0,2019-05-09
3173,경기,안양시,3,0,1,4,2,0,2019-06-09
3174,경기,안양시,3,0,3,6,5,0,2019-07-09
3175,경기,안양시,14,18,2,34,6,0,2019-08-09
3176,경기,안양시,2,1,0,3,3,0,2019-09-09
3177,경기,안양시,6,1,1,8,5,0,2019-10-09
3178,경기,안양시,4,0,3,7,6,0,2019-11-09
3179,경기,안양시,9,0,0,9,8,0,2019-12-09
3180,경기,양주시,2,0,0,2,2,0,2019-01-09
3181,경기,양주시,6,0,0,6,3,0,2019-02-09
3182,경기,양주시,4,1,1,6,4,0,2019-03-09
3183,경기,양주시,8,1,1,10,5,0,2019-04-09
3184,경기,양주시,1,0,0,1,1,0,2019-05-09
3185,경기,양주시,1,1,2,4,3,0,2019-06-09
3186,경기,양주시,5,0,4,9,8,0,2019-07-09
3187,경기,양주시,2,0,0,2,2,0,2019-08-09
3188,경기,양주시,1,0,0,1,1,0,2019-09-09
3189,경기,양주시,1,0,2,3,3,0,2019-10-09
3190,경기,양주시,19,0,2,21,9,1,2019-11-09
3191,경기,양주시,5,0,1,6,3,0,2019-12-09
3192,경기,양평군,2,0,0,2,2,0,2019-01-09
3193,경기,양평군,1,0,1,2,1,0,2019-02-09
3194,경기,양평군,3,1,1,5,4,1,2019-03-09
3195,경기,양평군,2,0,1,3,2,0,2019-04-09
3196,경기,양평군,0,0,0,0,0,0,2019-05-09
3197,경기,양평군,10,2,0,12,4,1,2019-06-09
3198,경기,양평군,1,1,0,2,2,0,2019-07-09
3199,경기,양평군,0,0,0,0,0,0,2019-08-09
3200,경기,양평군,2,1,0,3,1,0,2019-09-09
3201,경기,양평군,0,0,0,0,0,0,2019-10-09
3202,경기,양평군,4,0,1,5,3,0,2019-11-09
3203,경기,양평군,1,0,2,3,2,0,2019-12-09
3204,경기,여주시,4,0,0,4,2,0,2019-01-09
3205,경기,여주시,2,0,0,2,2,0,2019-02-09
3206,경기,여주시,0,0,0,0,0,0,2019-03-09
3207,경기,여주시,1,0,0,1,1,0,2019-04-09
3208,경기,여주시,0,0,1,1,1,0,2019-05-09
3209,경기,여주시,0,0,0,0,0,0,2019-06-09
3210,경기,여주시,2,1,1,4,3,0,2019-07-09
3211,경기,여주시,1,0,0,1,1,0,2019-08-09
3212,경기,여주시,3,0,0,3,2,0,2019-09-09
3213,경기,여주시,0,0,0,0,0,0,2019-10-09
3214,경기,여주시,0,0,1,1,1,0,2019-11-09
3215,경기,여주시,1,0,0,1,1,0,2019-12-09
3216,경기,연천군,0,0,0,0,0,0,2019-01-09
3217,경기,연천군,0,0,0,0,0,0,2019-02-09
3218,경기,연천군,0,0,0,0,0,0,2019-03-09
3219,경기,연천군,1,0,0,1,1,0,2019-04-09
3220,경기,연천군,0,0,0,0,0,0,2019-05-09
3221,경기,연천군,0,0,0,0,0,0,2019-06-09
3222,경기,연천군,0,0,0,0,0,0,2019-07-09
3223,경기,연천군,1,2,0,3,1,0,2019-08-09
3224,경기,연천군,0,0,0,0,0,0,2019-09-09
3225,경기,연천군,0,0,0,0,0,0,2019-10-09
3226,경기,연천군,0,0,1,1,1,0,2019-11-09
3227,경기,연천군,0,0,0,0,0,0,2019-12-09
3228,경기,오산시,4,0,0,4,3,0,2019-01-09
3229,경기,오산시,2,0,0,2,2,0,2019-02-09
3230,경기,오산시,3,0,0,3,2,0,2019-03-09
3231,경기,오산시,6,1,1,8,5,0,2019-04-09
3232,경기,오산시,0,0,0,0,1,1,2019-05-09
3233,경기,오산시,4,0,1,5,2,0,2019-06-09
3234,경기,오산시,0,0,1,1,1,0,2019-07-09
3235,경기,오산시,4,0,0,4,3,0,2019-08-09
3236,경기,오산시,2,0,0,2,2,0,2019-09-09
3237,경기,오산시,14,2,1,17,9,0,2019-10-09
3238,경기,오산시,3,0,1,4,2,0,2019-11-09
3239,경기,오산시,1,0,1,2,2,0,2019-12-09
3240,경기,용인시,6,1,3,10,8,0,2019-01-09
3241,경기,용인시,4,1,0,5,3,0,2019-02-09
3242,경기,용인시,6,4,4,14,8,0,2019-03-09
3243,경기,용인시,11,2,6,19,14,0,2019-04-09
3244,경기,용인시,8,0,2,10,5,0,2019-05-09
3245,경기,용인시,5,7,0,12,8,0,2019-06-09
3246,경기,용인시,22,0,4,26,11,0,2019-07-09
3247,경기,용인시,21,1,2,24,12,0,2019-08-09
3248,경기,용인시,10,0,2,12,12,0,2019-09-09
3249,경기,용인시,8,1,2,11,6,0,2019-10-09
3250,경기,용인시,19,0,0,19,12,0,2019-11-09
3251,경기,용인시,12,0,1,13,13,0,2019-12-09
3252,경기,의왕시,0,0,1,1,1,0,2019-01-09
3253,경기,의왕시,1,0,0,1,1,0,2019-02-09
3254,경기,의왕시,8,1,2,11,3,0,2019-03-09
3255,경기,의왕시,0,0,0,0,0,0,2019-04-09
3256,경기,의왕시,1,0,1,2,2,0,2019-05-09
3257,경기,의왕시,0,0,0,0,0,0,2019-06-09
3258,경기,의왕시,0,0,0,0,0,0,2019-07-09
3259,경기,의왕시,4,1,0,5,2,0,2019-08-09
3260,경기,의왕시,3,0,0,3,3,0,2019-09-09
3261,경기,의왕시,0,0,0,0,0,0,2019-10-09
3262,경기,의왕시,3,2,0,5,2,0,2019-11-09
3263,경기,의왕시,7,1,0,8,2,0,2019-12-09
3264,경기,의정부시,8,0,1,9,6,0,2019-01-09
3265,경기,의정부시,1,1,1,3,3,0,2019-02-09
3266,경기,의정부시,4,1,0,5,4,0,2019-03-09
3267,경기,의정부시,5,1,0,6,5,0,2019-04-09
3268,경기,의정부시,4,1,0,5,4,0,2019-05-09
3269,경기,의정부시,0,0,1,1,1,0,2019-06-09
3270,경기,의정부시,2,0,1,3,3,0,2019-07-09
3271,경기,의정부시,3,0,0,3,3,0,2019-08-09
3272,경기,의정부시,4,2,2,8,6,0,2019-09-09
3273,경기,의정부시,4,0,3,7,6,0,2019-10-09
3274,경기,의정부시,7,1,2,10,6,0,2019-11-09
3275,경기,의정부시,2,0,1,3,3,0,2019-12-09
3276,경기,이천시,0,1,1,2,1,0,2019-01-09
3277,경기,이천시,0,0,0,0,0,0,2019-02-09
3278,경기,이천시,3,0,0,3,3,0,2019-03-09
3279,경기,이천시,5,0,0,5,2,0,2019-04-09
3280,경기,이천시,6,0,2,8,7,0,2019-05-09
3281,경기,이천시,0,0,0,0,0,0,2019-06-09
3282,경기,이천시,10,0,2,12,7,0,2019-07-09
3283,경기,이천시,3,0,0,3,1,0,2019-08-09
3284,경기,이천시,2,0,1,3,3,0,2019-09-09
3285,경기,이천시,3,0,5,8,6,0,2019-10-09
3286,경기,이천시,13,0,0,13,6,0,2019-11-09
3287,경기,이천시,0,1,3,4,3,0,2019-12-09
3288,경기,파주시,3,1,0,4,2,0,2019-01-09
3289,경기,파주시,4,0,1,5,4,0,2019-02-09
3290,경기,파주시,15,1,4,20,10,0,2019-03-09
3291,경기,파주시,5,0,1,6,5,0,2019-04-09
3292,경기,파주시,6,0,0,6,4,0,2019-05-09
3293,경기,파주시,0,1,0,1,1,0,2019-06-09
3294,경기,파주시,1,2,1,4,4,0,2019-07-09
3295,경기,파주시,3,0,1,4,4,0,2019-08-09
3296,경기,파주시,2,0,4,6,4,0,2019-09-09
3297,경기,파주시,15,0,5,20,8,0,2019-10-09
3298,경기,파주시,18,0,8,26,12,0,2019-11-09
3299,경기,파주시,4,0,3,7,7,0,2019-12-09
3300,경기,평택시,11,0,2,13,10,0,2019-01-09
3301,경기,평택시,5,4,3,12,6,1,2019-02-09
3302,경기,평택시,12,14,4,30,18,0,2019-03-09
3303,경기,평택시,15,3,8,26,19,1,2019-04-09
3304,경기,평택시,4,1,3,8,7,0,2019-05-09
3305,경기,평택시,3,1,2,6,4,1,2019-06-09
3306,경기,평택시,16,0,2,18,12,0,2019-07-09
3307,경기,평택시,8,1,4,13,8,0,2019-08-09
3308,경기,평택시,18,3,2,23,12,0,2019-09-09
3309,경기,평택시,17,2,2,21,15,1,2019-10-09
3310,경기,평택시,27,1,5,33,15,0,2019-11-09
3311,경기,평택시,4,0,1,5,4,0,2019-12-09
3312,경기,포천시,5,0,0,5,4,0,2019-01-09
3313,경기,포천시,3,0,1,4,2,0,2019-02-09
3314,경기,포천시,0,0,0,0,0,0,2019-03-09
3315,경기,포천시,7,0,0,7,2,0,2019-04-09
3316,경기,포천시,2,0,0,2,1,0,2019-05-09
3317,경기,포천시,6,0,0,6,4,0,2019-06-09
3318,경기,포천시,1,1,2,4,3,0,2019-07-09
3319,경기,포천시,8,0,1,9,4,0,2019-08-09
3320,경기,포천시,0,0,1,1,1,0,2019-09-09
3321,경기,포천시,1,0,0,1,1,0,2019-10-09
3322,경기,포천시,13,4,2,19,4,0,2019-11-09
3323,경기,포천시,1,0,0,1,1,0,2019-12-09
3324,경기,하남시,3,0,0,3,1,0,2019-01-09
3325,경기,하남시,1,0,0,1,1,0,2019-02-09
3326,경기,하남시,6,0,2,8,6,0,2019-03-09
3327,경기,하남시,2,1,1,4,2,0,2019-04-09
3328,경기,하남시,6,0,2,8,5,0,2019-05-09
3329,경기,하남시,1,0,2,3,3,0,2019-06-09
3330,경기,하남시,6,2,0,8,5,0,2019-07-09
3331,경기,하남시,0,0,0,0,0,0,2019-08-09
3332,경기,하남시,3,1,3,7,4,0,2019-09-09
3333,경기,하남시,6,5,2,13,7,0,2019-10-09
3334,경기,하남시,7,0,0,7,4,0,2019-11-09
3335,경기,하남시,7,0,0,7,5,0,2019-12-09
3336,경기,화성시,1,1,6,8,8,1,2019-01-09
3337,경기,화성시,8,2,1,11,7,0,2019-02-09
3338,경기,화성시,9,0,5,14,8,0,2019-03-09
3339,경기,화성시,9,0,3,12,10,0,2019-04-09
3340,경기,화성시,13,0,4,17,11,0,2019-05-09
3341,경기,화성시,11,1,1,13,6,0,2019-06-09
3342,경기,화성시,14,0,4,18,11,0,2019-07-09
3343,경기,화성시,11,0,1,12,10,0,2019-08-09
3344,경기,화성시,3,2,0,5,4,0,2019-09-09
3345,경기,화성시,7,0,2,9,5,0,2019-10-09
3346,경기,화성시,18,3,5,26,8,0,2019-11-09
3347,경기,화성시,19,1,4,24,9,0,2019-12-09
3348,경기,가평군,3,1,2,6,1,0,2019-01-10
3349,경기,가평군,4,0,1,5,3,0,2019-02-10
3350,경기,가평군,0,0,1,1,1,0,2019-03-10
3351,경기,가평군,0,0,0,0,0,0,2019-04-10
3352,경기,가평군,0,0,0,0,0,0,2019-05-10
3353,경기,가평군,2,0,0,2,1,0,2019-06-10
3354,경기,가평군,1,0,0,1,1,0,2019-07-10
3355,경기,가평군,6,0,10,16,5,0,2019-08-10
3356,경기,가평군,0,0,1,1,1,0,2019-09-10
3357,경기,가평군,0,0,1,1,1,0,2019-10-10
3358,경기,가평군,2,0,0,2,1,0,2019-11-10
3359,경기,가평군,2,0,0,2,2,0,2019-12-10
3360,경기,고양시,12,1,4,17,10,1,2019-01-10
3361,경기,고양시,4,0,4,8,6,0,2019-02-10
3362,경기,고양시,6,0,1,7,5,0,2019-03-10
3363,경기,고양시,5,0,2,7,6,0,2019-04-10
3364,경기,고양시,16,0,3,19,14,0,2019-05-10
3365,경기,고양시,14,1,2,17,13,1,2019-06-10
3366,경기,고양시,10,3,2,15,9,0,2019-07-10
3367,경기,고양시,22,2,2,26,16,0,2019-08-10
3368,경기,고양시,20,3,4,27,21,0,2019-09-10
3369,경기,고양시,12,2,4,18,16,1,2019-10-10
3370,경기,고양시,10,1,7,18,12,0,2019-11-10
3371,경기,고양시,20,2,2,24,13,0,2019-12-10
3372,경기,과천시,0,0,0,0,0,0,2019-01-10
3373,경기,과천시,0,0,0,0,0,0,2019-02-10
3374,경기,과천시,0,0,0,0,0,0,2019-03-10
3375,경기,과천시,0,0,0,0,0,0,2019-04-10
3376,경기,과천시,0,0,0,0,0,0,2019-05-10
3377,경기,과천시,0,0,0,0,0,0,2019-06-10
3378,경기,과천시,4,0,1,5,3,0,2019-07-10
3379,경기,과천시,2,1,0,3,2,0,2019-08-10
3380,경기,과천시,0,0,0,0,0,0,2019-09-10
3381,경기,과천시,2,0,0,2,2,0,2019-10-10
3382,경기,과천시,3,0,0,3,1,0,2019-11-10
3383,경기,과천시,1,0,0,1,1,0,2019-12-10
3384,경기,광명시,2,0,0,2,1,0,2019-01-10
3385,경기,광명시,4,1,0,5,3,0,2019-02-10
3386,경기,광명시,0,1,1,2,2,0,2019-03-10
3387,경기,광명시,1,0,4,5,5,1,2019-04-10
3388,경기,광명시,8,0,1,9,7,0,2019-05-10
3389,경기,광명시,1,0,0,1,1,0,2019-06-10
3390,경기,광명시,7,2,0,9,3,0,2019-07-10
3391,경기,광명시,0,0,3,3,2,0,2019-08-10
3392,경기,광명시,0,0,0,0,0,0,2019-09-10
3393,경기,광명시,3,0,2,5,5,0,2019-10-10
3394,경기,광명시,0,0,0,0,0,0,2019-11-10
3395,경기,광명시,0,0,1,1,1,0,2019-12-10
3396,경기,광주시,8,0,0,8,5,0,2019-01-10
3397,경기,광주시,0,0,0,0,0,0,2019-02-10
3398,경기,광주시,9,0,0,9,2,0,2019-03-10
3399,경기,광주시,5,0,1,6,4,0,2019-04-10
3400,경기,광주시,5,0,2,7,6,0,2019-05-10
3401,경기,광주시,2,1,0,3,2,0,2019-06-10
3402,경기,광주시,8,0,1,9,5,0,2019-07-10
3403,경기,광주시,4,1,1,6,5,0,2019-08-10
3404,경기,광주시,2,0,2,4,4,0,2019-09-10
3405,경기,광주시,11,2,6,19,10,0,2019-10-10
3406,경기,광주시,7,0,2,9,6,0,2019-11-10
3407,경기,광주시,3,0,0,3,3,0,2019-12-10
3408,경기,구리시,2,0,0,2,2,0,2019-01-10
3409,경기,구리시,0,0,0,0,0,0,2019-02-10
3410,경기,구리시,0,0,0,0,0,0,2019-03-10
3411,경기,구리시,3,0,0,3,2,0,2019-04-10
3412,경기,구리시,1,0,1,2,2,0,2019-05-10
3413,경기,구리시,3,0,1,4,2,0,2019-06-10
3414,경기,구리시,0,0,0,0,0,0,2019-07-10
3415,경기,구리시,2,0,1,3,3,0,2019-08-10
3416,경기,구리시,2,0,1,3,3,0,2019-09-10
3417,경기,구리시,2,0,1,3,3,0,2019-10-10
3418,경기,구리시,2,0,0,2,2,0,2019-11-10
3419,경기,구리시,1,0,1,2,2,0,2019-12-10
3420,경기,군포시,4,0,0,4,2,0,2019-01-10
3421,경기,군포시,0,1,0,1,1,0,2019-02-10
3422,경기,군포시,1,0,0,1,1,0,2019-03-10
3423,경기,군포시,1,0,0,1,1,0,2019-04-10
3424,경기,군포시,2,0,0,2,2,0,2019-05-10
3425,경기,군포시,0,1,0,1,1,0,2019-06-10
3426,경기,군포시,3,0,3,6,4,0,2019-07-10
3427,경기,군포시,8,3,2,13,5,0,2019-08-10
3428,경기,군포시,4,0,0,4,3,0,2019-09-10
3429,경기,군포시,8,3,3,14,5,0,2019-10-10
3430,경기,군포시,1,0,0,1,1,0,2019-11-10
3431,경기,군포시,2,0,0,2,1,0,2019-12-10
3432,경기,김포시,5,0,7,12,6,0,2019-01-10
3433,경기,김포시,3,0,0,3,1,0,2019-02-10
3434,경기,김포시,2,0,1,3,1,0,2019-03-10
3435,경기,김포시,4,1,2,7,6,0,2019-04-10
3436,경기,김포시,2,1,3,6,5,0,2019-05-10
3437,경기,김포시,4,1,0,5,5,0,2019-06-10
3438,경기,김포시,7,2,2,11,7,0,2019-07-10
3439,경기,김포시,10,0,2,12,6,0,2019-08-10
3440,경기,김포시,8,0,0,8,5,0,2019-09-10
3441,경기,김포시,10,0,3,13,7,0,2019-10-10
3442,경기,김포시,2,0,0,2,1,0,2019-11-10
3443,경기,김포시,4,0,1,5,2,0,2019-12-10
3444,경기,남양주시,5,0,2,7,5,0,2019-01-10
3445,경기,남양주시,3,2,0,5,3,0,2019-02-10
3446,경기,남양주시,6,1,2,9,6,0,2019-03-10
3447,경기,남양주시,7,3,2,12,9,0,2019-04-10
3448,경기,남양주시,9,0,2,11,9,0,2019-05-10
3449,경기,남양주시,4,1,2,7,6,0,2019-06-10
3450,경기,남양주시,9,1,3,13,9,0,2019-07-10
3451,경기,남양주시,6,0,3,9,8,0,2019-08-10
3452,경기,남양주시,7,2,1,10,7,0,2019-09-10
3453,경기,남양주시,16,0,2,18,12,0,2019-10-10
3454,경기,남양주시,7,3,1,11,6,0,2019-11-10
3455,경기,남양주시,6,1,1,8,6,0,2019-12-10
3456,경기,동두천시,2,1,0,3,3,0,2019-01-10
3457,경기,동두천시,3,0,0,3,1,0,2019-02-10
3458,경기,동두천시,0,0,0,0,1,1,2019-03-10
3459,경기,동두천시,2,0,1,3,2,0,2019-04-10
3460,경기,동두천시,1,0,0,1,1,0,2019-05-10
3461,경기,동두천시,2,0,1,3,2,0,2019-06-10
3462,경기,동두천시,0,0,0,0,0,0,2019-07-10
3463,경기,동두천시,2,1,1,4,3,0,2019-08-10
3464,경기,동두천시,1,0,0,1,1,0,2019-09-10
3465,경기,동두천시,0,0,0,0,0,0,2019-10-10
3466,경기,동두천시,3,1,0,4,3,0,2019-11-10
3467,경기,동두천시,2,0,0,2,2,0,2019-12-10
3468,경기,부천시,3,2,3,8,7,0,2019-01-10
3469,경기,부천시,6,0,2,8,4,0,2019-02-10
3470,경기,부천시,6,1,1,8,5,0,2019-03-10
3471,경기,부천시,8,2,3,13,9,0,2019-04-10
3472,경기,부천시,10,3,4,17,13,0,2019-05-10
3473,경기,부천시,15,0,5,20,12,0,2019-06-10
3474,경기,부천시,15,1,1,17,13,0,2019-07-10
3475,경기,부천시,13,3,1,17,13,0,2019-08-10
3476,경기,부천시,15,1,3,19,16,0,2019-09-10
3477,경기,부천시,7,1,0,8,7,0,2019-10-10
3478,경기,부천시,13,1,4,18,12,0,2019-11-10
3479,경기,부천시,15,1,1,17,11,1,2019-12-10
3480,경기,성남시,4,0,7,11,9,0,2019-01-10
3481,경기,성남시,9,0,6,15,9,0,2019-02-10
3482,경기,성남시,11,1,1,13,8,1,2019-03-10
3483,경기,성남시,18,4,5,27,19,0,2019-04-10
3484,경기,성남시,9,0,6,15,11,0,2019-05-10
3485,경기,성남시,14,1,4,19,12,0,2019-06-10
3486,경기,성남시,14,3,4,21,14,1,2019-07-10
3487,경기,성남시,8,0,1,9,8,0,2019-08-10
3488,경기,성남시,16,2,1,19,10,0,2019-09-10
3489,경기,성남시,9,2,8,19,15,1,2019-10-10
3490,경기,성남시,13,1,3,17,12,0,2019-11-10
3491,경기,성남시,5,1,2,8,8,0,2019-12-10
3492,경기,수원시,8,0,2,10,8,0,2019-01-10
3493,경기,수원시,4,0,0,4,3,0,2019-02-10
3494,경기,수원시,11,3,4,18,11,0,2019-03-10
3495,경기,수원시,11,0,4,15,13,0,2019-04-10
3496,경기,수원시,15,0,2,17,14,0,2019-05-10
3497,경기,수원시,4,2,3,9,9,0,2019-06-10
3498,경기,수원시,20,2,3,25,17,0,2019-07-10
3499,경기,수원시,12,0,3,15,13,0,2019-08-10
3500,경기,수원시,36,1,3,40,25,0,2019-09-10
3501,경기,수원시,20,2,4,26,21,0,2019-10-10
3502,경기,수원시,12,3,3,18,10,0,2019-11-10
3503,경기,수원시,9,0,2,11,12,1,2019-12-10
3504,경기,시흥시,4,0,2,6,6,0,2019-01-10
3505,경기,시흥시,11,0,1,12,4,0,2019-02-10
3506,경기,시흥시,4,1,1,6,3,0,2019-03-10
3507,경기,시흥시,5,0,0,5,4,1,2019-04-10
3508,경기,시흥시,9,1,2,12,7,0,2019-05-10
3509,경기,시흥시,11,1,6,18,12,0,2019-06-10
3510,경기,시흥시,7,3,7,17,9,0,2019-07-10
3511,경기,시흥시,4,0,3,7,5,0,2019-08-10
3512,경기,시흥시,17,1,4,22,16,0,2019-09-10
3513,경기,시흥시,18,1,2,21,13,0,2019-10-10
3514,경기,시흥시,16,1,2,19,9,0,2019-11-10
3515,경기,시흥시,1,0,3,4,4,0,2019-12-10
3516,경기,안산시,11,0,2,13,9,0,2019-01-10
3517,경기,안산시,15,0,0,15,6,0,2019-02-10
3518,경기,안산시,6,2,3,11,7,0,2019-03-10
3519,경기,안산시,15,2,2,19,10,0,2019-04-10
3520,경기,안산시,17,1,3,21,14,0,2019-05-10
3521,경기,안산시,6,2,3,11,9,0,2019-06-10
3522,경기,안산시,11,3,2,16,9,0,2019-07-10
3523,경기,안산시,6,0,4,10,8,1,2019-08-10
3524,경기,안산시,19,2,6,27,15,0,2019-09-10
3525,경기,안산시,14,0,6,20,13,0,2019-10-10
3526,경기,안산시,24,1,3,28,17,0,2019-11-10
3527,경기,안산시,15,0,0,15,10,0,2019-12-10
3528,경기,안성시,3,0,0,3,2,0,2019-01-10
3529,경기,안성시,0,0,0,0,0,0,2019-02-10
3530,경기,안성시,1,0,0,1,1,0,2019-03-10
3531,경기,안성시,0,0,0,0,0,0,2019-04-10
3532,경기,안성시,8,0,1,9,5,0,2019-05-10
3533,경기,안성시,5,1,0,6,3,0,2019-06-10
3534,경기,안성시,7,0,0,7,5,0,2019-07-10
3535,경기,안성시,3,0,0,3,2,0,2019-08-10
3536,경기,안성시,2,2,0,4,4,0,2019-09-10
3537,경기,안성시,3,0,1,4,4,0,2019-10-10
3538,경기,안성시,3,0,1,4,2,0,2019-11-10
3539,경기,안성시,3,1,0,4,4,0,2019-12-10
3540,경기,안양시,2,0,0,2,1,0,2019-01-10
3541,경기,안양시,2,0,1,3,2,0,2019-02-10
3542,경기,안양시,3,1,1,5,4,0,2019-03-10
3543,경기,안양시,5,0,0,5,3,0,2019-04-10
3544,경기,안양시,6,0,0,6,4,0,2019-05-10
3545,경기,안양시,8,0,3,11,6,0,2019-06-10
3546,경기,안양시,3,1,1,5,4,0,2019-07-10
3547,경기,안양시,4,1,1,6,3,0,2019-08-10
3548,경기,안양시,7,0,0,7,7,0,2019-09-10
3549,경기,안양시,0,1,2,3,3,0,2019-10-10
3550,경기,안양시,8,0,0,8,5,0,2019-11-10
3551,경기,안양시,2,1,0,3,3,0,2019-12-10
3552,경기,양주시,7,2,1,10,8,0,2019-01-10
3553,경기,양주시,0,0,0,0,0,0,2019-02-10
3554,경기,양주시,5,1,0,6,2,0,2019-03-10
3555,경기,양주시,1,0,0,1,1,0,2019-04-10
3556,경기,양주시,0,1,0,1,1,0,2019-05-10
3557,경기,양주시,10,0,2,12,6,0,2019-06-10
3558,경기,양주시,9,0,3,12,7,0,2019-07-10
3559,경기,양주시,0,0,0,0,0,0,2019-08-10
3560,경기,양주시,10,1,1,12,3,0,2019-09-10
3561,경기,양주시,7,0,4,11,7,0,2019-10-10
3562,경기,양주시,5,0,0,5,1,0,2019-11-10
3563,경기,양주시,3,1,1,5,4,0,2019-12-10
3564,경기,양평군,0,0,0,0,0,0,2019-01-10
3565,경기,양평군,0,1,1,2,2,0,2019-02-10
3566,경기,양평군,0,0,1,1,1,0,2019-03-10
3567,경기,양평군,2,2,2,6,3,0,2019-04-10
3568,경기,양평군,1,0,0,1,1,0,2019-05-10
3569,경기,양평군,1,0,0,1,1,0,2019-06-10
3570,경기,양평군,0,0,0,0,1,1,2019-07-10
3571,경기,양평군,10,2,0,12,4,0,2019-08-10
3572,경기,양평군,0,0,0,0,0,0,2019-09-10
3573,경기,양평군,0,0,0,0,0,0,2019-10-10
3574,경기,양평군,4,1,3,8,3,0,2019-11-10
3575,경기,양평군,3,0,0,3,2,0,2019-12-10
3576,경기,여주시,0,0,0,0,0,0,2019-01-10
3577,경기,여주시,4,0,0,4,2,0,2019-02-10
3578,경기,여주시,3,0,1,4,1,0,2019-03-10
3579,경기,여주시,2,0,1,3,3,0,2019-04-10
3580,경기,여주시,0,0,0,0,0,0,2019-05-10
3581,경기,여주시,1,0,0,1,1,0,2019-06-10
3582,경기,여주시,2,0,1,3,3,0,2019-07-10
3583,경기,여주시,6,0,0,6,4,0,2019-08-10
3584,경기,여주시,1,0,0,1,1,0,2019-09-10
3585,경기,여주시,2,2,2,6,4,0,2019-10-10
3586,경기,여주시,2,0,0,2,1,0,2019-11-10
3587,경기,여주시,1,0,0,1,1,0,2019-12-10
3588,경기,연천군,0,0,0,0,0,0,2019-01-10
3589,경기,연천군,0,0,0,0,0,0,2019-02-10
3590,경기,연천군,0,1,0,1,1,0,2019-03-10
3591,경기,연천군,1,0,0,1,1,0,2019-04-10
3592,경기,연천군,1,0,1,2,2,0,2019-05-10
3593,경기,연천군,0,0,0,0,0,0,2019-06-10
3594,경기,연천군,0,0,0,0,0,0,2019-07-10
3595,경기,연천군,0,0,1,1,1,0,2019-08-10
3596,경기,연천군,0,0,0,0,0,0,2019-09-10
3597,경기,연천군,1,0,0,1,1,0,2019-10-10
3598,경기,연천군,0,0,0,0,0,0,2019-11-10
3599,경기,연천군,0,0,0,0,0,0,2019-12-10
3600,경기,오산시,4,0,0,4,3,0,2019-01-10
3601,경기,오산시,1,0,1,2,2,0,2019-02-10
3602,경기,오산시,2,1,2,5,4,0,2019-03-10
3603,경기,오산시,3,0,1,4,4,0,2019-04-10
3604,경기,오산시,2,0,2,4,2,0,2019-05-10
3605,경기,오산시,6,0,0,6,4,0,2019-06-10
3606,경기,오산시,4,0,2,6,4,0,2019-07-10
3607,경기,오산시,3,1,0,4,3,0,2019-08-10
3608,경기,오산시,1,0,3,4,4,0,2019-09-10
3609,경기,오산시,3,0,1,4,4,0,2019-10-10
3610,경기,오산시,11,0,1,12,10,0,2019-11-10
3611,경기,오산시,3,1,0,4,3,0,2019-12-10
3612,경기,용인시,16,2,3,21,11,1,2019-01-10
3613,경기,용인시,12,1,4,17,12,0,2019-02-10
3614,경기,용인시,10,0,1,11,6,0,2019-03-10
3615,경기,용인시,10,1,4,15,10,0,2019-04-10
3616,경기,용인시,3,3,2,8,7,0,2019-05-10
3617,경기,용인시,13,3,2,18,11,0,2019-06-10
3618,경기,용인시,11,4,2,17,12,0,2019-07-10
3619,경기,용인시,12,0,4,16,9,0,2019-08-10
3620,경기,용인시,7,1,3,11,11,0,2019-09-10
3621,경기,용인시,19,5,4,28,12,0,2019-10-10
3622,경기,용인시,8,0,3,11,8,0,2019-11-10
3623,경기,용인시,11,3,3,17,14,0,2019-12-10
3624,경기,의왕시,2,0,0,2,2,0,2019-01-10
3625,경기,의왕시,0,0,0,0,0,0,2019-02-10
3626,경기,의왕시,1,0,1,2,2,0,2019-03-10
3627,경기,의왕시,1,0,0,1,1,0,2019-04-10
3628,경기,의왕시,1,0,0,1,1,0,2019-05-10
3629,경기,의왕시,4,0,0,4,1,0,2019-06-10
3630,경기,의왕시,0,0,0,0,0,0,2019-07-10
3631,경기,의왕시,0,0,0,0,0,0,2019-08-10
3632,경기,의왕시,4,1,1,6,3,0,2019-09-10
3633,경기,의왕시,1,0,3,4,3,0,2019-10-10
3634,경기,의왕시,1,0,0,1,1,0,2019-11-10
3635,경기,의왕시,4,0,1,5,3,0,2019-12-10
3636,경기,의정부시,3,0,1,4,4,0,2019-01-10
3637,경기,의정부시,2,0,2,4,3,0,2019-02-10
3638,경기,의정부시,4,0,1,5,4,0,2019-03-10
3639,경기,의정부시,0,0,0,0,0,0,2019-04-10
3640,경기,의정부시,2,0,0,2,2,0,2019-05-10
3641,경기,의정부시,7,1,0,8,6,0,2019-06-10
3642,경기,의정부시,1,3,0,4,4,0,2019-07-10
3643,경기,의정부시,1,2,1,4,3,0,2019-08-10
3644,경기,의정부시,5,1,0,6,4,1,2019-09-10
3645,경기,의정부시,7,0,0,7,5,0,2019-10-10
3646,경기,의정부시,3,0,1,4,4,0,2019-11-10
3647,경기,의정부시,11,1,1,13,10,0,2019-12-10
3648,경기,이천시,4,0,1,5,3,0,2019-01-10
3649,경기,이천시,0,0,0,0,0,0,2019-02-10
3650,경기,이천시,2,0,0,2,2,0,2019-03-10
3651,경기,이천시,4,1,5,10,5,0,2019-04-10
3652,경기,이천시,1,1,0,2,2,0,2019-05-10
3653,경기,이천시,3,0,0,3,1,0,2019-06-10
3654,경기,이천시,1,0,0,1,1,0,2019-07-10
3655,경기,이천시,5,0,2,7,5,1,2019-08-10
3656,경기,이천시,1,1,2,4,4,0,2019-09-10
3657,경기,이천시,5,0,1,6,5,0,2019-10-10
3658,경기,이천시,7,0,0,7,5,0,2019-11-10
3659,경기,이천시,1,1,1,3,2,0,2019-12-10
3660,경기,파주시,5,0,1,6,5,0,2019-01-10
3661,경기,파주시,2,0,1,3,3,0,2019-02-10
3662,경기,파주시,9,0,0,9,6,1,2019-03-10
3663,경기,파주시,3,0,0,3,3,0,2019-04-10
3664,경기,파주시,4,1,2,7,6,0,2019-05-10
3665,경기,파주시,6,0,0,6,5,0,2019-06-10
3666,경기,파주시,2,0,0,2,2,0,2019-07-10
3667,경기,파주시,4,1,3,8,5,0,2019-08-10
3668,경기,파주시,6,1,3,10,6,0,2019-09-10
3669,경기,파주시,3,0,1,4,3,0,2019-10-10
3670,경기,파주시,6,0,2,8,4,0,2019-11-10
3671,경기,파주시,4,0,1,5,5,0,2019-12-10
3672,경기,평택시,12,0,2,14,3,0,2019-01-10
3673,경기,평택시,5,0,0,5,3,0,2019-02-10
3674,경기,평택시,12,0,1,13,7,0,2019-03-10
3675,경기,평택시,15,2,2,19,13,0,2019-04-10
3676,경기,평택시,9,0,2,11,9,1,2019-05-10
3677,경기,평택시,17,4,3,24,12,0,2019-06-10
3678,경기,평택시,12,4,2,18,9,0,2019-07-10
3679,경기,평택시,18,1,2,21,14,1,2019-08-10
3680,경기,평택시,17,2,4,23,20,1,2019-09-10
3681,경기,평택시,7,6,4,17,9,0,2019-10-10
3682,경기,평택시,7,4,4,15,8,0,2019-11-10
3683,경기,평택시,17,3,2,22,13,0,2019-12-10
3684,경기,포천시,0,0,0,0,0,0,2019-01-10
3685,경기,포천시,5,0,1,6,3,0,2019-02-10
3686,경기,포천시,1,0,1,2,2,0,2019-03-10
3687,경기,포천시,1,0,0,1,1,0,2019-04-10
3688,경기,포천시,7,0,0,7,2,0,2019-05-10
3689,경기,포천시,3,0,0,3,2,0,2019-06-10
3690,경기,포천시,3,3,0,6,2,0,2019-07-10
3691,경기,포천시,3,0,1,4,3,0,2019-08-10
3692,경기,포천시,1,0,0,1,1,0,2019-09-10
3693,경기,포천시,2,0,1,3,3,0,2019-10-10
3694,경기,포천시,2,0,1,3,5,2,2019-11-10
3695,경기,포천시,2,0,1,3,3,0,2019-12-10
3696,경기,하남시,0,1,1,2,2,0,2019-01-10
3697,경기,하남시,1,0,0,1,1,0,2019-02-10
3698,경기,하남시,5,0,2,7,5,0,2019-03-10
3699,경기,하남시,3,1,1,5,5,0,2019-04-10
3700,경기,하남시,2,1,0,3,3,0,2019-05-10
3701,경기,하남시,0,0,0,0,0,0,2019-06-10
3702,경기,하남시,6,0,1,7,3,0,2019-07-10
3703,경기,하남시,3,3,0,6,4,0,2019-08-10
3704,경기,하남시,7,1,1,9,3,0,2019-09-10
3705,경기,하남시,2,1,1,4,4,0,2019-10-10
3706,경기,하남시,11,0,2,13,6,0,2019-11-10
3707,경기,하남시,6,2,1,9,4,0,2019-12-10
3708,경기,화성시,13,1,0,14,9,0,2019-01-10
3709,경기,화성시,3,1,0,4,2,0,2019-02-10
3710,경기,화성시,6,0,1,7,6,1,2019-03-10
3711,경기,화성시,5,0,1,6,5,0,2019-04-10
3712,경기,화성시,7,0,3,10,9,0,2019-05-10
3713,경기,화성시,9,1,3,13,8,0,2019-06-10
3714,경기,화성시,16,2,5,23,10,0,2019-07-10
3715,경기,화성시,5,0,2,7,5,0,2019-08-10
3716,경기,화성시,18,2,4,24,13,0,2019-09-10
3717,경기,화성시,13,1,2,16,10,0,2019-10-10
3718,경기,화성시,12,3,6,21,13,0,2019-11-10
3719,경기,화성시,15,2,6,23,17,1,2019-12-10
3720,경기,가평군,1,0,0,1,1,0,2019-01-11
3721,경기,가평군,3,0,0,3,3,0,2019-02-11
3722,경기,가평군,0,0,0,0,0,0,2019-03-11
3723,경기,가평군,0,0,0,0,0,0,2019-04-11
3724,경기,가평군,3,0,0,3,2,0,2019-05-11
3725,경기,가평군,1,0,0,1,1,0,2019-06-11
3726,경기,가평군,0,0,0,0,0,0,2019-07-11
3727,경기,가평군,5,0,2,7,3,0,2019-08-11
3728,경기,가평군,0,0,1,1,1,0,2019-09-11
3729,경기,가평군,2,0,0,2,2,0,2019-10-11
3730,경기,가평군,6,0,1,7,3,0,2019-11-11
3731,경기,가평군,0,0,3,3,1,0,2019-12-11
3732,경기,고양시,12,3,3,18,12,1,2019-01-11
3733,경기,고양시,14,0,5,19,15,0,2019-02-11
3734,경기,고양시,10,0,2,12,11,0,2019-03-11
3735,경기,고양시,6,1,5,12,10,0,2019-04-11
3736,경기,고양시,28,7,2,37,20,0,2019-05-11
3737,경기,고양시,11,2,6,19,13,0,2019-06-11
3738,경기,고양시,4,1,2,7,7,0,2019-07-11
3739,경기,고양시,24,6,4,34,17,0,2019-08-11
3740,경기,고양시,13,2,4,19,15,0,2019-09-11
3741,경기,고양시,11,0,4,15,10,0,2019-10-11
3742,경기,고양시,5,2,5,12,11,0,2019-11-11
3743,경기,고양시,11,1,4,16,9,0,2019-12-11
3744,경기,과천시,2,0,0,2,1,0,2019-01-11
3745,경기,과천시,1,0,0,1,1,0,2019-02-11
3746,경기,과천시,2,1,1,4,2,0,2019-03-11
3747,경기,과천시,0,0,0,0,0,0,2019-04-11
3748,경기,과천시,0,0,0,0,0,0,2019-05-11
3749,경기,과천시,0,0,1,1,1,0,2019-06-11
3750,경기,과천시,0,0,0,0,0,0,2019-07-11
3751,경기,과천시,1,0,1,2,2,0,2019-08-11
3752,경기,과천시,0,0,0,0,0,0,2019-09-11
3753,경기,과천시,0,0,0,0,0,0,2019-10-11
3754,경기,과천시,0,0,1,1,1,0,2019-11-11
3755,경기,과천시,3,0,0,3,2,0,2019-12-11
3756,경기,광명시,2,1,2,5,4,0,2019-01-11
3757,경기,광명시,0,1,0,1,1,0,2019-02-11
3758,경기,광명시,1,2,0,3,3,0,2019-03-11
3759,경기,광명시,2,0,1,3,2,0,2019-04-11
3760,경기,광명시,3,2,1,6,3,0,2019-05-11
3761,경기,광명시,3,2,0,5,3,0,2019-06-11
3762,경기,광명시,1,1,0,2,2,0,2019-07-11
3763,경기,광명시,4,1,0,5,4,0,2019-08-11
3764,경기,광명시,1,0,0,1,1,0,2019-09-11
3765,경기,광명시,3,0,1,4,4,0,2019-10-11
3766,경기,광명시,1,3,0,4,2,0,2019-11-11
3767,경기,광명시,2,0,0,2,1,0,2019-12-11
3768,경기,광주시,11,0,3,14,6,1,2019-01-11
3769,경기,광주시,2,0,2,4,4,0,2019-02-11
3770,경기,광주시,8,0,0,8,6,0,2019-03-11
3771,경기,광주시,6,1,1,8,5,0,2019-04-11
3772,경기,광주시,4,0,2,6,4,0,2019-05-11
3773,경기,광주시,3,0,0,3,2,0,2019-06-11
3774,경기,광주시,6,1,0,7,4,0,2019-07-11
3775,경기,광주시,0,1,0,1,1,0,2019-08-11
3776,경기,광주시,4,0,2,6,4,0,2019-09-11
3777,경기,광주시,3,0,0,3,2,0,2019-10-11
3778,경기,광주시,1,0,2,3,3,0,2019-11-11
3779,경기,광주시,2,0,1,3,2,0,2019-12-11
3780,경기,구리시,1,0,0,1,1,0,2019-01-11
3781,경기,구리시,2,0,1,3,3,0,2019-02-11
3782,경기,구리시,0,0,0,0,0,0,2019-03-11
3783,경기,구리시,4,1,2,7,3,0,2019-04-11
3784,경기,구리시,2,0,1,3,3,0,2019-05-11
3785,경기,구리시,1,0,0,1,1,0,2019-06-11
3786,경기,구리시,0,0,2,2,2,0,2019-07-11
3787,경기,구리시,4,1,0,5,2,0,2019-08-11
3788,경기,구리시,6,0,1,7,7,0,2019-09-11
3789,경기,구리시,3,0,0,3,1,0,2019-10-11
3790,경기,구리시,5,0,0,5,3,0,2019-11-11
3791,경기,구리시,4,0,1,5,2,0,2019-12-11
3792,경기,군포시,3,1,1,5,2,0,2019-01-11
3793,경기,군포시,2,0,0,2,2,0,2019-02-11
3794,경기,군포시,2,0,1,3,2,0,2019-03-11
3795,경기,군포시,0,0,3,3,1,0,2019-04-11
3796,경기,군포시,12,6,0,18,5,0,2019-05-11
3797,경기,군포시,6,0,0,6,3,0,2019-06-11
3798,경기,군포시,0,2,0,2,2,0,2019-07-11
3799,경기,군포시,0,0,0,0,0,0,2019-08-11
3800,경기,군포시,7,1,5,13,4,0,2019-09-11
3801,경기,군포시,0,0,0,0,0,0,2019-10-11
3802,경기,군포시,0,0,1,1,1,0,2019-11-11
3803,경기,군포시,4,0,0,4,2,0,2019-12-11
3804,경기,김포시,7,0,6,13,7,0,2019-01-11
3805,경기,김포시,3,0,4,7,2,0,2019-02-11
3806,경기,김포시,4,0,0,4,3,0,2019-03-11
3807,경기,김포시,8,0,0,8,3,0,2019-04-11
3808,경기,김포시,11,0,1,12,4,0,2019-05-11
3809,경기,김포시,8,1,1,10,9,0,2019-06-11
3810,경기,김포시,4,0,4,8,6,0,2019-07-11
3811,경기,김포시,5,0,1,6,3,0,2019-08-11
3812,경기,김포시,4,0,2,6,5,0,2019-09-11
3813,경기,김포시,12,1,1,14,9,2,2019-10-11
3814,경기,김포시,1,0,1,2,2,0,2019-11-11
3815,경기,김포시,5,1,2,8,8,0,2019-12-11
3816,경기,남양주시,7,0,0,7,6,0,2019-01-11
3817,경기,남양주시,2,0,2,4,3,0,2019-02-11
3818,경기,남양주시,2,0,0,2,2,0,2019-03-11
3819,경기,남양주시,7,0,3,10,8,0,2019-04-11
3820,경기,남양주시,17,4,6,27,13,0,2019-05-11
3821,경기,남양주시,3,0,0,3,2,0,2019-06-11
3822,경기,남양주시,5,1,4,10,5,0,2019-07-11
3823,경기,남양주시,4,0,5,9,4,0,2019-08-11
3824,경기,남양주시,7,0,1,8,7,0,2019-09-11
3825,경기,남양주시,7,3,2,12,10,0,2019-10-11
3826,경기,남양주시,17,0,3,20,12,1,2019-11-11
3827,경기,남양주시,4,1,1,6,5,0,2019-12-11
3828,경기,동두천시,0,1,0,1,1,0,2019-01-11
3829,경기,동두천시,0,0,0,0,0,0,2019-02-11
3830,경기,동두천시,0,0,0,0,0,0,2019-03-11
3831,경기,동두천시,1,0,1,2,2,0,2019-04-11
3832,경기,동두천시,0,0,0,0,0,0,2019-05-11
3833,경기,동두천시,1,0,0,1,1,0,2019-06-11
3834,경기,동두천시,0,0,0,0,0,0,2019-07-11
3835,경기,동두천시,0,0,0,0,0,0,2019-08-11
3836,경기,동두천시,1,0,0,1,1,0,2019-09-11
3837,경기,동두천시,0,0,0,0,0,0,2019-10-11
3838,경기,동두천시,2,0,1,3,2,0,2019-11-11
3839,경기,동두천시,0,0,0,0,0,0,2019-12-11
3840,경기,부천시,12,0,3,15,9,0,2019-01-11
3841,경기,부천시,3,2,1,6,3,0,2019-02-11
3842,경기,부천시,9,2,1,12,9,0,2019-03-11
3843,경기,부천시,3,1,4,8,7,0,2019-04-11
3844,경기,부천시,14,2,1,17,10,0,2019-05-11
3845,경기,부천시,10,1,5,16,12,0,2019-06-11
3846,경기,부천시,13,0,2,15,8,0,2019-07-11
3847,경기,부천시,13,0,6,19,10,0,2019-08-11
3848,경기,부천시,13,0,2,15,11,0,2019-09-11
3849,경기,부천시,9,1,3,13,10,0,2019-10-11
3850,경기,부천시,12,0,2,14,13,0,2019-11-11
3851,경기,부천시,6,1,2,9,8,0,2019-12-11
3852,경기,성남시,5,1,5,11,10,0,2019-01-11
3853,경기,성남시,13,3,1,17,9,0,2019-02-11
3854,경기,성남시,6,0,2,8,8,1,2019-03-11
3855,경기,성남시,6,3,1,10,9,1,2019-04-11
3856,경기,성남시,14,1,0,15,12,0,2019-05-11
3857,경기,성남시,8,1,2,11,9,0,2019-06-11
3858,경기,성남시,15,1,13,29,15,0,2019-07-11
3859,경기,성남시,8,1,3,12,10,0,2019-08-11
3860,경기,성남시,20,0,8,28,17,0,2019-09-11
3861,경기,성남시,14,2,2,18,14,0,2019-10-11
3862,경기,성남시,22,2,8,32,22,0,2019-11-11
3863,경기,성남시,14,2,1,17,14,0,2019-12-11
3864,경기,수원시,6,0,1,7,7,0,2019-01-11
3865,경기,수원시,8,1,3,12,10,0,2019-02-11
3866,경기,수원시,14,2,6,22,17,0,2019-03-11
3867,경기,수원시,13,0,0,13,10,0,2019-04-11
3868,경기,수원시,8,0,3,11,10,0,2019-05-11
3869,경기,수원시,11,4,1,16,11,0,2019-06-11
3870,경기,수원시,9,3,3,15,13,0,2019-07-11
3871,경기,수원시,12,1,0,13,8,0,2019-08-11
3872,경기,수원시,22,0,1,23,19,0,2019-09-11
3873,경기,수원시,10,2,7,19,13,0,2019-10-11
3874,경기,수원시,17,2,4,23,18,0,2019-11-11
3875,경기,수원시,13,1,3,17,10,0,2019-12-11
3876,경기,시흥시,14,0,3,17,13,0,2019-01-11
3877,경기,시흥시,3,0,2,5,5,0,2019-02-11
3878,경기,시흥시,9,1,2,12,8,0,2019-03-11
3879,경기,시흥시,3,0,1,4,4,1,2019-04-11
3880,경기,시흥시,16,2,0,18,10,0,2019-05-11
3881,경기,시흥시,7,2,2,11,7,0,2019-06-11
3882,경기,시흥시,6,0,1,7,6,0,2019-07-11
3883,경기,시흥시,9,3,0,12,8,0,2019-08-11
3884,경기,시흥시,12,0,4,16,11,0,2019-09-11
3885,경기,시흥시,5,0,0,5,4,0,2019-10-11
3886,경기,시흥시,10,1,2,13,8,0,2019-11-11
3887,경기,시흥시,6,0,1,7,5,0,2019-12-11
3888,경기,안산시,9,1,5,15,12,0,2019-01-11
3889,경기,안산시,11,1,4,16,11,0,2019-02-11
3890,경기,안산시,19,0,6,25,13,0,2019-03-11
3891,경기,안산시,5,1,5,11,8,0,2019-04-11
3892,경기,안산시,15,1,3,19,15,0,2019-05-11
3893,경기,안산시,7,0,4,11,9,0,2019-06-11
3894,경기,안산시,8,0,1,9,6,0,2019-07-11
3895,경기,안산시,20,1,2,23,11,0,2019-08-11
3896,경기,안산시,14,1,4,19,12,0,2019-09-11
3897,경기,안산시,16,1,1,18,14,1,2019-10-11
3898,경기,안산시,9,2,4,15,11,0,2019-11-11
3899,경기,안산시,13,0,3,16,12,0,2019-12-11
3900,경기,안성시,0,0,2,2,2,0,2019-01-11
3901,경기,안성시,1,0,0,1,1,0,2019-02-11
3902,경기,안성시,6,1,2,9,5,0,2019-03-11
3903,경기,안성시,3,0,0,3,2,0,2019-04-11
3904,경기,안성시,3,0,3,6,4,0,2019-05-11
3905,경기,안성시,6,0,1,7,3,0,2019-06-11
3906,경기,안성시,6,0,2,8,5,0,2019-07-11
3907,경기,안성시,3,1,1,5,2,0,2019-08-11
3908,경기,안성시,4,4,1,9,4,0,2019-09-11
3909,경기,안성시,3,0,2,5,3,0,2019-10-11
3910,경기,안성시,8,1,2,11,4,0,2019-11-11
3911,경기,안성시,2,0,2,4,3,0,2019-12-11
3912,경기,안양시,3,0,1,4,4,0,2019-01-11
3913,경기,안양시,6,1,0,7,3,0,2019-02-11
3914,경기,안양시,8,0,1,9,7,0,2019-03-11
3915,경기,안양시,8,0,2,10,6,0,2019-04-11
3916,경기,안양시,2,0,1,3,2,0,2019-05-11
3917,경기,안양시,0,0,3,3,3,0,2019-06-11
3918,경기,안양시,3,0,0,3,3,0,2019-07-11
3919,경기,안양시,2,1,1,4,4,0,2019-08-11
3920,경기,안양시,6,3,0,9,4,0,2019-09-11
3921,경기,안양시,5,0,0,5,4,0,2019-10-11
3922,경기,안양시,5,0,0,5,3,0,2019-11-11
3923,경기,안양시,8,0,1,9,9,1,2019-12-11
3924,경기,양주시,2,1,1,4,3,1,2019-01-11
3925,경기,양주시,3,0,0,3,2,0,2019-02-11
3926,경기,양주시,5,1,3,9,3,0,2019-03-11
3927,경기,양주시,4,0,0,4,3,0,2019-04-11
3928,경기,양주시,2,0,0,2,2,0,2019-05-11
3929,경기,양주시,3,1,0,4,3,0,2019-06-11
3930,경기,양주시,0,0,2,2,2,0,2019-07-11
3931,경기,양주시,0,0,5,5,1,0,2019-08-11
3932,경기,양주시,5,0,0,5,4,0,2019-09-11
3933,경기,양주시,5,0,3,8,5,0,2019-10-11
3934,경기,양주시,2,0,0,2,2,0,2019-11-11
3935,경기,양주시,4,0,1,5,3,0,2019-12-11
3936,경기,양평군,1,0,1,2,1,0,2019-01-11
3937,경기,양평군,3,3,0,6,3,0,2019-02-11
3938,경기,양평군,2,0,0,2,1,0,2019-03-11
3939,경기,양평군,0,0,1,1,1,0,2019-04-11
3940,경기,양평군,5,0,1,6,4,0,2019-05-11
3941,경기,양평군,2,0,2,4,3,0,2019-06-11
3942,경기,양평군,3,0,1,4,1,0,2019-07-11
3943,경기,양평군,0,0,0,0,0,0,2019-08-11
3944,경기,양평군,0,0,0,0,0,0,2019-09-11
3945,경기,양평군,0,0,1,1,1,0,2019-10-11
3946,경기,양평군,1,0,0,1,1,0,2019-11-11
3947,경기,양평군,1,0,0,1,1,0,2019-12-11
3948,경기,여주시,1,0,0,1,1,0,2019-01-11
3949,경기,여주시,1,0,2,3,3,0,2019-02-11
3950,경기,여주시,1,0,0,1,1,0,2019-03-11
3951,경기,여주시,1,0,0,1,1,0,2019-04-11
3952,경기,여주시,3,1,1,5,4,0,2019-05-11
3953,경기,여주시,5,0,0,5,2,0,2019-06-11
3954,경기,여주시,1,1,0,2,2,0,2019-07-11
3955,경기,여주시,0,0,0,0,0,0,2019-08-11
3956,경기,여주시,5,0,0,5,3,0,2019-09-11
3957,경기,여주시,4,1,1,6,3,0,2019-10-11
3958,경기,여주시,3,1,2,6,5,0,2019-11-11
3959,경기,여주시,3,0,1,4,2,0,2019-12-11
3960,경기,연천군,0,0,0,0,0,0,2019-01-11
3961,경기,연천군,0,0,0,0,0,0,2019-02-11
3962,경기,연천군,1,0,0,1,1,0,2019-03-11
3963,경기,연천군,0,0,0,0,0,0,2019-04-11
3964,경기,연천군,0,0,1,1,1,0,2019-05-11
3965,경기,연천군,1,0,0,1,1,0,2019-06-11
3966,경기,연천군,0,0,0,0,0,0,2019-07-11
3967,경기,연천군,7,1,0,8,2,0,2019-08-11
3968,경기,연천군,0,0,0,0,0,0,2019-09-11
3969,경기,연천군,0,0,0,0,0,0,2019-10-11
3970,경기,연천군,0,0,0,0,0,0,2019-11-11
3971,경기,연천군,3,0,0,3,1,0,2019-12-11
3972,경기,오산시,0,0,0,0,0,0,2019-01-11
3973,경기,오산시,6,0,0,6,5,0,2019-02-11
3974,경기,오산시,3,1,0,4,2,0,2019-03-11
3975,경기,오산시,13,0,0,13,4,0,2019-04-11
3976,경기,오산시,5,0,0,5,4,0,2019-05-11
3977,경기,오산시,0,0,0,0,0,0,2019-06-11
3978,경기,오산시,5,0,0,5,4,0,2019-07-11
3979,경기,오산시,2,0,0,2,2,0,2019-08-11
3980,경기,오산시,6,0,3,9,4,0,2019-09-11
3981,경기,오산시,2,0,0,2,2,0,2019-10-11
3982,경기,오산시,9,1,1,11,5,0,2019-11-11
3983,경기,오산시,3,0,2,5,4,0,2019-12-11
3984,경기,용인시,9,2,2,13,12,0,2019-01-11
3985,경기,용인시,8,0,1,9,4,0,2019-02-11
3986,경기,용인시,9,1,4,14,12,0,2019-03-11
3987,경기,용인시,13,3,5,21,13,0,2019-04-11
3988,경기,용인시,15,1,4,20,12,0,2019-05-11
3989,경기,용인시,14,2,6,22,14,0,2019-06-11
3990,경기,용인시,8,2,1,11,11,0,2019-07-11
3991,경기,용인시,7,1,1,9,7,0,2019-08-11
3992,경기,용인시,12,4,2,18,15,0,2019-09-11
3993,경기,용인시,11,1,2,14,11,0,2019-10-11
3994,경기,용인시,10,0,1,11,9,0,2019-11-11
3995,경기,용인시,6,2,3,11,8,0,2019-12-11
3996,경기,의왕시,0,0,0,0,0,0,2019-01-11
3997,경기,의왕시,0,0,0,0,0,0,2019-02-11
3998,경기,의왕시,1,0,1,2,2,0,2019-03-11
3999,경기,의왕시,3,0,1,4,3,0,2019-04-11
4000,경기,의왕시,5,0,1,6,4,0,2019-05-11
4001,경기,의왕시,2,0,0,2,2,0,2019-06-11
4002,경기,의왕시,2,0,0,2,1,0,2019-07-11
4003,경기,의왕시,1,1,0,2,1,0,2019-08-11
4004,경기,의왕시,2,0,1,3,1,0,2019-09-11
4005,경기,의왕시,1,0,1,2,2,0,2019-10-11
4006,경기,의왕시,1,0,0,1,1,0,2019-11-11
4007,경기,의왕시,0,0,1,1,1,0,2019-12-11
4008,경기,의정부시,5,0,3,8,7,0,2019-01-11
4009,경기,의정부시,5,1,6,12,6,0,2019-02-11
4010,경기,의정부시,3,1,0,4,3,0,2019-03-11
4011,경기,의정부시,2,0,1,3,3,0,2019-04-11
4012,경기,의정부시,2,0,1,3,3,0,2019-05-11
4013,경기,의정부시,0,0,0,0,0,0,2019-06-11
4014,경기,의정부시,3,3,0,6,3,0,2019-07-11
4015,경기,의정부시,6,0,0,6,3,0,2019-08-11
4016,경기,의정부시,7,4,0,11,7,0,2019-09-11
4017,경기,의정부시,2,0,1,3,2,0,2019-10-11
4018,경기,의정부시,10,2,1,13,6,0,2019-11-11
4019,경기,의정부시,10,3,1,14,12,0,2019-12-11
4020,경기,이천시,0,0,1,1,1,0,2019-01-11
4021,경기,이천시,3,0,4,7,6,0,2019-02-11
4022,경기,이천시,1,0,0,1,1,0,2019-03-11
4023,경기,이천시,11,0,1,12,6,0,2019-04-11
4024,경기,이천시,7,0,1,8,4,0,2019-05-11
4025,경기,이천시,4,0,1,5,3,0,2019-06-11
4026,경기,이천시,3,0,3,6,5,0,2019-07-11
4027,경기,이천시,3,0,0,3,2,0,2019-08-11
4028,경기,이천시,0,1,5,6,4,0,2019-09-11
4029,경기,이천시,3,0,2,5,6,1,2019-10-11
4030,경기,이천시,1,0,1,2,1,0,2019-11-11
4031,경기,이천시,3,0,0,3,2,0,2019-12-11
4032,경기,파주시,6,1,0,7,4,0,2019-01-11
4033,경기,파주시,3,0,4,7,6,0,2019-02-11
4034,경기,파주시,8,1,2,11,5,0,2019-03-11
4035,경기,파주시,3,2,0,5,4,0,2019-04-11
4036,경기,파주시,1,0,0,1,1,0,2019-05-11
4037,경기,파주시,3,0,1,4,4,0,2019-06-11
4038,경기,파주시,2,0,2,4,4,0,2019-07-11
4039,경기,파주시,2,0,1,3,3,0,2019-08-11
4040,경기,파주시,7,0,2,9,7,1,2019-09-11
4041,경기,파주시,7,0,0,7,6,0,2019-10-11
4042,경기,파주시,10,1,1,12,7,0,2019-11-11
4043,경기,파주시,5,0,0,5,4,0,2019-12-11
4044,경기,평택시,7,2,8,17,9,0,2019-01-11
4045,경기,평택시,7,0,3,10,6,0,2019-02-11
4046,경기,평택시,21,3,0,24,13,0,2019-03-11
4047,경기,평택시,6,1,1,8,5,0,2019-04-11
4048,경기,평택시,11,5,2,18,11,0,2019-05-11
4049,경기,평택시,14,2,5,21,14,0,2019-06-11
4050,경기,평택시,4,0,3,7,5,0,2019-07-11
4051,경기,평택시,5,4,4,13,9,0,2019-08-11
4052,경기,평택시,18,3,1,22,12,0,2019-09-11
4053,경기,평택시,13,2,3,18,16,2,2019-10-11
4054,경기,평택시,19,7,1,27,16,0,2019-11-11
4055,경기,평택시,17,2,5,24,12,0,2019-12-11
4056,경기,포천시,1,0,0,1,1,0,2019-01-11
4057,경기,포천시,6,0,0,6,2,0,2019-02-11
4058,경기,포천시,7,0,0,7,3,0,2019-03-11
4059,경기,포천시,6,0,1,7,4,0,2019-04-11
4060,경기,포천시,3,0,0,3,2,0,2019-05-11
4061,경기,포천시,0,0,1,1,1,0,2019-06-11
4062,경기,포천시,5,0,0,5,3,0,2019-07-11
4063,경기,포천시,3,0,0,3,4,1,2019-08-11
4064,경기,포천시,1,2,1,4,3,0,2019-09-11
4065,경기,포천시,2,1,0,3,2,0,2019-10-11
4066,경기,포천시,1,0,1,2,2,0,2019-11-11
4067,경기,포천시,0,0,0,0,0,0,2019-12-11
4068,경기,하남시,2,1,1,4,3,0,2019-01-11
4069,경기,하남시,2,0,0,2,2,0,2019-02-11
4070,경기,하남시,6,0,0,6,4,0,2019-03-11
4071,경기,하남시,1,0,0,1,1,0,2019-04-11
4072,경기,하남시,2,2,1,5,4,0,2019-05-11
4073,경기,하남시,1,0,1,2,2,0,2019-06-11
4074,경기,하남시,0,2,0,2,2,0,2019-07-11
4075,경기,하남시,1,0,1,2,2,0,2019-08-11
4076,경기,하남시,2,3,2,7,3,1,2019-09-11
4077,경기,하남시,5,0,0,5,3,0,2019-10-11
4078,경기,하남시,1,0,0,1,1,0,2019-11-11
4079,경기,하남시,3,0,0,3,3,0,2019-12-11
4080,경기,화성시,10,1,1,12,9,0,2019-01-11
4081,경기,화성시,7,0,1,8,5,0,2019-02-11
4082,경기,화성시,9,0,4,13,9,0,2019-03-11
4083,경기,화성시,13,6,1,20,8,0,2019-04-11
4084,경기,화성시,12,2,5,19,9,0,2019-05-11
4085,경기,화성시,12,1,4,17,12,0,2019-06-11
4086,경기,화성시,3,0,1,4,3,0,2019-07-11
4087,경기,화성시,3,1,0,4,3,0,2019-08-11
4088,경기,화성시,14,1,2,17,8,0,2019-09-11
4089,경기,화성시,8,1,1,10,7,0,2019-10-11
4090,경기,화성시,11,0,2,13,8,0,2019-11-11
4091,경기,화성시,7,0,3,10,8,0,2019-12-11
4092,경기,가평군,0,0,0,0,0,0,2019-01-12
4093,경기,가평군,1,0,0,1,1,0,2019-02-12
4094,경기,가평군,0,0,0,0,0,0,2019-03-12
4095,경기,가평군,4,0,3,7,2,0,2019-04-12
4096,경기,가평군,4,3,2,9,5,0,2019-05-12
4097,경기,가평군,5,1,0,6,4,0,2019-06-12
4098,경기,가평군,2,0,0,2,2,0,2019-07-12
4099,경기,가평군,0,0,0,0,0,0,2019-08-12
4100,경기,가평군,6,6,0,12,2,0,2019-09-12
4101,경기,가평군,0,0,0,0,0,0,2019-10-12
4102,경기,가평군,0,0,0,0,0,0,2019-11-12
4103,경기,가평군,0,0,0,0,0,0,2019-12-12
4104,경기,고양시,5,2,3,10,9,1,2019-01-12
4105,경기,고양시,9,2,5,16,11,0,2019-02-12
4106,경기,고양시,7,3,2,12,10,0,2019-03-12
4107,경기,고양시,14,2,7,23,15,0,2019-04-12
4108,경기,고양시,11,2,4,17,10,0,2019-05-12
4109,경기,고양시,11,2,3,16,14,0,2019-06-12
4110,경기,고양시,17,2,9,28,16,0,2019-07-12
4111,경기,고양시,14,1,0,15,11,1,2019-08-12
4112,경기,고양시,10,0,1,11,8,0,2019-09-12
4113,경기,고양시,16,2,7,25,17,0,2019-10-12
4114,경기,고양시,12,2,4,18,10,0,2019-11-12
4115,경기,고양시,11,3,0,14,9,0,2019-12-12
4116,경기,과천시,1,0,0,1,1,0,2019-01-12
4117,경기,과천시,3,0,0,3,1,0,2019-02-12
4118,경기,과천시,0,0,1,1,1,0,2019-03-12
4119,경기,과천시,0,0,0,0,0,0,2019-04-12
4120,경기,과천시,0,0,1,1,1,0,2019-05-12
4121,경기,과천시,0,0,0,0,0,0,2019-06-12
4122,경기,과천시,0,0,0,0,0,0,2019-07-12
4123,경기,과천시,2,0,1,3,3,0,2019-08-12
4124,경기,과천시,0,0,0,0,0,0,2019-09-12
4125,경기,과천시,6,2,2,10,6,0,2019-10-12
4126,경기,과천시,0,0,0,0,0,0,2019-11-12
4127,경기,과천시,0,0,0,0,0,0,2019-12-12
4128,경기,광명시,2,0,0,2,2,0,2019-01-12
4129,경기,광명시,1,1,0,2,2,0,2019-02-12
4130,경기,광명시,2,0,1,3,2,0,2019-03-12
4131,경기,광명시,7,1,0,8,5,0,2019-04-12
4132,경기,광명시,0,1,2,3,3,0,2019-05-12
4133,경기,광명시,0,0,0,0,0,0,2019-06-12
4134,경기,광명시,4,2,1,7,4,0,2019-07-12
4135,경기,광명시,12,5,0,17,5,0,2019-08-12
4136,경기,광명시,5,2,0,7,3,0,2019-09-12
4137,경기,광명시,2,0,1,3,2,0,2019-10-12
4138,경기,광명시,5,0,1,6,6,0,2019-11-12
4139,경기,광명시,1,0,1,2,2,0,2019-12-12
4140,경기,광주시,5,0,4,9,5,1,2019-01-12
4141,경기,광주시,8,0,0,8,7,0,2019-02-12
4142,경기,광주시,3,0,0,3,4,1,2019-03-12
4143,경기,광주시,8,1,0,9,5,0,2019-04-12
4144,경기,광주시,13,0,0,13,3,0,2019-05-12
4145,경기,광주시,4,1,1,6,5,0,2019-06-12
4146,경기,광주시,3,1,3,7,7,0,2019-07-12
4147,경기,광주시,4,0,3,7,5,0,2019-08-12
4148,경기,광주시,11,0,0,11,5,0,2019-09-12
4149,경기,광주시,6,1,1,8,7,0,2019-10-12
4150,경기,광주시,2,2,2,6,6,1,2019-11-12
4151,경기,광주시,5,0,3,8,6,0,2019-12-12
4152,경기,구리시,5,0,4,9,4,0,2019-01-12
4153,경기,구리시,0,0,0,0,0,0,2019-02-12
4154,경기,구리시,2,0,0,2,2,0,2019-03-12
4155,경기,구리시,3,0,1,4,4,0,2019-04-12
4156,경기,구리시,3,0,0,3,2,0,2019-05-12
4157,경기,구리시,2,0,1,3,3,0,2019-06-12
4158,경기,구리시,3,0,0,3,1,0,2019-07-12
4159,경기,구리시,2,1,3,6,4,0,2019-08-12
4160,경기,구리시,9,0,1,10,5,0,2019-09-12
4161,경기,구리시,3,0,0,3,3,0,2019-10-12
4162,경기,구리시,4,0,0,4,4,0,2019-11-12
4163,경기,구리시,2,0,1,3,3,0,2019-12-12
4164,경기,군포시,5,1,1,7,3,0,2019-01-12
4165,경기,군포시,1,0,1,2,2,0,2019-02-12
4166,경기,군포시,0,0,2,2,2,0,2019-03-12
4167,경기,군포시,1,0,0,1,1,0,2019-04-12
4168,경기,군포시,1,1,0,2,1,0,2019-05-12
4169,경기,군포시,0,0,0,0,0,0,2019-06-12
4170,경기,군포시,2,0,1,3,3,0,2019-07-12
4171,경기,군포시,1,0,1,2,2,0,2019-08-12
4172,경기,군포시,3,0,0,3,2,0,2019-09-12
4173,경기,군포시,1,1,0,2,1,0,2019-10-12
4174,경기,군포시,1,2,1,4,2,0,2019-11-12
4175,경기,군포시,2,0,1,3,2,0,2019-12-12
4176,경기,김포시,3,0,0,3,3,1,2019-01-12
4177,경기,김포시,4,0,1,5,3,0,2019-02-12
4178,경기,김포시,4,0,1,5,5,0,2019-03-12
4179,경기,김포시,9,0,1,10,7,0,2019-04-12
4180,경기,김포시,4,0,1,5,4,0,2019-05-12
4181,경기,김포시,9,0,0,9,6,0,2019-06-12
4182,경기,김포시,4,0,4,8,6,1,2019-07-12
4183,경기,김포시,4,1,4,9,5,0,2019-08-12
4184,경기,김포시,12,1,0,13,3,0,2019-09-12
4185,경기,김포시,3,0,1,4,3,0,2019-10-12
4186,경기,김포시,0,1,2,3,3,0,2019-11-12
4187,경기,김포시,4,0,1,5,4,0,2019-12-12
4188,경기,남양주시,3,4,2,9,4,0,2019-01-12
4189,경기,남양주시,7,1,0,8,6,0,2019-02-12
4190,경기,남양주시,10,0,1,11,7,0,2019-03-12
4191,경기,남양주시,4,1,3,8,7,0,2019-04-12
4192,경기,남양주시,21,1,2,24,8,0,2019-05-12
4193,경기,남양주시,8,1,2,11,7,0,2019-06-12
4194,경기,남양주시,5,0,1,6,5,0,2019-07-12
4195,경기,남양주시,5,2,3,10,7,0,2019-08-12
4196,경기,남양주시,8,0,0,8,5,0,2019-09-12
4197,경기,남양주시,5,5,4,14,10,0,2019-10-12
4198,경기,남양주시,11,1,1,13,9,0,2019-11-12
4199,경기,남양주시,12,3,2,17,7,2,2019-12-12
4200,경기,동두천시,1,0,1,2,2,0,2019-01-12
4201,경기,동두천시,0,0,0,0,0,0,2019-02-12
4202,경기,동두천시,0,0,0,0,0,0,2019-03-12
4203,경기,동두천시,2,0,2,4,3,0,2019-04-12
4204,경기,동두천시,0,0,0,0,0,0,2019-05-12
4205,경기,동두천시,1,0,0,1,1,0,2019-06-12
4206,경기,동두천시,1,0,0,1,1,0,2019-07-12
4207,경기,동두천시,1,0,1,2,2,0,2019-08-12
4208,경기,동두천시,0,1,0,1,1,0,2019-09-12
4209,경기,동두천시,0,0,1,1,1,0,2019-10-12
4210,경기,동두천시,0,0,1,1,1,0,2019-11-12
4211,경기,동두천시,3,0,0,3,2,0,2019-12-12
4212,경기,부천시,9,1,0,10,6,1,2019-01-12
4213,경기,부천시,4,1,2,7,7,0,2019-02-12
4214,경기,부천시,7,0,2,9,7,0,2019-03-12
4215,경기,부천시,14,2,7,23,12,0,2019-04-12
4216,경기,부천시,9,0,0,9,7,0,2019-05-12
4217,경기,부천시,6,0,3,9,9,0,2019-06-12
4218,경기,부천시,11,1,1,13,11,0,2019-07-12
4219,경기,부천시,5,0,2,7,6,0,2019-08-12
4220,경기,부천시,4,1,3,8,8,0,2019-09-12
4221,경기,부천시,8,2,3,13,9,0,2019-10-12
4222,경기,부천시,3,0,4,7,5,0,2019-11-12
4223,경기,부천시,11,2,5,18,13,0,2019-12-12
4224,경기,성남시,7,0,1,8,5,0,2019-01-12
4225,경기,성남시,11,2,5,18,7,0,2019-02-12
4226,경기,성남시,6,3,3,12,10,0,2019-03-12
4227,경기,성남시,5,0,3,8,6,0,2019-04-12
4228,경기,성남시,9,0,2,11,7,0,2019-05-12
4229,경기,성남시,11,1,4,16,13,0,2019-06-12
4230,경기,성남시,16,3,8,27,16,0,2019-07-12
4231,경기,성남시,14,4,1,19,12,0,2019-08-12
4232,경기,성남시,16,4,1,21,11,0,2019-09-12
4233,경기,성남시,8,1,2,11,9,0,2019-10-12
4234,경기,성남시,5,0,3,8,7,0,2019-11-12
4235,경기,성남시,8,6,3,17,12,0,2019-12-12
4236,경기,수원시,8,2,6,16,13,0,2019-01-12
4237,경기,수원시,19,4,2,25,11,0,2019-02-12
4238,경기,수원시,8,4,1,13,8,0,2019-03-12
4239,경기,수원시,8,1,1,10,8,0,2019-04-12
4240,경기,수원시,23,0,3,26,14,0,2019-05-12
4241,경기,수원시,21,0,2,23,16,0,2019-06-12
4242,경기,수원시,14,3,4,21,13,0,2019-07-12
4243,경기,수원시,12,1,3,16,12,0,2019-08-12
4244,경기,수원시,11,1,3,15,10,0,2019-09-12
4245,경기,수원시,20,5,5,30,22,0,2019-10-12
4246,경기,수원시,9,0,2,11,10,0,2019-11-12
4247,경기,수원시,20,3,3,26,15,0,2019-12-12
4248,경기,시흥시,6,0,0,6,5,0,2019-01-12
4249,경기,시흥시,3,0,0,3,2,0,2019-02-12
4250,경기,시흥시,5,0,0,5,3,0,2019-03-12
4251,경기,시흥시,6,0,2,8,7,1,2019-04-12
4252,경기,시흥시,10,1,2,13,5,0,2019-05-12
4253,경기,시흥시,2,0,2,4,4,0,2019-06-12
4254,경기,시흥시,5,1,3,9,9,0,2019-07-12
4255,경기,시흥시,5,1,1,7,6,0,2019-08-12
4256,경기,시흥시,13,0,3,16,7,0,2019-09-12
4257,경기,시흥시,14,0,2,16,10,0,2019-10-12
4258,경기,시흥시,4,0,3,7,6,0,2019-11-12
4259,경기,시흥시,13,1,13,27,7,0,2019-12-12
4260,경기,안산시,17,0,5,22,14,0,2019-01-12
4261,경기,안산시,9,1,2,12,8,0,2019-02-12
4262,경기,안산시,16,1,2,19,9,0,2019-03-12
4263,경기,안산시,14,0,4,18,12,0,2019-04-12
4264,경기,안산시,10,0,2,12,9,0,2019-05-12
4265,경기,안산시,1,0,0,1,1,0,2019-06-12
4266,경기,안산시,15,2,0,17,10,0,2019-07-12
4267,경기,안산시,13,0,6,19,15,0,2019-08-12
4268,경기,안산시,10,2,1,13,9,0,2019-09-12
4269,경기,안산시,24,4,2,30,14,0,2019-10-12
4270,경기,안산시,7,0,3,10,8,0,2019-11-12
4271,경기,안산시,10,1,2,13,11,0,2019-12-12
4272,경기,안성시,1,1,2,4,3,0,2019-01-12
4273,경기,안성시,1,0,0,1,1,0,2019-02-12
4274,경기,안성시,1,0,0,1,1,0,2019-03-12
4275,경기,안성시,5,0,0,5,3,0,2019-04-12
4276,경기,안성시,0,0,1,1,1,0,2019-05-12
4277,경기,안성시,3,1,0,4,3,0,2019-06-12
4278,경기,안성시,3,0,0,3,3,0,2019-07-12
4279,경기,안성시,2,0,2,4,2,0,2019-08-12
4280,경기,안성시,1,0,0,1,1,0,2019-09-12
4281,경기,안성시,5,0,1,6,4,0,2019-10-12
4282,경기,안성시,5,1,1,7,4,0,2019-11-12
4283,경기,안성시,3,2,0,5,5,0,2019-12-12
4284,경기,안양시,9,1,2,12,8,0,2019-01-12
4285,경기,안양시,5,0,2,7,4,0,2019-02-12
4286,경기,안양시,5,0,1,6,5,0,2019-03-12
4287,경기,안양시,1,0,2,3,3,0,2019-04-12
4288,경기,안양시,6,0,1,7,5,0,2019-05-12
4289,경기,안양시,8,0,0,8,3,0,2019-06-12
4290,경기,안양시,7,0,1,8,6,0,2019-07-12
4291,경기,안양시,2,1,1,4,3,0,2019-08-12
4292,경기,안양시,2,0,1,3,2,0,2019-09-12
4293,경기,안양시,6,0,2,8,4,0,2019-10-12
4294,경기,안양시,5,0,2,7,6,0,2019-11-12
4295,경기,안양시,2,0,1,3,3,0,2019-12-12
4296,경기,양주시,5,0,1,6,3,0,2019-01-12
4297,경기,양주시,5,0,1,6,5,0,2019-02-12
4298,경기,양주시,6,0,0,6,3,0,2019-03-12
4299,경기,양주시,1,0,2,3,3,0,2019-04-12
4300,경기,양주시,1,0,1,2,2,0,2019-05-12
4301,경기,양주시,4,0,2,6,3,0,2019-06-12
4302,경기,양주시,2,0,0,2,2,0,2019-07-12
4303,경기,양주시,0,1,3,4,4,0,2019-08-12
4304,경기,양주시,1,1,0,2,1,0,2019-09-12
4305,경기,양주시,3,0,0,3,2,0,2019-10-12
4306,경기,양주시,7,0,1,8,4,0,2019-11-12
4307,경기,양주시,1,1,1,3,2,0,2019-12-12
4308,경기,양평군,4,0,0,4,2,0,2019-01-12
4309,경기,양평군,3,0,1,4,2,0,2019-02-12
4310,경기,양평군,6,0,1,7,3,0,2019-03-12
4311,경기,양평군,1,0,0,1,1,0,2019-04-12
4312,경기,양평군,6,0,0,6,2,0,2019-05-12
4313,경기,양평군,3,0,0,3,3,0,2019-06-12
4314,경기,양평군,1,1,3,5,4,0,2019-07-12
4315,경기,양평군,1,0,0,1,1,0,2019-08-12
4316,경기,양평군,1,0,1,2,2,0,2019-09-12
4317,경기,양평군,1,0,0,1,1,0,2019-10-12
4318,경기,양평군,2,0,0,2,2,0,2019-11-12
4319,경기,양평군,1,0,1,2,2,0,2019-12-12
4320,경기,여주시,1,0,0,1,1,0,2019-01-12
4321,경기,여주시,0,0,0,0,0,0,2019-02-12
4322,경기,여주시,0,0,0,0,0,0,2019-03-12
4323,경기,여주시,2,1,1,4,3,0,2019-04-12
4324,경기,여주시,2,0,0,2,1,0,2019-05-12
4325,경기,여주시,1,0,0,1,1,0,2019-06-12
4326,경기,여주시,0,0,0,0,0,0,2019-07-12
4327,경기,여주시,4,10,0,14,3,0,2019-08-12
4328,경기,여주시,3,0,0,3,2,0,2019-09-12
4329,경기,여주시,7,1,3,11,4,0,2019-10-12
4330,경기,여주시,1,0,0,1,1,0,2019-11-12
4331,경기,여주시,1,0,0,1,1,0,2019-12-12
4332,경기,연천군,2,0,1,3,3,0,2019-01-12
4333,경기,연천군,0,0,0,0,0,0,2019-02-12
4334,경기,연천군,0,0,1,1,1,0,2019-03-12
4335,경기,연천군,0,0,0,0,0,0,2019-04-12
4336,경기,연천군,0,0,0,0,0,0,2019-05-12
4337,경기,연천군,0,0,0,0,0,0,2019-06-12
4338,경기,연천군,2,0,0,2,1,0,2019-07-12
4339,경기,연천군,0,0,0,0,0,0,2019-08-12
4340,경기,연천군,0,0,0,0,0,0,2019-09-12
4341,경기,연천군,0,0,0,0,0,0,2019-10-12
4342,경기,연천군,3,0,1,4,1,0,2019-11-12
4343,경기,연천군,1,0,0,1,1,0,2019-12-12
4344,경기,오산시,2,0,1,3,1,0,2019-01-12
4345,경기,오산시,2,1,1,4,4,0,2019-02-12
4346,경기,오산시,1,0,0,1,1,0,2019-03-12
4347,경기,오산시,1,2,1,4,4,0,2019-04-12
4348,경기,오산시,1,0,0,1,1,0,2019-05-12
4349,경기,오산시,3,0,2,5,4,0,2019-06-12
4350,경기,오산시,2,2,0,4,4,0,2019-07-12
4351,경기,오산시,7,0,0,7,5,0,2019-08-12
4352,경기,오산시,3,0,0,3,2,0,2019-09-12
4353,경기,오산시,0,1,0,1,1,0,2019-10-12
4354,경기,오산시,2,0,1,3,2,0,2019-11-12
4355,경기,오산시,9,2,1,12,6,0,2019-12-12
4356,경기,용인시,8,1,0,9,7,0,2019-01-12
4357,경기,용인시,13,5,5,23,10,1,2019-02-12
4358,경기,용인시,7,2,7,16,8,0,2019-03-12
4359,경기,용인시,12,1,2,15,10,0,2019-04-12
4360,경기,용인시,2,1,1,4,4,0,2019-05-12
4361,경기,용인시,14,0,3,17,12,0,2019-06-12
4362,경기,용인시,16,3,3,22,12,0,2019-07-12
4363,경기,용인시,9,0,1,10,8,0,2019-08-12
4364,경기,용인시,23,1,1,25,6,0,2019-09-12
4365,경기,용인시,22,1,2,25,10,0,2019-10-12
4366,경기,용인시,10,4,5,19,14,0,2019-11-12
4367,경기,용인시,14,2,8,24,15,0,2019-12-12
4368,경기,의왕시,1,0,0,1,1,0,2019-01-12
4369,경기,의왕시,0,0,1,1,1,0,2019-02-12
4370,경기,의왕시,0,0,0,0,0,0,2019-03-12
4371,경기,의왕시,6,0,0,6,3,0,2019-04-12
4372,경기,의왕시,1,0,1,2,1,0,2019-05-12
4373,경기,의왕시,0,0,0,0,0,0,2019-06-12
4374,경기,의왕시,1,0,0,1,1,0,2019-07-12
4375,경기,의왕시,1,0,0,1,1,0,2019-08-12
4376,경기,의왕시,2,0,1,3,2,0,2019-09-12
4377,경기,의왕시,1,0,0,1,1,0,2019-10-12
4378,경기,의왕시,0,0,0,0,0,0,2019-11-12
4379,경기,의왕시,0,0,0,0,0,0,2019-12-12
4380,경기,의정부시,3,0,3,6,4,1,2019-01-12
4381,경기,의정부시,4,1,0,5,4,0,2019-02-12
4382,경기,의정부시,2,0,0,2,1,0,2019-03-12
4383,경기,의정부시,3,0,1,4,3,0,2019-04-12
4384,경기,의정부시,8,0,1,9,5,0,2019-05-12
4385,경기,의정부시,0,0,0,0,0,0,2019-06-12
4386,경기,의정부시,7,0,1,8,7,0,2019-07-12
4387,경기,의정부시,7,2,2,11,10,0,2019-08-12
4388,경기,의정부시,1,1,0,2,2,0,2019-09-12
4389,경기,의정부시,2,0,1,3,3,0,2019-10-12
4390,경기,의정부시,6,2,1,9,7,0,2019-11-12
4391,경기,의정부시,1,1,1,3,3,0,2019-12-12
4392,경기,이천시,1,1,0,2,2,0,2019-01-12
4393,경기,이천시,12,0,2,14,4,0,2019-02-12
4394,경기,이천시,3,0,1,4,2,0,2019-03-12
4395,경기,이천시,3,0,1,4,2,1,2019-04-12
4396,경기,이천시,1,1,1,3,3,0,2019-05-12
4397,경기,이천시,0,0,0,0,0,0,2019-06-12
4398,경기,이천시,1,0,3,4,4,0,2019-07-12
4399,경기,이천시,2,0,2,4,3,0,2019-08-12
4400,경기,이천시,5,0,2,7,5,0,2019-09-12
4401,경기,이천시,7,5,5,17,4,2,2019-10-12
4402,경기,이천시,1,0,1,2,2,0,2019-11-12
4403,경기,이천시,2,0,1,3,3,0,2019-12-12
4404,경기,파주시,10,0,0,10,5,0,2019-01-12
4405,경기,파주시,5,0,1,6,4,0,2019-02-12
4406,경기,파주시,1,0,2,3,3,0,2019-03-12
4407,경기,파주시,4,0,3,7,4,0,2019-04-12
4408,경기,파주시,1,0,1,2,2,0,2019-05-12
4409,경기,파주시,7,0,0,7,1,0,2019-06-12
4410,경기,파주시,9,0,4,13,8,0,2019-07-12
4411,경기,파주시,10,0,0,10,7,0,2019-08-12
4412,경기,파주시,4,0,1,5,4,0,2019-09-12
4413,경기,파주시,5,1,3,9,7,0,2019-10-12
4414,경기,파주시,6,1,4,11,9,0,2019-11-12
4415,경기,파주시,2,1,1,4,4,0,2019-12-12
4416,경기,평택시,15,3,1,19,10,0,2019-01-12
4417,경기,평택시,4,0,2,6,6,0,2019-02-12
4418,경기,평택시,8,1,4,13,10,0,2019-03-12
4419,경기,평택시,8,2,1,11,8,0,2019-04-12
4420,경기,평택시,11,0,2,13,8,0,2019-05-12
4421,경기,평택시,5,3,2,10,9,1,2019-06-12
4422,경기,평택시,11,4,1,16,11,1,2019-07-12
4423,경기,평택시,15,2,2,19,12,1,2019-08-12
4424,경기,평택시,9,0,1,10,6,0,2019-09-12
4425,경기,평택시,13,0,2,15,7,1,2019-10-12
4426,경기,평택시,6,1,1,8,8,0,2019-11-12
4427,경기,평택시,19,1,3,23,13,0,2019-12-12
4428,경기,포천시,1,0,1,2,2,0,2019-01-12
4429,경기,포천시,1,0,0,1,1,0,2019-02-12
4430,경기,포천시,0,0,0,0,0,0,2019-03-12
4431,경기,포천시,2,1,0,3,2,0,2019-04-12
4432,경기,포천시,4,0,1,5,5,0,2019-05-12
4433,경기,포천시,0,1,0,1,1,0,2019-06-12
4434,경기,포천시,2,0,0,2,2,0,2019-07-12
4435,경기,포천시,1,0,0,1,1,0,2019-08-12
4436,경기,포천시,1,2,0,3,3,0,2019-09-12
4437,경기,포천시,10,0,0,10,2,0,2019-10-12
4438,경기,포천시,3,0,0,3,3,0,2019-11-12
4439,경기,포천시,1,2,1,4,3,0,2019-12-12
4440,경기,하남시,0,1,0,1,1,0,2019-01-12
4441,경기,하남시,1,2,3,6,4,0,2019-02-12
4442,경기,하남시,0,0,3,3,3,0,2019-03-12
4443,경기,하남시,6,0,3,9,5,1,2019-04-12
4444,경기,하남시,1,0,0,1,1,0,2019-05-12
4445,경기,하남시,4,0,0,4,3,0,2019-06-12
4446,경기,하남시,2,2,1,5,5,0,2019-07-12
4447,경기,하남시,2,0,0,2,2,0,2019-08-12
4448,경기,하남시,0,0,0,0,0,0,2019-09-12
4449,경기,하남시,8,0,1,9,4,0,2019-10-12
4450,경기,하남시,2,0,0,2,2,0,2019-11-12
4451,경기,하남시,0,1,1,2,2,0,2019-12-12
4452,경기,화성시,10,0,3,13,6,2,2019-01-12
4453,경기,화성시,9,1,3,13,10,1,2019-02-12
4454,경기,화성시,11,1,1,13,9,0,2019-03-12
4455,경기,화성시,12,4,0,16,9,0,2019-04-12
4456,경기,화성시,5,1,0,6,2,0,2019-05-12
4457,경기,화성시,20,0,2,22,14,0,2019-06-12
4458,경기,화성시,16,1,3,20,11,0,2019-07-12
4459,경기,화성시,7,2,3,12,9,0,2019-08-12
4460,경기,화성시,4,0,5,9,6,0,2019-09-12
4461,경기,화성시,7,2,2,11,8,0,2019-10-12
4462,경기,화성시,18,1,0,19,14,0,2019-11-12
4463,경기,화성시,15,0,1,16,14,1,2019-12-12
4464,경기,가평군,0,0,0,0,0,0,2019-01-13
4465,경기,가평군,0,0,0,0,0,0,2019-02-13
4466,경기,가평군,1,1,0,2,2,0,2019-03-13
4467,경기,가평군,0,0,1,1,1,0,2019-04-13
4468,경기,가평군,0,0,0,0,0,0,2019-05-13
4469,경기,가평군,2,0,0,2,1,0,2019-06-13
4470,경기,가평군,5,0,2,7,5,0,2019-07-13
4471,경기,가평군,2,0,0,2,1,0,2019-08-13
4472,경기,가평군,3,0,0,3,1,0,2019-09-13
4473,경기,가평군,0,0,0,0,0,0,2019-10-13
4474,경기,가평군,0,0,0,0,0,0,2019-11-13
4475,경기,가평군,2,0,1,3,1,0,2019-12-13
4476,경기,고양시,5,1,5,11,10,0,2019-01-13
4477,경기,고양시,3,2,0,5,5,2,2019-02-13
4478,경기,고양시,18,0,4,22,13,0,2019-03-13
4479,경기,고양시,18,1,2,21,15,0,2019-04-13
4480,경기,고양시,4,0,2,6,7,1,2019-05-13
4481,경기,고양시,3,2,3,8,7,1,2019-06-13
4482,경기,고양시,8,0,2,10,6,0,2019-07-13
4483,경기,고양시,9,2,1,12,12,0,2019-08-13
4484,경기,고양시,12,0,1,13,7,0,2019-09-13
4485,경기,고양시,8,0,4,12,8,0,2019-10-13
4486,경기,고양시,13,0,2,15,12,0,2019-11-13
4487,경기,고양시,15,2,2,19,12,0,2019-12-13
4488,경기,과천시,0,0,0,0,0,0,2019-01-13
4489,경기,과천시,0,0,0,0,0,0,2019-02-13
4490,경기,과천시,0,0,0,0,0,0,2019-03-13
4491,경기,과천시,6,0,0,6,2,0,2019-04-13
4492,경기,과천시,0,0,0,0,0,0,2019-05-13
4493,경기,과천시,0,0,0,0,0,0,2019-06-13
4494,경기,과천시,0,0,0,0,0,0,2019-07-13
4495,경기,과천시,1,0,1,2,2,0,2019-08-13
4496,경기,과천시,0,0,0,0,0,0,2019-09-13
4497,경기,과천시,0,3,2,5,2,0,2019-10-13
4498,경기,과천시,0,0,0,0,0,0,2019-11-13
4499,경기,과천시,1,0,0,1,1,0,2019-12-13
4500,경기,광명시,2,2,0,4,2,0,2019-01-13
4501,경기,광명시,1,0,1,2,2,0,2019-02-13
4502,경기,광명시,1,0,0,1,1,0,2019-03-13
4503,경기,광명시,1,1,1,3,3,0,2019-04-13
4504,경기,광명시,3,0,0,3,1,0,2019-05-13
4505,경기,광명시,2,2,0,4,3,0,2019-06-13
4506,경기,광명시,3,0,1,4,3,0,2019-07-13
4507,경기,광명시,1,0,1,2,1,0,2019-08-13
4508,경기,광명시,5,0,0,5,1,0,2019-09-13
4509,경기,광명시,3,0,0,3,3,0,2019-10-13
4510,경기,광명시,5,0,0,5,4,0,2019-11-13
4511,경기,광명시,10,1,1,12,6,0,2019-12-13
4512,경기,광주시,8,0,2,10,5,0,2019-01-13
4513,경기,광주시,1,0,1,2,2,0,2019-02-13
4514,경기,광주시,6,0,0,6,4,0,2019-03-13
4515,경기,광주시,12,0,2,14,8,0,2019-04-13
4516,경기,광주시,4,2,1,7,6,0,2019-05-13
4517,경기,광주시,5,2,2,9,4,0,2019-06-13
4518,경기,광주시,6,1,4,11,7,0,2019-07-13
4519,경기,광주시,3,0,2,5,4,0,2019-08-13
4520,경기,광주시,1,1,1,3,3,0,2019-09-13
4521,경기,광주시,1,0,0,1,1,0,2019-10-13
4522,경기,광주시,9,2,4,15,11,0,2019-11-13
4523,경기,광주시,8,1,1,10,6,0,2019-12-13
4524,경기,구리시,3,0,0,3,1,0,2019-01-13
4525,경기,구리시,2,0,0,2,2,0,2019-02-13
4526,경기,구리시,1,0,1,2,2,0,2019-03-13
4527,경기,구리시,6,0,0,6,4,0,2019-04-13
4528,경기,구리시,1,0,1,2,2,0,2019-05-13
4529,경기,구리시,0,0,0,0,0,0,2019-06-13
4530,경기,구리시,11,0,1,12,5,0,2019-07-13
4531,경기,구리시,2,0,0,2,2,0,2019-08-13
4532,경기,구리시,1,3,0,4,2,0,2019-09-13
4533,경기,구리시,4,2,0,6,2,0,2019-10-13
4534,경기,구리시,3,0,1,4,3,0,2019-11-13
4535,경기,구리시,1,1,2,4,3,0,2019-12-13
4536,경기,군포시,1,0,0,1,1,0,2019-01-13
4537,경기,군포시,2,0,1,3,3,0,2019-02-13
4538,경기,군포시,0,0,0,0,0,0,2019-03-13
4539,경기,군포시,0,0,0,0,0,0,2019-04-13
4540,경기,군포시,0,0,0,0,0,0,2019-05-13
4541,경기,군포시,0,0,0,0,0,0,2019-06-13
4542,경기,군포시,1,0,1,2,2,0,2019-07-13
4543,경기,군포시,2,0,0,2,2,0,2019-08-13
4544,경기,군포시,2,0,1,3,3,0,2019-09-13
4545,경기,군포시,1,0,0,1,1,0,2019-10-13
4546,경기,군포시,0,1,2,3,3,0,2019-11-13
4547,경기,군포시,1,0,0,1,1,0,2019-12-13
4548,경기,김포시,1,0,2,3,4,1,2019-01-13
4549,경기,김포시,2,0,0,2,1,0,2019-02-13
4550,경기,김포시,8,0,2,10,6,0,2019-03-13
4551,경기,김포시,4,0,1,5,4,0,2019-04-13
4552,경기,김포시,3,2,0,5,3,0,2019-05-13
4553,경기,김포시,4,0,3,7,7,1,2019-06-13
4554,경기,김포시,2,1,0,3,2,0,2019-07-13
4555,경기,김포시,4,0,1,5,4,0,2019-08-13
4556,경기,김포시,1,0,1,2,2,0,2019-09-13
4557,경기,김포시,6,0,0,6,3,0,2019-10-13
4558,경기,김포시,7,1,0,8,5,0,2019-11-13
4559,경기,김포시,6,0,4,10,8,0,2019-12-13
4560,경기,남양주시,10,1,1,12,7,1,2019-01-13
4561,경기,남양주시,6,2,2,10,6,0,2019-02-13
4562,경기,남양주시,7,1,1,9,8,0,2019-03-13
4563,경기,남양주시,13,1,0,14,6,0,2019-04-13
4564,경기,남양주시,8,1,2,11,4,0,2019-05-13
4565,경기,남양주시,4,3,2,9,5,0,2019-06-13
4566,경기,남양주시,7,1,1,9,6,0,2019-07-13
4567,경기,남양주시,10,0,4,14,8,0,2019-08-13
4568,경기,남양주시,10,1,3,14,8,0,2019-09-13
4569,경기,남양주시,18,0,3,21,10,0,2019-10-13
4570,경기,남양주시,11,0,2,13,11,0,2019-11-13
4571,경기,남양주시,13,1,6,20,11,0,2019-12-13
4572,경기,동두천시,0,0,0,0,0,0,2019-01-13
4573,경기,동두천시,0,0,0,0,0,0,2019-02-13
4574,경기,동두천시,1,1,0,2,2,0,2019-03-13
4575,경기,동두천시,0,0,0,0,0,0,2019-04-13
4576,경기,동두천시,1,1,0,2,2,0,2019-05-13
4577,경기,동두천시,1,0,0,1,1,0,2019-06-13
4578,경기,동두천시,0,0,0,0,0,0,2019-07-13
4579,경기,동두천시,2,0,0,2,1,0,2019-08-13
4580,경기,동두천시,2,0,0,2,1,0,2019-09-13
4581,경기,동두천시,0,0,0,0,0,0,2019-10-13
4582,경기,동두천시,1,0,0,1,1,0,2019-11-13
4583,경기,동두천시,4,0,1,5,4,0,2019-12-13
4584,경기,부천시,10,2,1,13,8,0,2019-01-13
4585,경기,부천시,9,1,0,10,8,0,2019-02-13
4586,경기,부천시,14,3,3,20,12,0,2019-03-13
4587,경기,부천시,8,1,4,13,9,0,2019-04-13
4588,경기,부천시,8,2,2,12,11,0,2019-05-13
4589,경기,부천시,15,0,2,17,15,0,2019-06-13
4590,경기,부천시,20,1,5,26,13,0,2019-07-13
4591,경기,부천시,12,0,1,13,8,0,2019-08-13
4592,경기,부천시,17,2,3,22,9,0,2019-09-13
4593,경기,부천시,7,0,5,12,9,0,2019-10-13
4594,경기,부천시,6,1,6,13,12,0,2019-11-13
4595,경기,부천시,12,0,5,17,13,0,2019-12-13
4596,경기,성남시,3,1,0,4,4,0,2019-01-13
4597,경기,성남시,11,2,8,21,13,0,2019-02-13
4598,경기,성남시,14,0,5,19,13,0,2019-03-13
4599,경기,성남시,3,0,2,5,5,0,2019-04-13
4600,경기,성남시,14,2,7,23,15,0,2019-05-13
4601,경기,성남시,14,0,1,15,12,0,2019-06-13
4602,경기,성남시,3,1,1,5,4,0,2019-07-13
4603,경기,성남시,16,1,3,20,10,0,2019-08-13
4604,경기,성남시,14,4,0,18,7,0,2019-09-13
4605,경기,성남시,22,4,5,31,13,0,2019-10-13
4606,경기,성남시,10,0,6,16,14,0,2019-11-13
4607,경기,성남시,13,1,2,16,12,0,2019-12-13
4608,경기,수원시,8,0,0,8,7,0,2019-01-13
4609,경기,수원시,6,1,1,8,6,0,2019-02-13
4610,경기,수원시,14,2,5,21,18,1,2019-03-13
4611,경기,수원시,19,0,5,24,20,0,2019-04-13
4612,경기,수원시,10,0,6,16,13,1,2019-05-13
4613,경기,수원시,15,1,4,20,18,0,2019-06-13
4614,경기,수원시,17,1,3,21,15,0,2019-07-13
4615,경기,수원시,12,2,0,14,9,0,2019-08-13
4616,경기,수원시,4,0,0,4,3,0,2019-09-13
4617,경기,수원시,12,2,3,17,13,0,2019-10-13
4618,경기,수원시,8,0,4,12,10,0,2019-11-13
4619,경기,수원시,21,3,8,32,26,0,2019-12-13
4620,경기,시흥시,6,0,1,7,4,0,2019-01-13
4621,경기,시흥시,5,1,2,8,7,0,2019-02-13
4622,경기,시흥시,2,0,0,2,2,0,2019-03-13
4623,경기,시흥시,10,1,1,12,5,0,2019-04-13
4624,경기,시흥시,2,1,0,3,3,0,2019-05-13
4625,경기,시흥시,1,1,1,3,2,0,2019-06-13
4626,경기,시흥시,7,0,2,9,5,0,2019-07-13
4627,경기,시흥시,6,1,2,9,6,0,2019-08-13
4628,경기,시흥시,15,3,2,20,5,0,2019-09-13
4629,경기,시흥시,4,3,0,7,3,0,2019-10-13
4630,경기,시흥시,12,0,4,16,10,0,2019-11-13
4631,경기,시흥시,3,0,0,3,4,1,2019-12-13
4632,경기,안산시,8,0,2,10,5,0,2019-01-13
4633,경기,안산시,7,1,0,8,6,1,2019-02-13
4634,경기,안산시,9,0,2,11,6,0,2019-03-13
4635,경기,안산시,4,2,3,9,7,0,2019-04-13
4636,경기,안산시,12,0,5,17,5,0,2019-05-13
4637,경기,안산시,7,1,3,11,10,0,2019-06-13
4638,경기,안산시,10,1,1,12,9,0,2019-07-13
4639,경기,안산시,8,0,3,11,8,0,2019-08-13
4640,경기,안산시,6,0,1,7,4,0,2019-09-13
4641,경기,안산시,6,4,2,12,8,0,2019-10-13
4642,경기,안산시,9,0,1,10,7,0,2019-11-13
4643,경기,안산시,9,0,6,15,14,0,2019-12-13
4644,경기,안성시,8,1,1,10,6,0,2019-01-13
4645,경기,안성시,3,0,1,4,2,0,2019-02-13
4646,경기,안성시,4,2,3,9,5,0,2019-03-13
4647,경기,안성시,3,0,0,3,2,0,2019-04-13
4648,경기,안성시,6,0,1,7,5,0,2019-05-13
4649,경기,안성시,7,0,1,8,5,0,2019-06-13
4650,경기,안성시,6,1,0,7,5,0,2019-07-13
4651,경기,안성시,3,0,0,3,3,0,2019-08-13
4652,경기,안성시,8,3,2,13,5,0,2019-09-13
4653,경기,안성시,0,0,2,2,2,0,2019-10-13
4654,경기,안성시,6,0,0,6,3,0,2019-11-13
4655,경기,안성시,2,0,2,4,3,0,2019-12-13
4656,경기,안양시,6,0,2,8,4,0,2019-01-13
4657,경기,안양시,2,0,1,3,3,0,2019-02-13
4658,경기,안양시,5,0,1,6,4,0,2019-03-13
4659,경기,안양시,4,0,0,4,3,0,2019-04-13
4660,경기,안양시,6,0,2,8,6,0,2019-05-13
4661,경기,안양시,7,1,1,9,5,0,2019-06-13
4662,경기,안양시,2,1,0,3,3,0,2019-07-13
4663,경기,안양시,6,0,1,7,5,0,2019-08-13
4664,경기,안양시,9,1,1,11,4,0,2019-09-13
4665,경기,안양시,2,0,2,4,3,0,2019-10-13
4666,경기,안양시,11,1,2,14,10,0,2019-11-13
4667,경기,안양시,4,0,5,9,8,0,2019-12-13
4668,경기,양주시,0,0,0,0,0,0,2019-01-13
4669,경기,양주시,3,0,0,3,2,0,2019-02-13
4670,경기,양주시,0,0,1,1,1,0,2019-03-13
4671,경기,양주시,0,0,2,2,3,1,2019-04-13
4672,경기,양주시,1,0,0,1,1,0,2019-05-13
4673,경기,양주시,2,0,0,2,2,0,2019-06-13
4674,경기,양주시,1,0,0,1,1,0,2019-07-13
4675,경기,양주시,1,0,0,1,1,0,2019-08-13
4676,경기,양주시,6,0,0,6,2,0,2019-09-13
4677,경기,양주시,0,0,1,1,1,0,2019-10-13
4678,경기,양주시,5,1,0,6,6,1,2019-11-13
4679,경기,양주시,3,0,0,3,2,0,2019-12-13
4680,경기,양평군,1,0,0,1,1,0,2019-01-13
4681,경기,양평군,0,0,0,0,0,0,2019-02-13
4682,경기,양평군,1,1,1,3,2,0,2019-03-13
4683,경기,양평군,3,0,1,4,4,0,2019-04-13
4684,경기,양평군,1,1,0,2,2,0,2019-05-13
4685,경기,양평군,1,0,2,3,3,0,2019-06-13
4686,경기,양평군,3,0,0,3,1,0,2019-07-13
4687,경기,양평군,6,0,0,6,2,0,2019-08-13
4688,경기,양평군,8,0,0,8,3,0,2019-09-13
4689,경기,양평군,2,0,3,5,2,0,2019-10-13
4690,경기,양평군,0,0,0,0,0,0,2019-11-13
4691,경기,양평군,2,0,1,3,2,0,2019-12-13
4692,경기,여주시,0,0,0,0,0,0,2019-01-13
4693,경기,여주시,0,0,0,0,0,0,2019-02-13
4694,경기,여주시,2,0,0,2,1,0,2019-03-13
4695,경기,여주시,2,0,0,2,2,0,2019-04-13
4696,경기,여주시,4,1,0,5,4,0,2019-05-13
4697,경기,여주시,0,0,0,0,0,0,2019-06-13
4698,경기,여주시,2,1,0,3,2,0,2019-07-13
4699,경기,여주시,6,0,0,6,4,0,2019-08-13
4700,경기,여주시,0,0,0,0,0,0,2019-09-13
4701,경기,여주시,1,0,1,2,1,0,2019-10-13
4702,경기,여주시,2,0,2,4,4,0,2019-11-13
4703,경기,여주시,4,0,0,4,2,0,2019-12-13
4704,경기,연천군,0,0,0,0,0,0,2019-01-13
4705,경기,연천군,0,0,0,0,0,0,2019-02-13
4706,경기,연천군,0,0,0,0,0,0,2019-03-13
4707,경기,연천군,0,0,0,0,0,0,2019-04-13
4708,경기,연천군,1,0,0,1,1,0,2019-05-13
4709,경기,연천군,0,0,0,0,0,0,2019-06-13
4710,경기,연천군,4,0,0,4,2,0,2019-07-13
4711,경기,연천군,0,0,0,0,0,0,2019-08-13
4712,경기,연천군,0,0,0,0,0,0,2019-09-13
4713,경기,연천군,2,0,1,3,2,0,2019-10-13
4714,경기,연천군,1,2,0,3,2,0,2019-11-13
4715,경기,연천군,0,0,0,0,0,0,2019-12-13
4716,경기,오산시,1,1,0,2,2,0,2019-01-13
4717,경기,오산시,1,0,0,1,1,0,2019-02-13
4718,경기,오산시,6,1,0,7,6,0,2019-03-13
4719,경기,오산시,2,0,0,2,2,0,2019-04-13
4720,경기,오산시,0,0,0,0,0,0,2019-05-13
4721,경기,오산시,4,0,0,4,3,0,2019-06-13
4722,경기,오산시,1,0,1,2,2,0,2019-07-13
4723,경기,오산시,0,0,1,1,1,0,2019-08-13
4724,경기,오산시,1,0,0,1,1,0,2019-09-13
4725,경기,오산시,2,0,0,2,2,0,2019-10-13
4726,경기,오산시,5,0,0,5,4,0,2019-11-13
4727,경기,오산시,5,3,0,8,3,0,2019-12-13
4728,경기,용인시,11,2,0,13,7,0,2019-01-13
4729,경기,용인시,11,1,2,14,8,0,2019-02-13
4730,경기,용인시,8,2,1,11,8,0,2019-03-13
4731,경기,용인시,22,5,6,33,7,0,2019-04-13
4732,경기,용인시,14,2,4,20,12,0,2019-05-13
4733,경기,용인시,8,5,3,16,11,0,2019-06-13
4734,경기,용인시,23,10,4,37,14,0,2019-07-13
4735,경기,용인시,13,3,1,17,7,0,2019-08-13
4736,경기,용인시,19,7,3,29,11,0,2019-09-13
4737,경기,용인시,8,3,3,14,9,0,2019-10-13
4738,경기,용인시,10,1,2,13,9,0,2019-11-13
4739,경기,용인시,19,1,2,22,15,0,2019-12-13
4740,경기,의왕시,1,0,1,2,2,0,2019-01-13
4741,경기,의왕시,2,1,2,5,2,0,2019-02-13
4742,경기,의왕시,0,0,0,0,0,0,2019-03-13
4743,경기,의왕시,2,1,0,3,2,0,2019-04-13
4744,경기,의왕시,0,0,0,0,0,0,2019-05-13
4745,경기,의왕시,2,2,0,4,3,0,2019-06-13
4746,경기,의왕시,0,0,0,0,0,0,2019-07-13
4747,경기,의왕시,0,0,1,1,1,0,2019-08-13
4748,경기,의왕시,1,0,0,1,1,0,2019-09-13
4749,경기,의왕시,8,1,0,9,3,0,2019-10-13
4750,경기,의왕시,0,0,1,1,1,0,2019-11-13
4751,경기,의왕시,1,0,0,1,1,0,2019-12-13
4752,경기,의정부시,1,2,0,3,3,0,2019-01-13
4753,경기,의정부시,6,0,1,7,6,0,2019-02-13
4754,경기,의정부시,3,0,1,4,3,0,2019-03-13
4755,경기,의정부시,5,0,4,9,5,0,2019-04-13
4756,경기,의정부시,3,0,1,4,4,0,2019-05-13
4757,경기,의정부시,2,2,1,5,4,0,2019-06-13
4758,경기,의정부시,5,4,0,9,6,0,2019-07-13
4759,경기,의정부시,3,2,3,8,7,0,2019-08-13
4760,경기,의정부시,4,0,1,5,4,0,2019-09-13
4761,경기,의정부시,2,1,0,3,3,0,2019-10-13
4762,경기,의정부시,2,0,0,2,2,0,2019-11-13
4763,경기,의정부시,1,0,0,1,1,0,2019-12-13
4764,경기,이천시,6,0,1,7,2,0,2019-01-13
4765,경기,이천시,2,1,0,3,3,0,2019-02-13
4766,경기,이천시,5,0,1,6,4,0,2019-03-13
4767,경기,이천시,10,0,0,10,5,0,2019-04-13
4768,경기,이천시,0,5,0,5,2,1,2019-05-13
4769,경기,이천시,2,1,1,4,3,0,2019-06-13
4770,경기,이천시,2,1,1,4,4,0,2019-07-13
4771,경기,이천시,6,1,3,10,7,0,2019-08-13
4772,경기,이천시,3,0,0,3,2,0,2019-09-13
4773,경기,이천시,0,0,0,0,0,0,2019-10-13
4774,경기,이천시,3,0,0,3,2,0,2019-11-13
4775,경기,이천시,0,0,0,0,0,0,2019-12-13
4776,경기,파주시,7,2,0,9,4,0,2019-01-13
4777,경기,파주시,1,0,0,1,1,0,2019-02-13
4778,경기,파주시,5,1,1,7,6,0,2019-03-13
4779,경기,파주시,0,0,1,1,1,0,2019-04-13
4780,경기,파주시,5,0,3,8,7,0,2019-05-13
4781,경기,파주시,2,0,2,4,4,0,2019-06-13
4782,경기,파주시,6,0,1,7,5,0,2019-07-13
4783,경기,파주시,12,3,0,15,11,0,2019-08-13
4784,경기,파주시,5,4,1,10,3,0,2019-09-13
4785,경기,파주시,7,1,1,9,5,0,2019-10-13
4786,경기,파주시,4,1,0,5,4,0,2019-11-13
4787,경기,파주시,7,0,0,7,5,0,2019-12-13
4788,경기,평택시,14,2,1,17,5,0,2019-01-13
4789,경기,평택시,12,2,3,17,12,0,2019-02-13
4790,경기,평택시,11,1,1,13,8,0,2019-03-13
4791,경기,평택시,13,1,5,19,14,0,2019-04-13
4792,경기,평택시,10,1,0,11,7,1,2019-05-13
4793,경기,평택시,12,4,5,21,12,0,2019-06-13
4794,경기,평택시,10,0,8,18,11,0,2019-07-13
4795,경기,평택시,14,1,4,19,17,0,2019-08-13
4796,경기,평택시,10,5,1,16,8,1,2019-09-13
4797,경기,평택시,10,1,0,11,7,0,2019-10-13
4798,경기,평택시,11,1,3,15,10,0,2019-11-13
4799,경기,평택시,11,5,3,19,11,0,2019-12-13
4800,경기,포천시,0,0,0,0,0,0,2019-01-13
4801,경기,포천시,0,0,2,2,1,0,2019-02-13
4802,경기,포천시,4,1,0,5,4,0,2019-03-13
4803,경기,포천시,1,8,1,10,3,0,2019-04-13
4804,경기,포천시,4,0,2,6,4,1,2019-05-13
4805,경기,포천시,5,0,3,8,5,0,2019-06-13
4806,경기,포천시,0,3,0,3,1,0,2019-07-13
4807,경기,포천시,5,0,3,8,3,0,2019-08-13
4808,경기,포천시,0,0,2,2,1,0,2019-09-13
4809,경기,포천시,1,0,0,1,1,0,2019-10-13
4810,경기,포천시,1,0,0,1,1,0,2019-11-13
4811,경기,포천시,4,0,3,7,3,0,2019-12-13
4812,경기,하남시,10,4,5,19,7,1,2019-01-13
4813,경기,하남시,1,0,0,1,1,0,2019-02-13
4814,경기,하남시,0,0,0,0,0,0,2019-03-13
4815,경기,하남시,2,0,1,3,3,0,2019-04-13
4816,경기,하남시,3,0,0,3,3,0,2019-05-13
4817,경기,하남시,2,0,1,3,2,0,2019-06-13
4818,경기,하남시,15,0,1,16,5,0,2019-07-13
4819,경기,하남시,1,0,0,1,1,0,2019-08-13
4820,경기,하남시,2,1,2,5,4,0,2019-09-13
4821,경기,하남시,4,5,0,9,3,0,2019-10-13
4822,경기,하남시,0,1,0,1,1,0,2019-11-13
4823,경기,하남시,4,0,0,4,2,0,2019-12-13
4824,경기,화성시,6,0,3,9,6,0,2019-01-13
4825,경기,화성시,14,0,6,20,13,0,2019-02-13
4826,경기,화성시,8,0,4,12,6,0,2019-03-13
4827,경기,화성시,10,0,1,11,8,0,2019-04-13
4828,경기,화성시,6,0,0,6,5,0,2019-05-13
4829,경기,화성시,12,1,1,14,5,0,2019-06-13
4830,경기,화성시,7,0,1,8,6,0,2019-07-13
4831,경기,화성시,14,1,5,20,13,0,2019-08-13
4832,경기,화성시,1,0,0,1,1,0,2019-09-13
4833,경기,화성시,13,0,2,15,8,0,2019-10-13
4834,경기,화성시,14,0,6,20,11,0,2019-11-13
4835,경기,화성시,10,0,5,15,9,0,2019-12-13
4836,경기,가평군,0,0,0,0,0,0,2019-01-14
4837,경기,가평군,3,1,2,6,4,0,2019-02-14
4838,경기,가평군,1,0,0,1,1,0,2019-03-14
4839,경기,가평군,0,0,0,0,0,0,2019-04-14
4840,경기,가평군,2,0,0,2,1,0,2019-05-14
4841,경기,가평군,0,0,1,1,1,0,2019-06-14
4842,경기,가평군,2,0,0,2,2,0,2019-07-14
4843,경기,가평군,0,0,1,1,1,0,2019-08-14
4844,경기,가평군,0,0,0,0,0,0,2019-09-14
4845,경기,가평군,0,0,0,0,0,0,2019-10-14
4846,경기,가평군,6,0,0,6,3,0,2019-11-14
4847,경기,가평군,2,0,2,4,2,0,2019-12-14
4848,경기,고양시,16,1,6,23,16,0,2019-01-14
4849,경기,고양시,16,3,6,25,15,0,2019-02-14
4850,경기,고양시,9,4,4,17,14,0,2019-03-14
4851,경기,고양시,6,1,1,8,6,0,2019-04-14
4852,경기,고양시,14,0,4,18,13,0,2019-05-14
4853,경기,고양시,7,3,1,11,9,0,2019-06-14
4854,경기,고양시,7,2,4,13,9,0,2019-07-14
4855,경기,고양시,12,2,2,16,10,0,2019-08-14
4856,경기,고양시,4,0,2,6,4,0,2019-09-14
4857,경기,고양시,6,1,2,9,7,0,2019-10-14
4858,경기,고양시,19,0,1,20,13,1,2019-11-14
4859,경기,고양시,9,3,0,12,8,0,2019-12-14
4860,경기,과천시,1,0,0,1,1,0,2019-01-14
4861,경기,과천시,0,0,0,0,0,0,2019-02-14
4862,경기,과천시,0,0,0,0,0,0,2019-03-14
4863,경기,과천시,0,0,0,0,0,0,2019-04-14
4864,경기,과천시,0,0,0,0,0,0,2019-05-14
4865,경기,과천시,0,1,0,1,1,0,2019-06-14
4866,경기,과천시,0,0,0,0,0,0,2019-07-14
4867,경기,과천시,0,0,0,0,0,0,2019-08-14
4868,경기,과천시,0,0,0,0,0,0,2019-09-14
4869,경기,과천시,0,0,0,0,0,0,2019-10-14
4870,경기,과천시,0,0,1,1,1,0,2019-11-14
4871,경기,과천시,3,0,0,3,1,0,2019-12-14
4872,경기,광명시,3,1,0,4,3,0,2019-01-14
4873,경기,광명시,5,2,0,7,2,0,2019-02-14
4874,경기,광명시,0,0,2,2,2,0,2019-03-14
4875,경기,광명시,1,1,1,3,2,0,2019-04-14
4876,경기,광명시,4,0,1,5,4,0,2019-05-14
4877,경기,광명시,1,4,1,6,3,0,2019-06-14
4878,경기,광명시,0,0,0,0,0,0,2019-07-14
4879,경기,광명시,1,1,1,3,2,0,2019-08-14
4880,경기,광명시,0,0,0,0,0,0,2019-09-14
4881,경기,광명시,0,1,2,3,2,0,2019-10-14
4882,경기,광명시,2,0,1,3,3,0,2019-11-14
4883,경기,광명시,2,1,2,5,5,0,2019-12-14
4884,경기,광주시,5,2,0,7,4,0,2019-01-14
4885,경기,광주시,8,0,2,10,6,0,2019-02-14
4886,경기,광주시,9,1,0,10,4,0,2019-03-14
4887,경기,광주시,4,0,3,7,3,0,2019-04-14
4888,경기,광주시,4,1,0,5,5,0,2019-05-14
4889,경기,광주시,7,0,3,10,5,0,2019-06-14
4890,경기,광주시,5,0,1,6,3,0,2019-07-14
4891,경기,광주시,11,2,5,18,11,0,2019-08-14
4892,경기,광주시,7,1,0,8,3,0,2019-09-14
4893,경기,광주시,12,1,3,16,10,0,2019-10-14
4894,경기,광주시,12,0,0,12,6,0,2019-11-14
4895,경기,광주시,4,3,0,7,4,0,2019-12-14
4896,경기,구리시,5,0,1,6,3,0,2019-01-14
4897,경기,구리시,3,0,0,3,3,0,2019-02-14
4898,경기,구리시,4,2,0,6,4,0,2019-03-14
4899,경기,구리시,6,1,1,8,2,0,2019-04-14
4900,경기,구리시,2,0,1,3,3,0,2019-05-14
4901,경기,구리시,2,0,0,2,2,0,2019-06-14
4902,경기,구리시,3,0,2,5,4,0,2019-07-14
4903,경기,구리시,5,1,1,7,5,0,2019-08-14
4904,경기,구리시,4,0,0,4,2,0,2019-09-14
4905,경기,구리시,5,0,0,5,2,0,2019-10-14
4906,경기,구리시,1,0,0,1,1,0,2019-11-14
4907,경기,구리시,4,0,2,6,5,0,2019-12-14
4908,경기,군포시,0,0,0,0,0,0,2019-01-14
4909,경기,군포시,1,0,0,1,1,0,2019-02-14
4910,경기,군포시,0,0,1,1,1,0,2019-03-14
4911,경기,군포시,0,0,3,3,2,0,2019-04-14
4912,경기,군포시,5,2,1,8,4,0,2019-05-14
4913,경기,군포시,1,0,3,4,4,0,2019-06-14
4914,경기,군포시,2,0,0,2,1,0,2019-07-14
4915,경기,군포시,7,2,1,10,3,0,2019-08-14
4916,경기,군포시,0,0,1,1,1,0,2019-09-14
4917,경기,군포시,2,0,0,2,2,0,2019-10-14
4918,경기,군포시,1,0,1,2,2,0,2019-11-14
4919,경기,군포시,3,0,1,4,2,0,2019-12-14
4920,경기,김포시,7,0,0,7,6,1,2019-01-14
4921,경기,김포시,2,0,1,3,4,1,2019-02-14
4922,경기,김포시,14,1,3,18,8,0,2019-03-14
4923,경기,김포시,5,0,3,8,5,0,2019-04-14
4924,경기,김포시,6,0,1,7,5,0,2019-05-14
4925,경기,김포시,3,0,3,6,5,0,2019-06-14
4926,경기,김포시,2,3,2,7,4,0,2019-07-14
4927,경기,김포시,7,1,4,12,11,0,2019-08-14
4928,경기,김포시,1,0,1,2,2,0,2019-09-14
4929,경기,김포시,10,0,1,11,9,0,2019-10-14
4930,경기,김포시,8,1,1,10,7,0,2019-11-14
4931,경기,김포시,1,0,1,2,2,0,2019-12-14
4932,경기,남양주시,6,0,3,9,8,0,2019-01-14
4933,경기,남양주시,6,0,1,7,5,0,2019-02-14
4934,경기,남양주시,11,0,0,11,7,0,2019-03-14
4935,경기,남양주시,6,0,1,7,4,0,2019-04-14
4936,경기,남양주시,2,2,1,5,4,0,2019-05-14
4937,경기,남양주시,10,3,2,15,7,1,2019-06-14
4938,경기,남양주시,14,0,2,16,10,0,2019-07-14
4939,경기,남양주시,2,0,0,2,2,0,2019-08-14
4940,경기,남양주시,4,1,1,6,4,0,2019-09-14
4941,경기,남양주시,7,0,0,7,5,0,2019-10-14
4942,경기,남양주시,7,4,6,17,9,0,2019-11-14
4943,경기,남양주시,4,1,1,6,3,0,2019-12-14
4944,경기,동두천시,1,0,0,1,1,0,2019-01-14
4945,경기,동두천시,1,0,0,1,1,0,2019-02-14
4946,경기,동두천시,0,0,0,0,0,0,2019-03-14
4947,경기,동두천시,0,0,0,0,0,0,2019-04-14
4948,경기,동두천시,1,0,0,1,1,0,2019-05-14
4949,경기,동두천시,0,1,0,1,1,0,2019-06-14
4950,경기,동두천시,1,0,0,1,1,0,2019-07-14
4951,경기,동두천시,1,0,0,1,1,0,2019-08-14
4952,경기,동두천시,0,0,0,0,0,0,2019-09-14
4953,경기,동두천시,2,0,0,2,2,0,2019-10-14
4954,경기,동두천시,3,0,0,3,3,0,2019-11-14
4955,경기,동두천시,5,0,0,5,2,0,2019-12-14
4956,경기,부천시,8,2,2,12,10,0,2019-01-14
4957,경기,부천시,9,3,1,13,10,0,2019-02-14
4958,경기,부천시,10,3,2,15,11,0,2019-03-14
4959,경기,부천시,10,1,3,14,9,0,2019-04-14
4960,경기,부천시,4,0,3,7,7,0,2019-05-14
4961,경기,부천시,22,1,4,27,16,0,2019-06-14
4962,경기,부천시,6,0,1,7,5,0,2019-07-14
4963,경기,부천시,15,0,1,16,8,0,2019-08-14
4964,경기,부천시,7,0,1,8,5,0,2019-09-14
4965,경기,부천시,11,0,3,14,11,0,2019-10-14
4966,경기,부천시,12,1,4,17,10,0,2019-11-14
4967,경기,부천시,16,2,5,23,17,2,2019-12-14
4968,경기,성남시,7,0,5,12,9,0,2019-01-14
4969,경기,성남시,15,2,3,20,12,1,2019-02-14
4970,경기,성남시,6,0,2,8,8,0,2019-03-14
4971,경기,성남시,10,1,3,14,11,0,2019-04-14
4972,경기,성남시,9,3,2,14,12,1,2019-05-14
4973,경기,성남시,10,1,1,12,9,0,2019-06-14
4974,경기,성남시,16,1,5,22,10,0,2019-07-14
4975,경기,성남시,7,2,3,12,10,0,2019-08-14
4976,경기,성남시,0,1,3,4,4,0,2019-09-14
4977,경기,성남시,5,2,0,7,7,0,2019-10-14
4978,경기,성남시,11,2,2,15,14,0,2019-11-14
4979,경기,성남시,17,1,7,25,14,0,2019-12-14
4980,경기,수원시,13,0,4,17,12,0,2019-01-14
4981,경기,수원시,16,1,5,22,13,0,2019-02-14
4982,경기,수원시,20,4,3,27,19,0,2019-03-14
4983,경기,수원시,10,0,0,10,9,0,2019-04-14
4984,경기,수원시,11,0,7,18,15,0,2019-05-14
4985,경기,수원시,15,0,6,21,16,0,2019-06-14
4986,경기,수원시,13,2,4,19,15,0,2019-07-14
4987,경기,수원시,24,5,7,36,23,0,2019-08-14
4988,경기,수원시,8,4,1,13,7,0,2019-09-14
4989,경기,수원시,9,1,6,16,13,0,2019-10-14
4990,경기,수원시,23,6,5,34,21,0,2019-11-14
4991,경기,수원시,20,5,4,29,18,0,2019-12-14
4992,경기,시흥시,6,0,2,8,5,1,2019-01-14
4993,경기,시흥시,7,0,4,11,8,0,2019-02-14
4994,경기,시흥시,5,1,2,8,7,0,2019-03-14
4995,경기,시흥시,6,0,3,9,7,0,2019-04-14
4996,경기,시흥시,1,0,0,1,1,0,2019-05-14
4997,경기,시흥시,5,1,2,8,6,0,2019-06-14
4998,경기,시흥시,11,0,4,15,7,0,2019-07-14
4999,경기,시흥시,13,0,1,14,10,0,2019-08-14
5000,경기,시흥시,5,0,1,6,3,0,2019-09-14
5001,경기,시흥시,9,2,0,11,6,0,2019-10-14
5002,경기,시흥시,9,1,3,13,10,0,2019-11-14
5003,경기,시흥시,2,0,6,8,6,0,2019-12-14
5004,경기,안산시,4,1,3,8,5,0,2019-01-14
5005,경기,안산시,19,1,2,22,12,0,2019-02-14
5006,경기,안산시,16,0,1,17,12,0,2019-03-14
5007,경기,안산시,12,0,3,15,9,0,2019-04-14
5008,경기,안산시,12,0,5,17,13,0,2019-05-14
5009,경기,안산시,21,1,5,27,17,0,2019-06-14
5010,경기,안산시,9,0,1,10,7,0,2019-07-14
5011,경기,안산시,13,0,2,15,12,0,2019-08-14
5012,경기,안산시,6,0,0,6,2,0,2019-09-14
5013,경기,안산시,7,2,0,9,7,0,2019-10-14
5014,경기,안산시,8,0,2,10,8,0,2019-11-14
5015,경기,안산시,17,1,1,19,10,0,2019-12-14
5016,경기,안성시,2,0,0,2,2,0,2019-01-14
5017,경기,안성시,1,0,0,1,1,0,2019-02-14
5018,경기,안성시,4,0,1,5,4,0,2019-03-14
5019,경기,안성시,4,0,0,4,2,0,2019-04-14
5020,경기,안성시,0,0,1,1,1,0,2019-05-14
5021,경기,안성시,3,0,4,7,4,0,2019-06-14
5022,경기,안성시,1,0,1,2,2,0,2019-07-14
5023,경기,안성시,1,0,2,3,2,0,2019-08-14
5024,경기,안성시,1,1,0,2,1,0,2019-09-14
5025,경기,안성시,2,2,1,5,4,1,2019-10-14
5026,경기,안성시,2,0,1,3,3,0,2019-11-14
5027,경기,안성시,7,0,3,10,5,0,2019-12-14
5028,경기,안양시,4,0,0,4,3,0,2019-01-14
5029,경기,안양시,5,0,1,6,3,0,2019-02-14
5030,경기,안양시,2,0,0,2,2,0,2019-03-14
5031,경기,안양시,7,0,1,8,6,0,2019-04-14
5032,경기,안양시,4,0,3,7,7,0,2019-05-14
5033,경기,안양시,1,0,1,2,2,0,2019-06-14
5034,경기,안양시,3,0,1,4,2,0,2019-07-14
5035,경기,안양시,0,0,2,2,2,0,2019-08-14
5036,경기,안양시,0,2,0,2,2,0,2019-09-14
5037,경기,안양시,6,1,2,9,6,0,2019-10-14
5038,경기,안양시,5,1,3,9,7,1,2019-11-14
5039,경기,안양시,9,1,2,12,10,0,2019-12-14
5040,경기,양주시,0,0,0,0,0,0,2019-01-14
5041,경기,양주시,1,2,0,3,2,0,2019-02-14
5042,경기,양주시,4,1,2,7,6,0,2019-03-14
5043,경기,양주시,2,0,0,2,1,0,2019-04-14
5044,경기,양주시,12,1,1,14,10,0,2019-05-14
5045,경기,양주시,11,0,3,14,10,0,2019-06-14
5046,경기,양주시,4,0,0,4,4,0,2019-07-14
5047,경기,양주시,7,0,2,9,5,0,2019-08-14
5048,경기,양주시,0,0,0,0,0,0,2019-09-14
5049,경기,양주시,2,0,0,2,1,0,2019-10-14
5050,경기,양주시,12,0,7,19,8,0,2019-11-14
5051,경기,양주시,4,0,0,4,4,0,2019-12-14
5052,경기,양평군,0,0,0,0,0,0,2019-01-14
5053,경기,양평군,1,0,0,1,2,1,2019-02-14
5054,경기,양평군,1,0,0,1,1,0,2019-03-14
5055,경기,양평군,0,0,1,1,1,0,2019-04-14
5056,경기,양평군,0,1,0,1,1,0,2019-05-14
5057,경기,양평군,1,0,1,2,1,0,2019-06-14
5058,경기,양평군,1,0,0,1,1,0,2019-07-14
5059,경기,양평군,1,0,0,1,1,0,2019-08-14
5060,경기,양평군,5,0,1,6,5,0,2019-09-14
5061,경기,양평군,1,0,2,3,3,0,2019-10-14
5062,경기,양평군,0,0,0,0,1,1,2019-11-14
5063,경기,양평군,1,1,0,2,2,0,2019-12-14
5064,경기,여주시,2,0,0,2,2,0,2019-01-14
5065,경기,여주시,3,1,0,4,3,0,2019-02-14
5066,경기,여주시,0,0,0,0,0,0,2019-03-14
5067,경기,여주시,3,0,1,4,2,1,2019-04-14
5068,경기,여주시,6,0,0,6,3,1,2019-05-14
5069,경기,여주시,2,0,0,2,1,0,2019-06-14
5070,경기,여주시,2,0,4,6,2,0,2019-07-14
5071,경기,여주시,7,0,1,8,5,0,2019-08-14
5072,경기,여주시,4,0,1,5,3,1,2019-09-14
5073,경기,여주시,2,0,3,5,3,0,2019-10-14
5074,경기,여주시,0,0,0,0,0,0,2019-11-14
5075,경기,여주시,4,0,2,6,2,0,2019-12-14
5076,경기,연천군,0,0,1,1,1,0,2019-01-14
5077,경기,연천군,0,0,0,0,0,0,2019-02-14
5078,경기,연천군,0,0,0,0,0,0,2019-03-14
5079,경기,연천군,1,0,1,2,1,0,2019-04-14
5080,경기,연천군,0,0,0,0,0,0,2019-05-14
5081,경기,연천군,0,0,0,0,0,0,2019-06-14
5082,경기,연천군,0,0,0,0,0,0,2019-07-14
5083,경기,연천군,0,0,0,0,0,0,2019-08-14
5084,경기,연천군,0,0,0,0,0,0,2019-09-14
5085,경기,연천군,0,0,0,0,0,0,2019-10-14
5086,경기,연천군,0,0,0,0,0,0,2019-11-14
5087,경기,연천군,5,0,0,5,3,0,2019-12-14
5088,경기,오산시,3,0,0,3,1,0,2019-01-14
5089,경기,오산시,2,0,0,2,3,1,2019-02-14
5090,경기,오산시,1,0,0,1,1,0,2019-03-14
5091,경기,오산시,2,1,1,4,3,0,2019-04-14
5092,경기,오산시,8,1,0,9,7,0,2019-05-14
5093,경기,오산시,2,2,0,4,4,0,2019-06-14
5094,경기,오산시,5,0,1,6,1,0,2019-07-14
5095,경기,오산시,13,0,0,13,6,0,2019-08-14
5096,경기,오산시,0,0,1,1,1,0,2019-09-14
5097,경기,오산시,7,1,3,11,6,0,2019-10-14
5098,경기,오산시,1,0,1,2,2,0,2019-11-14
5099,경기,오산시,4,0,1,5,3,0,2019-12-14
5100,경기,용인시,10,0,2,12,6,0,2019-01-14
5101,경기,용인시,11,0,2,13,9,0,2019-02-14
5102,경기,용인시,5,2,4,11,10,0,2019-03-14
5103,경기,용인시,4,0,1,5,2,0,2019-04-14
5104,경기,용인시,9,0,2,11,8,0,2019-05-14
5105,경기,용인시,6,0,4,10,9,0,2019-06-14
5106,경기,용인시,11,4,4,19,12,0,2019-07-14
5107,경기,용인시,17,0,4,21,12,0,2019-08-14
5108,경기,용인시,1,1,0,2,2,0,2019-09-14
5109,경기,용인시,14,0,2,16,10,0,2019-10-14
5110,경기,용인시,16,14,2,32,17,0,2019-11-14
5111,경기,용인시,10,1,1,12,8,0,2019-12-14
5112,경기,의왕시,0,0,0,0,0,0,2019-01-14
5113,경기,의왕시,7,0,2,9,2,0,2019-02-14
5114,경기,의왕시,2,0,1,3,2,0,2019-03-14
5115,경기,의왕시,0,0,0,0,0,0,2019-04-14
5116,경기,의왕시,1,0,0,1,1,0,2019-05-14
5117,경기,의왕시,0,0,1,1,1,0,2019-06-14
5118,경기,의왕시,0,0,0,0,0,0,2019-07-14
5119,경기,의왕시,1,0,1,2,1,0,2019-08-14
5120,경기,의왕시,0,0,0,0,0,0,2019-09-14
5121,경기,의왕시,2,0,1,3,3,0,2019-10-14
5122,경기,의왕시,10,0,0,10,3,0,2019-11-14
5123,경기,의왕시,1,0,1,2,2,0,2019-12-14
5124,경기,의정부시,5,0,0,5,4,0,2019-01-14
5125,경기,의정부시,7,1,1,9,5,0,2019-02-14
5126,경기,의정부시,9,0,3,12,9,0,2019-03-14
5127,경기,의정부시,5,2,1,8,4,0,2019-04-14
5128,경기,의정부시,10,4,2,16,11,0,2019-05-14
5129,경기,의정부시,0,1,3,4,2,0,2019-06-14
5130,경기,의정부시,1,1,2,4,4,0,2019-07-14
5131,경기,의정부시,5,1,1,7,4,0,2019-08-14
5132,경기,의정부시,1,6,0,7,3,0,2019-09-14
5133,경기,의정부시,9,0,1,10,7,1,2019-10-14
5134,경기,의정부시,7,1,4,12,10,0,2019-11-14
5135,경기,의정부시,7,2,1,10,9,1,2019-12-14
5136,경기,이천시,1,0,0,1,1,0,2019-01-14
5137,경기,이천시,2,2,1,5,4,1,2019-02-14
5138,경기,이천시,0,0,0,0,0,0,2019-03-14
5139,경기,이천시,0,0,1,1,1,0,2019-04-14
5140,경기,이천시,6,0,2,8,5,0,2019-05-14
5141,경기,이천시,2,0,2,4,4,0,2019-06-14
5142,경기,이천시,1,0,0,1,1,0,2019-07-14
5143,경기,이천시,5,0,3,8,6,1,2019-08-14
5144,경기,이천시,0,2,0,2,1,0,2019-09-14
5145,경기,이천시,4,0,1,5,4,0,2019-10-14
5146,경기,이천시,5,0,0,5,3,0,2019-11-14
5147,경기,이천시,3,0,0,3,3,0,2019-12-14
5148,경기,파주시,4,0,0,4,2,0,2019-01-14
5149,경기,파주시,3,0,0,3,3,0,2019-02-14
5150,경기,파주시,2,0,1,3,3,0,2019-03-14
5151,경기,파주시,3,0,0,3,3,1,2019-04-14
5152,경기,파주시,4,1,1,6,5,0,2019-05-14
5153,경기,파주시,3,0,0,3,3,0,2019-06-14
5154,경기,파주시,5,0,0,5,3,0,2019-07-14
5155,경기,파주시,12,0,0,12,6,0,2019-08-14
5156,경기,파주시,4,0,0,4,2,1,2019-09-14
5157,경기,파주시,4,1,4,9,7,0,2019-10-14
5158,경기,파주시,3,0,1,4,3,0,2019-11-14
5159,경기,파주시,10,0,4,14,10,0,2019-12-14
5160,경기,평택시,7,0,3,10,8,0,2019-01-14
5161,경기,평택시,11,2,1,14,9,1,2019-02-14
5162,경기,평택시,19,1,6,26,14,3,2019-03-14
5163,경기,평택시,5,0,1,6,3,0,2019-04-14
5164,경기,평택시,26,0,2,28,12,0,2019-05-14
5165,경기,평택시,9,1,0,10,8,0,2019-06-14
5166,경기,평택시,8,4,4,16,12,0,2019-07-14
5167,경기,평택시,9,2,1,12,10,0,2019-08-14
5168,경기,평택시,7,1,0,8,4,0,2019-09-14
5169,경기,평택시,14,1,4,19,14,0,2019-10-14
5170,경기,평택시,8,0,3,11,5,0,2019-11-14
5171,경기,평택시,6,3,6,15,12,0,2019-12-14
5172,경기,포천시,0,0,0,0,0,0,2019-01-14
5173,경기,포천시,3,0,1,4,3,0,2019-02-14
5174,경기,포천시,6,0,0,6,3,0,2019-03-14
5175,경기,포천시,0,1,0,1,1,0,2019-04-14
5176,경기,포천시,1,0,0,1,1,0,2019-05-14
5177,경기,포천시,1,0,0,1,1,0,2019-06-14
5178,경기,포천시,10,0,2,12,5,0,2019-07-14
5179,경기,포천시,3,1,0,4,4,0,2019-08-14
5180,경기,포천시,3,0,2,5,3,0,2019-09-14
5181,경기,포천시,5,0,0,5,4,0,2019-10-14
5182,경기,포천시,1,0,0,1,1,0,2019-11-14
5183,경기,포천시,5,1,2,8,7,0,2019-12-14
5184,경기,하남시,1,0,1,2,2,0,2019-01-14
5185,경기,하남시,4,0,1,5,4,0,2019-02-14
5186,경기,하남시,7,1,0,8,4,0,2019-03-14
5187,경기,하남시,2,0,0,2,2,0,2019-04-14
5188,경기,하남시,7,1,0,8,3,0,2019-05-14
5189,경기,하남시,3,0,0,3,2,0,2019-06-14
5190,경기,하남시,1,0,0,1,1,0,2019-07-14
5191,경기,하남시,2,1,0,3,3,0,2019-08-14
5192,경기,하남시,0,0,1,1,1,0,2019-09-14
5193,경기,하남시,3,1,1,5,2,0,2019-10-14
5194,경기,하남시,3,1,1,5,3,0,2019-11-14
5195,경기,하남시,8,1,0,9,4,0,2019-12-14
5196,경기,화성시,5,0,3,8,6,0,2019-01-14
5197,경기,화성시,6,1,3,10,8,0,2019-02-14
5198,경기,화성시,6,0,4,10,8,0,2019-03-14
5199,경기,화성시,7,0,1,8,4,0,2019-04-14
5200,경기,화성시,13,1,2,16,11,0,2019-05-14
5201,경기,화성시,7,0,2,9,7,0,2019-06-14
5202,경기,화성시,3,0,1,4,4,0,2019-07-14
5203,경기,화성시,8,0,3,11,10,0,2019-08-14
5204,경기,화성시,4,0,2,6,3,0,2019-09-14
5205,경기,화성시,8,1,2,11,10,0,2019-10-14
5206,경기,화성시,6,0,0,6,7,1,2019-11-14
5207,경기,화성시,15,0,3,18,12,0,2019-12-14
5208,경기,가평군,1,0,0,1,1,0,2019-01-15
5209,경기,가평군,0,0,1,1,1,0,2019-02-15
5210,경기,가평군,0,0,0,0,0,0,2019-03-15
5211,경기,가평군,0,0,0,0,0,0,2019-04-15
5212,경기,가평군,1,0,3,4,3,0,2019-05-15
5213,경기,가평군,5,0,4,9,5,0,2019-06-15
5214,경기,가평군,0,0,1,1,1,0,2019-07-15
5215,경기,가평군,2,0,0,2,2,1,2019-08-15
5216,경기,가평군,4,1,1,6,3,0,2019-09-15
5217,경기,가평군,0,0,0,0,0,0,2019-10-15
5218,경기,가평군,0,0,1,1,1,0,2019-11-15
5219,경기,가평군,5,1,1,7,3,0,2019-12-15
5220,경기,고양시,12,1,2,15,7,0,2019-01-15
5221,경기,고양시,17,1,2,20,10,0,2019-02-15
5222,경기,고양시,6,0,2,8,8,1,2019-03-15
5223,경기,고양시,11,1,4,16,14,0,2019-04-15
5224,경기,고양시,12,3,2,17,14,0,2019-05-15
5225,경기,고양시,16,1,2,19,13,0,2019-06-15
5226,경기,고양시,7,2,4,13,8,0,2019-07-15
5227,경기,고양시,28,1,5,34,16,0,2019-08-15
5228,경기,고양시,5,0,2,7,7,0,2019-09-15
5229,경기,고양시,12,0,7,19,15,0,2019-10-15
5230,경기,고양시,17,7,3,27,17,1,2019-11-15
5231,경기,고양시,9,1,4,14,8,1,2019-12-15
5232,경기,과천시,0,0,0,0,0,0,2019-01-15
5233,경기,과천시,0,0,0,0,0,0,2019-02-15
5234,경기,과천시,0,0,1,1,1,0,2019-03-15
5235,경기,과천시,0,0,0,0,0,0,2019-04-15
5236,경기,과천시,0,0,0,0,0,0,2019-05-15
5237,경기,과천시,0,0,0,0,0,0,2019-06-15
5238,경기,과천시,0,1,0,1,1,0,2019-07-15
5239,경기,과천시,0,0,0,0,0,0,2019-08-15
5240,경기,과천시,2,2,0,4,1,0,2019-09-15
5241,경기,과천시,0,0,0,0,0,0,2019-10-15
5242,경기,과천시,0,0,0,0,0,0,2019-11-15
5243,경기,과천시,0,0,0,0,0,0,2019-12-15
5244,경기,광명시,1,1,1,3,4,1,2019-01-15
5245,경기,광명시,7,1,0,8,4,0,2019-02-15
5246,경기,광명시,0,1,2,3,3,0,2019-03-15
5247,경기,광명시,5,4,1,10,6,0,2019-04-15
5248,경기,광명시,5,1,0,6,4,0,2019-05-15
5249,경기,광명시,5,0,1,6,4,1,2019-06-15
5250,경기,광명시,3,0,1,4,3,0,2019-07-15
5251,경기,광명시,2,2,1,5,3,0,2019-08-15
5252,경기,광명시,2,1,2,5,4,0,2019-09-15
5253,경기,광명시,5,0,1,6,3,0,2019-10-15
5254,경기,광명시,6,1,1,8,6,0,2019-11-15
5255,경기,광명시,0,0,0,0,0,0,2019-12-15
5256,경기,광주시,0,0,1,1,1,0,2019-01-15
5257,경기,광주시,6,0,0,6,4,0,2019-02-15
5258,경기,광주시,6,0,0,6,5,0,2019-03-15
5259,경기,광주시,3,0,1,4,4,0,2019-04-15
5260,경기,광주시,4,0,0,4,2,0,2019-05-15
5261,경기,광주시,12,0,2,14,7,0,2019-06-15
5262,경기,광주시,3,0,0,3,2,0,2019-07-15
5263,경기,광주시,6,0,0,6,2,0,2019-08-15
5264,경기,광주시,9,0,1,10,4,0,2019-09-15
5265,경기,광주시,3,1,0,4,4,0,2019-10-15
5266,경기,광주시,14,0,2,16,12,0,2019-11-15
5267,경기,광주시,7,0,4,11,7,0,2019-12-15
5268,경기,구리시,4,0,1,5,4,0,2019-01-15
5269,경기,구리시,0,0,1,1,2,1,2019-02-15
5270,경기,구리시,11,0,0,11,8,0,2019-03-15
5271,경기,구리시,3,1,2,6,2,0,2019-04-15
5272,경기,구리시,4,0,0,4,3,0,2019-05-15
5273,경기,구리시,6,1,0,7,1,0,2019-06-15
5274,경기,구리시,3,0,2,5,2,0,2019-07-15
5275,경기,구리시,6,0,0,6,4,0,2019-08-15
5276,경기,구리시,2,0,0,2,2,0,2019-09-15
5277,경기,구리시,1,0,0,1,1,0,2019-10-15
5278,경기,구리시,2,1,2,5,3,0,2019-11-15
5279,경기,구리시,0,0,0,0,0,0,2019-12-15
5280,경기,군포시,4,1,0,5,2,0,2019-01-15
5281,경기,군포시,0,1,1,2,2,0,2019-02-15
5282,경기,군포시,0,1,1,2,2,0,2019-03-15
5283,경기,군포시,1,0,0,1,1,0,2019-04-15
5284,경기,군포시,0,0,0,0,0,0,2019-05-15
5285,경기,군포시,7,1,4,12,6,0,2019-06-15
5286,경기,군포시,2,0,1,3,2,0,2019-07-15
5287,경기,군포시,2,0,1,3,1,0,2019-08-15
5288,경기,군포시,0,0,0,0,0,0,2019-09-15
5289,경기,군포시,4,0,2,6,3,0,2019-10-15
5290,경기,군포시,5,1,0,6,2,0,2019-11-15
5291,경기,군포시,2,0,0,2,1,0,2019-12-15
5292,경기,김포시,0,0,1,1,1,0,2019-01-15
5293,경기,김포시,11,0,3,14,7,0,2019-02-15
5294,경기,김포시,5,2,4,11,8,0,2019-03-15
5295,경기,김포시,3,0,2,5,5,0,2019-04-15
5296,경기,김포시,7,0,1,8,5,0,2019-05-15
5297,경기,김포시,5,0,4,9,9,0,2019-06-15
5298,경기,김포시,3,0,4,7,6,0,2019-07-15
5299,경기,김포시,5,0,1,6,4,0,2019-08-15
5300,경기,김포시,2,1,0,3,3,0,2019-09-15
5301,경기,김포시,6,0,1,7,5,0,2019-10-15
5302,경기,김포시,3,1,2,6,4,0,2019-11-15
5303,경기,김포시,3,0,0,3,3,0,2019-12-15
5304,경기,남양주시,3,1,3,7,6,0,2019-01-15
5305,경기,남양주시,16,0,3,19,11,0,2019-02-15
5306,경기,남양주시,10,0,2,12,9,0,2019-03-15
5307,경기,남양주시,7,1,2,10,7,0,2019-04-15
5308,경기,남양주시,7,1,3,11,9,0,2019-05-15
5309,경기,남양주시,9,0,1,10,6,0,2019-06-15
5310,경기,남양주시,3,0,0,3,3,0,2019-07-15
5311,경기,남양주시,6,0,1,7,3,0,2019-08-15
5312,경기,남양주시,6,1,3,10,9,1,2019-09-15
5313,경기,남양주시,7,0,2,9,7,0,2019-10-15
5314,경기,남양주시,10,1,2,13,10,0,2019-11-15
5315,경기,남양주시,5,0,0,5,4,0,2019-12-15
5316,경기,동두천시,2,0,1,3,3,0,2019-01-15
5317,경기,동두천시,2,0,1,3,3,0,2019-02-15
5318,경기,동두천시,0,0,0,0,0,0,2019-03-15
5319,경기,동두천시,1,1,0,2,2,0,2019-04-15
5320,경기,동두천시,0,0,0,0,0,0,2019-05-15
5321,경기,동두천시,1,0,0,1,1,0,2019-06-15
5322,경기,동두천시,0,0,0,0,0,0,2019-07-15
5323,경기,동두천시,0,0,1,1,1,0,2019-08-15
5324,경기,동두천시,0,0,1,1,1,0,2019-09-15
5325,경기,동두천시,4,0,0,4,3,0,2019-10-15
5326,경기,동두천시,2,0,1,3,2,0,2019-11-15
5327,경기,동두천시,0,0,0,0,0,0,2019-12-15
5328,경기,부천시,4,0,2,6,6,0,2019-01-15
5329,경기,부천시,24,2,3,29,10,0,2019-02-15
5330,경기,부천시,14,2,2,18,12,0,2019-03-15
5331,경기,부천시,17,1,6,24,17,0,2019-04-15
5332,경기,부천시,8,0,1,9,7,0,2019-05-15
5333,경기,부천시,6,3,2,11,11,0,2019-06-15
5334,경기,부천시,8,2,2,12,10,0,2019-07-15
5335,경기,부천시,11,5,0,16,12,1,2019-08-15
5336,경기,부천시,6,1,0,7,4,0,2019-09-15
5337,경기,부천시,14,1,1,16,12,0,2019-10-15
5338,경기,부천시,19,1,6,26,17,0,2019-11-15
5339,경기,부천시,6,1,1,8,8,1,2019-12-15
5340,경기,성남시,13,2,3,18,9,0,2019-01-15
5341,경기,성남시,9,3,2,14,8,0,2019-02-15
5342,경기,성남시,15,1,4,20,11,0,2019-03-15
5343,경기,성남시,11,3,1,15,10,0,2019-04-15
5344,경기,성남시,7,1,5,13,10,0,2019-05-15
5345,경기,성남시,16,3,3,22,13,0,2019-06-15
5346,경기,성남시,22,2,3,27,15,0,2019-07-15
5347,경기,성남시,17,1,4,22,14,0,2019-08-15
5348,경기,성남시,3,0,2,5,3,0,2019-09-15
5349,경기,성남시,17,1,4,22,16,0,2019-10-15
5350,경기,성남시,9,2,6,17,14,0,2019-11-15
5351,경기,성남시,11,3,3,17,13,0,2019-12-15
5352,경기,수원시,15,0,3,18,10,0,2019-01-15
5353,경기,수원시,15,3,4,22,14,0,2019-02-15
5354,경기,수원시,24,1,3,28,21,0,2019-03-15
5355,경기,수원시,14,1,5,20,15,0,2019-04-15
5356,경기,수원시,15,0,7,22,15,0,2019-05-15
5357,경기,수원시,18,1,4,23,18,1,2019-06-15
5358,경기,수원시,14,4,0,18,13,0,2019-07-15
5359,경기,수원시,7,0,3,10,7,0,2019-08-15
5360,경기,수원시,11,0,2,13,10,0,2019-09-15
5361,경기,수원시,30,4,5,39,23,0,2019-10-15
5362,경기,수원시,19,2,5,26,19,1,2019-11-15
5363,경기,수원시,8,3,4,15,9,0,2019-12-15
5364,경기,시흥시,6,1,3,10,9,0,2019-01-15
5365,경기,시흥시,15,1,8,24,18,0,2019-02-15
5366,경기,시흥시,13,0,1,14,13,0,2019-03-15
5367,경기,시흥시,5,0,1,6,6,0,2019-04-15
5368,경기,시흥시,12,0,2,14,10,1,2019-05-15
5369,경기,시흥시,19,0,2,21,7,0,2019-06-15
5370,경기,시흥시,6,0,1,7,7,0,2019-07-15
5371,경기,시흥시,8,1,3,12,7,0,2019-08-15
5372,경기,시흥시,7,2,1,10,5,0,2019-09-15
5373,경기,시흥시,21,1,6,28,16,0,2019-10-15
5374,경기,시흥시,8,1,3,12,8,0,2019-11-15
5375,경기,시흥시,4,1,0,5,3,0,2019-12-15
5376,경기,안산시,11,0,1,12,6,0,2019-01-15
5377,경기,안산시,16,0,4,20,10,0,2019-02-15
5378,경기,안산시,17,3,3,23,18,0,2019-03-15
5379,경기,안산시,18,1,5,24,13,0,2019-04-15
5380,경기,안산시,23,1,6,30,19,0,2019-05-15
5381,경기,안산시,13,3,1,17,11,0,2019-06-15
5382,경기,안산시,12,1,0,13,9,0,2019-07-15
5383,경기,안산시,17,2,1,20,12,0,2019-08-15
5384,경기,안산시,10,0,2,12,9,0,2019-09-15
5385,경기,안산시,7,1,4,12,11,1,2019-10-15
5386,경기,안산시,16,0,2,18,13,0,2019-11-15
5387,경기,안산시,15,3,5,23,13,0,2019-12-15
5388,경기,안성시,3,0,2,5,2,0,2019-01-15
5389,경기,안성시,5,0,1,6,3,0,2019-02-15
5390,경기,안성시,0,0,1,1,1,0,2019-03-15
5391,경기,안성시,3,0,0,3,1,0,2019-04-15
5392,경기,안성시,3,0,2,5,4,0,2019-05-15
5393,경기,안성시,0,0,0,0,0,0,2019-06-15
5394,경기,안성시,1,0,2,3,2,0,2019-07-15
5395,경기,안성시,0,0,0,0,0,0,2019-08-15
5396,경기,안성시,3,1,0,4,2,0,2019-09-15
5397,경기,안성시,3,3,1,7,5,0,2019-10-15
5398,경기,안성시,1,0,0,1,1,0,2019-11-15
5399,경기,안성시,0,2,0,2,2,0,2019-12-15
5400,경기,안양시,3,1,2,6,6,0,2019-01-15
5401,경기,안양시,6,0,0,6,4,0,2019-02-15
5402,경기,안양시,8,0,5,13,5,0,2019-03-15
5403,경기,안양시,5,0,1,6,5,0,2019-04-15
5404,경기,안양시,4,0,0,4,3,0,2019-05-15
5405,경기,안양시,7,0,1,8,3,0,2019-06-15
5406,경기,안양시,2,0,0,2,2,0,2019-07-15
5407,경기,안양시,3,0,0,3,1,0,2019-08-15
5408,경기,안양시,7,0,3,10,5,0,2019-09-15
5409,경기,안양시,2,1,0,3,3,0,2019-10-15
5410,경기,안양시,3,2,2,7,6,0,2019-11-15
5411,경기,안양시,3,0,0,3,2,0,2019-12-15
5412,경기,양주시,1,0,1,2,1,0,2019-01-15
5413,경기,양주시,19,2,2,23,9,1,2019-02-15
5414,경기,양주시,3,1,0,4,3,0,2019-03-15
5415,경기,양주시,9,0,0,9,2,0,2019-04-15
5416,경기,양주시,4,1,0,5,3,0,2019-05-15
5417,경기,양주시,6,0,4,10,7,0,2019-06-15
5418,경기,양주시,1,1,0,2,2,0,2019-07-15
5419,경기,양주시,1,1,2,4,4,0,2019-08-15
5420,경기,양주시,17,0,2,19,4,0,2019-09-15
5421,경기,양주시,4,0,0,4,4,0,2019-10-15
5422,경기,양주시,3,1,0,4,3,0,2019-11-15
5423,경기,양주시,2,0,0,2,1,0,2019-12-15
5424,경기,양평군,0,0,0,0,0,0,2019-01-15
5425,경기,양평군,5,0,10,15,6,0,2019-02-15
5426,경기,양평군,3,0,0,3,2,0,2019-03-15
5427,경기,양평군,2,0,0,2,1,0,2019-04-15
5428,경기,양평군,3,0,0,3,2,1,2019-05-15
5429,경기,양평군,2,2,1,5,3,0,2019-06-15
5430,경기,양평군,0,0,2,2,1,0,2019-07-15
5431,경기,양평군,1,0,0,1,1,0,2019-08-15
5432,경기,양평군,0,0,0,0,0,0,2019-09-15
5433,경기,양평군,2,0,1,3,2,0,2019-10-15
5434,경기,양평군,8,0,4,12,7,0,2019-11-15
5435,경기,양평군,0,0,0,0,0,0,2019-12-15
5436,경기,여주시,1,0,0,1,1,0,2019-01-15
5437,경기,여주시,0,1,1,2,2,0,2019-02-15
5438,경기,여주시,1,0,0,1,1,0,2019-03-15
5439,경기,여주시,0,0,0,0,0,0,2019-04-15
5440,경기,여주시,4,0,0,4,2,0,2019-05-15
5441,경기,여주시,10,0,0,10,4,0,2019-06-15
5442,경기,여주시,7,0,1,8,4,0,2019-07-15
5443,경기,여주시,8,0,0,8,4,0,2019-08-15
5444,경기,여주시,4,0,0,4,3,0,2019-09-15
5445,경기,여주시,5,1,0,6,2,0,2019-10-15
5446,경기,여주시,0,0,0,0,0,0,2019-11-15
5447,경기,여주시,2,0,0,2,1,0,2019-12-15
5448,경기,연천군,0,0,0,0,0,0,2019-01-15
5449,경기,연천군,0,0,1,1,1,0,2019-02-15
5450,경기,연천군,0,0,0,0,0,0,2019-03-15
5451,경기,연천군,0,0,2,2,1,0,2019-04-15
5452,경기,연천군,0,0,0,0,0,0,2019-05-15
5453,경기,연천군,0,0,0,0,0,0,2019-06-15
5454,경기,연천군,4,0,1,5,2,0,2019-07-15
5455,경기,연천군,1,0,0,1,1,0,2019-08-15
5456,경기,연천군,0,0,0,0,0,0,2019-09-15
5457,경기,연천군,0,0,2,2,2,0,2019-10-15
5458,경기,연천군,1,0,0,1,1,0,2019-11-15
5459,경기,연천군,0,0,0,0,0,0,2019-12-15
5460,경기,오산시,0,0,1,1,1,0,2019-01-15
5461,경기,오산시,4,0,0,4,2,0,2019-02-15
5462,경기,오산시,8,0,3,11,6,0,2019-03-15
5463,경기,오산시,0,0,0,0,0,0,2019-04-15
5464,경기,오산시,2,0,0,2,2,0,2019-05-15
5465,경기,오산시,3,0,0,3,2,0,2019-06-15
5466,경기,오산시,2,0,0,2,1,0,2019-07-15
5467,경기,오산시,7,0,1,8,5,0,2019-08-15
5468,경기,오산시,5,1,0,6,4,0,2019-09-15
5469,경기,오산시,1,2,2,5,5,0,2019-10-15
5470,경기,오산시,6,1,1,8,7,0,2019-11-15
5471,경기,오산시,2,0,1,3,1,0,2019-12-15
5472,경기,용인시,5,0,4,9,8,0,2019-01-15
5473,경기,용인시,4,0,1,5,4,0,2019-02-15
5474,경기,용인시,13,1,2,16,11,0,2019-03-15
5475,경기,용인시,15,1,2,18,14,0,2019-04-15
5476,경기,용인시,25,2,7,34,18,0,2019-05-15
5477,경기,용인시,8,5,6,19,11,0,2019-06-15
5478,경기,용인시,19,2,4,25,16,0,2019-07-15
5479,경기,용인시,8,2,2,12,7,0,2019-08-15
5480,경기,용인시,12,4,6,22,12,0,2019-09-15
5481,경기,용인시,11,2,4,17,14,0,2019-10-15
5482,경기,용인시,12,5,5,22,10,0,2019-11-15
5483,경기,용인시,7,2,0,9,5,0,2019-12-15
5484,경기,의왕시,1,0,0,1,1,0,2019-01-15
5485,경기,의왕시,1,0,0,1,1,0,2019-02-15
5486,경기,의왕시,0,0,0,0,0,0,2019-03-15
5487,경기,의왕시,2,0,1,3,2,0,2019-04-15
5488,경기,의왕시,4,1,0,5,4,0,2019-05-15
5489,경기,의왕시,0,0,0,0,0,0,2019-06-15
5490,경기,의왕시,0,0,0,0,0,0,2019-07-15
5491,경기,의왕시,1,0,0,1,1,0,2019-08-15
5492,경기,의왕시,0,0,0,0,0,0,2019-09-15
5493,경기,의왕시,2,0,1,3,3,0,2019-10-15
5494,경기,의왕시,1,0,0,1,1,0,2019-11-15
5495,경기,의왕시,0,1,0,1,1,0,2019-12-15
5496,경기,의정부시,5,0,1,6,3,0,2019-01-15
5497,경기,의정부시,11,0,0,11,10,0,2019-02-15
5498,경기,의정부시,3,0,0,3,1,0,2019-03-15
5499,경기,의정부시,22,5,3,30,9,0,2019-04-15
5500,경기,의정부시,7,0,2,9,2,0,2019-05-15
5501,경기,의정부시,11,0,4,15,9,0,2019-06-15
5502,경기,의정부시,3,1,0,4,3,0,2019-07-15
5503,경기,의정부시,2,0,2,4,3,0,2019-08-15
5504,경기,의정부시,6,0,2,8,5,0,2019-09-15
5505,경기,의정부시,6,1,4,11,6,0,2019-10-15
5506,경기,의정부시,6,2,0,8,5,0,2019-11-15
5507,경기,의정부시,5,1,1,7,6,0,2019-12-15
5508,경기,이천시,1,0,0,1,1,0,2019-01-15
5509,경기,이천시,0,0,0,0,0,0,2019-02-15
5510,경기,이천시,2,0,1,3,3,0,2019-03-15
5511,경기,이천시,5,0,0,5,3,1,2019-04-15
5512,경기,이천시,6,0,1,7,4,1,2019-05-15
5513,경기,이천시,3,0,1,4,4,0,2019-06-15
5514,경기,이천시,7,0,1,8,6,0,2019-07-15
5515,경기,이천시,3,0,0,3,1,0,2019-08-15
5516,경기,이천시,2,0,0,2,1,0,2019-09-15
5517,경기,이천시,5,0,0,5,4,0,2019-10-15
5518,경기,이천시,4,0,2,6,6,1,2019-11-15
5519,경기,이천시,1,0,0,1,1,0,2019-12-15
5520,경기,파주시,7,0,1,8,7,0,2019-01-15
5521,경기,파주시,11,2,5,18,8,0,2019-02-15
5522,경기,파주시,4,0,0,4,3,0,2019-03-15
5523,경기,파주시,5,3,0,8,6,0,2019-04-15
5524,경기,파주시,7,1,0,8,5,0,2019-05-15
5525,경기,파주시,5,0,0,5,4,0,2019-06-15
5526,경기,파주시,1,0,0,1,1,0,2019-07-15
5527,경기,파주시,0,1,1,2,2,0,2019-08-15
5528,경기,파주시,4,2,0,6,5,0,2019-09-15
5529,경기,파주시,3,1,2,6,5,0,2019-10-15
5530,경기,파주시,3,0,4,7,6,0,2019-11-15
5531,경기,파주시,6,0,2,8,5,0,2019-12-15
5532,경기,평택시,4,0,1,5,6,2,2019-01-15
5533,경기,평택시,9,3,1,13,9,0,2019-02-15
5534,경기,평택시,14,1,0,15,8,0,2019-03-15
5535,경기,평택시,21,3,7,31,14,0,2019-04-15
5536,경기,평택시,14,2,5,21,13,0,2019-05-15
5537,경기,평택시,8,0,1,9,6,0,2019-06-15
5538,경기,평택시,11,1,1,13,10,0,2019-07-15
5539,경기,평택시,10,11,1,22,9,0,2019-08-15
5540,경기,평택시,1,0,2,3,3,0,2019-09-15
5541,경기,평택시,21,2,5,28,17,0,2019-10-15
5542,경기,평택시,17,6,2,25,17,0,2019-11-15
5543,경기,평택시,13,1,5,19,11,0,2019-12-15
5544,경기,포천시,4,1,1,6,3,0,2019-01-15
5545,경기,포천시,4,1,0,5,2,0,2019-02-15
5546,경기,포천시,1,0,0,1,1,0,2019-03-15
5547,경기,포천시,3,1,6,10,2,0,2019-04-15
5548,경기,포천시,1,2,1,4,4,0,2019-05-15
5549,경기,포천시,5,0,0,5,2,0,2019-06-15
5550,경기,포천시,2,0,1,3,3,0,2019-07-15
5551,경기,포천시,2,0,3,5,2,1,2019-08-15
5552,경기,포천시,1,0,0,1,1,0,2019-09-15
5553,경기,포천시,1,0,1,2,2,0,2019-10-15
5554,경기,포천시,4,0,1,5,2,0,2019-11-15
5555,경기,포천시,0,0,0,0,1,1,2019-12-15
5556,경기,하남시,1,0,0,1,1,0,2019-01-15
5557,경기,하남시,16,0,1,17,7,0,2019-02-15
5558,경기,하남시,5,1,0,6,4,0,2019-03-15
5559,경기,하남시,1,0,0,1,1,0,2019-04-15
5560,경기,하남시,4,1,1,6,6,0,2019-05-15
5561,경기,하남시,7,0,1,8,7,0,2019-06-15
5562,경기,하남시,0,0,1,1,1,0,2019-07-15
5563,경기,하남시,4,0,0,4,2,0,2019-08-15
5564,경기,하남시,2,2,1,5,3,0,2019-09-15
5565,경기,하남시,0,0,1,1,1,0,2019-10-15
5566,경기,하남시,8,2,1,11,6,0,2019-11-15
5567,경기,하남시,0,0,1,1,1,0,2019-12-15
5568,경기,화성시,9,0,2,11,7,1,2019-01-15
5569,경기,화성시,10,0,8,18,12,1,2019-02-15
5570,경기,화성시,11,0,2,13,9,0,2019-03-15
5571,경기,화성시,3,1,1,5,4,0,2019-04-15
5572,경기,화성시,15,1,7,23,13,0,2019-05-15
5573,경기,화성시,11,0,3,14,11,0,2019-06-15
5574,경기,화성시,11,0,0,11,9,1,2019-07-15
5575,경기,화성시,7,0,3,10,4,0,2019-08-15
5576,경기,화성시,6,1,0,7,4,1,2019-09-15
5577,경기,화성시,9,0,2,11,8,0,2019-10-15
5578,경기,화성시,17,1,1,19,12,0,2019-11-15
5579,경기,화성시,4,0,2,6,3,0,2019-12-15
5580,경기,가평군,0,0,0,0,0,0,2019-01-16
5581,경기,가평군,0,0,0,0,0,0,2019-02-16
5582,경기,가평군,6,0,4,10,4,0,2019-03-16
5583,경기,가평군,0,0,0,0,0,0,2019-04-16
5584,경기,가평군,0,0,0,0,0,0,2019-05-16
5585,경기,가평군,8,0,0,8,5,0,2019-06-16
5586,경기,가평군,2,0,0,2,2,0,2019-07-16
5587,경기,가평군,5,0,1,6,2,0,2019-08-16
5588,경기,가평군,0,0,0,0,0,0,2019-09-16
5589,경기,가평군,0,0,0,0,0,0,2019-10-16
5590,경기,가평군,3,0,0,3,2,0,2019-11-16
5591,경기,가평군,0,0,0,0,0,0,2019-12-16
5592,경기,고양시,10,0,4,14,10,1,2019-01-16
5593,경기,고양시,30,10,5,45,19,0,2019-02-16
5594,경기,고양시,13,0,4,17,9,0,2019-03-16
5595,경기,고양시,7,0,1,8,6,0,2019-04-16
5596,경기,고양시,16,2,7,25,18,0,2019-05-16
5597,경기,고양시,9,2,4,15,10,0,2019-06-16
5598,경기,고양시,6,0,3,9,8,0,2019-07-16
5599,경기,고양시,6,1,5,12,11,0,2019-08-16
5600,경기,고양시,16,1,1,18,15,1,2019-09-16
5601,경기,고양시,9,1,0,10,8,0,2019-10-16
5602,경기,고양시,11,7,1,19,12,0,2019-11-16
5603,경기,고양시,11,1,4,16,8,0,2019-12-16
5604,경기,과천시,1,0,0,1,1,0,2019-01-16
5605,경기,과천시,0,0,0,0,0,0,2019-02-16
5606,경기,과천시,1,0,0,1,1,0,2019-03-16
5607,경기,과천시,0,0,0,0,0,0,2019-04-16
5608,경기,과천시,4,1,1,6,2,0,2019-05-16
5609,경기,과천시,0,0,0,0,0,0,2019-06-16
5610,경기,과천시,0,0,0,0,0,0,2019-07-16
5611,경기,과천시,0,0,0,0,0,0,2019-08-16
5612,경기,과천시,0,0,0,0,0,0,2019-09-16
5613,경기,과천시,1,0,0,1,1,0,2019-10-16
5614,경기,과천시,0,0,0,0,0,0,2019-11-16
5615,경기,과천시,1,0,0,1,1,0,2019-12-16
5616,경기,광명시,2,4,1,7,6,0,2019-01-16
5617,경기,광명시,3,0,1,4,3,0,2019-02-16
5618,경기,광명시,5,0,0,5,4,0,2019-03-16
5619,경기,광명시,2,1,1,4,4,0,2019-04-16
5620,경기,광명시,1,1,0,2,2,0,2019-05-16
5621,경기,광명시,6,0,0,6,3,0,2019-06-16
5622,경기,광명시,0,0,0,0,0,0,2019-07-16
5623,경기,광명시,1,2,1,4,4,0,2019-08-16
5624,경기,광명시,2,1,0,3,3,0,2019-09-16
5625,경기,광명시,1,0,2,3,3,0,2019-10-16
5626,경기,광명시,7,5,4,16,9,0,2019-11-16
5627,경기,광명시,4,0,0,4,3,0,2019-12-16
5628,경기,광주시,5,0,0,5,3,0,2019-01-16
5629,경기,광주시,12,0,4,16,8,0,2019-02-16
5630,경기,광주시,4,0,1,5,4,0,2019-03-16
5631,경기,광주시,7,1,0,8,9,1,2019-04-16
5632,경기,광주시,5,0,2,7,7,0,2019-05-16
5633,경기,광주시,3,0,0,3,2,0,2019-06-16
5634,경기,광주시,8,1,1,10,5,0,2019-07-16
5635,경기,광주시,1,1,0,2,2,0,2019-08-16
5636,경기,광주시,5,0,0,5,3,0,2019-09-16
5637,경기,광주시,5,0,0,5,4,0,2019-10-16
5638,경기,광주시,4,2,1,7,4,0,2019-11-16
5639,경기,광주시,8,0,2,10,7,0,2019-12-16
5640,경기,구리시,2,0,1,3,3,0,2019-01-16
5641,경기,구리시,1,0,1,2,2,0,2019-02-16
5642,경기,구리시,1,0,0,1,1,0,2019-03-16
5643,경기,구리시,4,0,0,4,3,0,2019-04-16
5644,경기,구리시,1,0,0,1,1,0,2019-05-16
5645,경기,구리시,3,0,0,3,3,0,2019-06-16
5646,경기,구리시,0,0,0,0,0,0,2019-07-16
5647,경기,구리시,4,2,1,7,2,0,2019-08-16
5648,경기,구리시,2,0,0,2,2,0,2019-09-16
5649,경기,구리시,0,0,1,1,1,0,2019-10-16
5650,경기,구리시,6,2,0,8,4,0,2019-11-16
5651,경기,구리시,1,0,0,1,1,0,2019-12-16
5652,경기,군포시,0,2,0,2,1,0,2019-01-16
5653,경기,군포시,6,1,0,7,3,0,2019-02-16
5654,경기,군포시,2,0,2,4,2,0,2019-03-16
5655,경기,군포시,2,0,0,2,2,0,2019-04-16
5656,경기,군포시,2,0,0,2,2,0,2019-05-16
5657,경기,군포시,0,0,1,1,1,0,2019-06-16
5658,경기,군포시,2,1,2,5,4,0,2019-07-16
5659,경기,군포시,4,0,1,5,1,0,2019-08-16
5660,경기,군포시,0,0,2,2,1,0,2019-09-16
5661,경기,군포시,0,0,0,0,0,0,2019-10-16
5662,경기,군포시,3,2,2,7,5,0,2019-11-16
5663,경기,군포시,0,0,0,0,0,0,2019-12-16
5664,경기,김포시,3,0,3,6,6,1,2019-01-16
5665,경기,김포시,16,0,1,17,5,0,2019-02-16
5666,경기,김포시,2,0,1,3,2,0,2019-03-16
5667,경기,김포시,2,0,1,3,3,0,2019-04-16
5668,경기,김포시,11,0,1,12,9,0,2019-05-16
5669,경기,김포시,5,0,1,6,4,0,2019-06-16
5670,경기,김포시,5,0,3,8,5,0,2019-07-16
5671,경기,김포시,7,0,4,11,6,0,2019-08-16
5672,경기,김포시,1,0,1,2,2,0,2019-09-16
5673,경기,김포시,8,0,0,8,5,0,2019-10-16
5674,경기,김포시,8,0,0,8,5,0,2019-11-16
5675,경기,김포시,6,0,2,8,6,1,2019-12-16
5676,경기,남양주시,10,1,3,14,8,0,2019-01-16
5677,경기,남양주시,8,0,1,9,4,0,2019-02-16
5678,경기,남양주시,8,2,1,11,5,0,2019-03-16
5679,경기,남양주시,9,1,2,12,6,0,2019-04-16
5680,경기,남양주시,12,0,0,12,9,0,2019-05-16
5681,경기,남양주시,1,1,3,5,5,0,2019-06-16
5682,경기,남양주시,4,0,4,8,5,0,2019-07-16
5683,경기,남양주시,9,0,1,10,5,0,2019-08-16
5684,경기,남양주시,7,2,3,12,7,0,2019-09-16
5685,경기,남양주시,12,1,1,14,9,0,2019-10-16
5686,경기,남양주시,6,0,1,7,4,0,2019-11-16
5687,경기,남양주시,6,3,3,12,11,0,2019-12-16
5688,경기,동두천시,0,0,0,0,0,0,2019-01-16
5689,경기,동두천시,5,0,0,5,1,0,2019-02-16
5690,경기,동두천시,0,0,0,0,0,0,2019-03-16
5691,경기,동두천시,1,0,1,2,2,0,2019-04-16
5692,경기,동두천시,0,0,0,0,0,0,2019-05-16
5693,경기,동두천시,0,1,0,1,1,0,2019-06-16
5694,경기,동두천시,2,0,0,2,2,0,2019-07-16
5695,경기,동두천시,0,0,0,0,0,0,2019-08-16
5696,경기,동두천시,0,0,0,0,0,0,2019-09-16
5697,경기,동두천시,0,0,0,0,0,0,2019-10-16
5698,경기,동두천시,0,0,0,0,0,0,2019-11-16
5699,경기,동두천시,2,0,1,3,2,0,2019-12-16
5700,경기,부천시,10,1,3,14,10,0,2019-01-16
5701,경기,부천시,11,0,1,12,8,0,2019-02-16
5702,경기,부천시,10,0,0,10,7,0,2019-03-16
5703,경기,부천시,14,0,1,15,11,0,2019-04-16
5704,경기,부천시,8,1,4,13,10,0,2019-05-16
5705,경기,부천시,4,0,6,10,4,0,2019-06-16
5706,경기,부천시,8,1,5,14,12,0,2019-07-16
5707,경기,부천시,9,0,3,12,8,0,2019-08-16
5708,경기,부천시,12,0,3,15,12,0,2019-09-16
5709,경기,부천시,10,0,4,14,13,0,2019-10-16
5710,경기,부천시,10,1,3,14,8,0,2019-11-16
5711,경기,부천시,7,1,1,9,8,0,2019-12-16
5712,경기,성남시,5,0,1,6,4,0,2019-01-16
5713,경기,성남시,10,3,3,16,10,1,2019-02-16
5714,경기,성남시,7,0,3,10,7,0,2019-03-16
5715,경기,성남시,11,1,1,13,9,0,2019-04-16
5716,경기,성남시,11,3,7,21,15,0,2019-05-16
5717,경기,성남시,6,3,3,12,9,0,2019-06-16
5718,경기,성남시,14,1,4,19,13,0,2019-07-16
5719,경기,성남시,25,4,5,34,13,0,2019-08-16
5720,경기,성남시,9,1,1,11,10,0,2019-09-16
5721,경기,성남시,6,0,0,6,5,0,2019-10-16
5722,경기,성남시,15,3,2,20,14,0,2019-11-16
5723,경기,성남시,6,1,1,8,6,0,2019-12-16
5724,경기,수원시,15,5,8,28,17,0,2019-01-16
5725,경기,수원시,30,1,3,34,18,0,2019-02-16
5726,경기,수원시,12,0,3,15,11,0,2019-03-16
5727,경기,수원시,18,7,5,30,16,1,2019-04-16
5728,경기,수원시,24,1,6,31,20,0,2019-05-16
5729,경기,수원시,19,2,4,25,15,0,2019-06-16
5730,경기,수원시,18,3,10,31,18,0,2019-07-16
5731,경기,수원시,12,0,8,20,15,0,2019-08-16
5732,경기,수원시,14,2,4,20,14,0,2019-09-16
5733,경기,수원시,13,1,3,17,9,0,2019-10-16
5734,경기,수원시,20,1,4,25,17,0,2019-11-16
5735,경기,수원시,12,1,3,16,16,1,2019-12-16
5736,경기,시흥시,5,0,1,6,5,0,2019-01-16
5737,경기,시흥시,10,3,1,14,6,0,2019-02-16
5738,경기,시흥시,8,1,1,10,9,1,2019-03-16
5739,경기,시흥시,6,1,6,13,8,0,2019-04-16
5740,경기,시흥시,7,1,2,10,6,0,2019-05-16
5741,경기,시흥시,8,0,0,8,4,0,2019-06-16
5742,경기,시흥시,7,0,1,8,7,0,2019-07-16
5743,경기,시흥시,7,2,2,11,8,0,2019-08-16
5744,경기,시흥시,6,3,2,11,5,0,2019-09-16
5745,경기,시흥시,11,0,5,16,8,0,2019-10-16
5746,경기,시흥시,8,0,1,9,7,0,2019-11-16
5747,경기,시흥시,10,1,4,15,10,0,2019-12-16
5748,경기,안산시,14,0,2,16,11,0,2019-01-16
5749,경기,안산시,28,0,5,33,15,0,2019-02-16
5750,경기,안산시,10,0,4,14,10,0,2019-03-16
5751,경기,안산시,23,4,2,29,19,0,2019-04-16
5752,경기,안산시,8,0,5,13,10,0,2019-05-16
5753,경기,안산시,12,1,1,14,8,0,2019-06-16
5754,경기,안산시,12,0,4,16,10,0,2019-07-16
5755,경기,안산시,15,0,3,18,10,0,2019-08-16
5756,경기,안산시,10,3,0,13,11,0,2019-09-16
5757,경기,안산시,7,3,3,13,10,0,2019-10-16
5758,경기,안산시,5,0,4,9,6,0,2019-11-16
5759,경기,안산시,13,0,6,19,15,0,2019-12-16
5760,경기,안성시,3,1,0,4,2,0,2019-01-16
5761,경기,안성시,7,1,0,8,5,0,2019-02-16
5762,경기,안성시,9,0,0,9,4,0,2019-03-16
5763,경기,안성시,1,0,1,2,4,2,2019-04-16
5764,경기,안성시,0,1,1,2,2,0,2019-05-16
5765,경기,안성시,3,2,2,7,6,0,2019-06-16
5766,경기,안성시,2,0,0,2,2,0,2019-07-16
5767,경기,안성시,0,0,0,0,0,0,2019-08-16
5768,경기,안성시,10,1,1,12,5,0,2019-09-16
5769,경기,안성시,0,0,3,3,4,1,2019-10-16
5770,경기,안성시,0,0,0,0,0,0,2019-11-16
5771,경기,안성시,3,0,0,3,2,0,2019-12-16
5772,경기,안양시,8,1,0,9,6,0,2019-01-16
5773,경기,안양시,4,0,1,5,5,0,2019-02-16
5774,경기,안양시,3,0,2,5,4,0,2019-03-16
5775,경기,안양시,6,0,1,7,7,0,2019-04-16
5776,경기,안양시,4,0,4,8,7,0,2019-05-16
5777,경기,안양시,1,0,0,1,1,0,2019-06-16
5778,경기,안양시,8,0,1,9,4,0,2019-07-16
5779,경기,안양시,2,0,1,3,3,0,2019-08-16
5780,경기,안양시,9,0,1,10,5,0,2019-09-16
5781,경기,안양시,6,1,0,7,6,0,2019-10-16
5782,경기,안양시,4,0,1,5,4,0,2019-11-16
5783,경기,안양시,3,0,1,4,4,0,2019-12-16
5784,경기,양주시,2,0,2,4,3,0,2019-01-16
5785,경기,양주시,5,0,3,8,6,0,2019-02-16
5786,경기,양주시,0,0,1,1,1,0,2019-03-16
5787,경기,양주시,6,2,4,12,9,0,2019-04-16
5788,경기,양주시,2,1,1,4,4,0,2019-05-16
5789,경기,양주시,3,0,0,3,3,0,2019-06-16
5790,경기,양주시,2,0,0,2,2,0,2019-07-16
5791,경기,양주시,7,0,0,7,5,0,2019-08-16
5792,경기,양주시,4,0,0,4,2,0,2019-09-16
5793,경기,양주시,4,0,0,4,2,0,2019-10-16
5794,경기,양주시,2,1,0,3,3,0,2019-11-16
5795,경기,양주시,6,0,0,6,4,0,2019-12-16
5796,경기,양평군,1,1,3,5,2,0,2019-01-16
5797,경기,양평군,3,1,1,5,2,0,2019-02-16
5798,경기,양평군,1,0,0,1,1,0,2019-03-16
5799,경기,양평군,0,0,3,3,1,0,2019-04-16
5800,경기,양평군,1,0,0,1,1,0,2019-05-16
5801,경기,양평군,20,0,1,21,3,0,2019-06-16
5802,경기,양평군,0,0,0,0,0,0,2019-07-16
5803,경기,양평군,7,0,1,8,5,0,2019-08-16
5804,경기,양평군,4,0,0,4,1,0,2019-09-16
5805,경기,양평군,0,0,0,0,0,0,2019-10-16
5806,경기,양평군,4,0,0,4,2,0,2019-11-16
5807,경기,양평군,1,0,0,1,1,0,2019-12-16
5808,경기,여주시,1,0,0,1,1,0,2019-01-16
5809,경기,여주시,0,0,1,1,1,0,2019-02-16
5810,경기,여주시,2,0,0,2,1,0,2019-03-16
5811,경기,여주시,1,0,0,1,1,0,2019-04-16
5812,경기,여주시,3,0,1,4,1,0,2019-05-16
5813,경기,여주시,5,0,1,6,3,1,2019-06-16
5814,경기,여주시,3,0,0,3,2,0,2019-07-16
5815,경기,여주시,0,0,0,0,0,0,2019-08-16
5816,경기,여주시,0,0,1,1,1,0,2019-09-16
5817,경기,여주시,0,1,1,2,2,0,2019-10-16
5818,경기,여주시,0,1,0,1,1,0,2019-11-16
5819,경기,여주시,0,0,1,1,1,0,2019-12-16
5820,경기,연천군,0,0,0,0,0,0,2019-01-16
5821,경기,연천군,0,1,1,2,2,0,2019-02-16
5822,경기,연천군,0,0,0,0,0,0,2019-03-16
5823,경기,연천군,0,0,0,0,0,0,2019-04-16
5824,경기,연천군,0,0,1,1,1,0,2019-05-16
5825,경기,연천군,0,0,0,0,0,0,2019-06-16
5826,경기,연천군,0,0,0,0,0,0,2019-07-16
5827,경기,연천군,0,0,0,0,0,0,2019-08-16
5828,경기,연천군,0,1,0,1,1,0,2019-09-16
5829,경기,연천군,0,1,0,1,1,0,2019-10-16
5830,경기,연천군,0,0,0,0,0,0,2019-11-16
5831,경기,연천군,0,0,1,1,1,0,2019-12-16
5832,경기,오산시,0,0,1,1,1,0,2019-01-16
5833,경기,오산시,0,0,1,1,1,0,2019-02-16
5834,경기,오산시,1,0,1,2,2,0,2019-03-16
5835,경기,오산시,1,1,0,2,2,0,2019-04-16
5836,경기,오산시,3,0,0,3,3,0,2019-05-16
5837,경기,오산시,4,1,2,7,4,0,2019-06-16
5838,경기,오산시,0,0,2,2,2,0,2019-07-16
5839,경기,오산시,1,0,0,1,1,0,2019-08-16
5840,경기,오산시,6,0,0,6,4,0,2019-09-16
5841,경기,오산시,5,1,0,6,4,0,2019-10-16
5842,경기,오산시,4,2,0,6,3,0,2019-11-16
5843,경기,오산시,2,0,2,4,4,1,2019-12-16
5844,경기,용인시,9,1,2,12,8,0,2019-01-16
5845,경기,용인시,7,2,5,14,9,0,2019-02-16
5846,경기,용인시,15,1,3,19,11,1,2019-03-16
5847,경기,용인시,7,1,2,10,9,0,2019-04-16
5848,경기,용인시,5,2,3,10,8,0,2019-05-16
5849,경기,용인시,4,0,0,4,2,0,2019-06-16
5850,경기,용인시,5,2,1,8,8,0,2019-07-16
5851,경기,용인시,13,3,1,17,8,0,2019-08-16
5852,경기,용인시,8,1,0,9,8,0,2019-09-16
5853,경기,용인시,11,2,3,16,9,0,2019-10-16
5854,경기,용인시,9,1,1,11,9,0,2019-11-16
5855,경기,용인시,12,2,1,15,12,0,2019-12-16
5856,경기,의왕시,0,0,1,1,1,0,2019-01-16
5857,경기,의왕시,5,0,0,5,1,0,2019-02-16
5858,경기,의왕시,4,0,4,8,3,0,2019-03-16
5859,경기,의왕시,3,0,0,3,2,0,2019-04-16
5860,경기,의왕시,0,0,0,0,0,0,2019-05-16
5861,경기,의왕시,1,0,0,1,2,1,2019-06-16
5862,경기,의왕시,0,0,0,0,0,0,2019-07-16
5863,경기,의왕시,3,0,0,3,1,0,2019-08-16
5864,경기,의왕시,3,0,0,3,3,0,2019-09-16
5865,경기,의왕시,2,0,0,2,2,0,2019-10-16
5866,경기,의왕시,1,0,0,1,1,0,2019-11-16
5867,경기,의왕시,0,0,0,0,0,0,2019-12-16
5868,경기,의정부시,4,0,3,7,5,0,2019-01-16
5869,경기,의정부시,8,0,1,9,5,0,2019-02-16
5870,경기,의정부시,5,0,0,5,3,0,2019-03-16
5871,경기,의정부시,5,0,0,5,4,0,2019-04-16
5872,경기,의정부시,4,1,1,6,4,0,2019-05-16
5873,경기,의정부시,7,5,3,15,5,0,2019-06-16
5874,경기,의정부시,0,0,1,1,1,0,2019-07-16
5875,경기,의정부시,2,2,1,5,3,0,2019-08-16
5876,경기,의정부시,9,2,2,13,8,0,2019-09-16
5877,경기,의정부시,6,0,0,6,5,0,2019-10-16
5878,경기,의정부시,4,0,1,5,4,0,2019-11-16
5879,경기,의정부시,0,0,3,3,3,0,2019-12-16
5880,경기,이천시,1,0,0,1,1,0,2019-01-16
5881,경기,이천시,6,0,0,6,2,0,2019-02-16
5882,경기,이천시,1,0,0,1,1,0,2019-03-16
5883,경기,이천시,9,0,0,9,4,0,2019-04-16
5884,경기,이천시,3,0,0,3,2,0,2019-05-16
5885,경기,이천시,0,1,0,1,1,0,2019-06-16
5886,경기,이천시,3,0,2,5,4,0,2019-07-16
5887,경기,이천시,0,0,1,1,1,0,2019-08-16
5888,경기,이천시,6,1,0,7,3,0,2019-09-16
5889,경기,이천시,1,1,0,2,1,0,2019-10-16
5890,경기,이천시,3,0,2,5,3,0,2019-11-16
5891,경기,이천시,8,0,0,8,4,0,2019-12-16
5892,경기,파주시,5,0,3,8,6,0,2019-01-16
5893,경기,파주시,9,1,2,12,7,0,2019-02-16
5894,경기,파주시,2,0,3,5,4,0,2019-03-16
5895,경기,파주시,4,2,1,7,4,0,2019-04-16
5896,경기,파주시,8,0,0,8,4,0,2019-05-16
5897,경기,파주시,8,1,1,10,7,0,2019-06-16
5898,경기,파주시,4,1,3,8,5,0,2019-07-16
5899,경기,파주시,4,0,2,6,4,0,2019-08-16
5900,경기,파주시,6,2,3,11,7,0,2019-09-16
5901,경기,파주시,3,0,1,4,3,0,2019-10-16
5902,경기,파주시,0,0,1,1,1,0,2019-11-16
5903,경기,파주시,3,0,4,7,5,0,2019-12-16
5904,경기,평택시,4,4,2,10,10,0,2019-01-16
5905,경기,평택시,24,9,3,36,12,0,2019-02-16
5906,경기,평택시,9,0,5,14,7,0,2019-03-16
5907,경기,평택시,22,1,1,24,15,0,2019-04-16
5908,경기,평택시,13,2,2,17,11,0,2019-05-16
5909,경기,평택시,12,4,0,16,8,0,2019-06-16
5910,경기,평택시,8,2,3,13,7,0,2019-07-16
5911,경기,평택시,9,3,5,17,11,0,2019-08-16
5912,경기,평택시,8,1,3,12,8,0,2019-09-16
5913,경기,평택시,24,1,3,28,18,0,2019-10-16
5914,경기,평택시,7,2,5,14,11,0,2019-11-16
5915,경기,평택시,23,0,8,31,21,0,2019-12-16
5916,경기,포천시,4,0,0,4,3,0,2019-01-16
5917,경기,포천시,4,0,1,5,2,0,2019-02-16
5918,경기,포천시,1,0,0,1,1,0,2019-03-16
5919,경기,포천시,3,3,0,6,2,0,2019-04-16
5920,경기,포천시,2,0,0,2,2,0,2019-05-16
5921,경기,포천시,2,1,1,4,3,0,2019-06-16
5922,경기,포천시,3,0,0,3,3,0,2019-07-16
5923,경기,포천시,5,0,1,6,5,0,2019-08-16
5924,경기,포천시,2,0,0,2,1,0,2019-09-16
5925,경기,포천시,6,0,2,8,6,0,2019-10-16
5926,경기,포천시,1,0,3,4,3,0,2019-11-16
5927,경기,포천시,0,0,2,2,2,0,2019-12-16
5928,경기,하남시,2,0,0,2,2,0,2019-01-16
5929,경기,하남시,3,1,0,4,3,0,2019-02-16
5930,경기,하남시,1,0,0,1,1,0,2019-03-16
5931,경기,하남시,3,4,0,7,5,0,2019-04-16
5932,경기,하남시,1,0,0,1,1,0,2019-05-16
5933,경기,하남시,3,0,0,3,2,0,2019-06-16
5934,경기,하남시,4,1,1,6,5,0,2019-07-16
5935,경기,하남시,3,0,2,5,4,0,2019-08-16
5936,경기,하남시,9,0,1,10,5,0,2019-09-16
5937,경기,하남시,4,1,1,6,4,0,2019-10-16
5938,경기,하남시,3,0,2,5,3,0,2019-11-16
5939,경기,하남시,4,1,0,5,4,0,2019-12-16
5940,경기,화성시,14,2,1,17,7,0,2019-01-16
5941,경기,화성시,13,0,1,14,8,0,2019-02-16
5942,경기,화성시,8,0,1,9,6,1,2019-03-16
5943,경기,화성시,23,0,3,26,12,0,2019-04-16
5944,경기,화성시,4,0,2,6,5,1,2019-05-16
5945,경기,화성시,17,2,5,24,10,0,2019-06-16
5946,경기,화성시,4,0,5,9,8,0,2019-07-16
5947,경기,화성시,10,0,1,11,8,0,2019-08-16
5948,경기,화성시,10,0,0,10,10,0,2019-09-16
5949,경기,화성시,13,1,6,20,14,1,2019-10-16
5950,경기,화성시,2,0,2,4,4,0,2019-11-16
5951,경기,화성시,10,0,2,12,10,0,2019-12-16
5952,경기,가평군,0,0,0,0,0,0,2019-01-17
5953,경기,가평군,0,0,0,0,0,0,2019-02-17
5954,경기,가평군,0,0,0,0,0,0,2019-03-17
5955,경기,가평군,0,0,2,2,1,0,2019-04-17
5956,경기,가평군,0,0,0,0,0,0,2019-05-17
5957,경기,가평군,0,0,0,0,0,0,2019-06-17
5958,경기,가평군,3,0,0,3,2,0,2019-07-17
5959,경기,가평군,2,0,0,2,2,0,2019-08-17
5960,경기,가평군,0,0,0,0,0,0,2019-09-17
5961,경기,가평군,1,0,0,1,1,0,2019-10-17
5962,경기,가평군,0,0,0,0,0,0,2019-11-17
5963,경기,가평군,1,0,0,1,1,0,2019-12-17
5964,경기,고양시,10,0,5,15,8,0,2019-01-17
5965,경기,고양시,13,0,4,17,12,0,2019-02-17
5966,경기,고양시,8,0,3,11,6,0,2019-03-17
5967,경기,고양시,15,2,2,19,14,0,2019-04-17
5968,경기,고양시,19,4,7,30,20,0,2019-05-17
5969,경기,고양시,10,2,1,13,9,0,2019-06-17
5970,경기,고양시,4,1,2,7,5,0,2019-07-17
5971,경기,고양시,18,0,4,22,13,0,2019-08-17
5972,경기,고양시,10,0,4,14,12,0,2019-09-17
5973,경기,고양시,7,1,2,10,9,0,2019-10-17
5974,경기,고양시,13,2,3,18,13,0,2019-11-17
5975,경기,고양시,13,1,2,16,9,0,2019-12-17
5976,경기,과천시,0,0,0,0,0,0,2019-01-17
5977,경기,과천시,0,0,0,0,0,0,2019-02-17
5978,경기,과천시,0,0,0,0,0,0,2019-03-17
5979,경기,과천시,0,0,2,2,2,0,2019-04-17
5980,경기,과천시,0,0,0,0,0,0,2019-05-17
5981,경기,과천시,1,0,1,2,2,0,2019-06-17
5982,경기,과천시,0,0,1,1,1,0,2019-07-17
5983,경기,과천시,5,0,1,6,1,0,2019-08-17
5984,경기,과천시,3,0,0,3,1,0,2019-09-17
5985,경기,과천시,0,0,0,0,0,0,2019-10-17
5986,경기,과천시,0,0,0,0,0,0,2019-11-17
5987,경기,과천시,0,1,1,2,1,0,2019-12-17
5988,경기,광명시,0,0,1,1,1,0,2019-01-17
5989,경기,광명시,0,1,1,2,2,0,2019-02-17
5990,경기,광명시,4,0,0,4,2,0,2019-03-17
5991,경기,광명시,1,0,1,2,2,0,2019-04-17
5992,경기,광명시,5,0,0,5,4,0,2019-05-17
5993,경기,광명시,2,0,0,2,2,0,2019-06-17
5994,경기,광명시,2,0,3,5,2,0,2019-07-17
5995,경기,광명시,2,2,1,5,4,0,2019-08-17
5996,경기,광명시,4,0,2,6,4,0,2019-09-17
5997,경기,광명시,5,1,0,6,4,0,2019-10-17
5998,경기,광명시,8,3,2,13,5,0,2019-11-17
5999,경기,광명시,6,0,1,7,6,0,2019-12-17
6000,경기,광주시,2,2,4,8,6,0,2019-01-17
6001,경기,광주시,9,0,2,11,6,0,2019-02-17
6002,경기,광주시,4,0,1,5,4,0,2019-03-17
6003,경기,광주시,11,0,3,14,11,0,2019-04-17
6004,경기,광주시,9,0,2,11,8,0,2019-05-17
6005,경기,광주시,8,0,0,8,3,0,2019-06-17
6006,경기,광주시,5,1,2,8,7,1,2019-07-17
6007,경기,광주시,10,1,0,11,8,0,2019-08-17
6008,경기,광주시,9,2,4,15,9,0,2019-09-17
6009,경기,광주시,7,0,3,10,10,0,2019-10-17
6010,경기,광주시,10,0,2,12,5,0,2019-11-17
6011,경기,광주시,7,1,1,9,4,0,2019-12-17
6012,경기,구리시,0,0,0,0,0,0,2019-01-17
6013,경기,구리시,1,0,0,1,1,0,2019-02-17
6014,경기,구리시,0,0,1,1,1,0,2019-03-17
6015,경기,구리시,0,0,0,0,0,0,2019-04-17
6016,경기,구리시,0,0,2,2,2,0,2019-05-17
6017,경기,구리시,1,0,0,1,1,0,2019-06-17
6018,경기,구리시,2,0,2,4,4,0,2019-07-17
6019,경기,구리시,0,0,0,0,0,0,2019-08-17
6020,경기,구리시,1,0,0,1,1,0,2019-09-17
6021,경기,구리시,3,0,0,3,3,0,2019-10-17
6022,경기,구리시,2,0,1,3,3,0,2019-11-17
6023,경기,구리시,4,0,1,5,3,0,2019-12-17
6024,경기,군포시,1,1,0,2,2,0,2019-01-17
6025,경기,군포시,0,1,0,1,1,0,2019-02-17
6026,경기,군포시,2,0,0,2,1,0,2019-03-17
6027,경기,군포시,2,1,0,3,2,0,2019-04-17
6028,경기,군포시,2,0,0,2,1,0,2019-05-17
6029,경기,군포시,0,0,0,0,0,0,2019-06-17
6030,경기,군포시,0,0,1,1,1,0,2019-07-17
6031,경기,군포시,0,0,0,0,0,0,2019-08-17
6032,경기,군포시,0,0,1,1,1,0,2019-09-17
6033,경기,군포시,1,0,0,1,1,0,2019-10-17
6034,경기,군포시,1,0,2,3,3,0,2019-11-17
6035,경기,군포시,2,0,2,4,4,0,2019-12-17
6036,경기,김포시,10,0,1,11,7,0,2019-01-17
6037,경기,김포시,1,0,3,4,3,0,2019-02-17
6038,경기,김포시,7,1,3,11,4,0,2019-03-17
6039,경기,김포시,13,1,4,18,6,0,2019-04-17
6040,경기,김포시,8,0,4,12,9,0,2019-05-17
6041,경기,김포시,5,2,1,8,6,0,2019-06-17
6042,경기,김포시,4,0,0,4,4,1,2019-07-17
6043,경기,김포시,5,2,3,10,5,0,2019-08-17
6044,경기,김포시,7,0,0,7,6,0,2019-09-17
6045,경기,김포시,2,0,1,3,3,0,2019-10-17
6046,경기,김포시,7,0,1,8,5,0,2019-11-17
6047,경기,김포시,8,0,1,9,6,0,2019-12-17
6048,경기,남양주시,15,1,5,21,13,0,2019-01-17
6049,경기,남양주시,6,0,5,11,6,0,2019-02-17
6050,경기,남양주시,3,1,1,5,5,0,2019-03-17
6051,경기,남양주시,3,0,0,3,2,0,2019-04-17
6052,경기,남양주시,8,1,2,11,6,0,2019-05-17
6053,경기,남양주시,3,1,6,10,9,0,2019-06-17
6054,경기,남양주시,12,1,1,14,10,0,2019-07-17
6055,경기,남양주시,5,0,1,6,4,0,2019-08-17
6056,경기,남양주시,5,0,0,5,5,0,2019-09-17
6057,경기,남양주시,9,0,0,9,6,0,2019-10-17
6058,경기,남양주시,2,0,1,3,3,0,2019-11-17
6059,경기,남양주시,5,2,1,8,6,1,2019-12-17
6060,경기,동두천시,1,0,0,1,2,1,2019-01-17
6061,경기,동두천시,0,0,0,0,0,0,2019-02-17
6062,경기,동두천시,2,0,0,2,1,0,2019-03-17
6063,경기,동두천시,0,0,0,0,0,0,2019-04-17
6064,경기,동두천시,2,0,1,3,2,0,2019-05-17
6065,경기,동두천시,9,0,0,9,4,0,2019-06-17
6066,경기,동두천시,4,0,0,4,1,0,2019-07-17
6067,경기,동두천시,0,0,0,0,0,0,2019-08-17
6068,경기,동두천시,1,0,2,3,3,0,2019-09-17
6069,경기,동두천시,2,0,1,3,2,0,2019-10-17
6070,경기,동두천시,0,0,1,1,1,0,2019-11-17
6071,경기,동두천시,0,0,0,0,0,0,2019-12-17
6072,경기,부천시,9,1,2,12,9,0,2019-01-17
6073,경기,부천시,9,0,1,10,6,0,2019-02-17
6074,경기,부천시,9,0,2,11,10,0,2019-03-17
6075,경기,부천시,7,1,1,9,9,0,2019-04-17
6076,경기,부천시,16,0,4,20,12,0,2019-05-17
6077,경기,부천시,14,2,3,19,14,0,2019-06-17
6078,경기,부천시,7,1,1,9,8,0,2019-07-17
6079,경기,부천시,16,0,1,17,8,0,2019-08-17
6080,경기,부천시,7,1,3,11,11,0,2019-09-17
6081,경기,부천시,10,0,1,11,9,0,2019-10-17
6082,경기,부천시,20,1,1,22,13,0,2019-11-17
6083,경기,부천시,8,1,3,12,11,0,2019-12-17
6084,경기,성남시,8,6,5,19,15,1,2019-01-17
6085,경기,성남시,4,0,3,7,5,0,2019-02-17
6086,경기,성남시,7,1,1,9,6,0,2019-03-17
6087,경기,성남시,9,0,1,10,8,0,2019-04-17
6088,경기,성남시,14,5,2,21,9,0,2019-05-17
6089,경기,성남시,15,0,2,17,9,0,2019-06-17
6090,경기,성남시,6,2,2,10,7,0,2019-07-17
6091,경기,성남시,0,0,3,3,3,0,2019-08-17
6092,경기,성남시,20,2,4,26,16,0,2019-09-17
6093,경기,성남시,12,8,2,22,11,0,2019-10-17
6094,경기,성남시,18,2,4,24,16,0,2019-11-17
6095,경기,성남시,15,0,7,22,14,0,2019-12-17
6096,경기,수원시,25,2,2,29,20,0,2019-01-17
6097,경기,수원시,12,4,8,24,16,0,2019-02-17
6098,경기,수원시,8,4,1,13,10,0,2019-03-17
6099,경기,수원시,24,1,6,31,18,0,2019-04-17
6100,경기,수원시,8,0,6,14,11,0,2019-05-17
6101,경기,수원시,16,6,5,27,19,0,2019-06-17
6102,경기,수원시,6,1,2,9,8,0,2019-07-17
6103,경기,수원시,11,3,4,18,13,0,2019-08-17
6104,경기,수원시,23,2,4,29,17,0,2019-09-17
6105,경기,수원시,18,1,5,24,17,0,2019-10-17
6106,경기,수원시,15,2,1,18,11,1,2019-11-17
6107,경기,수원시,23,2,1,26,16,0,2019-12-17
6108,경기,시흥시,3,0,1,4,4,0,2019-01-17
6109,경기,시흥시,1,1,0,2,2,0,2019-02-17
6110,경기,시흥시,10,1,2,13,7,0,2019-03-17
6111,경기,시흥시,2,0,2,4,4,0,2019-04-17
6112,경기,시흥시,19,1,5,25,13,0,2019-05-17
6113,경기,시흥시,7,2,1,10,5,0,2019-06-17
6114,경기,시흥시,10,0,1,11,6,0,2019-07-17
6115,경기,시흥시,6,1,1,8,4,0,2019-08-17
6116,경기,시흥시,4,2,3,9,5,0,2019-09-17
6117,경기,시흥시,5,0,4,9,4,0,2019-10-17
6118,경기,시흥시,8,0,0,8,4,0,2019-11-17
6119,경기,시흥시,20,0,6,26,15,0,2019-12-17
6120,경기,안산시,18,2,1,21,11,0,2019-01-17
6121,경기,안산시,10,0,1,11,7,0,2019-02-17
6122,경기,안산시,9,0,4,13,9,0,2019-03-17
6123,경기,안산시,9,1,4,14,8,0,2019-04-17
6124,경기,안산시,6,1,3,10,10,0,2019-05-17
6125,경기,안산시,5,0,1,6,5,0,2019-06-17
6126,경기,안산시,5,1,2,8,6,0,2019-07-17
6127,경기,안산시,15,1,3,19,14,0,2019-08-17
6128,경기,안산시,7,1,6,14,11,0,2019-09-17
6129,경기,안산시,7,0,7,14,11,0,2019-10-17
6130,경기,안산시,20,1,3,24,16,0,2019-11-17
6131,경기,안산시,21,0,4,25,12,1,2019-12-17
6132,경기,안성시,3,0,4,7,4,0,2019-01-17
6133,경기,안성시,9,0,0,9,4,0,2019-02-17
6134,경기,안성시,0,0,0,0,0,0,2019-03-17
6135,경기,안성시,2,0,0,2,2,0,2019-04-17
6136,경기,안성시,0,0,0,0,0,0,2019-05-17
6137,경기,안성시,2,1,1,4,3,0,2019-06-17
6138,경기,안성시,4,0,0,4,2,0,2019-07-17
6139,경기,안성시,0,0,4,4,3,0,2019-08-17
6140,경기,안성시,2,2,0,4,3,0,2019-09-17
6141,경기,안성시,5,1,1,7,4,0,2019-10-17
6142,경기,안성시,1,0,0,1,1,0,2019-11-17
6143,경기,안성시,2,0,0,2,2,0,2019-12-17
6144,경기,안양시,8,0,2,10,10,0,2019-01-17
6145,경기,안양시,2,0,0,2,2,1,2019-02-17
6146,경기,안양시,3,0,1,4,2,0,2019-03-17
6147,경기,안양시,7,1,3,11,6,0,2019-04-17
6148,경기,안양시,11,0,0,11,7,0,2019-05-17
6149,경기,안양시,4,1,1,6,6,0,2019-06-17
6150,경기,안양시,9,1,4,14,6,0,2019-07-17
6151,경기,안양시,8,1,0,9,5,0,2019-08-17
6152,경기,안양시,3,2,1,6,4,0,2019-09-17
6153,경기,안양시,5,2,0,7,5,0,2019-10-17
6154,경기,안양시,9,0,1,10,6,2,2019-11-17
6155,경기,안양시,3,0,1,4,4,0,2019-12-17
6156,경기,양주시,10,0,0,10,5,0,2019-01-17
6157,경기,양주시,9,0,0,9,7,1,2019-02-17
6158,경기,양주시,2,0,1,3,3,0,2019-03-17
6159,경기,양주시,2,0,0,2,2,0,2019-04-17
6160,경기,양주시,2,0,2,4,4,0,2019-05-17
6161,경기,양주시,1,0,0,1,1,0,2019-06-17
6162,경기,양주시,0,0,0,0,0,0,2019-07-17
6163,경기,양주시,2,0,1,3,2,0,2019-08-17
6164,경기,양주시,3,0,2,5,3,0,2019-09-17
6165,경기,양주시,1,0,0,1,1,0,2019-10-17
6166,경기,양주시,0,0,0,0,0,0,2019-11-17
6167,경기,양주시,3,2,1,6,4,0,2019-12-17
6168,경기,양평군,2,3,0,5,3,0,2019-01-17
6169,경기,양평군,2,1,0,3,1,0,2019-02-17
6170,경기,양평군,2,0,1,3,3,0,2019-03-17
6171,경기,양평군,1,0,1,2,1,0,2019-04-17
6172,경기,양평군,0,0,0,0,0,0,2019-05-17
6173,경기,양평군,0,0,1,1,1,0,2019-06-17
6174,경기,양평군,1,0,1,2,1,0,2019-07-17
6175,경기,양평군,0,0,0,0,0,0,2019-08-17
6176,경기,양평군,2,0,1,3,2,0,2019-09-17
6177,경기,양평군,0,0,0,0,0,0,2019-10-17
6178,경기,양평군,2,0,0,2,1,0,2019-11-17
6179,경기,양평군,1,0,1,2,2,0,2019-12-17
6180,경기,여주시,2,0,3,5,5,1,2019-01-17
6181,경기,여주시,0,0,0,0,0,0,2019-02-17
6182,경기,여주시,9,1,1,11,3,0,2019-03-17
6183,경기,여주시,0,0,2,2,1,0,2019-04-17
6184,경기,여주시,7,0,0,7,3,0,2019-05-17
6185,경기,여주시,0,0,0,0,0,0,2019-06-17
6186,경기,여주시,5,2,0,7,3,0,2019-07-17
6187,경기,여주시,0,0,0,0,0,0,2019-08-17
6188,경기,여주시,0,0,0,0,0,0,2019-09-17
6189,경기,여주시,1,0,0,1,2,1,2019-10-17
6190,경기,여주시,0,0,0,0,0,0,2019-11-17
6191,경기,여주시,0,0,1,1,1,0,2019-12-17
6192,경기,연천군,0,0,0,0,0,0,2019-01-17
6193,경기,연천군,0,0,0,0,0,0,2019-02-17
6194,경기,연천군,0,0,0,0,0,0,2019-03-17
6195,경기,연천군,0,0,0,0,0,0,2019-04-17
6196,경기,연천군,1,0,0,1,1,0,2019-05-17
6197,경기,연천군,1,0,0,1,1,0,2019-06-17
6198,경기,연천군,0,0,0,0,0,0,2019-07-17
6199,경기,연천군,0,0,0,0,0,0,2019-08-17
6200,경기,연천군,0,0,0,0,0,0,2019-09-17
6201,경기,연천군,4,0,0,4,1,0,2019-10-17
6202,경기,연천군,2,0,2,4,2,0,2019-11-17
6203,경기,연천군,1,0,0,1,1,0,2019-12-17
6204,경기,오산시,6,0,1,7,4,0,2019-01-17
6205,경기,오산시,12,0,0,12,1,0,2019-02-17
6206,경기,오산시,2,0,0,2,2,1,2019-03-17
6207,경기,오산시,2,1,0,3,3,0,2019-04-17
6208,경기,오산시,3,1,1,5,4,0,2019-05-17
6209,경기,오산시,3,0,0,3,3,0,2019-06-17
6210,경기,오산시,1,0,2,3,3,0,2019-07-17
6211,경기,오산시,3,1,0,4,2,0,2019-08-17
6212,경기,오산시,4,0,0,4,4,0,2019-09-17
6213,경기,오산시,2,0,1,3,3,0,2019-10-17
6214,경기,오산시,1,1,1,3,3,0,2019-11-17
6215,경기,오산시,0,0,0,0,0,0,2019-12-17
6216,경기,용인시,12,0,5,17,12,0,2019-01-17
6217,경기,용인시,6,0,0,6,6,0,2019-02-17
6218,경기,용인시,9,8,2,19,10,0,2019-03-17
6219,경기,용인시,9,6,3,18,7,0,2019-04-17
6220,경기,용인시,2,0,3,5,5,0,2019-05-17
6221,경기,용인시,13,2,7,22,16,0,2019-06-17
6222,경기,용인시,8,1,3,12,10,0,2019-07-17
6223,경기,용인시,17,3,2,22,12,0,2019-08-17
6224,경기,용인시,12,6,4,22,9,0,2019-09-17
6225,경기,용인시,7,4,3,14,11,0,2019-10-17
6226,경기,용인시,10,3,1,14,10,0,2019-11-17
6227,경기,용인시,17,0,1,18,13,1,2019-12-17
6228,경기,의왕시,1,1,0,2,2,0,2019-01-17
6229,경기,의왕시,0,0,0,0,0,0,2019-02-17
6230,경기,의왕시,1,0,0,1,1,0,2019-03-17
6231,경기,의왕시,0,0,1,1,1,0,2019-04-17
6232,경기,의왕시,1,0,0,1,1,0,2019-05-17
6233,경기,의왕시,0,0,2,2,1,0,2019-06-17
6234,경기,의왕시,2,0,0,2,1,0,2019-07-17
6235,경기,의왕시,0,0,0,0,0,0,2019-08-17
6236,경기,의왕시,0,0,1,1,1,0,2019-09-17
6237,경기,의왕시,0,0,0,0,1,1,2019-10-17
6238,경기,의왕시,0,0,0,0,0,0,2019-11-17
6239,경기,의왕시,1,0,0,1,1,0,2019-12-17
6240,경기,의정부시,9,0,2,11,7,0,2019-01-17
6241,경기,의정부시,0,0,1,1,1,0,2019-02-17
6242,경기,의정부시,6,0,0,6,2,0,2019-03-17
6243,경기,의정부시,4,0,0,4,4,0,2019-04-17
6244,경기,의정부시,3,0,2,5,4,0,2019-05-17
6245,경기,의정부시,0,0,2,2,2,0,2019-06-17
6246,경기,의정부시,7,6,5,18,7,0,2019-07-17
6247,경기,의정부시,5,0,1,6,3,0,2019-08-17
6248,경기,의정부시,0,0,1,1,1,0,2019-09-17
6249,경기,의정부시,9,0,3,12,7,0,2019-10-17
6250,경기,의정부시,7,1,1,9,7,0,2019-11-17
6251,경기,의정부시,9,0,0,9,4,0,2019-12-17
6252,경기,이천시,2,0,1,3,2,0,2019-01-17
6253,경기,이천시,1,1,0,2,2,0,2019-02-17
6254,경기,이천시,3,0,1,4,2,0,2019-03-17
6255,경기,이천시,2,0,2,4,3,0,2019-04-17
6256,경기,이천시,1,1,2,4,2,0,2019-05-17
6257,경기,이천시,3,0,1,4,4,0,2019-06-17
6258,경기,이천시,9,0,0,9,4,0,2019-07-17
6259,경기,이천시,2,0,0,2,2,0,2019-08-17
6260,경기,이천시,2,1,0,3,3,0,2019-09-17
6261,경기,이천시,0,0,0,0,0,0,2019-10-17
6262,경기,이천시,0,0,0,0,1,1,2019-11-17
6263,경기,이천시,2,0,0,2,2,0,2019-12-17
6264,경기,파주시,4,0,0,4,2,0,2019-01-17
6265,경기,파주시,6,1,3,10,5,0,2019-02-17
6266,경기,파주시,3,0,3,6,5,0,2019-03-17
6267,경기,파주시,4,1,4,9,8,0,2019-04-17
6268,경기,파주시,1,0,2,3,3,0,2019-05-17
6269,경기,파주시,10,5,0,15,4,1,2019-06-17
6270,경기,파주시,0,1,0,1,1,0,2019-07-17
6271,경기,파주시,5,1,1,7,5,0,2019-08-17
6272,경기,파주시,1,0,0,1,1,0,2019-09-17
6273,경기,파주시,2,0,0,2,2,0,2019-10-17
6274,경기,파주시,7,0,1,8,2,0,2019-11-17
6275,경기,파주시,0,1,1,2,2,0,2019-12-17
6276,경기,평택시,5,0,4,9,5,0,2019-01-17
6277,경기,평택시,12,1,3,16,10,0,2019-02-17
6278,경기,평택시,10,1,1,12,6,0,2019-03-17
6279,경기,평택시,10,0,4,14,11,0,2019-04-17
6280,경기,평택시,17,0,0,17,10,0,2019-05-17
6281,경기,평택시,9,3,1,13,9,0,2019-06-17
6282,경기,평택시,4,0,6,10,7,1,2019-07-17
6283,경기,평택시,8,1,0,9,6,0,2019-08-17
6284,경기,평택시,17,4,2,23,13,0,2019-09-17
6285,경기,평택시,6,2,2,10,10,0,2019-10-17
6286,경기,평택시,6,1,2,9,7,0,2019-11-17
6287,경기,평택시,8,0,3,11,11,0,2019-12-17
6288,경기,포천시,1,0,3,4,2,0,2019-01-17
6289,경기,포천시,1,0,3,4,3,0,2019-02-17
6290,경기,포천시,5,0,1,6,4,0,2019-03-17
6291,경기,포천시,4,0,1,5,3,0,2019-04-17
6292,경기,포천시,3,0,2,5,3,0,2019-05-17
6293,경기,포천시,0,0,1,1,1,0,2019-06-17
6294,경기,포천시,3,0,1,4,3,0,2019-07-17
6295,경기,포천시,0,1,0,1,1,0,2019-08-17
6296,경기,포천시,0,0,1,1,1,0,2019-09-17
6297,경기,포천시,3,0,2,5,3,0,2019-10-17
6298,경기,포천시,3,0,3,6,3,0,2019-11-17
6299,경기,포천시,7,0,2,9,4,0,2019-12-17
6300,경기,하남시,11,0,2,13,5,0,2019-01-17
6301,경기,하남시,6,0,0,6,2,0,2019-02-17
6302,경기,하남시,1,4,3,8,3,0,2019-03-17
6303,경기,하남시,1,1,1,3,3,0,2019-04-17
6304,경기,하남시,2,1,0,3,3,0,2019-05-17
6305,경기,하남시,6,0,0,6,6,1,2019-06-17
6306,경기,하남시,2,2,3,7,7,0,2019-07-17
6307,경기,하남시,5,0,0,5,2,0,2019-08-17
6308,경기,하남시,0,3,0,3,3,0,2019-09-17
6309,경기,하남시,2,2,2,6,4,0,2019-10-17
6310,경기,하남시,3,0,0,3,3,0,2019-11-17
6311,경기,하남시,3,0,1,4,3,0,2019-12-17
6312,경기,화성시,5,0,2,7,5,1,2019-01-17
6313,경기,화성시,9,0,3,12,11,0,2019-02-17
6314,경기,화성시,1,1,1,3,3,0,2019-03-17
6315,경기,화성시,17,0,1,18,11,0,2019-04-17
6316,경기,화성시,16,0,7,23,14,1,2019-05-17
6317,경기,화성시,9,1,3,13,12,1,2019-06-17
6318,경기,화성시,13,0,3,16,9,0,2019-07-17
6319,경기,화성시,8,1,0,9,9,0,2019-08-17
6320,경기,화성시,16,1,2,19,14,0,2019-09-17
6321,경기,화성시,12,0,0,12,11,0,2019-10-17
6322,경기,화성시,2,0,0,2,2,0,2019-11-17
6323,경기,화성시,8,0,8,16,7,0,2019-12-17
6324,경기,가평군,2,2,0,4,3,0,2019-01-18
6325,경기,가평군,2,1,0,3,2,0,2019-02-18
6326,경기,가평군,3,0,0,3,3,0,2019-03-18
6327,경기,가평군,1,0,0,1,1,0,2019-04-18
6328,경기,가평군,2,0,0,2,2,0,2019-05-18
6329,경기,가평군,0,0,0,0,0,0,2019-06-18
6330,경기,가평군,2,0,1,3,2,0,2019-07-18
6331,경기,가평군,12,0,0,12,5,0,2019-08-18
6332,경기,가평군,1,0,1,2,2,0,2019-09-18
6333,경기,가평군,3,0,1,4,1,0,2019-10-18
6334,경기,가평군,0,0,0,0,0,0,2019-11-18
6335,경기,가평군,1,1,0,2,2,0,2019-12-18
6336,경기,고양시,8,0,0,8,6,0,2019-01-18
6337,경기,고양시,9,1,6,16,14,0,2019-02-18
6338,경기,고양시,6,1,3,10,7,0,2019-03-18
6339,경기,고양시,10,1,4,15,9,1,2019-04-18
6340,경기,고양시,10,2,1,13,6,0,2019-05-18
6341,경기,고양시,7,3,6,16,14,0,2019-06-18
6342,경기,고양시,16,2,5,23,15,0,2019-07-18
6343,경기,고양시,14,2,2,18,10,0,2019-08-18
6344,경기,고양시,14,1,5,20,14,0,2019-09-18
6345,경기,고양시,23,3,2,28,15,0,2019-10-18
6346,경기,고양시,11,3,4,18,14,0,2019-11-18
6347,경기,고양시,7,1,2,10,8,0,2019-12-18
6348,경기,과천시,0,0,0,0,0,0,2019-01-18
6349,경기,과천시,0,0,0,0,0,0,2019-02-18
6350,경기,과천시,0,0,0,0,0,0,2019-03-18
6351,경기,과천시,0,0,0,0,0,0,2019-04-18
6352,경기,과천시,0,0,0,0,0,0,2019-05-18
6353,경기,과천시,0,0,0,0,0,0,2019-06-18
6354,경기,과천시,0,0,0,0,0,0,2019-07-18
6355,경기,과천시,0,0,0,0,0,0,2019-08-18
6356,경기,과천시,0,0,0,0,0,0,2019-09-18
6357,경기,과천시,3,0,0,3,2,0,2019-10-18
6358,경기,과천시,1,1,0,2,2,0,2019-11-18
6359,경기,과천시,0,0,0,0,0,0,2019-12-18
6360,경기,광명시,4,1,1,6,5,0,2019-01-18
6361,경기,광명시,0,0,0,0,0,0,2019-02-18
6362,경기,광명시,2,1,0,3,3,0,2019-03-18
6363,경기,광명시,2,3,3,8,8,0,2019-04-18
6364,경기,광명시,9,0,3,12,9,0,2019-05-18
6365,경기,광명시,0,0,0,0,0,0,2019-06-18
6366,경기,광명시,1,1,0,2,2,0,2019-07-18
6367,경기,광명시,5,1,3,9,5,0,2019-08-18
6368,경기,광명시,1,1,0,2,2,0,2019-09-18
6369,경기,광명시,3,0,0,3,3,0,2019-10-18
6370,경기,광명시,1,1,1,3,3,0,2019-11-18
6371,경기,광명시,7,0,2,9,2,0,2019-12-18
6372,경기,광주시,2,1,0,3,3,0,2019-01-18
6373,경기,광주시,8,0,3,11,7,0,2019-02-18
6374,경기,광주시,8,0,0,8,4,0,2019-03-18
6375,경기,광주시,3,0,0,3,3,0,2019-04-18
6376,경기,광주시,2,1,1,4,4,0,2019-05-18
6377,경기,광주시,7,1,0,8,5,0,2019-06-18
6378,경기,광주시,11,3,2,16,10,0,2019-07-18
6379,경기,광주시,10,0,1,11,5,0,2019-08-18
6380,경기,광주시,15,14,1,30,9,0,2019-09-18
6381,경기,광주시,9,1,1,11,6,0,2019-10-18
6382,경기,광주시,4,1,2,7,5,0,2019-11-18
6383,경기,광주시,9,0,1,10,8,0,2019-12-18
6384,경기,구리시,0,1,0,1,1,0,2019-01-18
6385,경기,구리시,0,0,0,0,0,0,2019-02-18
6386,경기,구리시,2,0,0,2,1,0,2019-03-18
6387,경기,구리시,1,0,0,1,1,0,2019-04-18
6388,경기,구리시,5,0,0,5,4,0,2019-05-18
6389,경기,구리시,1,0,1,2,2,0,2019-06-18
6390,경기,구리시,2,1,0,3,3,0,2019-07-18
6391,경기,구리시,6,2,0,8,2,0,2019-08-18
6392,경기,구리시,1,0,1,2,2,0,2019-09-18
6393,경기,구리시,0,0,1,1,2,1,2019-10-18
6394,경기,구리시,2,0,0,2,2,0,2019-11-18
6395,경기,구리시,1,1,1,3,3,0,2019-12-18
6396,경기,군포시,1,0,0,1,1,0,2019-01-18
6397,경기,군포시,4,0,0,4,2,0,2019-02-18
6398,경기,군포시,0,0,0,0,0,0,2019-03-18
6399,경기,군포시,0,0,0,0,0,0,2019-04-18
6400,경기,군포시,2,0,3,5,4,0,2019-05-18
6401,경기,군포시,3,0,1,4,2,0,2019-06-18
6402,경기,군포시,1,0,1,2,2,0,2019-07-18
6403,경기,군포시,0,1,0,1,1,0,2019-08-18
6404,경기,군포시,2,0,0,2,1,0,2019-09-18
6405,경기,군포시,7,1,1,9,6,0,2019-10-18
6406,경기,군포시,1,1,2,4,3,0,2019-11-18
6407,경기,군포시,2,0,0,2,2,0,2019-12-18
6408,경기,김포시,5,0,1,6,4,0,2019-01-18
6409,경기,김포시,8,1,1,10,6,0,2019-02-18
6410,경기,김포시,4,1,1,6,4,0,2019-03-18
6411,경기,김포시,1,0,0,1,1,0,2019-04-18
6412,경기,김포시,9,0,2,11,5,0,2019-05-18
6413,경기,김포시,5,0,2,7,6,0,2019-06-18
6414,경기,김포시,8,2,0,10,7,1,2019-07-18
6415,경기,김포시,4,2,1,7,5,0,2019-08-18
6416,경기,김포시,3,0,4,7,6,0,2019-09-18
6417,경기,김포시,7,1,2,10,8,0,2019-10-18
6418,경기,김포시,4,0,0,4,4,0,2019-11-18
6419,경기,김포시,7,0,1,8,6,0,2019-12-18
6420,경기,남양주시,6,6,1,13,7,0,2019-01-18
6421,경기,남양주시,8,0,3,11,6,0,2019-02-18
6422,경기,남양주시,8,0,4,12,9,0,2019-03-18
6423,경기,남양주시,7,0,3,10,9,1,2019-04-18
6424,경기,남양주시,6,1,0,7,6,0,2019-05-18
6425,경기,남양주시,7,2,0,9,6,0,2019-06-18
6426,경기,남양주시,8,1,1,10,4,0,2019-07-18
6427,경기,남양주시,7,0,1,8,4,0,2019-08-18
6428,경기,남양주시,2,0,3,5,4,1,2019-09-18
6429,경기,남양주시,6,0,6,12,8,0,2019-10-18
6430,경기,남양주시,6,0,0,6,5,0,2019-11-18
6431,경기,남양주시,3,1,0,4,3,0,2019-12-18
6432,경기,동두천시,3,0,0,3,2,0,2019-01-18
6433,경기,동두천시,3,0,0,3,2,0,2019-02-18
6434,경기,동두천시,0,0,0,0,0,0,2019-03-18
6435,경기,동두천시,2,0,1,3,3,0,2019-04-18
6436,경기,동두천시,0,0,0,0,0,0,2019-05-18
6437,경기,동두천시,0,0,0,0,0,0,2019-06-18
6438,경기,동두천시,2,0,0,2,1,0,2019-07-18
6439,경기,동두천시,0,0,0,0,0,0,2019-08-18
6440,경기,동두천시,0,0,0,0,0,0,2019-09-18
6441,경기,동두천시,1,0,0,1,1,0,2019-10-18
6442,경기,동두천시,1,0,0,1,1,0,2019-11-18
6443,경기,동두천시,8,1,0,9,1,0,2019-12-18
6444,경기,부천시,10,1,1,12,9,0,2019-01-18
6445,경기,부천시,10,2,5,17,16,1,2019-02-18
6446,경기,부천시,13,0,0,13,10,0,2019-03-18
6447,경기,부천시,4,1,2,7,6,0,2019-04-18
6448,경기,부천시,12,0,5,17,9,0,2019-05-18
6449,경기,부천시,16,0,4,20,8,0,2019-06-18
6450,경기,부천시,7,2,7,16,13,0,2019-07-18
6451,경기,부천시,10,0,2,12,8,0,2019-08-18
6452,경기,부천시,12,1,1,14,11,1,2019-09-18
6453,경기,부천시,6,0,5,11,10,0,2019-10-18
6454,경기,부천시,16,2,0,18,9,0,2019-11-18
6455,경기,부천시,6,1,1,8,6,0,2019-12-18
6456,경기,성남시,10,1,6,17,13,0,2019-01-18
6457,경기,성남시,18,2,3,23,13,0,2019-02-18
6458,경기,성남시,6,0,1,7,6,0,2019-03-18
6459,경기,성남시,7,0,4,11,9,0,2019-04-18
6460,경기,성남시,14,5,5,24,12,0,2019-05-18
6461,경기,성남시,8,0,2,10,6,0,2019-06-18
6462,경기,성남시,7,1,5,13,11,0,2019-07-18
6463,경기,성남시,2,0,1,3,2,0,2019-08-18
6464,경기,성남시,14,3,5,22,14,0,2019-09-18
6465,경기,성남시,14,1,4,19,14,0,2019-10-18
6466,경기,성남시,18,0,2,20,14,0,2019-11-18
6467,경기,성남시,14,3,2,19,10,0,2019-12-18
6468,경기,수원시,17,1,3,21,16,1,2019-01-18
6469,경기,수원시,8,1,2,11,12,1,2019-02-18
6470,경기,수원시,13,6,1,20,13,0,2019-03-18
6471,경기,수원시,27,1,5,33,16,0,2019-04-18
6472,경기,수원시,23,1,6,30,16,0,2019-05-18
6473,경기,수원시,15,1,3,19,15,0,2019-06-18
6474,경기,수원시,16,1,1,18,13,0,2019-07-18
6475,경기,수원시,15,0,2,17,11,0,2019-08-18
6476,경기,수원시,18,1,5,24,18,0,2019-09-18
6477,경기,수원시,13,1,3,17,12,0,2019-10-18
6478,경기,수원시,12,4,4,20,15,0,2019-11-18
6479,경기,수원시,19,1,3,23,16,1,2019-12-18
6480,경기,시흥시,7,2,2,11,7,0,2019-01-18
6481,경기,시흥시,3,1,1,5,4,0,2019-02-18
6482,경기,시흥시,12,0,2,14,9,0,2019-03-18
6483,경기,시흥시,13,0,4,17,13,0,2019-04-18
6484,경기,시흥시,9,2,1,12,9,0,2019-05-18
6485,경기,시흥시,12,2,3,17,11,0,2019-06-18
6486,경기,시흥시,3,0,0,3,3,0,2019-07-18
6487,경기,시흥시,9,2,5,16,12,1,2019-08-18
6488,경기,시흥시,3,2,2,7,6,0,2019-09-18
6489,경기,시흥시,9,0,1,10,6,0,2019-10-18
6490,경기,시흥시,4,0,2,6,6,0,2019-11-18
6491,경기,시흥시,11,0,1,12,6,0,2019-12-18
6492,경기,안산시,13,0,1,14,10,0,2019-01-18
6493,경기,안산시,13,1,1,15,10,0,2019-02-18
6494,경기,안산시,7,0,3,10,10,0,2019-03-18
6495,경기,안산시,10,0,7,17,9,0,2019-04-18
6496,경기,안산시,9,0,4,13,5,0,2019-05-18
6497,경기,안산시,16,1,1,18,13,0,2019-06-18
6498,경기,안산시,12,0,1,13,10,0,2019-07-18
6499,경기,안산시,6,4,4,14,8,0,2019-08-18
6500,경기,안산시,12,2,3,17,12,0,2019-09-18
6501,경기,안산시,13,1,5,19,11,0,2019-10-18
6502,경기,안산시,15,1,2,18,13,0,2019-11-18
6503,경기,안산시,19,0,6,25,16,0,2019-12-18
6504,경기,안성시,0,0,1,1,1,0,2019-01-18
6505,경기,안성시,5,0,1,6,5,0,2019-02-18
6506,경기,안성시,5,0,0,5,3,0,2019-03-18
6507,경기,안성시,2,0,0,2,2,0,2019-04-18
6508,경기,안성시,4,2,0,6,4,0,2019-05-18
6509,경기,안성시,6,2,1,9,5,0,2019-06-18
6510,경기,안성시,3,1,2,6,4,0,2019-07-18
6511,경기,안성시,1,0,0,1,1,0,2019-08-18
6512,경기,안성시,5,0,0,5,4,0,2019-09-18
6513,경기,안성시,7,0,0,7,6,0,2019-10-18
6514,경기,안성시,7,0,2,9,5,0,2019-11-18
6515,경기,안성시,0,2,1,3,2,0,2019-12-18
6516,경기,안양시,13,0,4,17,6,0,2019-01-18
6517,경기,안양시,3,0,0,3,3,0,2019-02-18
6518,경기,안양시,1,0,0,1,1,0,2019-03-18
6519,경기,안양시,1,0,1,2,2,0,2019-04-18
6520,경기,안양시,3,0,0,3,3,0,2019-05-18
6521,경기,안양시,3,2,0,5,5,0,2019-06-18
6522,경기,안양시,0,0,2,2,2,0,2019-07-18
6523,경기,안양시,1,0,0,1,1,0,2019-08-18
6524,경기,안양시,3,0,3,6,6,0,2019-09-18
6525,경기,안양시,4,0,0,4,3,0,2019-10-18
6526,경기,안양시,5,0,0,5,4,0,2019-11-18
6527,경기,안양시,1,0,3,4,4,0,2019-12-18
6528,경기,양주시,5,0,1,6,3,0,2019-01-18
6529,경기,양주시,0,1,1,2,2,0,2019-02-18
6530,경기,양주시,0,0,0,0,0,0,2019-03-18
6531,경기,양주시,5,0,0,5,3,0,2019-04-18
6532,경기,양주시,0,0,1,1,2,1,2019-05-18
6533,경기,양주시,5,0,0,5,3,0,2019-06-18
6534,경기,양주시,2,0,0,2,1,0,2019-07-18
6535,경기,양주시,2,0,1,3,3,0,2019-08-18
6536,경기,양주시,3,1,1,5,4,0,2019-09-18
6537,경기,양주시,6,0,1,7,6,0,2019-10-18
6538,경기,양주시,3,1,0,4,3,0,2019-11-18
6539,경기,양주시,5,0,0,5,4,0,2019-12-18
6540,경기,양평군,1,0,0,1,1,0,2019-01-18
6541,경기,양평군,1,0,0,1,1,0,2019-02-18
6542,경기,양평군,0,0,1,1,1,0,2019-03-18
6543,경기,양평군,0,0,1,1,1,0,2019-04-18
6544,경기,양평군,1,0,2,3,2,0,2019-05-18
6545,경기,양평군,2,0,1,3,3,0,2019-06-18
6546,경기,양평군,0,2,1,3,3,0,2019-07-18
6547,경기,양평군,7,1,3,11,4,0,2019-08-18
6548,경기,양평군,0,1,1,2,2,0,2019-09-18
6549,경기,양평군,3,0,1,4,2,0,2019-10-18
6550,경기,양평군,4,0,0,4,2,0,2019-11-18
6551,경기,양평군,0,0,0,0,0,0,2019-12-18
6552,경기,여주시,3,0,0,3,2,0,2019-01-18
6553,경기,여주시,1,0,0,1,2,1,2019-02-18
6554,경기,여주시,3,0,0,3,2,0,2019-03-18
6555,경기,여주시,0,0,0,0,0,0,2019-04-18
6556,경기,여주시,3,0,2,5,4,1,2019-05-18
6557,경기,여주시,0,0,0,0,0,0,2019-06-18
6558,경기,여주시,0,0,0,0,0,0,2019-07-18
6559,경기,여주시,2,0,1,3,2,0,2019-08-18
6560,경기,여주시,1,0,0,1,1,0,2019-09-18
6561,경기,여주시,5,1,1,7,2,0,2019-10-18
6562,경기,여주시,0,0,0,0,0,0,2019-11-18
6563,경기,여주시,0,0,0,0,0,0,2019-12-18
6564,경기,연천군,1,0,1,2,2,0,2019-01-18
6565,경기,연천군,0,0,0,0,0,0,2019-02-18
6566,경기,연천군,0,0,0,0,0,0,2019-03-18
6567,경기,연천군,0,0,0,0,0,0,2019-04-18
6568,경기,연천군,0,0,0,0,0,0,2019-05-18
6569,경기,연천군,0,0,0,0,0,0,2019-06-18
6570,경기,연천군,1,0,0,1,1,0,2019-07-18
6571,경기,연천군,0,0,0,0,0,0,2019-08-18
6572,경기,연천군,0,0,0,0,0,0,2019-09-18
6573,경기,연천군,0,0,0,0,0,0,2019-10-18
6574,경기,연천군,0,0,1,1,1,0,2019-11-18
6575,경기,연천군,0,0,0,0,0,0,2019-12-18
6576,경기,오산시,2,4,1,7,4,0,2019-01-18
6577,경기,오산시,1,0,0,1,1,0,2019-02-18
6578,경기,오산시,3,0,0,3,1,0,2019-03-18
6579,경기,오산시,6,0,1,7,3,0,2019-04-18
6580,경기,오산시,3,0,1,4,4,0,2019-05-18
6581,경기,오산시,7,0,0,7,4,0,2019-06-18
6582,경기,오산시,5,0,0,5,4,0,2019-07-18
6583,경기,오산시,2,0,0,2,2,0,2019-08-18
6584,경기,오산시,1,2,0,3,2,0,2019-09-18
6585,경기,오산시,6,0,0,6,4,0,2019-10-18
6586,경기,오산시,3,1,0,4,3,0,2019-11-18
6587,경기,오산시,2,0,0,2,2,0,2019-12-18
6588,경기,용인시,10,0,4,14,12,0,2019-01-18
6589,경기,용인시,8,0,1,9,6,0,2019-02-18
6590,경기,용인시,7,8,2,17,7,0,2019-03-18
6591,경기,용인시,20,0,5,25,12,0,2019-04-18
6592,경기,용인시,16,3,1,20,9,0,2019-05-18
6593,경기,용인시,8,0,1,9,7,0,2019-06-18
6594,경기,용인시,12,3,7,22,14,0,2019-07-18
6595,경기,용인시,7,5,5,17,6,0,2019-08-18
6596,경기,용인시,10,4,2,16,8,0,2019-09-18
6597,경기,용인시,9,1,2,12,9,0,2019-10-18
6598,경기,용인시,4,0,2,6,5,0,2019-11-18
6599,경기,용인시,7,2,3,12,10,0,2019-12-18
6600,경기,의왕시,3,0,0,3,2,0,2019-01-18
6601,경기,의왕시,3,0,0,3,1,0,2019-02-18
6602,경기,의왕시,0,0,1,1,1,1,2019-03-18
6603,경기,의왕시,0,0,1,1,1,0,2019-04-18
6604,경기,의왕시,1,0,1,2,2,0,2019-05-18
6605,경기,의왕시,2,0,0,2,1,0,2019-06-18
6606,경기,의왕시,0,0,0,0,0,0,2019-07-18
6607,경기,의왕시,1,1,0,2,2,0,2019-08-18
6608,경기,의왕시,0,0,0,0,0,0,2019-09-18
6609,경기,의왕시,0,0,0,0,0,0,2019-10-18
6610,경기,의왕시,1,0,0,1,1,0,2019-11-18
6611,경기,의왕시,3,0,2,5,4,0,2019-12-18
6612,경기,의정부시,11,0,0,11,8,0,2019-01-18
6613,경기,의정부시,5,1,0,6,2,0,2019-02-18
6614,경기,의정부시,2,0,5,7,5,0,2019-03-18
6615,경기,의정부시,1,0,3,4,3,0,2019-04-18
6616,경기,의정부시,4,2,1,7,3,0,2019-05-18
6617,경기,의정부시,3,0,1,4,4,0,2019-06-18
6618,경기,의정부시,5,1,2,8,6,0,2019-07-18
6619,경기,의정부시,3,1,1,5,4,0,2019-08-18
6620,경기,의정부시,5,0,0,5,4,0,2019-09-18
6621,경기,의정부시,0,0,1,1,1,0,2019-10-18
6622,경기,의정부시,5,1,2,8,6,0,2019-11-18
6623,경기,의정부시,6,1,1,8,6,0,2019-12-18
6624,경기,이천시,3,0,1,4,5,1,2019-01-18
6625,경기,이천시,0,0,1,1,1,0,2019-02-18
6626,경기,이천시,1,0,2,3,3,0,2019-03-18
6627,경기,이천시,2,1,1,4,4,0,2019-04-18
6628,경기,이천시,2,0,0,2,2,1,2019-05-18
6629,경기,이천시,2,1,0,3,4,1,2019-06-18
6630,경기,이천시,1,0,0,1,1,0,2019-07-18
6631,경기,이천시,1,0,0,1,1,0,2019-08-18
6632,경기,이천시,0,1,1,2,2,0,2019-09-18
6633,경기,이천시,3,0,0,3,3,0,2019-10-18
6634,경기,이천시,0,0,0,0,0,0,2019-11-18
6635,경기,이천시,1,2,1,4,3,1,2019-12-18
6636,경기,파주시,1,0,1,2,2,0,2019-01-18
6637,경기,파주시,12,0,1,13,9,0,2019-02-18
6638,경기,파주시,7,0,2,9,6,0,2019-03-18
6639,경기,파주시,4,1,4,9,5,0,2019-04-18
6640,경기,파주시,4,0,0,4,4,0,2019-05-18
6641,경기,파주시,11,1,0,12,9,0,2019-06-18
6642,경기,파주시,3,0,0,3,1,0,2019-07-18
6643,경기,파주시,4,0,3,7,5,0,2019-08-18
6644,경기,파주시,7,0,3,10,6,0,2019-09-18
6645,경기,파주시,8,0,2,10,7,0,2019-10-18
6646,경기,파주시,6,0,0,6,3,0,2019-11-18
6647,경기,파주시,2,0,1,3,3,0,2019-12-18
6648,경기,평택시,19,4,4,27,9,0,2019-01-18
6649,경기,평택시,13,1,5,19,11,0,2019-02-18
6650,경기,평택시,12,2,0,14,6,0,2019-03-18
6651,경기,평택시,12,3,0,15,10,0,2019-04-18
6652,경기,평택시,13,2,2,17,9,0,2019-05-18
6653,경기,평택시,21,1,2,24,15,2,2019-06-18
6654,경기,평택시,10,2,2,14,8,0,2019-07-18
6655,경기,평택시,7,0,2,9,7,0,2019-08-18
6656,경기,평택시,9,7,3,19,7,0,2019-09-18
6657,경기,평택시,6,3,3,12,9,0,2019-10-18
6658,경기,평택시,5,1,1,7,7,0,2019-11-18
6659,경기,평택시,24,1,4,29,17,1,2019-12-18
6660,경기,포천시,2,2,0,4,2,0,2019-01-18
6661,경기,포천시,1,0,0,1,1,0,2019-02-18
6662,경기,포천시,4,15,3,22,4,0,2019-03-18
6663,경기,포천시,4,1,0,5,3,0,2019-04-18
6664,경기,포천시,0,0,0,0,0,0,2019-05-18
6665,경기,포천시,3,0,3,6,4,0,2019-06-18
6666,경기,포천시,5,3,1,9,4,0,2019-07-18
6667,경기,포천시,5,0,3,8,3,0,2019-08-18
6668,경기,포천시,5,0,4,9,4,0,2019-09-18
6669,경기,포천시,1,0,3,4,3,0,2019-10-18
6670,경기,포천시,2,1,2,5,4,0,2019-11-18
6671,경기,포천시,1,0,2,3,3,0,2019-12-18
6672,경기,하남시,2,0,1,3,3,0,2019-01-18
6673,경기,하남시,0,0,4,4,3,0,2019-02-18
6674,경기,하남시,5,0,2,7,3,0,2019-03-18
6675,경기,하남시,1,1,0,2,2,0,2019-04-18
6676,경기,하남시,8,0,1,9,5,0,2019-05-18
6677,경기,하남시,4,0,0,4,3,0,2019-06-18
6678,경기,하남시,7,0,0,7,5,0,2019-07-18
6679,경기,하남시,0,0,0,0,0,0,2019-08-18
6680,경기,하남시,2,1,1,4,3,0,2019-09-18
6681,경기,하남시,4,1,2,7,5,0,2019-10-18
6682,경기,하남시,0,0,0,0,0,0,2019-11-18
6683,경기,하남시,1,0,0,1,1,0,2019-12-18
6684,경기,화성시,10,0,1,11,7,0,2019-01-18
6685,경기,화성시,13,0,1,14,9,0,2019-02-18
6686,경기,화성시,4,0,4,8,6,0,2019-03-18
6687,경기,화성시,17,0,1,18,13,0,2019-04-18
6688,경기,화성시,7,2,1,10,7,0,2019-05-18
6689,경기,화성시,5,2,5,12,8,0,2019-06-18
6690,경기,화성시,10,1,0,11,8,0,2019-07-18
6691,경기,화성시,6,3,2,11,8,0,2019-08-18
6692,경기,화성시,15,2,2,19,12,0,2019-09-18
6693,경기,화성시,14,2,1,17,15,0,2019-10-18
6694,경기,화성시,13,2,2,17,11,0,2019-11-18
6695,경기,화성시,10,1,2,13,9,0,2019-12-18
6696,경기,가평군,0,0,0,0,0,0,2019-01-19
6697,경기,가평군,0,0,0,0,0,0,2019-02-19
6698,경기,가평군,0,0,0,0,0,0,2019-03-19
6699,경기,가평군,0,0,0,0,0,0,2019-04-19
6700,경기,가평군,0,0,0,0,0,0,2019-05-19
6701,경기,가평군,0,0,0,0,0,0,2019-06-19
6702,경기,가평군,0,0,0,0,0,0,2019-07-19
6703,경기,가평군,0,0,0,0,0,0,2019-08-19
6704,경기,가평군,0,0,1,1,1,0,2019-09-19
6705,경기,가평군,1,0,2,3,2,0,2019-10-19
6706,경기,가평군,0,0,0,0,0,0,2019-11-19
6707,경기,가평군,0,0,0,0,0,0,2019-12-19
6708,경기,고양시,12,2,2,16,7,0,2019-01-19
6709,경기,고양시,15,0,3,18,12,0,2019-02-19
6710,경기,고양시,16,0,5,21,11,0,2019-03-19
6711,경기,고양시,20,3,7,30,17,0,2019-04-19
6712,경기,고양시,12,0,4,16,10,0,2019-05-19
6713,경기,고양시,6,2,3,11,8,0,2019-06-19
6714,경기,고양시,9,3,3,15,12,0,2019-07-19
6715,경기,고양시,11,0,0,11,9,0,2019-08-19
6716,경기,고양시,16,0,5,21,10,0,2019-09-19
6717,경기,고양시,11,1,3,15,10,0,2019-10-19
6718,경기,고양시,10,2,3,15,11,0,2019-11-19
6719,경기,고양시,13,0,5,18,17,0,2019-12-19
6720,경기,과천시,2,0,0,2,1,0,2019-01-19
6721,경기,과천시,0,0,0,0,0,0,2019-02-19
6722,경기,과천시,1,0,0,1,1,0,2019-03-19
6723,경기,과천시,0,0,0,0,0,0,2019-04-19
6724,경기,과천시,0,0,0,0,0,0,2019-05-19
6725,경기,과천시,0,0,0,0,0,0,2019-06-19
6726,경기,과천시,0,0,0,0,0,0,2019-07-19
6727,경기,과천시,2,1,1,4,1,0,2019-08-19
6728,경기,과천시,0,0,0,0,0,0,2019-09-19
6729,경기,과천시,1,0,0,1,1,0,2019-10-19
6730,경기,과천시,0,0,0,0,0,0,2019-11-19
6731,경기,과천시,0,0,0,0,0,0,2019-12-19
6732,경기,광명시,5,2,0,7,3,0,2019-01-19
6733,경기,광명시,4,1,0,5,2,0,2019-02-19
6734,경기,광명시,1,0,1,2,2,0,2019-03-19
6735,경기,광명시,0,0,2,2,2,0,2019-04-19
6736,경기,광명시,0,0,0,0,0,0,2019-05-19
6737,경기,광명시,5,0,1,6,4,0,2019-06-19
6738,경기,광명시,6,0,2,8,6,0,2019-07-19
6739,경기,광명시,0,1,1,2,2,0,2019-08-19
6740,경기,광명시,1,1,0,2,2,0,2019-09-19
6741,경기,광명시,3,0,0,3,3,0,2019-10-19
6742,경기,광명시,0,2,0,2,2,0,2019-11-19
6743,경기,광명시,4,2,0,6,5,0,2019-12-19
6744,경기,광주시,9,0,0,9,5,0,2019-01-19
6745,경기,광주시,0,1,2,3,3,0,2019-02-19
6746,경기,광주시,3,0,0,3,2,0,2019-03-19
6747,경기,광주시,1,0,1,2,2,0,2019-04-19
6748,경기,광주시,2,1,0,3,4,1,2019-05-19
6749,경기,광주시,7,4,1,12,6,0,2019-06-19
6750,경기,광주시,5,1,0,6,4,0,2019-07-19
6751,경기,광주시,3,0,1,4,5,1,2019-08-19
6752,경기,광주시,3,0,3,6,6,0,2019-09-19
6753,경기,광주시,12,4,2,18,9,0,2019-10-19
6754,경기,광주시,4,1,1,6,6,0,2019-11-19
6755,경기,광주시,5,1,1,7,7,0,2019-12-19
6756,경기,구리시,0,1,1,2,2,0,2019-01-19
6757,경기,구리시,5,2,0,7,5,0,2019-02-19
6758,경기,구리시,0,0,3,3,3,0,2019-03-19
6759,경기,구리시,1,0,0,1,1,0,2019-04-19
6760,경기,구리시,2,3,2,7,2,0,2019-05-19
6761,경기,구리시,3,0,0,3,3,0,2019-06-19
6762,경기,구리시,2,0,0,2,2,0,2019-07-19
6763,경기,구리시,10,0,1,11,5,0,2019-08-19
6764,경기,구리시,2,2,0,4,2,0,2019-09-19
6765,경기,구리시,2,2,1,5,2,0,2019-10-19
6766,경기,구리시,1,0,0,1,1,0,2019-11-19
6767,경기,구리시,3,0,0,3,2,0,2019-12-19
6768,경기,군포시,0,1,0,1,1,0,2019-01-19
6769,경기,군포시,0,0,0,0,0,0,2019-02-19
6770,경기,군포시,1,0,2,3,3,0,2019-03-19
6771,경기,군포시,0,0,1,1,1,0,2019-04-19
6772,경기,군포시,1,0,2,3,2,0,2019-05-19
6773,경기,군포시,1,1,0,2,1,0,2019-06-19
6774,경기,군포시,1,0,0,1,1,0,2019-07-19
6775,경기,군포시,0,0,1,1,1,0,2019-08-19
6776,경기,군포시,0,0,1,1,1,0,2019-09-19
6777,경기,군포시,1,0,0,1,1,0,2019-10-19
6778,경기,군포시,0,0,0,0,0,0,2019-11-19
6779,경기,군포시,5,4,0,9,3,0,2019-12-19
6780,경기,김포시,9,0,4,13,8,0,2019-01-19
6781,경기,김포시,5,0,0,5,5,0,2019-02-19
6782,경기,김포시,6,2,0,8,6,0,2019-03-19
6783,경기,김포시,9,1,4,14,9,0,2019-04-19
6784,경기,김포시,3,0,3,6,3,0,2019-05-19
6785,경기,김포시,5,0,3,8,6,0,2019-06-19
6786,경기,김포시,3,1,1,5,5,0,2019-07-19
6787,경기,김포시,10,1,0,11,6,0,2019-08-19
6788,경기,김포시,2,0,2,4,5,1,2019-09-19
6789,경기,김포시,11,0,1,12,4,0,2019-10-19
6790,경기,김포시,5,0,2,7,6,0,2019-11-19
6791,경기,김포시,12,1,0,13,9,1,2019-12-19
6792,경기,남양주시,7,0,4,11,11,0,2019-01-19
6793,경기,남양주시,5,0,0,5,4,0,2019-02-19
6794,경기,남양주시,4,1,1,6,5,0,2019-03-19
6795,경기,남양주시,7,0,2,9,6,1,2019-04-19
6796,경기,남양주시,5,2,1,8,6,1,2019-05-19
6797,경기,남양주시,4,0,1,5,5,0,2019-06-19
6798,경기,남양주시,8,1,3,12,5,0,2019-07-19
6799,경기,남양주시,4,1,4,9,8,0,2019-08-19
6800,경기,남양주시,19,6,6,31,16,0,2019-09-19
6801,경기,남양주시,8,0,0,8,4,0,2019-10-19
6802,경기,남양주시,12,1,3,16,10,0,2019-11-19
6803,경기,남양주시,9,3,3,15,11,0,2019-12-19
6804,경기,동두천시,1,0,3,4,2,0,2019-01-19
6805,경기,동두천시,0,0,0,0,0,0,2019-02-19
6806,경기,동두천시,1,0,0,1,1,0,2019-03-19
6807,경기,동두천시,2,0,0,2,2,0,2019-04-19
6808,경기,동두천시,1,1,0,2,1,0,2019-05-19
6809,경기,동두천시,2,0,0,2,2,0,2019-06-19
6810,경기,동두천시,1,0,0,1,1,0,2019-07-19
6811,경기,동두천시,3,0,0,3,1,0,2019-08-19
6812,경기,동두천시,0,0,1,1,1,0,2019-09-19
6813,경기,동두천시,0,0,0,0,0,0,2019-10-19
6814,경기,동두천시,2,0,0,2,2,0,2019-11-19
6815,경기,동두천시,0,0,0,0,0,0,2019-12-19
6816,경기,부천시,6,0,2,8,7,0,2019-01-19
6817,경기,부천시,11,4,3,18,14,0,2019-02-19
6818,경기,부천시,7,0,1,8,7,0,2019-03-19
6819,경기,부천시,9,0,6,15,13,1,2019-04-19
6820,경기,부천시,13,3,3,19,11,0,2019-05-19
6821,경기,부천시,15,1,2,18,11,0,2019-06-19
6822,경기,부천시,10,1,1,12,9,0,2019-07-19
6823,경기,부천시,9,0,4,13,9,0,2019-08-19
6824,경기,부천시,14,2,4,20,14,0,2019-09-19
6825,경기,부천시,8,1,1,10,9,0,2019-10-19
6826,경기,부천시,12,0,6,18,15,0,2019-11-19
6827,경기,부천시,16,1,0,17,13,0,2019-12-19
6828,경기,성남시,6,0,4,10,8,0,2019-01-19
6829,경기,성남시,8,2,1,11,8,0,2019-02-19
6830,경기,성남시,4,2,3,9,8,0,2019-03-19
6831,경기,성남시,16,2,4,22,7,0,2019-04-19
6832,경기,성남시,14,3,4,21,10,0,2019-05-19
6833,경기,성남시,7,0,2,9,7,0,2019-06-19
6834,경기,성남시,13,1,3,17,15,0,2019-07-19
6835,경기,성남시,8,0,1,9,9,0,2019-08-19
6836,경기,성남시,13,2,6,21,12,0,2019-09-19
6837,경기,성남시,28,0,7,35,11,0,2019-10-19
6838,경기,성남시,6,0,2,8,6,0,2019-11-19
6839,경기,성남시,9,2,6,17,11,0,2019-12-19
6840,경기,수원시,14,0,1,15,10,0,2019-01-19
6841,경기,수원시,8,0,2,10,7,0,2019-02-19
6842,경기,수원시,23,0,2,25,12,0,2019-03-19
6843,경기,수원시,19,0,6,25,16,0,2019-04-19
6844,경기,수원시,9,1,0,10,7,0,2019-05-19
6845,경기,수원시,22,2,4,28,12,0,2019-06-19
6846,경기,수원시,13,4,3,20,13,0,2019-07-19
6847,경기,수원시,14,1,8,23,17,0,2019-08-19
6848,경기,수원시,16,1,5,22,16,1,2019-09-19
6849,경기,수원시,18,1,2,21,17,0,2019-10-19
6850,경기,수원시,19,2,3,24,16,1,2019-11-19
6851,경기,수원시,14,2,3,19,15,0,2019-12-19
6852,경기,시흥시,11,0,1,12,5,1,2019-01-19
6853,경기,시흥시,7,0,4,11,7,1,2019-02-19
6854,경기,시흥시,12,0,1,13,7,0,2019-03-19
6855,경기,시흥시,7,0,1,8,7,2,2019-04-19
6856,경기,시흥시,16,0,3,19,7,0,2019-05-19
6857,경기,시흥시,5,1,2,8,7,0,2019-06-19
6858,경기,시흥시,7,3,3,13,8,0,2019-07-19
6859,경기,시흥시,6,1,2,9,4,0,2019-08-19
6860,경기,시흥시,10,0,1,11,6,0,2019-09-19
6861,경기,시흥시,8,1,2,11,10,1,2019-10-19
6862,경기,시흥시,6,0,0,6,5,0,2019-11-19
6863,경기,시흥시,4,0,3,7,5,0,2019-12-19
6864,경기,안산시,10,0,2,12,12,1,2019-01-19
6865,경기,안산시,10,0,1,11,10,0,2019-02-19
6866,경기,안산시,8,0,3,11,8,0,2019-03-19
6867,경기,안산시,17,1,2,20,17,0,2019-04-19
6868,경기,안산시,12,4,8,24,14,0,2019-05-19
6869,경기,안산시,9,3,1,13,11,0,2019-06-19
6870,경기,안산시,27,0,7,34,19,0,2019-07-19
6871,경기,안산시,6,0,1,7,6,0,2019-08-19
6872,경기,안산시,4,0,3,7,6,0,2019-09-19
6873,경기,안산시,5,1,0,6,4,0,2019-10-19
6874,경기,안산시,13,1,1,15,11,0,2019-11-19
6875,경기,안산시,21,2,2,25,12,0,2019-12-19
6876,경기,안성시,1,0,2,3,2,0,2019-01-19
6877,경기,안성시,1,0,0,1,1,0,2019-02-19
6878,경기,안성시,2,0,0,2,2,0,2019-03-19
6879,경기,안성시,1,0,0,1,1,0,2019-04-19
6880,경기,안성시,2,0,1,3,3,0,2019-05-19
6881,경기,안성시,2,2,3,7,3,0,2019-06-19
6882,경기,안성시,6,0,0,6,3,0,2019-07-19
6883,경기,안성시,0,1,4,5,1,0,2019-08-19
6884,경기,안성시,0,0,1,1,1,0,2019-09-19
6885,경기,안성시,0,0,1,1,1,0,2019-10-19
6886,경기,안성시,0,0,0,0,0,0,2019-11-19
6887,경기,안성시,4,0,1,5,3,0,2019-12-19
6888,경기,안양시,14,0,1,15,8,0,2019-01-19
6889,경기,안양시,4,0,2,6,5,0,2019-02-19
6890,경기,안양시,1,0,0,1,1,0,2019-03-19
6891,경기,안양시,4,0,3,7,5,0,2019-04-19
6892,경기,안양시,4,0,0,4,4,0,2019-05-19
6893,경기,안양시,4,2,1,7,5,0,2019-06-19
6894,경기,안양시,5,0,1,6,6,0,2019-07-19
6895,경기,안양시,2,0,2,4,4,0,2019-08-19
6896,경기,안양시,9,0,1,10,7,0,2019-09-19
6897,경기,안양시,1,0,3,4,3,0,2019-10-19
6898,경기,안양시,4,1,0,5,4,0,2019-11-19
6899,경기,안양시,3,0,1,4,3,0,2019-12-19
6900,경기,양주시,1,1,0,2,2,0,2019-01-19
6901,경기,양주시,2,0,1,3,2,0,2019-02-19
6902,경기,양주시,2,1,0,3,3,0,2019-03-19
6903,경기,양주시,4,0,0,4,1,0,2019-04-19
6904,경기,양주시,6,0,1,7,4,0,2019-05-19
6905,경기,양주시,2,0,0,2,2,0,2019-06-19
6906,경기,양주시,6,2,1,9,5,0,2019-07-19
6907,경기,양주시,5,0,1,6,3,0,2019-08-19
6908,경기,양주시,2,0,0,2,2,0,2019-09-19
6909,경기,양주시,8,1,1,10,5,0,2019-10-19
6910,경기,양주시,6,1,4,11,7,0,2019-11-19
6911,경기,양주시,3,1,1,5,4,0,2019-12-19
6912,경기,양평군,1,0,2,3,1,0,2019-01-19
6913,경기,양평군,0,0,0,0,0,0,2019-02-19
6914,경기,양평군,0,0,0,0,0,0,2019-03-19
6915,경기,양평군,2,0,0,2,2,0,2019-04-19
6916,경기,양평군,6,1,2,9,4,0,2019-05-19
6917,경기,양평군,0,0,0,0,0,0,2019-06-19
6918,경기,양평군,0,3,0,3,1,0,2019-07-19
6919,경기,양평군,1,1,0,2,2,0,2019-08-19
6920,경기,양평군,0,0,0,0,0,0,2019-09-19
6921,경기,양평군,4,0,0,4,1,0,2019-10-19
6922,경기,양평군,3,1,1,5,3,0,2019-11-19
6923,경기,양평군,1,0,1,2,2,0,2019-12-19
6924,경기,여주시,0,0,0,0,0,0,2019-01-19
6925,경기,여주시,0,0,0,0,0,0,2019-02-19
6926,경기,여주시,0,0,0,0,0,0,2019-03-19
6927,경기,여주시,0,0,0,0,0,0,2019-04-19
6928,경기,여주시,0,0,0,0,0,0,2019-05-19
6929,경기,여주시,6,0,1,7,4,0,2019-06-19
6930,경기,여주시,2,0,1,3,2,0,2019-07-19
6931,경기,여주시,3,1,1,5,3,0,2019-08-19
6932,경기,여주시,1,0,0,1,1,0,2019-09-19
6933,경기,여주시,0,1,0,1,1,0,2019-10-19
6934,경기,여주시,2,0,0,2,1,0,2019-11-19
6935,경기,여주시,2,0,0,2,2,0,2019-12-19
6936,경기,연천군,0,0,0,0,0,0,2019-01-19
6937,경기,연천군,2,0,0,2,1,0,2019-02-19
6938,경기,연천군,2,0,0,2,2,0,2019-03-19
6939,경기,연천군,1,0,0,1,1,0,2019-04-19
6940,경기,연천군,0,0,0,0,0,0,2019-05-19
6941,경기,연천군,0,0,0,0,0,0,2019-06-19
6942,경기,연천군,0,0,0,0,0,0,2019-07-19
6943,경기,연천군,0,0,0,0,0,0,2019-08-19
6944,경기,연천군,0,0,0,0,0,0,2019-09-19
6945,경기,연천군,1,0,0,1,1,0,2019-10-19
6946,경기,연천군,0,0,0,0,0,0,2019-11-19
6947,경기,연천군,0,0,0,0,0,0,2019-12-19
6948,경기,오산시,4,0,0,4,3,0,2019-01-19
6949,경기,오산시,9,0,0,9,2,0,2019-02-19
6950,경기,오산시,2,0,0,2,1,0,2019-03-19
6951,경기,오산시,3,0,0,3,3,0,2019-04-19
6952,경기,오산시,10,0,1,11,4,0,2019-05-19
6953,경기,오산시,0,0,0,0,0,0,2019-06-19
6954,경기,오산시,5,0,0,5,4,0,2019-07-19
6955,경기,오산시,0,0,0,0,0,0,2019-08-19
6956,경기,오산시,4,0,1,5,4,0,2019-09-19
6957,경기,오산시,3,0,0,3,2,0,2019-10-19
6958,경기,오산시,14,0,2,16,7,0,2019-11-19
6959,경기,오산시,2,3,0,5,3,0,2019-12-19
6960,경기,용인시,11,1,5,17,9,0,2019-01-19
6961,경기,용인시,4,1,0,5,4,0,2019-02-19
6962,경기,용인시,15,0,5,20,6,0,2019-03-19
6963,경기,용인시,12,2,6,20,9,0,2019-04-19
6964,경기,용인시,14,1,3,18,10,0,2019-05-19
6965,경기,용인시,16,2,5,23,12,0,2019-06-19
6966,경기,용인시,4,2,3,9,9,0,2019-07-19
6967,경기,용인시,12,0,2,14,10,0,2019-08-19
6968,경기,용인시,8,2,3,13,12,1,2019-09-19
6969,경기,용인시,22,8,2,32,15,0,2019-10-19
6970,경기,용인시,11,2,1,14,10,0,2019-11-19
6971,경기,용인시,10,1,5,16,6,0,2019-12-19
6972,경기,의왕시,0,0,0,0,0,0,2019-01-19
6973,경기,의왕시,1,0,0,1,1,0,2019-02-19
6974,경기,의왕시,1,0,0,1,1,0,2019-03-19
6975,경기,의왕시,7,0,0,7,4,0,2019-04-19
6976,경기,의왕시,1,0,1,2,2,0,2019-05-19
6977,경기,의왕시,0,0,0,0,0,0,2019-06-19
6978,경기,의왕시,5,0,0,5,4,0,2019-07-19
6979,경기,의왕시,1,0,1,2,2,0,2019-08-19
6980,경기,의왕시,9,0,0,9,2,0,2019-09-19
6981,경기,의왕시,0,0,0,0,0,0,2019-10-19
6982,경기,의왕시,3,0,1,4,3,0,2019-11-19
6983,경기,의왕시,4,1,0,5,4,0,2019-12-19
6984,경기,의정부시,4,0,0,4,3,0,2019-01-19
6985,경기,의정부시,2,0,2,4,4,0,2019-02-19
6986,경기,의정부시,4,0,2,6,5,0,2019-03-19
6987,경기,의정부시,6,1,2,9,6,0,2019-04-19
6988,경기,의정부시,4,1,0,5,4,0,2019-05-19
6989,경기,의정부시,4,0,0,4,2,0,2019-06-19
6990,경기,의정부시,8,0,1,9,8,0,2019-07-19
6991,경기,의정부시,7,0,1,8,6,0,2019-08-19
6992,경기,의정부시,4,0,1,5,4,0,2019-09-19
6993,경기,의정부시,5,0,2,7,7,1,2019-10-19
6994,경기,의정부시,12,2,2,16,12,0,2019-11-19
6995,경기,의정부시,3,3,0,6,4,0,2019-12-19
6996,경기,이천시,6,0,4,10,7,0,2019-01-19
6997,경기,이천시,2,0,0,2,1,0,2019-02-19
6998,경기,이천시,4,0,0,4,2,0,2019-03-19
6999,경기,이천시,3,0,0,3,2,0,2019-04-19
7000,경기,이천시,6,0,1,7,3,0,2019-05-19
7001,경기,이천시,1,0,2,3,2,0,2019-06-19
7002,경기,이천시,5,0,0,5,3,0,2019-07-19
7003,경기,이천시,7,0,1,8,6,0,2019-08-19
7004,경기,이천시,3,0,3,6,5,0,2019-09-19
7005,경기,이천시,6,1,2,9,5,0,2019-10-19
7006,경기,이천시,4,1,1,6,5,0,2019-11-19
7007,경기,이천시,7,1,1,9,5,0,2019-12-19
7008,경기,파주시,1,0,2,3,3,0,2019-01-19
7009,경기,파주시,5,0,1,6,3,0,2019-02-19
7010,경기,파주시,0,0,0,0,1,1,2019-03-19
7011,경기,파주시,2,0,5,7,5,0,2019-04-19
7012,경기,파주시,5,0,1,6,4,0,2019-05-19
7013,경기,파주시,2,0,1,3,3,0,2019-06-19
7014,경기,파주시,12,1,2,15,8,0,2019-07-19
7015,경기,파주시,0,2,0,2,1,0,2019-08-19
7016,경기,파주시,2,0,1,3,3,0,2019-09-19
7017,경기,파주시,2,0,0,2,2,0,2019-10-19
7018,경기,파주시,3,0,2,5,3,0,2019-11-19
7019,경기,파주시,10,0,0,10,8,0,2019-12-19
7020,경기,평택시,4,1,4,9,6,1,2019-01-19
7021,경기,평택시,3,1,1,5,4,0,2019-02-19
7022,경기,평택시,7,1,3,11,8,0,2019-03-19
7023,경기,평택시,5,0,1,6,5,0,2019-04-19
7024,경기,평택시,8,2,1,11,7,0,2019-05-19
7025,경기,평택시,10,1,4,15,13,1,2019-06-19
7026,경기,평택시,6,3,1,10,8,0,2019-07-19
7027,경기,평택시,5,3,2,10,9,0,2019-08-19
7028,경기,평택시,9,9,1,19,11,0,2019-09-19
7029,경기,평택시,6,3,3,12,9,0,2019-10-19
7030,경기,평택시,21,6,5,32,19,0,2019-11-19
7031,경기,평택시,12,1,6,19,15,0,2019-12-19
7032,경기,포천시,1,0,0,1,1,0,2019-01-19
7033,경기,포천시,2,0,1,3,1,0,2019-02-19
7034,경기,포천시,1,1,1,3,2,0,2019-03-19
7035,경기,포천시,1,0,0,1,1,0,2019-04-19
7036,경기,포천시,0,0,0,0,0,0,2019-05-19
7037,경기,포천시,2,0,1,3,2,0,2019-06-19
7038,경기,포천시,2,0,2,4,2,0,2019-07-19
7039,경기,포천시,1,0,2,3,2,0,2019-08-19
7040,경기,포천시,1,0,0,1,1,0,2019-09-19
7041,경기,포천시,7,0,0,7,4,0,2019-10-19
7042,경기,포천시,1,0,0,1,1,0,2019-11-19
7043,경기,포천시,4,0,1,5,3,0,2019-12-19
7044,경기,하남시,2,0,0,2,1,0,2019-01-19
7045,경기,하남시,2,1,0,3,2,0,2019-02-19
7046,경기,하남시,8,0,1,9,5,0,2019-03-19
7047,경기,하남시,9,0,0,9,3,0,2019-04-19
7048,경기,하남시,3,0,4,7,5,0,2019-05-19
7049,경기,하남시,1,2,1,4,3,0,2019-06-19
7050,경기,하남시,2,2,2,6,5,0,2019-07-19
7051,경기,하남시,1,0,0,1,1,0,2019-08-19
7052,경기,하남시,2,0,1,3,3,0,2019-09-19
7053,경기,하남시,3,0,1,4,3,0,2019-10-19
7054,경기,하남시,6,0,1,7,4,0,2019-11-19
7055,경기,하남시,15,0,1,16,6,0,2019-12-19
7056,경기,화성시,14,1,1,16,8,0,2019-01-19
7057,경기,화성시,8,0,1,9,4,0,2019-02-19
7058,경기,화성시,7,1,7,15,9,0,2019-03-19
7059,경기,화성시,4,0,2,6,5,0,2019-04-19
7060,경기,화성시,18,1,2,21,8,0,2019-05-19
7061,경기,화성시,3,1,3,7,6,0,2019-06-19
7062,경기,화성시,18,0,4,22,14,0,2019-07-19
7063,경기,화성시,6,0,1,7,5,0,2019-08-19
7064,경기,화성시,6,0,2,8,6,0,2019-09-19
7065,경기,화성시,11,3,1,15,9,0,2019-10-19
7066,경기,화성시,25,3,3,31,17,0,2019-11-19
7067,경기,화성시,13,0,6,19,14,0,2019-12-19
7068,경기,가평군,0,0,0,0,0,0,2019-01-20
7069,경기,가평군,0,0,0,0,0,0,2019-02-20
7070,경기,가평군,0,0,0,0,0,0,2019-03-20
7071,경기,가평군,0,0,0,0,0,0,2019-04-20
7072,경기,가평군,0,0,0,0,0,0,2019-05-20
7073,경기,가평군,0,0,0,0,0,0,2019-06-20
7074,경기,가평군,3,0,0,3,2,0,2019-07-20
7075,경기,가평군,0,0,0,0,0,0,2019-08-20
7076,경기,가평군,0,0,0,0,0,0,2019-09-20
7077,경기,가평군,2,0,0,2,1,0,2019-10-20
7078,경기,가평군,1,0,0,1,1,0,2019-11-20
7079,경기,가평군,3,0,0,3,1,0,2019-12-20
7080,경기,고양시,11,1,3,15,5,0,2019-01-20
7081,경기,고양시,12,1,5,18,13,0,2019-02-20
7082,경기,고양시,24,2,3,29,19,0,2019-03-20
7083,경기,고양시,9,1,3,13,11,0,2019-04-20
7084,경기,고양시,4,0,3,7,7,0,2019-05-20
7085,경기,고양시,6,1,3,10,9,0,2019-06-20
7086,경기,고양시,14,2,5,21,15,0,2019-07-20
7087,경기,고양시,18,1,0,19,10,0,2019-08-20
7088,경기,고양시,12,4,3,19,15,0,2019-09-20
7089,경기,고양시,4,2,3,9,7,0,2019-10-20
7090,경기,고양시,9,1,3,13,10,0,2019-11-20
7091,경기,고양시,12,0,2,14,10,0,2019-12-20
7092,경기,과천시,5,0,0,5,2,0,2019-01-20
7093,경기,과천시,0,0,0,0,0,0,2019-02-20
7094,경기,과천시,0,0,0,0,0,0,2019-03-20
7095,경기,과천시,0,0,1,1,1,0,2019-04-20
7096,경기,과천시,9,5,4,18,2,0,2019-05-20
7097,경기,과천시,1,0,0,1,1,0,2019-06-20
7098,경기,과천시,0,0,0,0,0,0,2019-07-20
7099,경기,과천시,0,0,0,0,0,0,2019-08-20
7100,경기,과천시,0,0,0,0,0,0,2019-09-20
7101,경기,과천시,0,0,0,0,0,0,2019-10-20
7102,경기,과천시,3,0,0,3,1,0,2019-11-20
7103,경기,과천시,0,0,0,0,0,0,2019-12-20
7104,경기,광명시,0,1,0,1,1,0,2019-01-20
7105,경기,광명시,1,0,0,1,1,0,2019-02-20
7106,경기,광명시,2,2,3,7,5,0,2019-03-20
7107,경기,광명시,1,1,1,3,3,0,2019-04-20
7108,경기,광명시,3,0,0,3,3,0,2019-05-20
7109,경기,광명시,1,0,0,1,1,0,2019-06-20
7110,경기,광명시,8,0,0,8,3,0,2019-07-20
7111,경기,광명시,2,1,2,5,4,0,2019-08-20
7112,경기,광명시,9,2,1,12,7,0,2019-09-20
7113,경기,광명시,2,2,1,5,4,0,2019-10-20
7114,경기,광명시,5,2,0,7,3,0,2019-11-20
7115,경기,광명시,1,0,1,2,2,0,2019-12-20
7116,경기,광주시,1,0,3,4,3,1,2019-01-20
7117,경기,광주시,4,0,0,4,4,0,2019-02-20
7118,경기,광주시,6,0,1,7,6,0,2019-03-20
7119,경기,광주시,4,0,1,5,5,0,2019-04-20
7120,경기,광주시,10,1,1,12,8,0,2019-05-20
7121,경기,광주시,4,1,4,9,8,0,2019-06-20
7122,경기,광주시,4,0,1,5,4,0,2019-07-20
7123,경기,광주시,4,0,3,7,5,0,2019-08-20
7124,경기,광주시,10,0,2,12,9,0,2019-09-20
7125,경기,광주시,14,0,1,15,9,0,2019-10-20
7126,경기,광주시,7,1,0,8,7,0,2019-11-20
7127,경기,광주시,12,0,4,16,10,0,2019-12-20
7128,경기,구리시,0,0,1,1,1,0,2019-01-20
7129,경기,구리시,2,0,0,2,2,0,2019-02-20
7130,경기,구리시,0,0,1,1,1,0,2019-03-20
7131,경기,구리시,8,0,3,11,4,0,2019-04-20
7132,경기,구리시,3,1,1,5,5,0,2019-05-20
7133,경기,구리시,5,0,0,5,4,0,2019-06-20
7134,경기,구리시,7,0,3,10,4,0,2019-07-20
7135,경기,구리시,6,0,1,7,5,0,2019-08-20
7136,경기,구리시,1,0,0,1,2,1,2019-09-20
7137,경기,구리시,1,0,0,1,1,0,2019-10-20
7138,경기,구리시,5,0,1,6,4,0,2019-11-20
7139,경기,구리시,3,0,0,3,2,0,2019-12-20
7140,경기,군포시,0,0,0,0,0,0,2019-01-20
7141,경기,군포시,2,1,1,4,2,0,2019-02-20
7142,경기,군포시,6,0,0,6,3,0,2019-03-20
7143,경기,군포시,9,1,1,11,7,0,2019-04-20
7144,경기,군포시,10,2,4,16,5,0,2019-05-20
7145,경기,군포시,3,0,0,3,3,0,2019-06-20
7146,경기,군포시,0,0,0,0,0,0,2019-07-20
7147,경기,군포시,2,0,1,3,3,0,2019-08-20
7148,경기,군포시,3,0,4,7,4,0,2019-09-20
7149,경기,군포시,1,1,0,2,1,0,2019-10-20
7150,경기,군포시,0,0,1,1,1,0,2019-11-20
7151,경기,군포시,1,1,1,3,3,0,2019-12-20
7152,경기,김포시,2,0,0,2,1,0,2019-01-20
7153,경기,김포시,17,0,5,22,9,0,2019-02-20
7154,경기,김포시,4,0,3,7,5,0,2019-03-20
7155,경기,김포시,11,1,1,13,9,0,2019-04-20
7156,경기,김포시,3,1,0,4,3,0,2019-05-20
7157,경기,김포시,2,0,3,5,4,0,2019-06-20
7158,경기,김포시,4,0,3,7,6,0,2019-07-20
7159,경기,김포시,7,0,1,8,5,0,2019-08-20
7160,경기,김포시,5,0,4,9,8,0,2019-09-20
7161,경기,김포시,7,0,0,7,4,0,2019-10-20
7162,경기,김포시,7,0,1,8,6,0,2019-11-20
7163,경기,김포시,15,1,2,18,12,0,2019-12-20
7164,경기,남양주시,5,1,0,6,4,0,2019-01-20
7165,경기,남양주시,8,2,2,12,10,0,2019-02-20
7166,경기,남양주시,11,0,3,14,9,0,2019-03-20
7167,경기,남양주시,11,0,5,16,9,1,2019-04-20
7168,경기,남양주시,16,2,4,22,7,0,2019-05-20
7169,경기,남양주시,6,2,3,11,4,1,2019-06-20
7170,경기,남양주시,9,1,2,12,7,0,2019-07-20
7171,경기,남양주시,7,0,4,11,7,0,2019-08-20
7172,경기,남양주시,5,2,3,10,4,0,2019-09-20
7173,경기,남양주시,12,1,1,14,6,0,2019-10-20
7174,경기,남양주시,12,1,1,14,10,0,2019-11-20
7175,경기,남양주시,11,0,3,14,9,0,2019-12-20
7176,경기,동두천시,2,0,0,2,1,0,2019-01-20
7177,경기,동두천시,0,0,1,1,1,0,2019-02-20
7178,경기,동두천시,1,0,0,1,1,0,2019-03-20
7179,경기,동두천시,4,0,0,4,1,0,2019-04-20
7180,경기,동두천시,3,0,2,5,4,0,2019-05-20
7181,경기,동두천시,1,0,0,1,1,0,2019-06-20
7182,경기,동두천시,0,0,1,1,1,0,2019-07-20
7183,경기,동두천시,1,0,0,1,1,0,2019-08-20
7184,경기,동두천시,0,0,0,0,0,0,2019-09-20
7185,경기,동두천시,0,0,0,0,0,0,2019-10-20
7186,경기,동두천시,0,0,0,0,0,0,2019-11-20
7187,경기,동두천시,0,0,0,0,0,0,2019-12-20
7188,경기,부천시,7,2,2,11,6,0,2019-01-20
7189,경기,부천시,9,2,1,12,8,0,2019-02-20
7190,경기,부천시,9,0,3,12,7,0,2019-03-20
7191,경기,부천시,5,1,3,9,8,0,2019-04-20
7192,경기,부천시,13,0,3,16,15,0,2019-05-20
7193,경기,부천시,10,0,2,12,10,0,2019-06-20
7194,경기,부천시,11,0,1,12,7,0,2019-07-20
7195,경기,부천시,20,1,5,26,18,0,2019-08-20
7196,경기,부천시,12,1,2,15,12,0,2019-09-20
7197,경기,부천시,14,0,2,16,8,0,2019-10-20
7198,경기,부천시,14,0,0,14,12,0,2019-11-20
7199,경기,부천시,15,1,3,19,15,0,2019-12-20
7200,경기,성남시,7,0,2,9,6,0,2019-01-20
7201,경기,성남시,10,0,3,13,11,0,2019-02-20
7202,경기,성남시,15,1,6,22,14,0,2019-03-20
7203,경기,성남시,8,1,3,12,9,1,2019-04-20
7204,경기,성남시,9,0,3,12,8,1,2019-05-20
7205,경기,성남시,4,0,3,7,7,0,2019-06-20
7206,경기,성남시,7,1,1,9,8,0,2019-07-20
7207,경기,성남시,13,1,5,19,13,0,2019-08-20
7208,경기,성남시,11,7,2,20,13,0,2019-09-20
7209,경기,성남시,16,0,8,24,13,0,2019-10-20
7210,경기,성남시,19,2,3,24,19,0,2019-11-20
7211,경기,성남시,9,5,1,15,12,0,2019-12-20
7212,경기,수원시,6,0,4,10,9,0,2019-01-20
7213,경기,수원시,28,1,2,31,13,0,2019-02-20
7214,경기,수원시,14,1,0,15,13,0,2019-03-20
7215,경기,수원시,18,1,4,23,16,0,2019-04-20
7216,경기,수원시,21,0,5,26,16,0,2019-05-20
7217,경기,수원시,12,3,1,16,13,0,2019-06-20
7218,경기,수원시,12,3,6,21,13,0,2019-07-20
7219,경기,수원시,13,2,0,15,12,2,2019-08-20
7220,경기,수원시,19,3,6,28,21,0,2019-09-20
7221,경기,수원시,15,1,4,20,15,0,2019-10-20
7222,경기,수원시,14,2,3,19,16,0,2019-11-20
7223,경기,수원시,10,0,4,14,12,0,2019-12-20
7224,경기,시흥시,4,0,2,6,5,0,2019-01-20
7225,경기,시흥시,2,2,0,4,2,0,2019-02-20
7226,경기,시흥시,3,1,1,5,5,0,2019-03-20
7227,경기,시흥시,4,2,2,8,6,0,2019-04-20
7228,경기,시흥시,8,0,3,11,8,0,2019-05-20
7229,경기,시흥시,4,0,0,4,2,0,2019-06-20
7230,경기,시흥시,4,1,1,6,4,0,2019-07-20
7231,경기,시흥시,2,1,2,5,5,0,2019-08-20
7232,경기,시흥시,7,2,2,11,6,0,2019-09-20
7233,경기,시흥시,3,0,1,4,4,0,2019-10-20
7234,경기,시흥시,4,0,1,5,5,0,2019-11-20
7235,경기,시흥시,5,0,0,5,5,0,2019-12-20
7236,경기,안산시,9,0,1,10,5,0,2019-01-20
7237,경기,안산시,15,0,1,16,10,1,2019-02-20
7238,경기,안산시,12,0,13,25,16,0,2019-03-20
7239,경기,안산시,9,0,3,12,8,0,2019-04-20
7240,경기,안산시,16,1,3,20,11,0,2019-05-20
7241,경기,안산시,23,0,3,26,16,0,2019-06-20
7242,경기,안산시,7,0,0,7,7,0,2019-07-20
7243,경기,안산시,11,2,1,14,11,0,2019-08-20
7244,경기,안산시,14,1,3,18,13,0,2019-09-20
7245,경기,안산시,12,7,4,23,10,0,2019-10-20
7246,경기,안산시,12,2,3,17,13,0,2019-11-20
7247,경기,안산시,10,0,3,13,10,0,2019-12-20
7248,경기,안성시,4,0,1,5,3,0,2019-01-20
7249,경기,안성시,0,0,1,1,1,0,2019-02-20
7250,경기,안성시,4,0,2,6,4,0,2019-03-20
7251,경기,안성시,4,0,1,5,4,0,2019-04-20
7252,경기,안성시,1,0,0,1,2,1,2019-05-20
7253,경기,안성시,2,0,0,2,2,0,2019-06-20
7254,경기,안성시,3,1,0,4,2,0,2019-07-20
7255,경기,안성시,1,0,0,1,1,0,2019-08-20
7256,경기,안성시,1,0,6,7,2,0,2019-09-20
7257,경기,안성시,1,0,0,1,1,0,2019-10-20
7258,경기,안성시,7,0,2,9,6,0,2019-11-20
7259,경기,안성시,1,0,0,1,1,0,2019-12-20
7260,경기,안양시,7,0,2,9,5,0,2019-01-20
7261,경기,안양시,4,0,1,5,3,0,2019-02-20
7262,경기,안양시,2,0,2,4,4,0,2019-03-20
7263,경기,안양시,0,0,2,2,2,0,2019-04-20
7264,경기,안양시,10,0,1,11,7,0,2019-05-20
7265,경기,안양시,6,0,0,6,5,0,2019-06-20
7266,경기,안양시,0,0,0,0,0,0,2019-07-20
7267,경기,안양시,4,1,0,5,3,0,2019-08-20
7268,경기,안양시,4,1,1,6,5,0,2019-09-20
7269,경기,안양시,7,1,0,8,5,0,2019-10-20
7270,경기,안양시,5,0,1,6,5,0,2019-11-20
7271,경기,안양시,7,0,1,8,4,0,2019-12-20
7272,경기,양주시,8,0,0,8,3,0,2019-01-20
7273,경기,양주시,0,0,1,1,1,0,2019-02-20
7274,경기,양주시,8,0,1,9,5,0,2019-03-20
7275,경기,양주시,7,0,0,7,4,0,2019-04-20
7276,경기,양주시,1,0,1,2,2,0,2019-05-20
7277,경기,양주시,4,0,1,5,4,0,2019-06-20
7278,경기,양주시,5,0,0,5,3,0,2019-07-20
7279,경기,양주시,3,0,0,3,3,0,2019-08-20
7280,경기,양주시,5,2,0,7,4,0,2019-09-20
7281,경기,양주시,1,0,1,2,1,0,2019-10-20
7282,경기,양주시,3,0,1,4,4,0,2019-11-20
7283,경기,양주시,4,0,1,5,5,0,2019-12-20
7284,경기,양평군,0,0,0,0,0,0,2019-01-20
7285,경기,양평군,2,0,0,2,2,0,2019-02-20
7286,경기,양평군,3,0,0,3,2,0,2019-03-20
7287,경기,양평군,4,0,0,4,4,0,2019-04-20
7288,경기,양평군,1,0,0,1,1,0,2019-05-20
7289,경기,양평군,0,0,0,0,0,0,2019-06-20
7290,경기,양평군,0,2,2,4,3,0,2019-07-20
7291,경기,양평군,0,0,0,0,0,0,2019-08-20
7292,경기,양평군,2,0,1,3,3,0,2019-09-20
7293,경기,양평군,8,1,1,10,7,0,2019-10-20
7294,경기,양평군,2,0,0,2,1,0,2019-11-20
7295,경기,양평군,0,0,1,1,1,0,2019-12-20
7296,경기,여주시,0,0,0,0,0,0,2019-01-20
7297,경기,여주시,2,0,0,2,1,0,2019-02-20
7298,경기,여주시,1,0,4,5,3,0,2019-03-20
7299,경기,여주시,4,0,0,4,3,0,2019-04-20
7300,경기,여주시,0,0,1,1,2,1,2019-05-20
7301,경기,여주시,1,0,0,1,1,0,2019-06-20
7302,경기,여주시,0,0,0,0,0,0,2019-07-20
7303,경기,여주시,2,0,0,2,2,0,2019-08-20
7304,경기,여주시,1,0,2,3,2,0,2019-09-20
7305,경기,여주시,9,0,0,9,5,0,2019-10-20
7306,경기,여주시,0,0,0,0,0,0,2019-11-20
7307,경기,여주시,2,1,0,3,3,0,2019-12-20
7308,경기,연천군,1,0,1,2,3,1,2019-01-20
7309,경기,연천군,0,0,0,0,0,0,2019-02-20
7310,경기,연천군,0,0,0,0,0,0,2019-03-20
7311,경기,연천군,0,0,0,0,0,0,2019-04-20
7312,경기,연천군,0,0,1,1,1,0,2019-05-20
7313,경기,연천군,0,0,0,0,0,0,2019-06-20
7314,경기,연천군,0,0,0,0,0,0,2019-07-20
7315,경기,연천군,0,0,0,0,0,0,2019-08-20
7316,경기,연천군,0,0,0,0,0,0,2019-09-20
7317,경기,연천군,0,0,0,0,0,0,2019-10-20
7318,경기,연천군,0,0,0,0,0,0,2019-11-20
7319,경기,연천군,0,0,0,0,0,0,2019-12-20
7320,경기,오산시,1,0,1,2,2,0,2019-01-20
7321,경기,오산시,3,0,0,3,2,1,2019-02-20
7322,경기,오산시,2,1,1,4,4,0,2019-03-20
7323,경기,오산시,1,1,3,5,5,0,2019-04-20
7324,경기,오산시,7,0,1,8,5,0,2019-05-20
7325,경기,오산시,2,0,1,3,3,0,2019-06-20
7326,경기,오산시,1,1,0,2,2,0,2019-07-20
7327,경기,오산시,3,0,0,3,3,0,2019-08-20
7328,경기,오산시,0,0,1,1,1,0,2019-09-20
7329,경기,오산시,2,1,0,3,1,0,2019-10-20
7330,경기,오산시,10,0,2,12,5,0,2019-11-20
7331,경기,오산시,2,1,1,4,4,0,2019-12-20
7332,경기,용인시,5,0,2,7,4,0,2019-01-20
7333,경기,용인시,8,0,3,11,8,1,2019-02-20
7334,경기,용인시,13,3,1,17,12,0,2019-03-20
7335,경기,용인시,7,0,2,9,7,0,2019-04-20
7336,경기,용인시,3,7,1,11,7,0,2019-05-20
7337,경기,용인시,14,2,6,22,12,0,2019-06-20
7338,경기,용인시,10,0,1,11,6,0,2019-07-20
7339,경기,용인시,11,0,1,12,8,0,2019-08-20
7340,경기,용인시,6,0,2,8,6,0,2019-09-20
7341,경기,용인시,11,7,2,20,10,0,2019-10-20
7342,경기,용인시,12,1,4,17,11,0,2019-11-20
7343,경기,용인시,9,1,4,14,10,0,2019-12-20
7344,경기,의왕시,1,0,1,2,2,0,2019-01-20
7345,경기,의왕시,7,0,0,7,3,0,2019-02-20
7346,경기,의왕시,1,0,0,1,1,0,2019-03-20
7347,경기,의왕시,1,0,1,2,2,0,2019-04-20
7348,경기,의왕시,0,0,0,0,1,1,2019-05-20
7349,경기,의왕시,5,1,2,8,3,0,2019-06-20
7350,경기,의왕시,0,0,0,0,0,0,2019-07-20
7351,경기,의왕시,1,0,0,1,1,0,2019-08-20
7352,경기,의왕시,1,1,0,2,2,0,2019-09-20
7353,경기,의왕시,0,0,0,0,0,0,2019-10-20
7354,경기,의왕시,0,0,1,1,1,0,2019-11-20
7355,경기,의왕시,5,0,0,5,1,0,2019-12-20
7356,경기,의정부시,1,0,0,1,1,0,2019-01-20
7357,경기,의정부시,5,0,2,7,5,0,2019-02-20
7358,경기,의정부시,6,2,2,10,4,0,2019-03-20
7359,경기,의정부시,6,0,1,7,6,0,2019-04-20
7360,경기,의정부시,0,0,1,1,1,0,2019-05-20
7361,경기,의정부시,3,1,0,4,3,0,2019-06-20
7362,경기,의정부시,9,1,0,10,9,0,2019-07-20
7363,경기,의정부시,0,0,1,1,1,0,2019-08-20
7364,경기,의정부시,9,4,3,16,12,0,2019-09-20
7365,경기,의정부시,7,0,4,11,7,0,2019-10-20
7366,경기,의정부시,6,0,1,7,5,0,2019-11-20
7367,경기,의정부시,7,0,1,8,6,0,2019-12-20
7368,경기,이천시,2,1,2,5,4,0,2019-01-20
7369,경기,이천시,2,0,0,2,1,0,2019-02-20
7370,경기,이천시,2,0,1,3,3,0,2019-03-20
7371,경기,이천시,2,0,0,2,1,0,2019-04-20
7372,경기,이천시,0,1,0,1,1,0,2019-05-20
7373,경기,이천시,2,1,1,4,2,0,2019-06-20
7374,경기,이천시,1,1,0,2,1,0,2019-07-20
7375,경기,이천시,4,0,0,4,3,0,2019-08-20
7376,경기,이천시,7,0,0,7,4,0,2019-09-20
7377,경기,이천시,1,0,0,1,1,0,2019-10-20
7378,경기,이천시,11,0,1,12,8,0,2019-11-20
7379,경기,이천시,7,0,0,7,4,0,2019-12-20
7380,경기,파주시,2,0,0,2,2,0,2019-01-20
7381,경기,파주시,3,0,0,3,3,0,2019-02-20
7382,경기,파주시,1,0,1,2,2,0,2019-03-20
7383,경기,파주시,7,1,2,10,4,0,2019-04-20
7384,경기,파주시,6,2,2,10,6,0,2019-05-20
7385,경기,파주시,8,0,0,8,5,0,2019-06-20
7386,경기,파주시,4,0,2,6,6,0,2019-07-20
7387,경기,파주시,8,0,0,8,6,0,2019-08-20
7388,경기,파주시,8,0,4,12,7,0,2019-09-20
7389,경기,파주시,2,0,0,2,2,0,2019-10-20
7390,경기,파주시,5,0,4,9,8,0,2019-11-20
7391,경기,파주시,4,0,2,6,4,0,2019-12-20
7392,경기,평택시,11,0,1,12,8,0,2019-01-20
7393,경기,평택시,5,5,8,18,7,0,2019-02-20
7394,경기,평택시,12,4,2,18,11,0,2019-03-20
7395,경기,평택시,14,2,0,16,7,0,2019-04-20
7396,경기,평택시,22,2,3,27,15,0,2019-05-20
7397,경기,평택시,15,1,3,19,13,0,2019-06-20
7398,경기,평택시,16,1,3,20,11,0,2019-07-20
7399,경기,평택시,7,2,1,10,9,0,2019-08-20
7400,경기,평택시,11,3,3,17,12,0,2019-09-20
7401,경기,평택시,7,4,3,14,8,2,2019-10-20
7402,경기,평택시,20,4,7,31,18,0,2019-11-20
7403,경기,평택시,28,1,7,36,20,0,2019-12-20
7404,경기,포천시,3,0,2,5,2,0,2019-01-20
7405,경기,포천시,0,0,0,0,0,0,2019-02-20
7406,경기,포천시,3,0,0,3,3,0,2019-03-20
7407,경기,포천시,7,0,1,8,3,0,2019-04-20
7408,경기,포천시,1,0,0,1,1,0,2019-05-20
7409,경기,포천시,0,0,1,1,1,0,2019-06-20
7410,경기,포천시,2,0,0,2,2,0,2019-07-20
7411,경기,포천시,4,0,1,5,3,0,2019-08-20
7412,경기,포천시,4,0,0,4,2,0,2019-09-20
7413,경기,포천시,5,1,1,7,4,0,2019-10-20
7414,경기,포천시,5,0,3,8,5,0,2019-11-20
7415,경기,포천시,3,0,2,5,3,0,2019-12-20
7416,경기,하남시,0,0,0,0,0,0,2019-01-20
7417,경기,하남시,3,0,2,5,4,0,2019-02-20
7418,경기,하남시,3,1,1,5,5,0,2019-03-20
7419,경기,하남시,8,3,4,15,4,0,2019-04-20
7420,경기,하남시,4,0,1,5,5,0,2019-05-20
7421,경기,하남시,2,1,0,3,2,0,2019-06-20
7422,경기,하남시,1,0,2,3,2,0,2019-07-20
7423,경기,하남시,8,1,0,9,4,0,2019-08-20
7424,경기,하남시,4,0,0,4,4,0,2019-09-20
7425,경기,하남시,1,0,1,2,2,0,2019-10-20
7426,경기,하남시,6,1,0,7,4,0,2019-11-20
7427,경기,하남시,3,0,0,3,1,0,2019-12-20
7428,경기,화성시,3,2,1,6,2,0,2019-01-20
7429,경기,화성시,5,2,2,9,6,0,2019-02-20
7430,경기,화성시,14,2,8,24,12,0,2019-03-20
7431,경기,화성시,21,2,4,27,10,0,2019-04-20
7432,경기,화성시,10,0,2,12,10,0,2019-05-20
7433,경기,화성시,13,0,0,13,8,0,2019-06-20
7434,경기,화성시,5,1,2,8,6,0,2019-07-20
7435,경기,화성시,11,0,0,11,10,0,2019-08-20
7436,경기,화성시,20,4,6,30,14,0,2019-09-20
7437,경기,화성시,14,0,0,14,7,0,2019-10-20
7438,경기,화성시,16,0,1,17,9,0,2019-11-20
7439,경기,화성시,19,1,4,24,15,0,2019-12-20
7440,경기,가평군,1,0,0,1,1,0,2019-01-21
7441,경기,가평군,1,0,1,2,2,0,2019-02-21
7442,경기,가평군,0,0,0,0,0,0,2019-03-21
7443,경기,가평군,4,0,0,4,2,0,2019-04-21
7444,경기,가평군,0,0,0,0,0,0,2019-05-21
7445,경기,가평군,0,0,0,0,0,0,2019-06-21
7446,경기,가평군,9,0,2,11,4,0,2019-07-21
7447,경기,가평군,0,0,0,0,0,0,2019-08-21
7448,경기,가평군,2,0,1,3,2,0,2019-09-21
7449,경기,가평군,0,0,0,0,0,0,2019-10-21
7450,경기,가평군,1,0,0,1,1,0,2019-11-21
7451,경기,가평군,1,0,1,2,1,0,2019-12-21
7452,경기,고양시,10,1,2,13,9,0,2019-01-21
7453,경기,고양시,13,1,1,15,10,0,2019-02-21
7454,경기,고양시,6,2,7,15,13,0,2019-03-21
7455,경기,고양시,11,0,3,14,9,0,2019-04-21
7456,경기,고양시,20,0,7,27,17,1,2019-05-21
7457,경기,고양시,5,2,2,9,8,0,2019-06-21
7458,경기,고양시,5,1,3,9,9,0,2019-07-21
7459,경기,고양시,12,3,2,17,14,1,2019-08-21
7460,경기,고양시,7,1,2,10,7,0,2019-09-21
7461,경기,고양시,10,1,3,14,12,0,2019-10-21
7462,경기,고양시,8,1,3,12,11,0,2019-11-21
7463,경기,고양시,9,3,3,15,10,0,2019-12-21
7464,경기,과천시,1,0,0,1,1,0,2019-01-21
7465,경기,과천시,2,0,0,2,2,0,2019-02-21
7466,경기,과천시,0,1,0,1,1,0,2019-03-21
7467,경기,과천시,2,0,0,2,1,0,2019-04-21
7468,경기,과천시,0,0,0,0,0,0,2019-05-21
7469,경기,과천시,1,0,0,1,1,0,2019-06-21
7470,경기,과천시,4,0,2,6,2,0,2019-07-21
7471,경기,과천시,0,0,0,0,0,0,2019-08-21
7472,경기,과천시,0,0,0,0,0,0,2019-09-21
7473,경기,과천시,4,1,0,5,3,0,2019-10-21
7474,경기,과천시,0,0,0,0,0,0,2019-11-21
7475,경기,과천시,0,0,0,0,0,0,2019-12-21
7476,경기,광명시,1,0,0,1,2,1,2019-01-21
7477,경기,광명시,0,1,0,1,1,0,2019-02-21
7478,경기,광명시,2,1,1,4,4,0,2019-03-21
7479,경기,광명시,2,1,1,4,3,0,2019-04-21
7480,경기,광명시,4,6,4,14,9,0,2019-05-21
7481,경기,광명시,1,1,1,3,3,0,2019-06-21
7482,경기,광명시,4,1,0,5,2,0,2019-07-21
7483,경기,광명시,0,1,0,1,1,0,2019-08-21
7484,경기,광명시,13,2,2,17,4,0,2019-09-21
7485,경기,광명시,2,2,2,6,6,0,2019-10-21
7486,경기,광명시,1,0,0,1,1,0,2019-11-21
7487,경기,광명시,2,2,0,4,2,0,2019-12-21
7488,경기,광주시,5,0,3,8,6,0,2019-01-21
7489,경기,광주시,5,1,3,9,6,0,2019-02-21
7490,경기,광주시,3,1,1,5,5,0,2019-03-21
7491,경기,광주시,4,1,2,7,5,0,2019-04-21
7492,경기,광주시,2,0,1,3,2,0,2019-05-21
7493,경기,광주시,14,0,0,14,7,0,2019-06-21
7494,경기,광주시,2,0,0,2,2,0,2019-07-21
7495,경기,광주시,5,1,2,8,6,0,2019-08-21
7496,경기,광주시,2,0,1,3,3,0,2019-09-21
7497,경기,광주시,6,0,1,7,4,0,2019-10-21
7498,경기,광주시,5,0,3,8,7,2,2019-11-21
7499,경기,광주시,2,1,2,5,5,0,2019-12-21
7500,경기,구리시,3,0,0,3,2,0,2019-01-21
7501,경기,구리시,4,0,0,4,3,0,2019-02-21
7502,경기,구리시,2,0,0,2,1,0,2019-03-21
7503,경기,구리시,1,0,2,3,3,0,2019-04-21
7504,경기,구리시,5,1,0,6,3,0,2019-05-21
7505,경기,구리시,0,0,1,1,1,0,2019-06-21
7506,경기,구리시,0,0,2,2,3,1,2019-07-21
7507,경기,구리시,0,0,0,0,0,0,2019-08-21
7508,경기,구리시,1,0,1,2,3,1,2019-09-21
7509,경기,구리시,6,0,0,6,2,0,2019-10-21
7510,경기,구리시,3,0,1,4,4,0,2019-11-21
7511,경기,구리시,1,1,0,2,2,0,2019-12-21
7512,경기,군포시,0,0,0,0,0,0,2019-01-21
7513,경기,군포시,2,0,0,2,1,0,2019-02-21
7514,경기,군포시,0,0,0,0,0,0,2019-03-21
7515,경기,군포시,4,0,0,4,1,0,2019-04-21
7516,경기,군포시,5,0,0,5,2,0,2019-05-21
7517,경기,군포시,1,0,0,1,1,0,2019-06-21
7518,경기,군포시,2,1,0,3,1,0,2019-07-21
7519,경기,군포시,1,2,1,4,3,0,2019-08-21
7520,경기,군포시,0,0,0,0,0,0,2019-09-21
7521,경기,군포시,0,0,0,0,0,0,2019-10-21
7522,경기,군포시,5,1,1,7,3,0,2019-11-21
7523,경기,군포시,0,1,0,1,1,0,2019-12-21
7524,경기,김포시,8,0,0,8,4,0,2019-01-21
7525,경기,김포시,2,0,1,3,2,0,2019-02-21
7526,경기,김포시,1,1,1,3,2,0,2019-03-21
7527,경기,김포시,7,0,2,9,3,0,2019-04-21
7528,경기,김포시,2,0,4,6,5,0,2019-05-21
7529,경기,김포시,4,2,2,8,7,0,2019-06-21
7530,경기,김포시,2,0,5,7,4,0,2019-07-21
7531,경기,김포시,17,0,3,20,11,0,2019-08-21
7532,경기,김포시,9,0,1,10,7,0,2019-09-21
7533,경기,김포시,13,1,4,18,14,0,2019-10-21
7534,경기,김포시,0,0,0,0,0,0,2019-11-21
7535,경기,김포시,4,0,3,7,6,0,2019-12-21
7536,경기,남양주시,9,0,3,12,9,0,2019-01-21
7537,경기,남양주시,11,2,0,13,8,0,2019-02-21
7538,경기,남양주시,14,0,2,16,11,1,2019-03-21
7539,경기,남양주시,3,2,1,6,3,0,2019-04-21
7540,경기,남양주시,12,5,0,17,8,0,2019-05-21
7541,경기,남양주시,11,0,1,12,7,0,2019-06-21
7542,경기,남양주시,3,0,1,4,4,0,2019-07-21
7543,경기,남양주시,16,3,3,22,10,0,2019-08-21
7544,경기,남양주시,10,1,1,12,7,0,2019-09-21
7545,경기,남양주시,4,0,3,7,5,0,2019-10-21
7546,경기,남양주시,2,1,2,5,4,0,2019-11-21
7547,경기,남양주시,9,3,0,12,5,0,2019-12-21
7548,경기,동두천시,0,0,0,0,0,0,2019-01-21
7549,경기,동두천시,0,0,1,1,1,0,2019-02-21
7550,경기,동두천시,1,0,0,1,1,0,2019-03-21
7551,경기,동두천시,0,0,2,2,2,0,2019-04-21
7552,경기,동두천시,1,0,0,1,1,0,2019-05-21
7553,경기,동두천시,0,0,0,0,0,0,2019-06-21
7554,경기,동두천시,2,1,0,3,2,0,2019-07-21
7555,경기,동두천시,0,0,0,0,0,0,2019-08-21
7556,경기,동두천시,0,0,0,0,1,1,2019-09-21
7557,경기,동두천시,0,0,0,0,0,0,2019-10-21
7558,경기,동두천시,5,0,0,5,3,0,2019-11-21
7559,경기,동두천시,0,0,0,0,0,0,2019-12-21
7560,경기,부천시,8,1,1,10,8,0,2019-01-21
7561,경기,부천시,14,1,2,17,13,0,2019-02-21
7562,경기,부천시,14,1,1,16,10,0,2019-03-21
7563,경기,부천시,3,0,2,5,5,0,2019-04-21
7564,경기,부천시,8,1,5,14,12,0,2019-05-21
7565,경기,부천시,13,2,3,18,12,0,2019-06-21
7566,경기,부천시,12,0,6,18,10,0,2019-07-21
7567,경기,부천시,8,2,3,13,8,0,2019-08-21
7568,경기,부천시,8,0,2,10,6,0,2019-09-21
7569,경기,부천시,12,3,4,19,15,0,2019-10-21
7570,경기,부천시,9,0,0,9,9,0,2019-11-21
7571,경기,부천시,14,0,3,17,13,1,2019-12-21
7572,경기,성남시,9,0,4,13,11,0,2019-01-21
7573,경기,성남시,13,0,4,17,12,0,2019-02-21
7574,경기,성남시,15,1,3,19,11,0,2019-03-21
7575,경기,성남시,13,7,1,21,8,0,2019-04-21
7576,경기,성남시,5,1,5,11,7,0,2019-05-21
7577,경기,성남시,13,2,2,17,9,0,2019-06-21
7578,경기,성남시,6,1,0,7,5,0,2019-07-21
7579,경기,성남시,8,1,1,10,7,0,2019-08-21
7580,경기,성남시,18,1,3,22,17,0,2019-09-21
7581,경기,성남시,12,2,3,17,12,0,2019-10-21
7582,경기,성남시,12,1,4,17,12,0,2019-11-21
7583,경기,성남시,12,1,2,15,10,1,2019-12-21
7584,경기,수원시,7,1,3,11,9,0,2019-01-21
7585,경기,수원시,21,5,6,32,24,1,2019-02-21
7586,경기,수원시,18,3,0,21,18,1,2019-03-21
7587,경기,수원시,7,4,0,11,7,0,2019-04-21
7588,경기,수원시,10,1,4,15,11,0,2019-05-21
7589,경기,수원시,25,5,5,35,17,0,2019-06-21
7590,경기,수원시,16,3,10,29,15,0,2019-07-21
7591,경기,수원시,21,2,1,24,15,1,2019-08-21
7592,경기,수원시,17,2,1,20,14,0,2019-09-21
7593,경기,수원시,8,1,2,11,10,0,2019-10-21
7594,경기,수원시,23,3,3,29,20,0,2019-11-21
7595,경기,수원시,4,7,1,12,9,0,2019-12-21
7596,경기,시흥시,4,0,2,6,6,0,2019-01-21
7597,경기,시흥시,3,0,1,4,3,0,2019-02-21
7598,경기,시흥시,9,0,2,11,6,0,2019-03-21
7599,경기,시흥시,9,4,2,15,8,0,2019-04-21
7600,경기,시흥시,11,0,2,13,8,0,2019-05-21
7601,경기,시흥시,13,1,1,15,10,0,2019-06-21
7602,경기,시흥시,6,0,2,8,6,0,2019-07-21
7603,경기,시흥시,10,0,4,14,5,0,2019-08-21
7604,경기,시흥시,9,0,2,11,8,0,2019-09-21
7605,경기,시흥시,5,0,1,6,5,0,2019-10-21
7606,경기,시흥시,10,1,0,11,7,0,2019-11-21
7607,경기,시흥시,26,0,3,29,14,2,2019-12-21
7608,경기,안산시,16,1,4,21,13,0,2019-01-21
7609,경기,안산시,14,0,3,17,11,0,2019-02-21
7610,경기,안산시,17,1,3,21,12,0,2019-03-21
7611,경기,안산시,8,0,1,9,5,0,2019-04-21
7612,경기,안산시,17,1,3,21,15,0,2019-05-21
7613,경기,안산시,19,0,3,22,17,0,2019-06-21
7614,경기,안산시,11,0,4,15,11,0,2019-07-21
7615,경기,안산시,10,1,1,12,9,0,2019-08-21
7616,경기,안산시,13,0,2,15,7,0,2019-09-21
7617,경기,안산시,6,0,3,9,8,0,2019-10-21
7618,경기,안산시,10,1,7,18,13,0,2019-11-21
7619,경기,안산시,10,1,1,12,9,0,2019-12-21
7620,경기,안성시,2,0,2,4,3,0,2019-01-21
7621,경기,안성시,3,0,0,3,2,0,2019-02-21
7622,경기,안성시,4,2,1,7,3,0,2019-03-21
7623,경기,안성시,1,0,2,3,3,0,2019-04-21
7624,경기,안성시,5,0,2,7,3,0,2019-05-21
7625,경기,안성시,8,0,0,8,3,0,2019-06-21
7626,경기,안성시,1,0,2,3,1,0,2019-07-21
7627,경기,안성시,7,0,2,9,4,0,2019-08-21
7628,경기,안성시,2,0,2,4,2,0,2019-09-21
7629,경기,안성시,1,0,0,1,1,0,2019-10-21
7630,경기,안성시,1,0,0,1,1,0,2019-11-21
7631,경기,안성시,0,0,0,0,0,0,2019-12-21
7632,경기,안양시,3,0,1,4,4,0,2019-01-21
7633,경기,안양시,6,2,1,9,6,0,2019-02-21
7634,경기,안양시,0,1,1,2,1,1,2019-03-21
7635,경기,안양시,4,1,1,6,5,0,2019-04-21
7636,경기,안양시,6,0,1,7,6,0,2019-05-21
7637,경기,안양시,13,0,3,16,11,0,2019-06-21
7638,경기,안양시,4,0,0,4,2,0,2019-07-21
7639,경기,안양시,3,0,0,3,3,0,2019-08-21
7640,경기,안양시,3,1,1,5,4,0,2019-09-21
7641,경기,안양시,5,0,3,8,5,0,2019-10-21
7642,경기,안양시,13,0,0,13,6,0,2019-11-21
7643,경기,안양시,7,0,1,8,7,2,2019-12-21
7644,경기,양주시,3,0,0,3,3,0,2019-01-21
7645,경기,양주시,8,0,1,9,5,0,2019-02-21
7646,경기,양주시,3,0,0,3,2,0,2019-03-21
7647,경기,양주시,2,0,3,5,3,0,2019-04-21
7648,경기,양주시,1,0,0,1,1,0,2019-05-21
7649,경기,양주시,2,0,2,4,3,0,2019-06-21
7650,경기,양주시,1,0,0,1,1,0,2019-07-21
7651,경기,양주시,7,0,0,7,4,0,2019-08-21
7652,경기,양주시,3,0,0,3,2,0,2019-09-21
7653,경기,양주시,10,0,1,11,7,0,2019-10-21
7654,경기,양주시,8,0,0,8,4,0,2019-11-21
7655,경기,양주시,4,0,0,4,2,0,2019-12-21
7656,경기,양평군,1,0,0,1,1,0,2019-01-21
7657,경기,양평군,1,0,0,1,1,0,2019-02-21
7658,경기,양평군,1,0,1,2,1,0,2019-03-21
7659,경기,양평군,3,1,1,5,4,0,2019-04-21
7660,경기,양평군,3,1,2,6,2,0,2019-05-21
7661,경기,양평군,0,0,2,2,3,1,2019-06-21
7662,경기,양평군,3,0,1,4,3,0,2019-07-21
7663,경기,양평군,1,0,0,1,1,0,2019-08-21
7664,경기,양평군,0,0,2,2,1,0,2019-09-21
7665,경기,양평군,4,0,2,6,4,0,2019-10-21
7666,경기,양평군,2,1,1,4,4,0,2019-11-21
7667,경기,양평군,0,0,1,1,1,0,2019-12-21
7668,경기,여주시,0,0,0,0,0,0,2019-01-21
7669,경기,여주시,1,0,0,1,1,0,2019-02-21
7670,경기,여주시,1,0,0,1,1,0,2019-03-21
7671,경기,여주시,1,0,1,2,2,0,2019-04-21
7672,경기,여주시,0,0,0,0,0,0,2019-05-21
7673,경기,여주시,2,0,1,3,3,0,2019-06-21
7674,경기,여주시,0,0,1,1,1,0,2019-07-21
7675,경기,여주시,1,1,0,2,2,0,2019-08-21
7676,경기,여주시,1,0,0,1,1,0,2019-09-21
7677,경기,여주시,0,0,1,1,1,0,2019-10-21
7678,경기,여주시,2,0,0,2,2,0,2019-11-21
7679,경기,여주시,0,0,0,0,0,0,2019-12-21
7680,경기,연천군,0,0,0,0,0,0,2019-01-21
7681,경기,연천군,0,0,0,0,0,0,2019-02-21
7682,경기,연천군,0,0,0,0,0,0,2019-03-21
7683,경기,연천군,0,0,0,0,0,0,2019-04-21
7684,경기,연천군,0,0,0,0,0,0,2019-05-21
7685,경기,연천군,4,0,3,7,4,0,2019-06-21
7686,경기,연천군,2,0,1,3,2,0,2019-07-21
7687,경기,연천군,0,0,0,0,0,0,2019-08-21
7688,경기,연천군,2,0,0,2,2,0,2019-09-21
7689,경기,연천군,0,0,2,2,1,4,2019-10-21
7690,경기,연천군,0,0,0,0,0,0,2019-11-21
7691,경기,연천군,0,0,0,0,0,0,2019-12-21
7692,경기,오산시,1,0,0,1,1,0,2019-01-21
7693,경기,오산시,5,0,1,6,5,0,2019-02-21
7694,경기,오산시,3,0,1,4,4,0,2019-03-21
7695,경기,오산시,2,0,1,3,3,0,2019-04-21
7696,경기,오산시,2,2,2,6,4,0,2019-05-21
7697,경기,오산시,1,0,0,1,1,0,2019-06-21
7698,경기,오산시,4,0,2,6,3,0,2019-07-21
7699,경기,오산시,1,0,0,1,1,0,2019-08-21
7700,경기,오산시,1,1,0,2,2,0,2019-09-21
7701,경기,오산시,6,0,0,6,3,0,2019-10-21
7702,경기,오산시,4,0,0,4,3,0,2019-11-21
7703,경기,오산시,5,0,0,5,4,0,2019-12-21
7704,경기,용인시,3,0,3,6,5,0,2019-01-21
7705,경기,용인시,9,1,4,14,11,0,2019-02-21
7706,경기,용인시,14,3,0,17,9,0,2019-03-21
7707,경기,용인시,22,3,1,26,9,0,2019-04-21
7708,경기,용인시,7,3,1,11,9,0,2019-05-21
7709,경기,용인시,12,4,1,17,11,0,2019-06-21
7710,경기,용인시,4,3,0,7,4,0,2019-07-21
7711,경기,용인시,14,0,5,19,12,0,2019-08-21
7712,경기,용인시,10,8,0,18,11,0,2019-09-21
7713,경기,용인시,11,1,1,13,11,0,2019-10-21
7714,경기,용인시,15,5,1,21,13,0,2019-11-21
7715,경기,용인시,10,2,1,13,10,0,2019-12-21
7716,경기,의왕시,0,0,1,1,1,0,2019-01-21
7717,경기,의왕시,0,0,0,0,0,0,2019-02-21
7718,경기,의왕시,2,1,0,3,2,0,2019-03-21
7719,경기,의왕시,1,0,0,1,1,0,2019-04-21
7720,경기,의왕시,0,0,0,0,0,0,2019-05-21
7721,경기,의왕시,0,0,1,1,1,0,2019-06-21
7722,경기,의왕시,1,0,0,1,1,0,2019-07-21
7723,경기,의왕시,1,0,0,1,1,0,2019-08-21
7724,경기,의왕시,2,0,0,2,1,0,2019-09-21
7725,경기,의왕시,2,0,0,2,2,0,2019-10-21
7726,경기,의왕시,4,0,1,5,2,0,2019-11-21
7727,경기,의왕시,0,0,1,1,1,0,2019-12-21
7728,경기,의정부시,6,1,2,9,6,0,2019-01-21
7729,경기,의정부시,1,0,1,2,2,0,2019-02-21
7730,경기,의정부시,2,1,0,3,3,0,2019-03-21
7731,경기,의정부시,6,4,1,11,4,0,2019-04-21
7732,경기,의정부시,5,1,2,8,8,0,2019-05-21
7733,경기,의정부시,1,0,1,2,2,0,2019-06-21
7734,경기,의정부시,4,0,0,4,3,0,2019-07-21
7735,경기,의정부시,0,1,0,1,1,0,2019-08-21
7736,경기,의정부시,6,1,0,7,3,0,2019-09-21
7737,경기,의정부시,12,0,0,12,8,1,2019-10-21
7738,경기,의정부시,0,0,1,1,2,1,2019-11-21
7739,경기,의정부시,7,0,0,7,6,0,2019-12-21
7740,경기,이천시,5,0,0,5,5,0,2019-01-21
7741,경기,이천시,9,1,2,12,8,0,2019-02-21
7742,경기,이천시,5,0,2,7,5,0,2019-03-21
7743,경기,이천시,0,0,0,0,0,0,2019-04-21
7744,경기,이천시,1,0,0,1,1,0,2019-05-21
7745,경기,이천시,5,0,1,6,5,0,2019-06-21
7746,경기,이천시,3,0,0,3,3,0,2019-07-21
7747,경기,이천시,8,1,7,16,3,0,2019-08-21
7748,경기,이천시,1,0,0,1,1,0,2019-09-21
7749,경기,이천시,11,0,1,12,3,0,2019-10-21
7750,경기,이천시,6,1,3,10,7,0,2019-11-21
7751,경기,이천시,7,2,2,11,3,0,2019-12-21
7752,경기,파주시,1,0,2,3,3,0,2019-01-21
7753,경기,파주시,2,1,1,4,3,0,2019-02-21
7754,경기,파주시,6,0,1,7,5,0,2019-03-21
7755,경기,파주시,2,0,2,4,3,0,2019-04-21
7756,경기,파주시,7,0,2,9,6,0,2019-05-21
7757,경기,파주시,5,2,0,7,6,0,2019-06-21
7758,경기,파주시,7,1,2,10,4,0,2019-07-21
7759,경기,파주시,6,1,1,8,7,0,2019-08-21
7760,경기,파주시,8,0,2,10,6,1,2019-09-21
7761,경기,파주시,10,1,1,12,9,0,2019-10-21
7762,경기,파주시,2,1,1,4,4,0,2019-11-21
7763,경기,파주시,3,0,0,3,2,0,2019-12-21
7764,경기,평택시,11,0,2,13,5,0,2019-01-21
7765,경기,평택시,4,0,1,5,5,0,2019-02-21
7766,경기,평택시,4,5,7,16,11,0,2019-03-21
7767,경기,평택시,7,0,0,7,4,0,2019-04-21
7768,경기,평택시,9,0,0,9,6,0,2019-05-21
7769,경기,평택시,7,2,4,13,7,0,2019-06-21
7770,경기,평택시,10,4,3,17,8,0,2019-07-21
7771,경기,평택시,11,0,5,16,11,0,2019-08-21
7772,경기,평택시,26,3,2,31,16,0,2019-09-21
7773,경기,평택시,9,2,5,16,10,0,2019-10-21
7774,경기,평택시,21,2,4,27,16,0,2019-11-21
7775,경기,평택시,18,0,3,21,13,0,2019-12-21
7776,경기,포천시,2,0,3,5,3,0,2019-01-21
7777,경기,포천시,2,8,0,10,3,1,2019-02-21
7778,경기,포천시,2,0,0,2,2,0,2019-03-21
7779,경기,포천시,0,0,1,1,1,0,2019-04-21
7780,경기,포천시,4,0,1,5,3,0,2019-05-21
7781,경기,포천시,1,2,0,3,2,0,2019-06-21
7782,경기,포천시,0,0,0,0,0,0,2019-07-21
7783,경기,포천시,3,0,0,3,2,0,2019-08-21
7784,경기,포천시,3,0,0,3,3,0,2019-09-21
7785,경기,포천시,7,0,2,9,6,0,2019-10-21
7786,경기,포천시,5,1,0,6,5,0,2019-11-21
7787,경기,포천시,9,1,1,11,5,0,2019-12-21
7788,경기,하남시,8,1,2,11,6,0,2019-01-21
7789,경기,하남시,3,1,0,4,2,0,2019-02-21
7790,경기,하남시,1,1,0,2,2,0,2019-03-21
7791,경기,하남시,1,1,0,2,2,0,2019-04-21
7792,경기,하남시,1,0,0,1,1,0,2019-05-21
7793,경기,하남시,2,0,2,4,3,0,2019-06-21
7794,경기,하남시,6,1,1,8,5,0,2019-07-21
7795,경기,하남시,1,1,1,3,2,0,2019-08-21
7796,경기,하남시,0,1,0,1,1,0,2019-09-21
7797,경기,하남시,5,0,1,6,5,0,2019-10-21
7798,경기,하남시,4,0,0,4,4,0,2019-11-21
7799,경기,하남시,1,0,1,2,3,1,2019-12-21
7800,경기,화성시,6,0,0,6,5,0,2019-01-21
7801,경기,화성시,12,1,4,17,9,0,2019-02-21
7802,경기,화성시,6,0,2,8,7,0,2019-03-21
7803,경기,화성시,6,0,0,6,2,0,2019-04-21
7804,경기,화성시,11,0,3,14,9,0,2019-05-21
7805,경기,화성시,13,2,1,16,10,0,2019-06-21
7806,경기,화성시,1,0,0,1,1,0,2019-07-21
7807,경기,화성시,6,4,5,15,8,0,2019-08-21
7808,경기,화성시,9,3,1,13,7,0,2019-09-21
7809,경기,화성시,21,2,2,25,17,0,2019-10-21
7810,경기,화성시,6,2,2,10,7,0,2019-11-21
7811,경기,화성시,20,3,4,27,11,0,2019-12-21
7812,경기,가평군,3,0,0,3,2,0,2019-01-22
7813,경기,가평군,0,0,0,0,0,0,2019-02-22
7814,경기,가평군,0,0,0,0,0,0,2019-03-22
7815,경기,가평군,0,1,0,1,1,0,2019-04-22
7816,경기,가평군,0,0,0,0,0,0,2019-05-22
7817,경기,가평군,5,0,0,5,2,1,2019-06-22
7818,경기,가평군,6,0,0,6,1,0,2019-07-22
7819,경기,가평군,3,0,0,3,3,0,2019-08-22
7820,경기,가평군,0,0,0,0,0,0,2019-09-22
7821,경기,가평군,0,0,1,1,1,0,2019-10-22
7822,경기,가평군,2,1,0,3,2,0,2019-11-22
7823,경기,가평군,3,0,1,4,1,0,2019-12-22
7824,경기,고양시,5,2,1,8,7,0,2019-01-22
7825,경기,고양시,7,0,3,10,7,0,2019-02-22
7826,경기,고양시,6,3,3,12,10,0,2019-03-22
7827,경기,고양시,5,1,3,9,7,0,2019-04-22
7828,경기,고양시,15,0,4,19,14,0,2019-05-22
7829,경기,고양시,15,5,8,28,19,0,2019-06-22
7830,경기,고양시,14,2,2,18,13,0,2019-07-22
7831,경기,고양시,21,2,6,29,12,0,2019-08-22
7832,경기,고양시,3,0,2,5,5,0,2019-09-22
7833,경기,고양시,20,1,0,21,13,0,2019-10-22
7834,경기,고양시,12,2,3,17,14,1,2019-11-22
7835,경기,고양시,10,3,2,15,9,0,2019-12-22
7836,경기,과천시,6,0,0,6,2,0,2019-01-22
7837,경기,과천시,0,0,0,0,0,0,2019-02-22
7838,경기,과천시,0,0,0,0,0,0,2019-03-22
7839,경기,과천시,1,0,0,1,1,0,2019-04-22
7840,경기,과천시,0,0,0,0,0,0,2019-05-22
7841,경기,과천시,4,0,0,4,1,0,2019-06-22
7842,경기,과천시,0,0,0,0,0,0,2019-07-22
7843,경기,과천시,2,0,0,2,1,0,2019-08-22
7844,경기,과천시,0,0,0,0,0,0,2019-09-22
7845,경기,과천시,0,0,0,0,0,0,2019-10-22
7846,경기,과천시,2,0,0,2,1,0,2019-11-22
7847,경기,과천시,1,1,0,2,2,0,2019-12-22
7848,경기,광명시,1,3,1,5,3,0,2019-01-22
7849,경기,광명시,1,0,0,1,1,0,2019-02-22
7850,경기,광명시,0,1,0,1,2,1,2019-03-22
7851,경기,광명시,3,0,0,3,3,0,2019-04-22
7852,경기,광명시,0,0,1,1,1,0,2019-05-22
7853,경기,광명시,0,0,0,0,0,0,2019-06-22
7854,경기,광명시,3,1,1,5,5,0,2019-07-22
7855,경기,광명시,1,1,0,2,2,0,2019-08-22
7856,경기,광명시,3,1,0,4,2,0,2019-09-22
7857,경기,광명시,5,3,2,10,5,0,2019-10-22
7858,경기,광명시,1,0,2,3,2,0,2019-11-22
7859,경기,광명시,4,0,0,4,2,0,2019-12-22
7860,경기,광주시,17,0,1,18,12,0,2019-01-22
7861,경기,광주시,3,0,3,6,6,0,2019-02-22
7862,경기,광주시,4,0,3,7,6,0,2019-03-22
7863,경기,광주시,4,0,4,8,7,0,2019-04-22
7864,경기,광주시,7,0,4,11,5,0,2019-05-22
7865,경기,광주시,3,0,5,8,6,0,2019-06-22
7866,경기,광주시,10,0,2,12,9,0,2019-07-22
7867,경기,광주시,4,0,1,5,4,0,2019-08-22
7868,경기,광주시,5,0,0,5,3,0,2019-09-22
7869,경기,광주시,8,1,2,11,8,0,2019-10-22
7870,경기,광주시,5,0,2,7,5,0,2019-11-22
7871,경기,광주시,3,0,2,5,5,0,2019-12-22
7872,경기,구리시,0,0,0,0,0,0,2019-01-22
7873,경기,구리시,0,0,0,0,0,0,2019-02-22
7874,경기,구리시,6,0,0,6,2,0,2019-03-22
7875,경기,구리시,1,0,0,1,1,0,2019-04-22
7876,경기,구리시,5,0,0,5,3,0,2019-05-22
7877,경기,구리시,1,0,0,1,1,0,2019-06-22
7878,경기,구리시,0,0,0,0,0,0,2019-07-22
7879,경기,구리시,1,0,0,1,1,0,2019-08-22
7880,경기,구리시,2,0,0,2,2,0,2019-09-22
7881,경기,구리시,2,0,0,2,2,0,2019-10-22
7882,경기,구리시,2,0,0,2,2,0,2019-11-22
7883,경기,구리시,0,0,0,0,0,0,2019-12-22
7884,경기,군포시,0,0,0,0,0,0,2019-01-22
7885,경기,군포시,1,0,0,1,1,0,2019-02-22
7886,경기,군포시,1,0,0,1,1,0,2019-03-22
7887,경기,군포시,1,0,0,1,1,0,2019-04-22
7888,경기,군포시,0,0,2,2,2,0,2019-05-22
7889,경기,군포시,2,0,0,2,1,0,2019-06-22
7890,경기,군포시,2,2,1,5,4,0,2019-07-22
7891,경기,군포시,1,0,1,2,2,0,2019-08-22
7892,경기,군포시,2,1,0,3,1,0,2019-09-22
7893,경기,군포시,2,0,1,3,3,0,2019-10-22
7894,경기,군포시,2,1,1,4,4,0,2019-11-22
7895,경기,군포시,2,0,2,4,4,0,2019-12-22
7896,경기,김포시,5,1,0,6,3,0,2019-01-22
7897,경기,김포시,11,3,3,17,8,0,2019-02-22
7898,경기,김포시,5,1,3,9,6,0,2019-03-22
7899,경기,김포시,15,2,4,21,12,0,2019-04-22
7900,경기,김포시,2,0,1,3,3,1,2019-05-22
7901,경기,김포시,5,0,2,7,6,0,2019-06-22
7902,경기,김포시,6,0,3,9,7,1,2019-07-22
7903,경기,김포시,3,1,0,4,3,0,2019-08-22
7904,경기,김포시,2,1,1,4,3,0,2019-09-22
7905,경기,김포시,7,0,2,9,5,0,2019-10-22
7906,경기,김포시,2,0,2,4,4,0,2019-11-22
7907,경기,김포시,21,3,2,26,13,0,2019-12-22
7908,경기,남양주시,11,3,2,16,12,0,2019-01-22
7909,경기,남양주시,5,0,1,6,4,0,2019-02-22
7910,경기,남양주시,9,3,2,14,7,0,2019-03-22
7911,경기,남양주시,9,0,4,13,9,0,2019-04-22
7912,경기,남양주시,3,1,2,6,6,0,2019-05-22
7913,경기,남양주시,4,3,3,10,8,1,2019-06-22
7914,경기,남양주시,9,3,3,15,8,0,2019-07-22
7915,경기,남양주시,8,1,1,10,6,0,2019-08-22
7916,경기,남양주시,1,0,2,3,3,0,2019-09-22
7917,경기,남양주시,4,2,3,9,8,0,2019-10-22
7918,경기,남양주시,10,0,4,14,10,0,2019-11-22
7919,경기,남양주시,6,3,1,10,6,1,2019-12-22
7920,경기,동두천시,2,0,1,3,3,0,2019-01-22
7921,경기,동두천시,1,0,0,1,1,0,2019-02-22
7922,경기,동두천시,1,0,0,1,1,0,2019-03-22
7923,경기,동두천시,0,0,0,0,0,0,2019-04-22
7924,경기,동두천시,3,0,0,3,3,0,2019-05-22
7925,경기,동두천시,1,1,0,2,2,0,2019-06-22
7926,경기,동두천시,0,0,0,0,0,0,2019-07-22
7927,경기,동두천시,2,0,0,2,1,0,2019-08-22
7928,경기,동두천시,0,0,0,0,0,0,2019-09-22
7929,경기,동두천시,2,0,0,2,2,0,2019-10-22
7930,경기,동두천시,1,0,1,2,2,0,2019-11-22
7931,경기,동두천시,0,1,0,1,1,0,2019-12-22
7932,경기,부천시,6,1,2,9,7,0,2019-01-22
7933,경기,부천시,6,0,4,10,8,0,2019-02-22
7934,경기,부천시,13,1,2,16,9,0,2019-03-22
7935,경기,부천시,12,0,11,23,12,0,2019-04-22
7936,경기,부천시,12,2,3,17,10,0,2019-05-22
7937,경기,부천시,10,0,3,13,8,0,2019-06-22
7938,경기,부천시,9,1,6,16,13,0,2019-07-22
7939,경기,부천시,19,3,1,23,15,0,2019-08-22
7940,경기,부천시,4,0,1,5,4,0,2019-09-22
7941,경기,부천시,7,1,2,10,10,0,2019-10-22
7942,경기,부천시,12,1,2,15,12,0,2019-11-22
7943,경기,부천시,6,1,4,11,9,0,2019-12-22
7944,경기,성남시,4,2,4,10,11,2,2019-01-22
7945,경기,성남시,12,2,0,14,9,1,2019-02-22
7946,경기,성남시,14,0,7,21,15,0,2019-03-22
7947,경기,성남시,10,3,4,17,12,0,2019-04-22
7948,경기,성남시,14,1,3,18,14,0,2019-05-22
7949,경기,성남시,8,1,6,15,12,0,2019-06-22
7950,경기,성남시,11,1,4,16,12,0,2019-07-22
7951,경기,성남시,9,2,1,12,11,0,2019-08-22
7952,경기,성남시,10,1,0,11,8,0,2019-09-22
7953,경기,성남시,11,0,4,15,14,0,2019-10-22
7954,경기,성남시,8,0,3,11,13,2,2019-11-22
7955,경기,성남시,9,1,0,10,7,0,2019-12-22
7956,경기,수원시,9,0,3,12,12,0,2019-01-22
7957,경기,수원시,14,1,3,18,15,0,2019-02-22
7958,경기,수원시,19,2,6,27,19,0,2019-03-22
7959,경기,수원시,18,1,10,29,20,0,2019-04-22
7960,경기,수원시,14,0,3,17,13,0,2019-05-22
7961,경기,수원시,25,4,5,34,27,0,2019-06-22
7962,경기,수원시,7,3,4,14,12,0,2019-07-22
7963,경기,수원시,23,7,0,30,14,0,2019-08-22
7964,경기,수원시,6,1,4,11,11,1,2019-09-22
7965,경기,수원시,25,2,1,28,23,0,2019-10-22
7966,경기,수원시,21,3,8,32,19,0,2019-11-22
7967,경기,수원시,11,5,6,22,13,0,2019-12-22
7968,경기,시흥시,11,0,3,14,11,0,2019-01-22
7969,경기,시흥시,8,0,1,9,9,0,2019-02-22
7970,경기,시흥시,13,8,6,27,9,0,2019-03-22
7971,경기,시흥시,16,1,8,25,14,0,2019-04-22
7972,경기,시흥시,21,1,5,27,15,0,2019-05-22
7973,경기,시흥시,5,5,6,16,7,0,2019-06-22
7974,경기,시흥시,9,1,0,10,9,2,2019-07-22
7975,경기,시흥시,4,0,2,6,4,0,2019-08-22
7976,경기,시흥시,8,0,0,8,5,0,2019-09-22
7977,경기,시흥시,2,4,1,7,3,0,2019-10-22
7978,경기,시흥시,7,1,8,16,15,0,2019-11-22
7979,경기,시흥시,12,1,1,14,8,0,2019-12-22
7980,경기,안산시,13,0,6,19,13,0,2019-01-22
7981,경기,안산시,12,1,1,14,10,0,2019-02-22
7982,경기,안산시,10,1,1,12,11,0,2019-03-22
7983,경기,안산시,24,4,4,32,18,0,2019-04-22
7984,경기,안산시,19,0,6,25,14,0,2019-05-22
7985,경기,안산시,16,1,3,20,12,0,2019-06-22
7986,경기,안산시,23,0,2,25,16,0,2019-07-22
7987,경기,안산시,12,2,4,18,10,0,2019-08-22
7988,경기,안산시,22,2,2,26,10,0,2019-09-22
7989,경기,안산시,20,2,10,32,20,1,2019-10-22
7990,경기,안산시,18,2,8,28,14,0,2019-11-22
7991,경기,안산시,10,1,3,14,9,0,2019-12-22
7992,경기,안성시,1,0,1,2,2,0,2019-01-22
7993,경기,안성시,0,0,0,0,0,0,2019-02-22
7994,경기,안성시,0,0,1,1,1,0,2019-03-22
7995,경기,안성시,0,1,0,1,1,0,2019-04-22
7996,경기,안성시,1,0,1,2,2,0,2019-05-22
7997,경기,안성시,1,0,0,1,1,0,2019-06-22
7998,경기,안성시,3,1,1,5,3,0,2019-07-22
7999,경기,안성시,2,0,0,2,2,0,2019-08-22
8000,경기,안성시,0,0,0,0,0,0,2019-09-22
8001,경기,안성시,5,1,1,7,4,0,2019-10-22
8002,경기,안성시,4,0,0,4,4,0,2019-11-22
8003,경기,안성시,0,0,0,0,0,0,2019-12-22
8004,경기,안양시,5,0,0,5,4,0,2019-01-22
8005,경기,안양시,1,0,1,2,2,0,2019-02-22
8006,경기,안양시,6,2,3,11,6,0,2019-03-22
8007,경기,안양시,3,0,2,5,3,0,2019-04-22
8008,경기,안양시,5,0,2,7,7,0,2019-05-22
8009,경기,안양시,3,0,6,9,8,0,2019-06-22
8010,경기,안양시,3,1,2,6,6,0,2019-07-22
8011,경기,안양시,4,0,3,7,4,0,2019-08-22
8012,경기,안양시,2,0,1,3,2,0,2019-09-22
8013,경기,안양시,12,0,2,14,8,0,2019-10-22
8014,경기,안양시,9,0,1,10,6,0,2019-11-22
8015,경기,안양시,1,0,0,1,1,0,2019-12-22
8016,경기,양주시,0,1,1,2,1,0,2019-01-22
8017,경기,양주시,3,1,2,6,4,0,2019-02-22
8018,경기,양주시,0,0,0,0,0,0,2019-03-22
8019,경기,양주시,2,0,0,2,2,0,2019-04-22
8020,경기,양주시,5,0,3,8,5,0,2019-05-22
8021,경기,양주시,6,1,1,8,4,0,2019-06-22
8022,경기,양주시,4,3,3,10,5,0,2019-07-22
8023,경기,양주시,1,1,1,3,3,0,2019-08-22
8024,경기,양주시,2,0,0,2,1,0,2019-09-22
8025,경기,양주시,3,0,0,3,2,0,2019-10-22
8026,경기,양주시,8,1,1,10,6,0,2019-11-22
8027,경기,양주시,1,0,0,1,1,0,2019-12-22
8028,경기,양평군,13,0,2,15,2,0,2019-01-22
8029,경기,양평군,2,0,1,3,2,0,2019-02-22
8030,경기,양평군,0,0,0,0,0,0,2019-03-22
8031,경기,양평군,1,0,0,1,1,0,2019-04-22
8032,경기,양평군,1,0,2,3,2,0,2019-05-22
8033,경기,양평군,2,1,0,3,2,0,2019-06-22
8034,경기,양평군,1,0,0,1,1,0,2019-07-22
8035,경기,양평군,0,0,0,0,0,0,2019-08-22
8036,경기,양평군,0,0,0,0,0,0,2019-09-22
8037,경기,양평군,1,0,0,1,2,1,2019-10-22
8038,경기,양평군,2,1,1,4,3,0,2019-11-22
8039,경기,양평군,0,2,1,3,2,0,2019-12-22
8040,경기,여주시,2,0,0,2,1,0,2019-01-22
8041,경기,여주시,0,0,0,0,0,0,2019-02-22
8042,경기,여주시,1,0,1,2,2,0,2019-03-22
8043,경기,여주시,0,0,0,0,0,0,2019-04-22
8044,경기,여주시,4,0,1,5,2,0,2019-05-22
8045,경기,여주시,1,0,1,2,1,1,2019-06-22
8046,경기,여주시,4,0,1,5,4,0,2019-07-22
8047,경기,여주시,3,0,2,5,2,0,2019-08-22
8048,경기,여주시,5,0,0,5,2,0,2019-09-22
8049,경기,여주시,3,0,0,3,2,0,2019-10-22
8050,경기,여주시,0,0,0,0,0,0,2019-11-22
8051,경기,여주시,2,0,0,2,2,0,2019-12-22
8052,경기,연천군,0,0,0,0,0,0,2019-01-22
8053,경기,연천군,0,0,1,1,1,0,2019-02-22
8054,경기,연천군,1,0,0,1,1,0,2019-03-22
8055,경기,연천군,0,0,0,0,0,0,2019-04-22
8056,경기,연천군,0,0,0,0,0,0,2019-05-22
8057,경기,연천군,0,0,0,0,0,0,2019-06-22
8058,경기,연천군,1,0,0,1,1,0,2019-07-22
8059,경기,연천군,5,2,2,9,3,0,2019-08-22
8060,경기,연천군,0,0,0,0,0,0,2019-09-22
8061,경기,연천군,1,0,1,2,1,0,2019-10-22
8062,경기,연천군,0,0,0,0,0,0,2019-11-22
8063,경기,연천군,0,0,4,4,1,0,2019-12-22
8064,경기,오산시,2,0,0,2,2,0,2019-01-22
8065,경기,오산시,4,0,1,5,4,0,2019-02-22
8066,경기,오산시,3,0,0,3,3,0,2019-03-22
8067,경기,오산시,6,0,1,7,4,0,2019-04-22
8068,경기,오산시,6,0,2,8,4,0,2019-05-22
8069,경기,오산시,3,0,0,3,2,0,2019-06-22
8070,경기,오산시,2,0,1,3,3,0,2019-07-22
8071,경기,오산시,6,1,2,9,6,0,2019-08-22
8072,경기,오산시,6,0,0,6,3,0,2019-09-22
8073,경기,오산시,4,2,3,9,6,0,2019-10-22
8074,경기,오산시,3,1,0,4,4,0,2019-11-22
8075,경기,오산시,1,2,0,3,2,0,2019-12-22
8076,경기,용인시,16,1,2,19,13,0,2019-01-22
8077,경기,용인시,6,0,4,10,9,0,2019-02-22
8078,경기,용인시,6,2,5,13,10,0,2019-03-22
8079,경기,용인시,4,2,2,8,7,0,2019-04-22
8080,경기,용인시,17,1,8,26,12,0,2019-05-22
8081,경기,용인시,12,1,2,15,11,0,2019-06-22
8082,경기,용인시,8,2,1,11,11,2,2019-07-22
8083,경기,용인시,15,2,2,19,14,0,2019-08-22
8084,경기,용인시,14,1,1,16,11,0,2019-09-22
8085,경기,용인시,6,3,8,17,12,0,2019-10-22
8086,경기,용인시,11,1,5,17,14,0,2019-11-22
8087,경기,용인시,9,0,0,9,6,0,2019-12-22
8088,경기,의왕시,3,0,0,3,3,0,2019-01-22
8089,경기,의왕시,1,0,1,2,2,0,2019-02-22
8090,경기,의왕시,0,0,0,0,0,0,2019-03-22
8091,경기,의왕시,0,0,0,0,0,0,2019-04-22
8092,경기,의왕시,0,0,0,0,0,0,2019-05-22
8093,경기,의왕시,3,1,2,6,2,0,2019-06-22
8094,경기,의왕시,0,0,0,0,0,0,2019-07-22
8095,경기,의왕시,3,0,0,3,2,0,2019-08-22
8096,경기,의왕시,0,0,1,1,1,0,2019-09-22
8097,경기,의왕시,1,0,0,1,1,0,2019-10-22
8098,경기,의왕시,1,0,0,1,1,0,2019-11-22
8099,경기,의왕시,0,0,0,0,0,0,2019-12-22
8100,경기,의정부시,10,0,0,10,9,1,2019-01-22
8101,경기,의정부시,6,0,0,6,6,0,2019-02-22
8102,경기,의정부시,10,0,1,11,7,0,2019-03-22
8103,경기,의정부시,2,1,1,4,3,1,2019-04-22
8104,경기,의정부시,11,0,3,14,7,0,2019-05-22
8105,경기,의정부시,6,0,1,7,6,0,2019-06-22
8106,경기,의정부시,2,0,1,3,3,0,2019-07-22
8107,경기,의정부시,1,1,0,2,2,0,2019-08-22
8108,경기,의정부시,4,2,1,7,5,0,2019-09-22
8109,경기,의정부시,2,2,2,6,6,0,2019-10-22
8110,경기,의정부시,6,1,4,11,9,0,2019-11-22
8111,경기,의정부시,11,0,0,11,3,0,2019-12-22
8112,경기,이천시,1,0,2,3,2,0,2019-01-22
8113,경기,이천시,2,0,0,2,2,0,2019-02-22
8114,경기,이천시,2,0,0,2,2,0,2019-03-22
8115,경기,이천시,4,0,1,5,3,0,2019-04-22
8116,경기,이천시,1,0,0,1,1,0,2019-05-22
8117,경기,이천시,2,0,0,2,2,0,2019-06-22
8118,경기,이천시,3,0,2,5,4,0,2019-07-22
8119,경기,이천시,4,2,1,7,6,1,2019-08-22
8120,경기,이천시,0,1,0,1,1,0,2019-09-22
8121,경기,이천시,10,0,1,11,5,0,2019-10-22
8122,경기,이천시,7,0,1,8,5,0,2019-11-22
8123,경기,이천시,5,0,0,5,3,0,2019-12-22
8124,경기,파주시,4,0,1,5,4,0,2019-01-22
8125,경기,파주시,3,2,2,7,5,0,2019-02-22
8126,경기,파주시,3,0,1,4,4,1,2019-03-22
8127,경기,파주시,4,1,2,7,7,0,2019-04-22
8128,경기,파주시,3,0,2,5,4,1,2019-05-22
8129,경기,파주시,5,1,2,8,5,0,2019-06-22
8130,경기,파주시,5,0,1,6,4,0,2019-07-22
8131,경기,파주시,5,0,4,9,8,0,2019-08-22
8132,경기,파주시,0,0,2,2,2,0,2019-09-22
8133,경기,파주시,7,1,2,10,8,0,2019-10-22
8134,경기,파주시,3,1,0,4,3,0,2019-11-22
8135,경기,파주시,2,0,1,3,1,0,2019-12-22
8136,경기,평택시,17,2,2,21,11,0,2019-01-22
8137,경기,평택시,7,2,1,10,7,0,2019-02-22
8138,경기,평택시,21,1,4,26,13,0,2019-03-22
8139,경기,평택시,11,3,4,18,11,0,2019-04-22
8140,경기,평택시,15,0,1,16,10,0,2019-05-22
8141,경기,평택시,14,1,3,18,10,2,2019-06-22
8142,경기,평택시,16,3,2,21,10,0,2019-07-22
8143,경기,평택시,12,0,3,15,11,0,2019-08-22
8144,경기,평택시,7,0,5,12,9,0,2019-09-22
8145,경기,평택시,11,6,3,20,12,0,2019-10-22
8146,경기,평택시,14,3,7,24,17,0,2019-11-22
8147,경기,평택시,13,3,4,20,11,0,2019-12-22
8148,경기,포천시,4,0,2,6,3,0,2019-01-22
8149,경기,포천시,1,3,1,5,3,0,2019-02-22
8150,경기,포천시,6,0,1,7,3,0,2019-03-22
8151,경기,포천시,1,0,0,1,1,0,2019-04-22
8152,경기,포천시,0,0,1,1,1,0,2019-05-22
8153,경기,포천시,5,0,1,6,6,0,2019-06-22
8154,경기,포천시,1,0,0,1,1,0,2019-07-22
8155,경기,포천시,4,0,0,4,1,0,2019-08-22
8156,경기,포천시,0,0,0,0,0,0,2019-09-22
8157,경기,포천시,0,0,1,1,1,0,2019-10-22
8158,경기,포천시,7,0,0,7,5,0,2019-11-22
8159,경기,포천시,9,1,3,13,6,0,2019-12-22
8160,경기,하남시,6,0,0,6,4,1,2019-01-22
8161,경기,하남시,0,0,0,0,1,1,2019-02-22
8162,경기,하남시,5,1,0,6,3,0,2019-03-22
8163,경기,하남시,0,0,0,0,1,1,2019-04-22
8164,경기,하남시,6,0,2,8,5,0,2019-05-22
8165,경기,하남시,4,2,1,7,5,0,2019-06-22
8166,경기,하남시,1,3,0,4,4,0,2019-07-22
8167,경기,하남시,1,0,4,5,2,0,2019-08-22
8168,경기,하남시,1,0,1,2,2,0,2019-09-22
8169,경기,하남시,1,0,1,2,1,0,2019-10-22
8170,경기,하남시,3,1,2,6,5,0,2019-11-22
8171,경기,하남시,0,1,0,1,1,0,2019-12-22
8172,경기,화성시,4,0,2,6,7,1,2019-01-22
8173,경기,화성시,11,1,2,14,9,0,2019-02-22
8174,경기,화성시,13,2,0,15,10,0,2019-03-22
8175,경기,화성시,12,0,0,12,8,0,2019-04-22
8176,경기,화성시,26,1,7,34,23,0,2019-05-22
8177,경기,화성시,12,2,7,21,12,0,2019-06-22
8178,경기,화성시,6,0,0,6,5,0,2019-07-22
8179,경기,화성시,16,0,0,16,9,0,2019-08-22
8180,경기,화성시,4,0,2,6,6,0,2019-09-22
8181,경기,화성시,8,0,1,9,8,0,2019-10-22
8182,경기,화성시,19,1,1,21,11,0,2019-11-22
8183,경기,화성시,14,1,4,19,7,0,2019-12-22
8184,경기,가평군,0,0,0,0,0,0,2019-01-23
8185,경기,가평군,5,0,0,5,3,0,2019-02-23
8186,경기,가평군,2,0,1,3,2,0,2019-03-23
8187,경기,가평군,0,0,0,0,0,0,2019-04-23
8188,경기,가평군,1,0,0,1,1,0,2019-05-23
8189,경기,가평군,2,0,0,2,2,0,2019-06-23
8190,경기,가평군,2,0,1,3,3,0,2019-07-23
8191,경기,가평군,4,0,0,4,3,0,2019-08-23
8192,경기,가평군,1,0,0,1,1,0,2019-09-23
8193,경기,가평군,0,0,0,0,0,0,2019-10-23
8194,경기,가평군,2,0,0,2,1,0,2019-11-23
8195,경기,가평군,5,0,0,5,1,0,2019-12-23
8196,경기,고양시,15,7,3,25,12,0,2019-01-23
8197,경기,고양시,14,1,0,15,12,0,2019-02-23
8198,경기,고양시,10,1,4,15,11,0,2019-03-23
8199,경기,고양시,24,2,7,33,20,0,2019-04-23
8200,경기,고양시,10,0,1,11,9,0,2019-05-23
8201,경기,고양시,22,1,1,24,10,0,2019-06-23
8202,경기,고양시,15,2,1,18,16,0,2019-07-23
8203,경기,고양시,19,8,2,29,18,0,2019-08-23
8204,경기,고양시,6,0,2,8,8,1,2019-09-23
8205,경기,고양시,8,1,2,11,11,0,2019-10-23
8206,경기,고양시,12,1,0,13,8,0,2019-11-23
8207,경기,고양시,9,0,4,13,8,0,2019-12-23
8208,경기,과천시,0,0,0,0,0,0,2019-01-23
8209,경기,과천시,0,0,0,0,0,0,2019-02-23
8210,경기,과천시,0,0,0,0,0,0,2019-03-23
8211,경기,과천시,0,0,0,0,0,0,2019-04-23
8212,경기,과천시,3,0,0,3,2,0,2019-05-23
8213,경기,과천시,0,0,0,0,0,0,2019-06-23
8214,경기,과천시,0,0,0,0,0,0,2019-07-23
8215,경기,과천시,1,0,0,1,1,0,2019-08-23
8216,경기,과천시,1,0,0,1,1,0,2019-09-23
8217,경기,과천시,2,0,0,2,1,0,2019-10-23
8218,경기,과천시,4,0,0,4,3,0,2019-11-23
8219,경기,과천시,0,0,1,1,1,0,2019-12-23
8220,경기,광명시,4,3,0,7,4,0,2019-01-23
8221,경기,광명시,6,0,0,6,5,0,2019-02-23
8222,경기,광명시,0,2,1,3,2,0,2019-03-23
8223,경기,광명시,4,7,1,12,5,0,2019-04-23
8224,경기,광명시,1,0,1,2,2,0,2019-05-23
8225,경기,광명시,6,1,1,8,3,0,2019-06-23
8226,경기,광명시,0,4,1,5,3,0,2019-07-23
8227,경기,광명시,4,1,2,7,5,0,2019-08-23
8228,경기,광명시,0,0,0,0,1,1,2019-09-23
8229,경기,광명시,4,1,0,5,4,0,2019-10-23
8230,경기,광명시,7,0,4,11,4,0,2019-11-23
8231,경기,광명시,2,0,0,2,2,0,2019-12-23
8232,경기,광주시,17,1,2,20,13,0,2019-01-23
8233,경기,광주시,1,0,2,3,2,0,2019-02-23
8234,경기,광주시,9,0,2,11,6,0,2019-03-23
8235,경기,광주시,5,0,1,6,4,0,2019-04-23
8236,경기,광주시,3,0,0,3,3,0,2019-05-23
8237,경기,광주시,7,0,0,7,4,0,2019-06-23
8238,경기,광주시,3,0,0,3,3,0,2019-07-23
8239,경기,광주시,4,0,1,5,4,0,2019-08-23
8240,경기,광주시,4,0,1,5,4,1,2019-09-23
8241,경기,광주시,3,0,1,4,3,0,2019-10-23
8242,경기,광주시,10,1,0,11,5,0,2019-11-23
8243,경기,광주시,10,1,1,12,7,0,2019-12-23
8244,경기,구리시,1,0,0,1,1,0,2019-01-23
8245,경기,구리시,0,0,1,1,1,0,2019-02-23
8246,경기,구리시,4,0,0,4,2,0,2019-03-23
8247,경기,구리시,0,0,0,0,0,0,2019-04-23
8248,경기,구리시,0,0,0,0,0,0,2019-05-23
8249,경기,구리시,1,1,3,5,3,0,2019-06-23
8250,경기,구리시,5,0,0,5,5,0,2019-07-23
8251,경기,구리시,3,0,1,4,4,0,2019-08-23
8252,경기,구리시,3,0,2,5,5,0,2019-09-23
8253,경기,구리시,0,0,0,0,0,0,2019-10-23
8254,경기,구리시,2,0,0,2,2,0,2019-11-23
8255,경기,구리시,1,0,0,1,1,0,2019-12-23
8256,경기,군포시,1,0,0,1,1,0,2019-01-23
8257,경기,군포시,1,0,1,2,1,0,2019-02-23
8258,경기,군포시,2,0,1,3,3,0,2019-03-23
8259,경기,군포시,2,2,0,4,3,0,2019-04-23
8260,경기,군포시,0,0,0,0,0,0,2019-05-23
8261,경기,군포시,3,0,0,3,2,0,2019-06-23
8262,경기,군포시,0,0,1,1,1,0,2019-07-23
8263,경기,군포시,3,0,0,3,2,0,2019-08-23
8264,경기,군포시,1,1,0,2,2,0,2019-09-23
8265,경기,군포시,2,0,0,2,2,0,2019-10-23
8266,경기,군포시,3,0,2,5,4,0,2019-11-23
8267,경기,군포시,2,0,0,2,1,0,2019-12-23
8268,경기,김포시,4,0,4,8,4,0,2019-01-23
8269,경기,김포시,5,0,0,5,4,0,2019-02-23
8270,경기,김포시,11,1,2,14,5,0,2019-03-23
8271,경기,김포시,3,0,3,6,4,0,2019-04-23
8272,경기,김포시,0,0,0,0,0,0,2019-05-23
8273,경기,김포시,5,0,1,6,3,0,2019-06-23
8274,경기,김포시,7,0,1,8,4,0,2019-07-23
8275,경기,김포시,10,0,0,10,6,0,2019-08-23
8276,경기,김포시,8,1,2,11,4,0,2019-09-23
8277,경기,김포시,2,0,1,3,3,0,2019-10-23
8278,경기,김포시,3,3,1,7,5,0,2019-11-23
8279,경기,김포시,4,1,1,6,5,0,2019-12-23
8280,경기,남양주시,6,1,3,10,6,0,2019-01-23
8281,경기,남양주시,4,0,2,6,5,0,2019-02-23
8282,경기,남양주시,1,0,0,1,1,0,2019-03-23
8283,경기,남양주시,9,0,0,9,6,0,2019-04-23
8284,경기,남양주시,2,3,1,6,5,0,2019-05-23
8285,경기,남양주시,24,1,7,32,11,0,2019-06-23
8286,경기,남양주시,3,1,4,8,8,0,2019-07-23
8287,경기,남양주시,13,1,1,15,7,0,2019-08-23
8288,경기,남양주시,6,1,1,8,7,0,2019-09-23
8289,경기,남양주시,5,2,4,11,7,0,2019-10-23
8290,경기,남양주시,13,1,2,16,7,0,2019-11-23
8291,경기,남양주시,4,0,4,8,6,0,2019-12-23
8292,경기,동두천시,0,0,0,0,0,0,2019-01-23
8293,경기,동두천시,0,0,0,0,0,0,2019-02-23
8294,경기,동두천시,0,0,0,0,0,0,2019-03-23
8295,경기,동두천시,0,0,0,0,0,0,2019-04-23
8296,경기,동두천시,1,2,1,4,4,0,2019-05-23
8297,경기,동두천시,0,0,0,0,0,0,2019-06-23
8298,경기,동두천시,0,0,0,0,0,0,2019-07-23
8299,경기,동두천시,1,1,0,2,2,0,2019-08-23
8300,경기,동두천시,4,2,1,7,4,0,2019-09-23
8301,경기,동두천시,0,0,0,0,0,0,2019-10-23
8302,경기,동두천시,0,0,0,0,0,0,2019-11-23
8303,경기,동두천시,0,0,0,0,0,0,2019-12-23
8304,경기,부천시,17,5,4,26,12,0,2019-01-23
8305,경기,부천시,2,0,0,2,2,0,2019-02-23
8306,경기,부천시,12,3,4,19,14,0,2019-03-23
8307,경기,부천시,8,1,0,9,8,1,2019-04-23
8308,경기,부천시,22,4,2,28,17,0,2019-05-23
8309,경기,부천시,16,2,6,24,13,0,2019-06-23
8310,경기,부천시,14,1,5,20,15,0,2019-07-23
8311,경기,부천시,16,2,4,22,13,0,2019-08-23
8312,경기,부천시,8,0,2,10,9,0,2019-09-23
8313,경기,부천시,6,3,1,10,8,0,2019-10-23
8314,경기,부천시,9,0,3,12,10,0,2019-11-23
8315,경기,부천시,13,0,5,18,11,0,2019-12-23
8316,경기,성남시,11,0,1,12,12,1,2019-01-23
8317,경기,성남시,6,3,4,13,10,0,2019-02-23
8318,경기,성남시,18,0,3,21,12,0,2019-03-23
8319,경기,성남시,11,3,3,17,13,0,2019-04-23
8320,경기,성남시,20,4,4,28,13,0,2019-05-23
8321,경기,성남시,7,1,3,11,8,0,2019-06-23
8322,경기,성남시,14,1,5,20,17,0,2019-07-23
8323,경기,성남시,8,1,2,11,10,1,2019-08-23
8324,경기,성남시,11,0,2,13,11,0,2019-09-23
8325,경기,성남시,14,6,5,25,14,1,2019-10-23
8326,경기,성남시,16,1,4,21,13,0,2019-11-23
8327,경기,성남시,10,1,3,14,13,0,2019-12-23
8328,경기,수원시,8,1,2,11,11,1,2019-01-23
8329,경기,수원시,14,2,1,17,15,0,2019-02-23
8330,경기,수원시,4,3,2,9,4,0,2019-03-23
8331,경기,수원시,10,1,0,11,9,0,2019-04-23
8332,경기,수원시,20,0,2,22,14,0,2019-05-23
8333,경기,수원시,14,4,1,19,12,0,2019-06-23
8334,경기,수원시,11,5,4,20,13,0,2019-07-23
8335,경기,수원시,15,2,4,21,13,0,2019-08-23
8336,경기,수원시,9,3,1,13,9,0,2019-09-23
8337,경기,수원시,10,0,0,10,8,0,2019-10-23
8338,경기,수원시,13,1,8,22,17,0,2019-11-23
8339,경기,수원시,16,1,4,21,16,0,2019-12-23
8340,경기,시흥시,3,1,2,6,5,0,2019-01-23
8341,경기,시흥시,2,1,4,7,6,0,2019-02-23
8342,경기,시흥시,2,0,0,2,2,0,2019-03-23
8343,경기,시흥시,8,1,0,9,7,0,2019-04-23
8344,경기,시흥시,12,1,0,13,8,0,2019-05-23
8345,경기,시흥시,7,0,2,9,7,0,2019-06-23
8346,경기,시흥시,6,1,3,10,9,1,2019-07-23
8347,경기,시흥시,11,1,1,13,8,1,2019-08-23
8348,경기,시흥시,11,1,2,14,6,0,2019-09-23
8349,경기,시흥시,12,0,7,19,14,0,2019-10-23
8350,경기,시흥시,5,1,2,8,6,0,2019-11-23
8351,경기,시흥시,10,3,4,17,11,0,2019-12-23
8352,경기,안산시,12,3,9,24,17,0,2019-01-23
8353,경기,안산시,10,3,6,19,12,0,2019-02-23
8354,경기,안산시,16,0,2,18,11,0,2019-03-23
8355,경기,안산시,3,0,2,5,4,0,2019-04-23
8356,경기,안산시,15,0,3,18,14,1,2019-05-23
8357,경기,안산시,17,3,1,21,14,0,2019-06-23
8358,경기,안산시,7,2,3,12,8,0,2019-07-23
8359,경기,안산시,10,1,2,13,9,0,2019-08-23
8360,경기,안산시,17,1,6,24,14,1,2019-09-23
8361,경기,안산시,15,1,2,18,13,0,2019-10-23
8362,경기,안산시,23,1,1,25,18,0,2019-11-23
8363,경기,안산시,9,0,1,10,6,0,2019-12-23
8364,경기,안성시,3,1,0,4,3,0,2019-01-23
8365,경기,안성시,2,0,1,3,3,0,2019-02-23
8366,경기,안성시,1,0,0,1,1,0,2019-03-23
8367,경기,안성시,2,0,1,3,3,0,2019-04-23
8368,경기,안성시,3,1,2,6,5,0,2019-05-23
8369,경기,안성시,0,0,0,0,0,0,2019-06-23
8370,경기,안성시,0,0,0,0,0,0,2019-07-23
8371,경기,안성시,3,0,0,3,1,0,2019-08-23
8372,경기,안성시,3,1,2,6,5,1,2019-09-23
8373,경기,안성시,4,0,1,5,4,0,2019-10-23
8374,경기,안성시,2,3,1,6,4,0,2019-11-23
8375,경기,안성시,4,0,3,7,3,0,2019-12-23
8376,경기,안양시,3,0,0,3,2,0,2019-01-23
8377,경기,안양시,9,0,0,9,5,0,2019-02-23
8378,경기,안양시,3,0,2,5,5,0,2019-03-23
8379,경기,안양시,3,0,1,4,3,0,2019-04-23
8380,경기,안양시,10,0,0,10,6,0,2019-05-23
8381,경기,안양시,3,0,0,3,2,0,2019-06-23
8382,경기,안양시,3,3,0,6,3,0,2019-07-23
8383,경기,안양시,2,0,1,3,3,0,2019-08-23
8384,경기,안양시,1,0,0,1,1,0,2019-09-23
8385,경기,안양시,3,0,0,3,3,0,2019-10-23
8386,경기,안양시,11,1,1,13,6,0,2019-11-23
8387,경기,안양시,10,0,3,13,8,0,2019-12-23
8388,경기,양주시,5,0,0,5,4,0,2019-01-23
8389,경기,양주시,9,0,1,10,7,1,2019-02-23
8390,경기,양주시,5,0,1,6,4,0,2019-03-23
8391,경기,양주시,1,1,0,2,2,0,2019-04-23
8392,경기,양주시,4,2,0,6,4,0,2019-05-23
8393,경기,양주시,1,1,0,2,1,0,2019-06-23
8394,경기,양주시,3,0,1,4,3,0,2019-07-23
8395,경기,양주시,6,0,1,7,6,0,2019-08-23
8396,경기,양주시,5,1,2,8,5,0,2019-09-23
8397,경기,양주시,3,0,1,4,4,0,2019-10-23
8398,경기,양주시,4,1,0,5,3,0,2019-11-23
8399,경기,양주시,7,1,0,8,5,0,2019-12-23
8400,경기,양평군,0,0,1,1,1,0,2019-01-23
8401,경기,양평군,3,0,5,8,5,0,2019-02-23
8402,경기,양평군,3,1,1,5,2,0,2019-03-23
8403,경기,양평군,1,0,0,1,1,0,2019-04-23
8404,경기,양평군,0,6,0,6,1,0,2019-05-23
8405,경기,양평군,4,1,2,7,4,0,2019-06-23
8406,경기,양평군,0,0,1,1,1,0,2019-07-23
8407,경기,양평군,3,0,0,3,2,0,2019-08-23
8408,경기,양평군,0,1,0,1,1,0,2019-09-23
8409,경기,양평군,3,3,0,6,2,0,2019-10-23
8410,경기,양평군,1,1,0,2,3,1,2019-11-23
8411,경기,양평군,0,0,0,0,0,0,2019-12-23
8412,경기,여주시,0,0,0,0,0,0,2019-01-23
8413,경기,여주시,2,1,1,4,3,0,2019-02-23
8414,경기,여주시,0,0,2,2,2,1,2019-03-23
8415,경기,여주시,3,0,1,4,2,0,2019-04-23
8416,경기,여주시,0,0,0,0,1,1,2019-05-23
8417,경기,여주시,0,3,2,5,3,0,2019-06-23
8418,경기,여주시,3,1,0,4,2,0,2019-07-23
8419,경기,여주시,3,0,1,4,4,0,2019-08-23
8420,경기,여주시,0,0,1,1,1,0,2019-09-23
8421,경기,여주시,1,0,0,1,1,0,2019-10-23
8422,경기,여주시,5,1,3,9,4,0,2019-11-23
8423,경기,여주시,1,0,0,1,1,0,2019-12-23
8424,경기,연천군,0,0,0,0,0,0,2019-01-23
8425,경기,연천군,0,0,0,0,0,0,2019-02-23
8426,경기,연천군,0,0,0,0,0,0,2019-03-23
8427,경기,연천군,0,0,0,0,0,0,2019-04-23
8428,경기,연천군,0,0,1,1,1,0,2019-05-23
8429,경기,연천군,0,0,0,0,0,0,2019-06-23
8430,경기,연천군,1,0,0,1,1,0,2019-07-23
8431,경기,연천군,0,0,0,0,0,0,2019-08-23
8432,경기,연천군,1,0,1,2,2,0,2019-09-23
8433,경기,연천군,0,0,0,0,0,0,2019-10-23
8434,경기,연천군,0,0,0,0,0,0,2019-11-23
8435,경기,연천군,0,0,0,0,0,0,2019-12-23
8436,경기,오산시,4,1,0,5,3,0,2019-01-23
8437,경기,오산시,0,0,0,0,0,0,2019-02-23
8438,경기,오산시,2,0,1,3,2,0,2019-03-23
8439,경기,오산시,5,0,2,7,5,0,2019-04-23
8440,경기,오산시,6,2,1,9,6,0,2019-05-23
8441,경기,오산시,1,2,1,4,3,0,2019-06-23
8442,경기,오산시,4,1,0,5,3,0,2019-07-23
8443,경기,오산시,2,0,1,3,2,0,2019-08-23
8444,경기,오산시,3,0,2,5,5,0,2019-09-23
8445,경기,오산시,3,0,1,4,3,0,2019-10-23
8446,경기,오산시,1,1,4,6,2,0,2019-11-23
8447,경기,오산시,3,0,0,3,2,0,2019-12-23
8448,경기,용인시,8,6,2,16,8,0,2019-01-23
8449,경기,용인시,3,0,3,6,5,0,2019-02-23
8450,경기,용인시,24,7,2,33,13,1,2019-03-23
8451,경기,용인시,5,1,0,6,4,0,2019-04-23
8452,경기,용인시,5,1,2,8,7,0,2019-05-23
8453,경기,용인시,9,2,2,13,8,0,2019-06-23
8454,경기,용인시,13,0,3,16,11,0,2019-07-23
8455,경기,용인시,7,0,1,8,6,0,2019-08-23
8456,경기,용인시,15,0,4,19,14,0,2019-09-23
8457,경기,용인시,16,6,6,28,16,1,2019-10-23
8458,경기,용인시,10,0,1,11,6,0,2019-11-23
8459,경기,용인시,22,2,3,27,15,0,2019-12-23
8460,경기,의왕시,0,0,0,0,0,0,2019-01-23
8461,경기,의왕시,0,0,0,0,0,0,2019-02-23
8462,경기,의왕시,1,0,0,1,1,0,2019-03-23
8463,경기,의왕시,0,0,0,0,0,0,2019-04-23
8464,경기,의왕시,1,0,1,2,1,0,2019-05-23
8465,경기,의왕시,0,0,0,0,0,0,2019-06-23
8466,경기,의왕시,0,0,0,0,0,0,2019-07-23
8467,경기,의왕시,1,0,1,2,2,0,2019-08-23
8468,경기,의왕시,4,0,0,4,2,0,2019-09-23
8469,경기,의왕시,2,0,1,3,3,0,2019-10-23
8470,경기,의왕시,0,0,1,1,1,0,2019-11-23
8471,경기,의왕시,0,0,0,0,0,0,2019-12-23
8472,경기,의정부시,3,0,2,5,4,0,2019-01-23
8473,경기,의정부시,9,3,0,12,7,0,2019-02-23
8474,경기,의정부시,0,0,2,2,2,0,2019-03-23
8475,경기,의정부시,7,1,0,8,6,0,2019-04-23
8476,경기,의정부시,4,2,0,6,6,0,2019-05-23
8477,경기,의정부시,0,1,1,2,2,0,2019-06-23
8478,경기,의정부시,3,0,0,3,2,0,2019-07-23
8479,경기,의정부시,5,1,1,7,6,0,2019-08-23
8480,경기,의정부시,1,0,2,3,3,0,2019-09-23
8481,경기,의정부시,0,0,0,0,0,0,2019-10-23
8482,경기,의정부시,9,1,2,12,5,0,2019-11-23
8483,경기,의정부시,1,0,2,3,2,0,2019-12-23
8484,경기,이천시,5,0,2,7,4,0,2019-01-23
8485,경기,이천시,2,0,0,2,1,0,2019-02-23
8486,경기,이천시,4,0,0,4,2,0,2019-03-23
8487,경기,이천시,1,0,2,3,2,0,2019-04-23
8488,경기,이천시,6,0,0,6,3,0,2019-05-23
8489,경기,이천시,0,0,0,0,0,0,2019-06-23
8490,경기,이천시,2,0,2,4,3,0,2019-07-23
8491,경기,이천시,0,0,1,1,1,0,2019-08-23
8492,경기,이천시,9,1,4,14,6,0,2019-09-23
8493,경기,이천시,1,0,1,2,2,0,2019-10-23
8494,경기,이천시,1,0,0,1,1,0,2019-11-23
8495,경기,이천시,5,1,0,6,5,0,2019-12-23
8496,경기,파주시,6,1,0,7,6,0,2019-01-23
8497,경기,파주시,11,4,3,18,10,0,2019-02-23
8498,경기,파주시,9,1,1,11,7,0,2019-03-23
8499,경기,파주시,6,0,3,9,8,0,2019-04-23
8500,경기,파주시,2,0,1,3,3,0,2019-05-23
8501,경기,파주시,4,0,0,4,3,0,2019-06-23
8502,경기,파주시,1,0,2,3,2,0,2019-07-23
8503,경기,파주시,3,0,2,5,4,0,2019-08-23
8504,경기,파주시,6,1,0,7,5,0,2019-09-23
8505,경기,파주시,7,0,1,8,8,0,2019-10-23
8506,경기,파주시,5,0,1,6,4,0,2019-11-23
8507,경기,파주시,2,0,6,8,6,0,2019-12-23
8508,경기,평택시,1,0,2,3,3,0,2019-01-23
8509,경기,평택시,15,2,0,17,11,0,2019-02-23
8510,경기,평택시,8,0,6,14,8,0,2019-03-23
8511,경기,평택시,13,0,0,13,8,0,2019-04-23
8512,경기,평택시,12,3,5,20,15,0,2019-05-23
8513,경기,평택시,13,0,3,16,13,0,2019-06-23
8514,경기,평택시,13,0,1,14,9,0,2019-07-23
8515,경기,평택시,7,5,1,13,10,0,2019-08-23
8516,경기,평택시,7,2,0,9,7,0,2019-09-23
8517,경기,평택시,12,3,2,17,11,0,2019-10-23
8518,경기,평택시,18,6,3,27,15,1,2019-11-23
8519,경기,평택시,5,0,6,11,8,0,2019-12-23
8520,경기,포천시,2,0,0,2,1,0,2019-01-23
8521,경기,포천시,5,0,1,6,4,0,2019-02-23
8522,경기,포천시,0,0,1,1,1,0,2019-03-23
8523,경기,포천시,1,0,1,2,2,0,2019-04-23
8524,경기,포천시,0,0,0,0,1,1,2019-05-23
8525,경기,포천시,8,1,3,12,7,0,2019-06-23
8526,경기,포천시,0,0,1,1,1,0,2019-07-23
8527,경기,포천시,0,1,1,2,2,0,2019-08-23
8528,경기,포천시,0,0,3,3,2,0,2019-09-23
8529,경기,포천시,1,1,0,2,2,0,2019-10-23
8530,경기,포천시,0,0,0,0,0,0,2019-11-23
8531,경기,포천시,5,2,1,8,6,0,2019-12-23
8532,경기,하남시,3,0,1,4,4,0,2019-01-23
8533,경기,하남시,3,0,1,4,3,0,2019-02-23
8534,경기,하남시,1,1,1,3,3,0,2019-03-23
8535,경기,하남시,2,0,0,2,1,0,2019-04-23
8536,경기,하남시,4,1,1,6,4,0,2019-05-23
8537,경기,하남시,7,1,0,8,4,0,2019-06-23
8538,경기,하남시,3,0,0,3,3,0,2019-07-23
8539,경기,하남시,5,0,1,6,3,0,2019-08-23
8540,경기,하남시,2,2,1,5,5,0,2019-09-23
8541,경기,하남시,3,0,3,6,5,0,2019-10-23
8542,경기,하남시,7,0,0,7,5,0,2019-11-23
8543,경기,하남시,3,0,1,4,4,0,2019-12-23
8544,경기,화성시,5,0,1,6,4,0,2019-01-23
8545,경기,화성시,12,0,1,13,5,0,2019-02-23
8546,경기,화성시,8,0,3,11,8,0,2019-03-23
8547,경기,화성시,14,2,3,19,12,0,2019-04-23
8548,경기,화성시,13,0,4,17,13,0,2019-05-23
8549,경기,화성시,29,1,3,33,14,0,2019-06-23
8550,경기,화성시,9,0,0,9,7,0,2019-07-23
8551,경기,화성시,11,0,3,14,11,0,2019-08-23
8552,경기,화성시,13,2,1,16,13,0,2019-09-23
8553,경기,화성시,11,0,4,15,10,0,2019-10-23
8554,경기,화성시,12,0,3,15,7,0,2019-11-23
8555,경기,화성시,11,0,2,13,12,1,2019-12-23
8556,경기,가평군,4,0,0,4,1,0,2019-01-24
8557,경기,가평군,0,0,0,0,0,0,2019-02-24
8558,경기,가평군,0,0,0,0,0,0,2019-03-24
8559,경기,가평군,0,0,0,0,0,0,2019-04-24
8560,경기,가평군,5,0,1,6,4,0,2019-05-24
8561,경기,가평군,0,1,0,1,1,0,2019-06-24
8562,경기,가평군,0,0,1,1,1,0,2019-07-24
8563,경기,가평군,3,0,2,5,1,0,2019-08-24
8564,경기,가평군,1,1,0,2,2,0,2019-09-24
8565,경기,가평군,1,0,0,1,1,0,2019-10-24
8566,경기,가평군,5,0,0,5,2,0,2019-11-24
8567,경기,가평군,0,0,0,0,0,0,2019-12-24
8568,경기,고양시,11,3,5,19,12,0,2019-01-24
8569,경기,고양시,10,0,3,13,9,0,2019-02-24
8570,경기,고양시,6,3,3,12,10,0,2019-03-24
8571,경기,고양시,12,0,1,13,12,0,2019-04-24
8572,경기,고양시,15,5,2,22,15,0,2019-05-24
8573,경기,고양시,8,5,8,21,16,0,2019-06-24
8574,경기,고양시,5,1,5,11,9,0,2019-07-24
8575,경기,고양시,11,0,1,12,9,0,2019-08-24
8576,경기,고양시,14,2,2,18,15,0,2019-09-24
8577,경기,고양시,7,1,5,13,11,0,2019-10-24
8578,경기,고양시,5,4,3,12,6,0,2019-11-24
8579,경기,고양시,19,3,0,22,17,0,2019-12-24
8580,경기,과천시,0,0,0,0,0,0,2019-01-24
8581,경기,과천시,0,1,1,2,2,0,2019-02-24
8582,경기,과천시,0,0,0,0,0,0,2019-03-24
8583,경기,과천시,2,0,0,2,1,0,2019-04-24
8584,경기,과천시,0,0,0,0,0,0,2019-05-24
8585,경기,과천시,2,0,2,4,4,0,2019-06-24
8586,경기,과천시,0,1,0,1,1,0,2019-07-24
8587,경기,과천시,1,0,0,1,1,0,2019-08-24
8588,경기,과천시,3,0,1,4,2,0,2019-09-24
8589,경기,과천시,2,0,2,4,3,0,2019-10-24
8590,경기,과천시,2,0,0,2,1,0,2019-11-24
8591,경기,과천시,3,0,2,5,2,0,2019-12-24
8592,경기,광명시,1,0,1,2,2,0,2019-01-24
8593,경기,광명시,6,3,1,10,4,0,2019-02-24
8594,경기,광명시,1,0,0,1,1,0,2019-03-24
8595,경기,광명시,1,0,0,1,1,0,2019-04-24
8596,경기,광명시,1,2,1,4,3,0,2019-05-24
8597,경기,광명시,5,2,1,8,7,0,2019-06-24
8598,경기,광명시,1,0,2,3,3,0,2019-07-24
8599,경기,광명시,1,0,0,1,1,0,2019-08-24
8600,경기,광명시,0,0,4,4,3,0,2019-09-24
8601,경기,광명시,1,1,0,2,2,0,2019-10-24
8602,경기,광명시,4,0,0,4,3,0,2019-11-24
8603,경기,광명시,6,2,1,9,7,0,2019-12-24
8604,경기,광주시,0,0,0,0,0,0,2019-01-24
8605,경기,광주시,1,0,2,3,2,0,2019-02-24
8606,경기,광주시,3,0,1,4,4,0,2019-03-24
8607,경기,광주시,6,0,3,9,6,0,2019-04-24
8608,경기,광주시,7,0,2,9,5,0,2019-05-24
8609,경기,광주시,2,0,2,4,4,0,2019-06-24
8610,경기,광주시,2,0,0,2,2,0,2019-07-24
8611,경기,광주시,4,2,0,6,4,0,2019-08-24
8612,경기,광주시,3,1,1,5,3,0,2019-09-24
8613,경기,광주시,4,1,0,5,4,0,2019-10-24
8614,경기,광주시,5,1,0,6,4,0,2019-11-24
8615,경기,광주시,10,1,4,15,9,0,2019-12-24
8616,경기,구리시,6,0,0,6,1,0,2019-01-24
8617,경기,구리시,3,0,0,3,1,0,2019-02-24
8618,경기,구리시,0,0,0,0,0,0,2019-03-24
8619,경기,구리시,8,0,2,10,5,0,2019-04-24
8620,경기,구리시,5,0,1,6,4,0,2019-05-24
8621,경기,구리시,6,1,2,9,5,0,2019-06-24
8622,경기,구리시,2,1,0,3,2,0,2019-07-24
8623,경기,구리시,4,0,0,4,2,0,2019-08-24
8624,경기,구리시,0,0,0,0,0,0,2019-09-24
8625,경기,구리시,4,1,1,6,4,0,2019-10-24
8626,경기,구리시,5,0,0,5,3,0,2019-11-24
8627,경기,구리시,4,0,0,4,4,0,2019-12-24
8628,경기,군포시,1,0,0,1,1,0,2019-01-24
8629,경기,군포시,1,0,0,1,1,0,2019-02-24
8630,경기,군포시,0,0,0,0,0,0,2019-03-24
8631,경기,군포시,4,1,1,6,3,0,2019-04-24
8632,경기,군포시,1,0,1,2,2,0,2019-05-24
8633,경기,군포시,2,0,0,2,2,0,2019-06-24
8634,경기,군포시,1,0,0,1,1,0,2019-07-24
8635,경기,군포시,1,0,0,1,1,0,2019-08-24
8636,경기,군포시,0,1,0,1,1,0,2019-09-24
8637,경기,군포시,4,0,2,6,5,0,2019-10-24
8638,경기,군포시,10,0,1,11,5,0,2019-11-24
8639,경기,군포시,0,0,2,2,2,0,2019-12-24
8640,경기,김포시,2,0,4,6,4,0,2019-01-24
8641,경기,김포시,2,0,2,4,4,0,2019-02-24
8642,경기,김포시,9,0,3,12,5,0,2019-03-24
8643,경기,김포시,7,0,1,8,8,0,2019-04-24
8644,경기,김포시,8,1,4,13,6,0,2019-05-24
8645,경기,김포시,12,0,1,13,8,0,2019-06-24
8646,경기,김포시,3,1,1,5,4,0,2019-07-24
8647,경기,김포시,10,0,2,12,8,0,2019-08-24
8648,경기,김포시,8,1,2,11,9,0,2019-09-24
8649,경기,김포시,5,0,2,7,4,0,2019-10-24
8650,경기,김포시,5,0,1,6,4,0,2019-11-24
8651,경기,김포시,6,0,1,7,3,0,2019-12-24
8652,경기,남양주시,8,0,1,9,4,0,2019-01-24
8653,경기,남양주시,5,3,1,9,4,0,2019-02-24
8654,경기,남양주시,13,0,3,16,9,0,2019-03-24
8655,경기,남양주시,1,0,3,4,4,0,2019-04-24
8656,경기,남양주시,8,1,5,14,10,2,2019-05-24
8657,경기,남양주시,19,2,4,25,11,0,2019-06-24
8658,경기,남양주시,9,2,1,12,9,0,2019-07-24
8659,경기,남양주시,8,0,2,10,8,0,2019-08-24
8660,경기,남양주시,12,2,3,17,12,0,2019-09-24
8661,경기,남양주시,20,1,5,26,12,0,2019-10-24
8662,경기,남양주시,12,0,2,14,5,0,2019-11-24
8663,경기,남양주시,11,2,3,16,10,0,2019-12-24
8664,경기,동두천시,2,0,3,5,4,0,2019-01-24
8665,경기,동두천시,1,0,0,1,1,0,2019-02-24
8666,경기,동두천시,1,0,1,2,1,0,2019-03-24
8667,경기,동두천시,0,0,0,0,0,0,2019-04-24
8668,경기,동두천시,3,0,0,3,2,0,2019-05-24
8669,경기,동두천시,0,0,0,0,0,0,2019-06-24
8670,경기,동두천시,7,0,1,8,4,0,2019-07-24
8671,경기,동두천시,0,0,0,0,0,0,2019-08-24
8672,경기,동두천시,3,0,0,3,3,0,2019-09-24
8673,경기,동두천시,3,1,1,5,4,0,2019-10-24
8674,경기,동두천시,0,0,0,0,0,0,2019-11-24
8675,경기,동두천시,0,0,0,0,0,0,2019-12-24
8676,경기,부천시,9,0,4,13,13,0,2019-01-24
8677,경기,부천시,13,1,3,17,13,0,2019-02-24
8678,경기,부천시,8,0,2,10,6,0,2019-03-24
8679,경기,부천시,15,0,3,18,11,0,2019-04-24
8680,경기,부천시,18,0,5,23,13,0,2019-05-24
8681,경기,부천시,18,2,5,25,14,0,2019-06-24
8682,경기,부천시,9,0,1,10,6,0,2019-07-24
8683,경기,부천시,11,0,5,16,11,0,2019-08-24
8684,경기,부천시,19,1,7,27,18,0,2019-09-24
8685,경기,부천시,12,1,1,14,11,0,2019-10-24
8686,경기,부천시,10,1,1,12,9,0,2019-11-24
8687,경기,부천시,17,3,1,21,12,0,2019-12-24
8688,경기,성남시,11,0,1,12,12,1,2019-01-24
8689,경기,성남시,6,0,1,7,7,0,2019-02-24
8690,경기,성남시,12,2,0,14,7,0,2019-03-24
8691,경기,성남시,11,1,4,16,11,0,2019-04-24
8692,경기,성남시,12,0,2,14,10,0,2019-05-24
8693,경기,성남시,7,0,1,8,6,0,2019-06-24
8694,경기,성남시,13,2,2,17,11,0,2019-07-24
8695,경기,성남시,17,1,2,20,8,0,2019-08-24
8696,경기,성남시,10,6,4,20,10,0,2019-09-24
8697,경기,성남시,9,1,1,11,10,0,2019-10-24
8698,경기,성남시,24,1,4,29,12,0,2019-11-24
8699,경기,성남시,10,1,1,12,8,0,2019-12-24
8700,경기,수원시,19,4,3,26,19,0,2019-01-24
8701,경기,수원시,12,0,2,14,8,0,2019-02-24
8702,경기,수원시,15,3,2,20,11,0,2019-03-24
8703,경기,수원시,14,2,5,21,16,0,2019-04-24
8704,경기,수원시,18,5,4,27,22,0,2019-05-24
8705,경기,수원시,24,4,4,32,19,0,2019-06-24
8706,경기,수원시,11,1,1,13,10,0,2019-07-24
8707,경기,수원시,14,0,3,17,14,1,2019-08-24
8708,경기,수원시,21,2,3,26,18,0,2019-09-24
8709,경기,수원시,13,1,4,18,17,0,2019-10-24
8710,경기,수원시,4,3,2,9,8,0,2019-11-24
8711,경기,수원시,10,4,1,15,11,0,2019-12-24
8712,경기,시흥시,6,0,2,8,5,0,2019-01-24
8713,경기,시흥시,8,0,2,10,4,0,2019-02-24
8714,경기,시흥시,7,0,2,9,4,0,2019-03-24
8715,경기,시흥시,5,1,8,14,7,0,2019-04-24
8716,경기,시흥시,6,2,1,9,7,0,2019-05-24
8717,경기,시흥시,15,1,2,18,10,0,2019-06-24
8718,경기,시흥시,3,0,2,5,5,0,2019-07-24
8719,경기,시흥시,1,0,3,4,2,0,2019-08-24
8720,경기,시흥시,3,1,5,9,5,0,2019-09-24
8721,경기,시흥시,10,3,1,14,6,0,2019-10-24
8722,경기,시흥시,5,1,6,12,8,0,2019-11-24
8723,경기,시흥시,4,0,4,8,8,0,2019-12-24
8724,경기,안산시,9,1,1,11,6,0,2019-01-24
8725,경기,안산시,6,0,5,11,5,0,2019-02-24
8726,경기,안산시,20,0,4,24,17,0,2019-03-24
8727,경기,안산시,11,1,6,18,15,0,2019-04-24
8728,경기,안산시,14,1,7,22,16,1,2019-05-24
8729,경기,안산시,15,1,1,17,12,0,2019-06-24
8730,경기,안산시,2,1,2,5,5,0,2019-07-24
8731,경기,안산시,19,1,1,21,14,0,2019-08-24
8732,경기,안산시,14,0,2,16,12,0,2019-09-24
8733,경기,안산시,19,3,8,30,16,0,2019-10-24
8734,경기,안산시,13,1,3,17,12,0,2019-11-24
8735,경기,안산시,22,0,7,29,21,0,2019-12-24
8736,경기,안성시,8,1,1,10,4,0,2019-01-24
8737,경기,안성시,2,0,1,3,2,0,2019-02-24
8738,경기,안성시,1,0,2,3,1,0,2019-03-24
8739,경기,안성시,1,0,1,2,2,0,2019-04-24
8740,경기,안성시,10,4,0,14,4,0,2019-05-24
8741,경기,안성시,1,0,1,2,2,0,2019-06-24
8742,경기,안성시,5,0,0,5,3,0,2019-07-24
8743,경기,안성시,4,1,2,7,4,0,2019-08-24
8744,경기,안성시,1,0,1,2,1,0,2019-09-24
8745,경기,안성시,14,0,2,16,5,0,2019-10-24
8746,경기,안성시,5,2,0,7,3,0,2019-11-24
8747,경기,안성시,1,2,1,4,2,0,2019-12-24
8748,경기,안양시,0,0,1,1,1,0,2019-01-24
8749,경기,안양시,4,0,0,4,3,0,2019-02-24
8750,경기,안양시,1,0,2,3,1,0,2019-03-24
8751,경기,안양시,3,0,2,5,4,0,2019-04-24
8752,경기,안양시,6,0,3,9,4,0,2019-05-24
8753,경기,안양시,4,1,3,8,6,0,2019-06-24
8754,경기,안양시,8,0,2,10,6,0,2019-07-24
8755,경기,안양시,1,0,1,2,1,0,2019-08-24
8756,경기,안양시,3,0,2,5,5,0,2019-09-24
8757,경기,안양시,8,0,1,9,6,0,2019-10-24
8758,경기,안양시,4,3,3,10,5,0,2019-11-24
8759,경기,안양시,2,0,2,4,3,0,2019-12-24
8760,경기,양주시,8,0,0,8,6,0,2019-01-24
8761,경기,양주시,1,0,0,1,1,0,2019-02-24
8762,경기,양주시,1,0,0,1,1,0,2019-03-24
8763,경기,양주시,2,0,1,3,3,0,2019-04-24
8764,경기,양주시,3,0,0,3,2,0,2019-05-24
8765,경기,양주시,8,0,0,8,4,0,2019-06-24
8766,경기,양주시,2,0,1,3,3,0,2019-07-24
8767,경기,양주시,4,0,0,4,4,0,2019-08-24
8768,경기,양주시,0,0,4,4,3,0,2019-09-24
8769,경기,양주시,7,1,0,8,5,0,2019-10-24
8770,경기,양주시,0,1,1,2,2,0,2019-11-24
8771,경기,양주시,2,0,2,4,3,0,2019-12-24
8772,경기,양평군,0,0,0,0,0,0,2019-01-24
8773,경기,양평군,3,0,0,3,1,0,2019-02-24
8774,경기,양평군,5,0,0,5,2,0,2019-03-24
8775,경기,양평군,2,0,1,3,2,0,2019-04-24
8776,경기,양평군,1,0,0,1,1,0,2019-05-24
8777,경기,양평군,1,1,2,4,3,0,2019-06-24
8778,경기,양평군,2,0,4,6,2,0,2019-07-24
8779,경기,양평군,1,1,0,2,2,0,2019-08-24
8780,경기,양평군,0,0,2,2,2,0,2019-09-24
8781,경기,양평군,2,0,0,2,2,0,2019-10-24
8782,경기,양평군,0,1,1,2,2,0,2019-11-24
8783,경기,양평군,2,1,1,4,1,0,2019-12-24
8784,경기,여주시,0,0,2,2,1,0,2019-01-24
8785,경기,여주시,1,0,0,1,1,0,2019-02-24
8786,경기,여주시,0,0,0,0,0,0,2019-03-24
8787,경기,여주시,2,1,0,3,1,0,2019-04-24
8788,경기,여주시,2,0,0,2,2,0,2019-05-24
8789,경기,여주시,1,0,0,1,1,0,2019-06-24
8790,경기,여주시,0,1,0,1,1,0,2019-07-24
8791,경기,여주시,0,0,0,0,0,0,2019-08-24
8792,경기,여주시,1,0,1,2,2,0,2019-09-24
8793,경기,여주시,1,0,0,1,1,0,2019-10-24
8794,경기,여주시,0,0,0,0,0,0,2019-11-24
8795,경기,여주시,2,0,1,3,3,0,2019-12-24
8796,경기,연천군,0,0,0,0,0,0,2019-01-24
8797,경기,연천군,0,0,1,1,1,0,2019-02-24
8798,경기,연천군,0,0,0,0,0,0,2019-03-24
8799,경기,연천군,0,0,0,0,0,0,2019-04-24
8800,경기,연천군,0,0,0,0,0,0,2019-05-24
8801,경기,연천군,1,0,0,1,1,0,2019-06-24
8802,경기,연천군,1,2,0,3,1,0,2019-07-24
8803,경기,연천군,0,0,0,0,0,0,2019-08-24
8804,경기,연천군,1,0,0,1,1,0,2019-09-24
8805,경기,연천군,0,0,0,0,0,0,2019-10-24
8806,경기,연천군,0,0,0,0,0,0,2019-11-24
8807,경기,연천군,1,1,0,2,2,0,2019-12-24
8808,경기,오산시,1,0,2,3,2,0,2019-01-24
8809,경기,오산시,2,0,0,2,2,0,2019-02-24
8810,경기,오산시,3,0,0,3,3,0,2019-03-24
8811,경기,오산시,3,1,1,5,5,0,2019-04-24
8812,경기,오산시,6,0,0,6,4,0,2019-05-24
8813,경기,오산시,4,0,0,4,2,0,2019-06-24
8814,경기,오산시,4,0,1,5,3,0,2019-07-24
8815,경기,오산시,2,1,0,3,3,0,2019-08-24
8816,경기,오산시,0,1,0,1,1,0,2019-09-24
8817,경기,오산시,7,1,0,8,8,0,2019-10-24
8818,경기,오산시,1,0,1,2,2,0,2019-11-24
8819,경기,오산시,12,9,4,25,6,0,2019-12-24
8820,경기,용인시,8,1,0,9,6,0,2019-01-24
8821,경기,용인시,4,1,1,6,4,0,2019-02-24
8822,경기,용인시,4,0,2,6,5,0,2019-03-24
8823,경기,용인시,10,1,1,12,9,0,2019-04-24
8824,경기,용인시,9,1,2,12,9,0,2019-05-24
8825,경기,용인시,15,0,3,18,11,0,2019-06-24
8826,경기,용인시,10,0,0,10,7,0,2019-07-24
8827,경기,용인시,14,0,5,19,10,0,2019-08-24
8828,경기,용인시,12,2,3,17,10,0,2019-09-24
8829,경기,용인시,21,1,4,26,16,1,2019-10-24
8830,경기,용인시,1,0,2,3,3,0,2019-11-24
8831,경기,용인시,21,6,6,33,15,0,2019-12-24
8832,경기,의왕시,2,0,2,4,3,0,2019-01-24
8833,경기,의왕시,0,0,0,0,0,0,2019-02-24
8834,경기,의왕시,1,0,2,3,3,0,2019-03-24
8835,경기,의왕시,2,0,0,2,1,0,2019-04-24
8836,경기,의왕시,0,1,0,1,1,0,2019-05-24
8837,경기,의왕시,0,0,1,1,2,1,2019-06-24
8838,경기,의왕시,0,0,0,0,0,0,2019-07-24
8839,경기,의왕시,0,1,0,1,1,0,2019-08-24
8840,경기,의왕시,0,1,0,1,1,0,2019-09-24
8841,경기,의왕시,4,0,1,5,4,0,2019-10-24
8842,경기,의왕시,2,0,0,2,2,0,2019-11-24
8843,경기,의왕시,1,0,0,1,1,0,2019-12-24
8844,경기,의정부시,6,1,2,9,5,0,2019-01-24
8845,경기,의정부시,13,0,1,14,5,0,2019-02-24
8846,경기,의정부시,8,0,1,9,5,0,2019-03-24
8847,경기,의정부시,6,0,1,7,6,0,2019-04-24
8848,경기,의정부시,6,0,2,8,5,0,2019-05-24
8849,경기,의정부시,4,2,4,10,7,0,2019-06-24
8850,경기,의정부시,3,0,3,6,3,0,2019-07-24
8851,경기,의정부시,4,1,0,5,4,0,2019-08-24
8852,경기,의정부시,4,0,2,6,5,0,2019-09-24
8853,경기,의정부시,1,0,2,3,3,0,2019-10-24
8854,경기,의정부시,6,1,0,7,3,0,2019-11-24
8855,경기,의정부시,5,2,0,7,6,0,2019-12-24
8856,경기,이천시,6,0,2,8,6,0,2019-01-24
8857,경기,이천시,2,0,2,4,4,0,2019-02-24
8858,경기,이천시,5,0,0,5,1,0,2019-03-24
8859,경기,이천시,5,2,3,10,4,0,2019-04-24
8860,경기,이천시,6,1,0,7,4,0,2019-05-24
8861,경기,이천시,3,0,1,4,4,0,2019-06-24
8862,경기,이천시,0,3,1,4,3,0,2019-07-24
8863,경기,이천시,3,0,1,4,3,0,2019-08-24
8864,경기,이천시,3,0,0,3,3,0,2019-09-24
8865,경기,이천시,6,0,3,9,6,0,2019-10-24
8866,경기,이천시,10,0,1,11,6,0,2019-11-24
8867,경기,이천시,2,0,0,2,2,0,2019-12-24
8868,경기,파주시,3,0,4,7,4,0,2019-01-24
8869,경기,파주시,9,1,4,14,7,0,2019-02-24
8870,경기,파주시,11,1,3,15,5,0,2019-03-24
8871,경기,파주시,4,0,2,6,5,0,2019-04-24
8872,경기,파주시,3,0,1,4,3,0,2019-05-24
8873,경기,파주시,5,0,3,8,7,0,2019-06-24
8874,경기,파주시,6,0,4,10,8,0,2019-07-24
8875,경기,파주시,9,0,0,9,5,0,2019-08-24
8876,경기,파주시,4,0,2,6,5,0,2019-09-24
8877,경기,파주시,9,0,6,15,8,0,2019-10-24
8878,경기,파주시,2,0,1,3,3,0,2019-11-24
8879,경기,파주시,7,0,3,10,10,0,2019-12-24
8880,경기,평택시,0,1,0,1,1,0,2019-01-24
8881,경기,평택시,11,0,2,13,4,0,2019-02-24
8882,경기,평택시,9,2,2,13,7,0,2019-03-24
8883,경기,평택시,11,0,6,17,12,0,2019-04-24
8884,경기,평택시,5,2,3,10,10,0,2019-05-24
8885,경기,평택시,11,4,3,18,13,0,2019-06-24
8886,경기,평택시,11,0,0,11,8,0,2019-07-24
8887,경기,평택시,7,5,1,13,9,0,2019-08-24
8888,경기,평택시,15,2,7,24,16,1,2019-09-24
8889,경기,평택시,8,0,5,13,11,0,2019-10-24
8890,경기,평택시,23,9,5,37,9,0,2019-11-24
8891,경기,평택시,19,3,3,25,13,0,2019-12-24
8892,경기,포천시,0,1,0,1,1,0,2019-01-24
8893,경기,포천시,0,0,0,0,0,0,2019-02-24
8894,경기,포천시,1,0,1,2,2,0,2019-03-24
8895,경기,포천시,4,1,0,5,3,0,2019-04-24
8896,경기,포천시,2,0,0,2,1,0,2019-05-24
8897,경기,포천시,5,0,1,6,4,0,2019-06-24
8898,경기,포천시,3,1,3,7,4,1,2019-07-24
8899,경기,포천시,0,1,0,1,1,0,2019-08-24
8900,경기,포천시,1,0,1,2,2,0,2019-09-24
8901,경기,포천시,6,0,0,6,6,0,2019-10-24
8902,경기,포천시,4,0,4,8,3,0,2019-11-24
8903,경기,포천시,2,1,1,4,4,0,2019-12-24
8904,경기,하남시,1,0,0,1,1,0,2019-01-24
8905,경기,하남시,1,0,1,2,2,0,2019-02-24
8906,경기,하남시,0,1,0,1,1,0,2019-03-24
8907,경기,하남시,3,0,2,5,5,0,2019-04-24
8908,경기,하남시,1,3,1,5,3,0,2019-05-24
8909,경기,하남시,2,0,0,2,2,0,2019-06-24
8910,경기,하남시,7,1,0,8,4,0,2019-07-24
8911,경기,하남시,1,1,2,4,3,0,2019-08-24
8912,경기,하남시,5,0,0,5,2,0,2019-09-24
8913,경기,하남시,2,0,2,4,3,0,2019-10-24
8914,경기,하남시,2,0,1,3,3,0,2019-11-24
8915,경기,하남시,2,1,2,5,3,0,2019-12-24
8916,경기,화성시,7,0,2,9,6,0,2019-01-24
8917,경기,화성시,7,1,3,11,7,0,2019-02-24
8918,경기,화성시,5,0,1,6,3,0,2019-03-24
8919,경기,화성시,11,0,1,12,8,0,2019-04-24
8920,경기,화성시,3,1,2,6,6,0,2019-05-24
8921,경기,화성시,13,2,7,22,12,0,2019-06-24
8922,경기,화성시,10,1,0,11,6,1,2019-07-24
8923,경기,화성시,1,0,1,2,2,0,2019-08-24
8924,경기,화성시,16,0,3,19,7,0,2019-09-24
8925,경기,화성시,6,0,3,9,7,0,2019-10-24
8926,경기,화성시,14,2,0,16,12,1,2019-11-24
8927,경기,화성시,21,0,2,23,18,0,2019-12-24
8928,경기,가평군,0,0,0,0,0,0,2019-01-25
8929,경기,가평군,0,0,0,0,0,0,2019-02-25
8930,경기,가평군,1,0,0,1,1,0,2019-03-25
8931,경기,가평군,0,0,0,0,0,0,2019-04-25
8932,경기,가평군,1,0,2,3,2,0,2019-05-25
8933,경기,가평군,3,1,0,4,2,0,2019-06-25
8934,경기,가평군,0,0,0,0,0,0,2019-07-25
8935,경기,가평군,4,0,0,4,2,0,2019-08-25
8936,경기,가평군,0,0,0,0,0,0,2019-09-25
8937,경기,가평군,1,0,1,2,1,0,2019-10-25
8938,경기,가평군,0,0,0,0,0,0,2019-11-25
8939,경기,가평군,0,0,0,0,0,0,2019-12-25
8940,경기,고양시,3,0,4,7,4,0,2019-01-25
8941,경기,고양시,6,2,2,10,8,0,2019-02-25
8942,경기,고양시,14,0,4,18,7,0,2019-03-25
8943,경기,고양시,35,1,5,41,22,0,2019-04-25
8944,경기,고양시,12,3,4,19,10,0,2019-05-25
8945,경기,고양시,27,4,9,40,17,0,2019-06-25
8946,경기,고양시,10,4,3,17,10,0,2019-07-25
8947,경기,고양시,21,2,6,29,13,0,2019-08-25
8948,경기,고양시,7,1,1,9,9,1,2019-09-25
8949,경기,고양시,20,3,2,25,14,0,2019-10-25
8950,경기,고양시,11,0,1,12,8,0,2019-11-25
8951,경기,고양시,6,1,1,8,6,0,2019-12-25
8952,경기,과천시,0,0,0,0,0,0,2019-01-25
8953,경기,과천시,2,0,0,2,1,0,2019-02-25
8954,경기,과천시,0,0,0,0,0,0,2019-03-25
8955,경기,과천시,0,0,0,0,0,0,2019-04-25
8956,경기,과천시,0,0,0,0,0,0,2019-05-25
8957,경기,과천시,0,0,0,0,0,0,2019-06-25
8958,경기,과천시,1,0,0,1,1,0,2019-07-25
8959,경기,과천시,4,0,0,4,1,0,2019-08-25
8960,경기,과천시,0,0,0,0,0,0,2019-09-25
8961,경기,과천시,0,0,0,0,0,0,2019-10-25
8962,경기,과천시,0,0,0,0,0,0,2019-11-25
8963,경기,과천시,0,0,0,0,0,0,2019-12-25
8964,경기,광명시,3,0,0,3,3,0,2019-01-25
8965,경기,광명시,1,0,0,1,1,0,2019-02-25
8966,경기,광명시,4,1,1,6,6,0,2019-03-25
8967,경기,광명시,3,0,2,5,5,0,2019-04-25
8968,경기,광명시,4,0,1,5,4,0,2019-05-25
8969,경기,광명시,2,0,2,4,3,0,2019-06-25
8970,경기,광명시,1,0,0,1,1,0,2019-07-25
8971,경기,광명시,1,11,0,12,2,0,2019-08-25
8972,경기,광명시,3,0,0,3,3,0,2019-09-25
8973,경기,광명시,13,4,0,17,4,0,2019-10-25
8974,경기,광명시,5,1,0,6,4,0,2019-11-25
8975,경기,광명시,2,0,0,2,2,0,2019-12-25
8976,경기,광주시,4,0,0,4,4,0,2019-01-25
8977,경기,광주시,8,0,0,8,7,0,2019-02-25
8978,경기,광주시,4,0,0,4,2,0,2019-03-25
8979,경기,광주시,0,0,1,1,1,0,2019-04-25
8980,경기,광주시,4,0,1,5,4,0,2019-05-25
8981,경기,광주시,8,0,0,8,5,0,2019-06-25
8982,경기,광주시,1,0,0,1,1,0,2019-07-25
8983,경기,광주시,0,0,1,1,1,0,2019-08-25
8984,경기,광주시,5,0,1,6,6,1,2019-09-25
8985,경기,광주시,2,0,1,3,3,0,2019-10-25
8986,경기,광주시,4,0,1,5,2,0,2019-11-25
8987,경기,광주시,4,0,0,4,3,0,2019-12-25
8988,경기,구리시,1,0,0,1,1,0,2019-01-25
8989,경기,구리시,2,0,0,2,2,0,2019-02-25
8990,경기,구리시,2,0,0,2,2,0,2019-03-25
8991,경기,구리시,5,1,0,6,2,0,2019-04-25
8992,경기,구리시,0,0,0,0,0,0,2019-05-25
8993,경기,구리시,3,0,0,3,2,0,2019-06-25
8994,경기,구리시,2,0,0,2,1,0,2019-07-25
8995,경기,구리시,1,0,0,1,1,0,2019-08-25
8996,경기,구리시,1,0,0,1,1,0,2019-09-25
8997,경기,구리시,3,0,0,3,2,0,2019-10-25
8998,경기,구리시,3,0,0,3,3,0,2019-11-25
8999,경기,구리시,0,0,0,0,0,0,2019-12-25
9000,경기,군포시,2,0,2,4,4,0,2019-01-25
9001,경기,군포시,3,0,1,4,3,0,2019-02-25
9002,경기,군포시,0,0,0,0,0,0,2019-03-25
9003,경기,군포시,0,1,1,2,2,0,2019-04-25
9004,경기,군포시,1,0,2,3,2,0,2019-05-25
9005,경기,군포시,2,0,0,2,2,0,2019-06-25
9006,경기,군포시,0,0,1,1,1,0,2019-07-25
9007,경기,군포시,1,0,0,1,1,0,2019-08-25
9008,경기,군포시,3,0,0,3,3,0,2019-09-25
9009,경기,군포시,0,0,0,0,0,0,2019-10-25
9010,경기,군포시,1,0,1,2,2,0,2019-11-25
9011,경기,군포시,0,0,0,0,0,0,2019-12-25
9012,경기,김포시,1,1,5,7,6,0,2019-01-25
9013,경기,김포시,17,1,5,23,4,0,2019-02-25
9014,경기,김포시,5,0,3,8,4,0,2019-03-25
9015,경기,김포시,3,0,3,6,5,0,2019-04-25
9016,경기,김포시,6,0,0,6,5,0,2019-05-25
9017,경기,김포시,5,0,1,6,5,0,2019-06-25
9018,경기,김포시,4,1,0,5,3,0,2019-07-25
9019,경기,김포시,1,1,0,2,2,0,2019-08-25
9020,경기,김포시,8,0,0,8,6,0,2019-09-25
9021,경기,김포시,6,0,7,13,10,0,2019-10-25
9022,경기,김포시,10,1,2,13,8,1,2019-11-25
9023,경기,김포시,0,0,0,0,0,0,2019-12-25
9024,경기,남양주시,4,3,1,8,7,0,2019-01-25
9025,경기,남양주시,5,0,4,9,5,1,2019-02-25
9026,경기,남양주시,10,1,2,13,8,0,2019-03-25
9027,경기,남양주시,6,2,1,9,6,0,2019-04-25
9028,경기,남양주시,11,2,1,14,9,0,2019-05-25
9029,경기,남양주시,11,1,1,13,9,0,2019-06-25
9030,경기,남양주시,6,1,4,11,9,0,2019-07-25
9031,경기,남양주시,9,0,2,11,7,0,2019-08-25
9032,경기,남양주시,2,0,0,2,2,0,2019-09-25
9033,경기,남양주시,14,0,5,19,14,0,2019-10-25
9034,경기,남양주시,8,1,4,13,8,0,2019-11-25
9035,경기,남양주시,2,4,3,9,3,0,2019-12-25
9036,경기,동두천시,2,0,2,4,4,0,2019-01-25
9037,경기,동두천시,1,0,1,2,2,0,2019-02-25
9038,경기,동두천시,0,0,1,1,1,0,2019-03-25
9039,경기,동두천시,1,1,0,2,2,0,2019-04-25
9040,경기,동두천시,1,0,0,1,1,0,2019-05-25
9041,경기,동두천시,6,0,0,6,2,0,2019-06-25
9042,경기,동두천시,0,1,0,1,1,0,2019-07-25
9043,경기,동두천시,0,0,0,0,0,0,2019-08-25
9044,경기,동두천시,0,0,0,0,0,0,2019-09-25
9045,경기,동두천시,5,1,0,6,6,0,2019-10-25
9046,경기,동두천시,0,0,0,0,0,0,2019-11-25
9047,경기,동두천시,0,0,0,0,0,0,2019-12-25
9048,경기,부천시,14,0,2,16,14,0,2019-01-25
9049,경기,부천시,8,1,4,13,10,0,2019-02-25
9050,경기,부천시,14,1,2,17,11,0,2019-03-25
9051,경기,부천시,14,2,5,21,14,0,2019-04-25
9052,경기,부천시,19,2,0,21,16,1,2019-05-25
9053,경기,부천시,16,0,2,18,12,0,2019-06-25
9054,경기,부천시,9,1,0,10,9,0,2019-07-25
9055,경기,부천시,2,0,3,5,5,0,2019-08-25
9056,경기,부천시,9,0,2,11,10,0,2019-09-25
9057,경기,부천시,2,1,1,4,5,1,2019-10-25
9058,경기,부천시,30,0,7,37,17,0,2019-11-25
9059,경기,부천시,8,1,3,12,8,0,2019-12-25
9060,경기,성남시,16,2,5,23,13,0,2019-01-25
9061,경기,성남시,10,3,3,16,13,0,2019-02-25
9062,경기,성남시,8,5,3,16,9,0,2019-03-25
9063,경기,성남시,12,1,5,18,13,0,2019-04-25
9064,경기,성남시,13,2,3,18,14,0,2019-05-25
9065,경기,성남시,8,1,7,16,9,0,2019-06-25
9066,경기,성남시,9,0,5,14,12,0,2019-07-25
9067,경기,성남시,4,1,3,8,8,0,2019-08-25
9068,경기,성남시,6,0,1,7,6,0,2019-09-25
9069,경기,성남시,17,1,4,22,17,0,2019-10-25
9070,경기,성남시,8,3,2,13,10,0,2019-11-25
9071,경기,성남시,12,2,1,15,10,0,2019-12-25
9072,경기,수원시,11,0,3,14,13,0,2019-01-25
9073,경기,수원시,17,2,6,25,17,0,2019-02-25
9074,경기,수원시,12,0,4,16,14,0,2019-03-25
9075,경기,수원시,18,1,6,25,19,1,2019-04-25
9076,경기,수원시,5,3,3,11,10,0,2019-05-25
9077,경기,수원시,7,5,2,14,10,0,2019-06-25
9078,경기,수원시,22,3,5,30,18,0,2019-07-25
9079,경기,수원시,14,1,4,19,11,0,2019-08-25
9080,경기,수원시,12,7,5,24,16,0,2019-09-25
9081,경기,수원시,23,3,6,32,19,1,2019-10-25
9082,경기,수원시,18,2,2,22,13,0,2019-11-25
9083,경기,수원시,8,1,4,13,11,0,2019-12-25
9084,경기,시흥시,12,2,5,19,11,0,2019-01-25
9085,경기,시흥시,16,1,2,19,9,0,2019-02-25
9086,경기,시흥시,1,0,1,2,2,0,2019-03-25
9087,경기,시흥시,6,0,2,8,6,0,2019-04-25
9088,경기,시흥시,5,1,2,8,6,0,2019-05-25
9089,경기,시흥시,3,1,3,7,6,0,2019-06-25
9090,경기,시흥시,9,0,3,12,5,2,2019-07-25
9091,경기,시흥시,4,0,3,7,6,0,2019-08-25
9092,경기,시흥시,8,0,3,11,7,0,2019-09-25
9093,경기,시흥시,11,0,5,16,13,0,2019-10-25
9094,경기,시흥시,4,1,3,8,6,0,2019-11-25
9095,경기,시흥시,6,0,2,8,4,0,2019-12-25
9096,경기,안산시,16,1,3,20,13,0,2019-01-25
9097,경기,안산시,15,2,2,19,13,0,2019-02-25
9098,경기,안산시,9,0,0,9,8,0,2019-03-25
9099,경기,안산시,9,1,5,15,9,0,2019-04-25
9100,경기,안산시,7,2,3,12,8,0,2019-05-25
9101,경기,안산시,14,0,4,18,12,0,2019-06-25
9102,경기,안산시,10,3,3,16,13,0,2019-07-25
9103,경기,안산시,10,2,4,16,10,0,2019-08-25
9104,경기,안산시,10,0,4,14,12,0,2019-09-25
9105,경기,안산시,16,1,2,19,14,0,2019-10-25
9106,경기,안산시,16,1,7,24,12,0,2019-11-25
9107,경기,안산시,10,0,0,10,5,0,2019-12-25
9108,경기,안성시,0,0,0,0,0,0,2019-01-25
9109,경기,안성시,6,0,2,8,5,0,2019-02-25
9110,경기,안성시,5,0,3,8,6,0,2019-03-25
9111,경기,안성시,4,0,0,4,3,0,2019-04-25
9112,경기,안성시,2,0,3,5,3,0,2019-05-25
9113,경기,안성시,3,2,4,9,5,0,2019-06-25
9114,경기,안성시,8,0,0,8,5,0,2019-07-25
9115,경기,안성시,8,0,3,11,3,0,2019-08-25
9116,경기,안성시,3,1,0,4,4,0,2019-09-25
9117,경기,안성시,7,1,0,8,4,0,2019-10-25
9118,경기,안성시,3,0,1,4,4,0,2019-11-25
9119,경기,안성시,0,0,0,0,0,0,2019-12-25
9120,경기,안양시,12,0,3,15,7,0,2019-01-25
9121,경기,안양시,5,1,3,9,7,0,2019-02-25
9122,경기,안양시,3,1,0,4,3,0,2019-03-25
9123,경기,안양시,6,0,0,6,4,0,2019-04-25
9124,경기,안양시,3,1,7,11,4,0,2019-05-25
9125,경기,안양시,1,0,1,2,2,0,2019-06-25
9126,경기,안양시,1,0,0,1,1,0,2019-07-25
9127,경기,안양시,8,0,0,8,4,0,2019-08-25
9128,경기,안양시,8,2,4,14,8,0,2019-09-25
9129,경기,안양시,4,0,4,8,6,0,2019-10-25
9130,경기,안양시,5,1,1,7,5,0,2019-11-25
9131,경기,안양시,1,0,0,1,1,0,2019-12-25
9132,경기,양주시,2,0,0,2,2,0,2019-01-25
9133,경기,양주시,0,0,0,0,0,0,2019-02-25
9134,경기,양주시,1,1,2,4,3,0,2019-03-25
9135,경기,양주시,8,1,1,10,5,0,2019-04-25
9136,경기,양주시,2,0,0,2,2,0,2019-05-25
9137,경기,양주시,5,2,0,7,4,0,2019-06-25
9138,경기,양주시,2,0,2,4,4,0,2019-07-25
9139,경기,양주시,2,1,1,4,3,0,2019-08-25
9140,경기,양주시,4,0,2,6,5,0,2019-09-25
9141,경기,양주시,9,1,1,11,8,0,2019-10-25
9142,경기,양주시,6,1,0,7,5,0,2019-11-25
9143,경기,양주시,1,0,1,2,2,0,2019-12-25
9144,경기,양평군,1,0,1,2,2,0,2019-01-25
9145,경기,양평군,2,0,0,2,1,0,2019-02-25
9146,경기,양평군,0,0,0,0,0,0,2019-03-25
9147,경기,양평군,3,0,4,7,5,0,2019-04-25
9148,경기,양평군,0,0,2,2,1,0,2019-05-25
9149,경기,양평군,3,0,0,3,2,0,2019-06-25
9150,경기,양평군,5,0,1,6,1,0,2019-07-25
9151,경기,양평군,7,3,3,13,7,0,2019-08-25
9152,경기,양평군,0,0,2,2,2,0,2019-09-25
9153,경기,양평군,0,1,0,1,1,0,2019-10-25
9154,경기,양평군,1,0,0,1,1,0,2019-11-25
9155,경기,양평군,0,0,0,0,0,0,2019-12-25
9156,경기,여주시,5,8,6,19,2,0,2019-01-25
9157,경기,여주시,0,0,0,0,0,0,2019-02-25
9158,경기,여주시,5,0,2,7,3,0,2019-03-25
9159,경기,여주시,1,0,0,1,1,0,2019-04-25
9160,경기,여주시,1,1,1,3,3,0,2019-05-25
9161,경기,여주시,0,1,0,1,1,0,2019-06-25
9162,경기,여주시,1,0,0,1,1,0,2019-07-25
9163,경기,여주시,1,0,1,2,2,0,2019-08-25
9164,경기,여주시,4,0,0,4,2,0,2019-09-25
9165,경기,여주시,1,0,0,1,1,0,2019-10-25
9166,경기,여주시,3,0,0,3,3,0,2019-11-25
9167,경기,여주시,0,0,0,0,0,0,2019-12-25
9168,경기,연천군,1,0,0,1,1,0,2019-01-25
9169,경기,연천군,0,0,0,0,0,0,2019-02-25
9170,경기,연천군,0,0,0,0,0,0,2019-03-25
9171,경기,연천군,0,0,0,0,0,0,2019-04-25
9172,경기,연천군,0,0,1,1,1,0,2019-05-25
9173,경기,연천군,0,0,0,0,0,0,2019-06-25
9174,경기,연천군,0,0,1,1,1,0,2019-07-25
9175,경기,연천군,0,1,2,3,2,0,2019-08-25
9176,경기,연천군,1,0,0,1,1,0,2019-09-25
9177,경기,연천군,0,0,0,0,0,0,2019-10-25
9178,경기,연천군,0,0,1,1,1,0,2019-11-25
9179,경기,연천군,2,0,2,4,1,0,2019-12-25
9180,경기,오산시,1,0,0,1,1,0,2019-01-25
9181,경기,오산시,0,0,2,2,2,0,2019-02-25
9182,경기,오산시,1,0,1,2,2,0,2019-03-25
9183,경기,오산시,0,0,1,1,1,0,2019-04-25
9184,경기,오산시,0,0,1,1,1,0,2019-05-25
9185,경기,오산시,3,0,1,4,3,0,2019-06-25
9186,경기,오산시,2,0,0,2,1,0,2019-07-25
9187,경기,오산시,0,0,1,1,1,0,2019-08-25
9188,경기,오산시,4,0,1,5,2,0,2019-09-25
9189,경기,오산시,5,1,0,6,5,0,2019-10-25
9190,경기,오산시,3,0,0,3,2,0,2019-11-25
9191,경기,오산시,0,0,0,0,0,0,2019-12-25
9192,경기,용인시,8,2,3,13,11,0,2019-01-25
9193,경기,용인시,7,2,4,13,10,0,2019-02-25
9194,경기,용인시,8,0,3,11,8,0,2019-03-25
9195,경기,용인시,25,1,3,29,18,0,2019-04-25
9196,경기,용인시,9,3,3,15,9,0,2019-05-25
9197,경기,용인시,12,3,6,21,9,0,2019-06-25
9198,경기,용인시,5,0,3,8,8,0,2019-07-25
9199,경기,용인시,24,3,3,30,10,0,2019-08-25
9200,경기,용인시,7,4,0,11,9,0,2019-09-25
9201,경기,용인시,21,0,3,24,12,0,2019-10-25
9202,경기,용인시,23,5,4,32,17,1,2019-11-25
9203,경기,용인시,12,4,1,17,7,0,2019-12-25
9204,경기,의왕시,3,0,0,3,1,0,2019-01-25
9205,경기,의왕시,0,0,0,0,0,0,2019-02-25
9206,경기,의왕시,1,0,0,1,1,0,2019-03-25
9207,경기,의왕시,4,1,2,7,6,0,2019-04-25
9208,경기,의왕시,0,0,0,0,1,1,2019-05-25
9209,경기,의왕시,5,0,1,6,3,0,2019-06-25
9210,경기,의왕시,0,0,0,0,0,0,2019-07-25
9211,경기,의왕시,0,0,0,0,0,0,2019-08-25
9212,경기,의왕시,9,4,7,20,3,1,2019-09-25
9213,경기,의왕시,3,2,2,7,4,0,2019-10-25
9214,경기,의왕시,4,0,0,4,3,0,2019-11-25
9215,경기,의왕시,0,0,0,0,0,0,2019-12-25
9216,경기,의정부시,3,0,0,3,2,0,2019-01-25
9217,경기,의정부시,4,1,3,8,6,0,2019-02-25
9218,경기,의정부시,6,0,1,7,7,0,2019-03-25
9219,경기,의정부시,1,0,4,5,4,0,2019-04-25
9220,경기,의정부시,6,2,1,9,6,0,2019-05-25
9221,경기,의정부시,3,1,1,5,5,0,2019-06-25
9222,경기,의정부시,5,1,1,7,4,0,2019-07-25
9223,경기,의정부시,2,2,0,4,4,0,2019-08-25
9224,경기,의정부시,7,0,0,7,5,0,2019-09-25
9225,경기,의정부시,5,2,2,9,6,0,2019-10-25
9226,경기,의정부시,9,0,2,11,7,0,2019-11-25
9227,경기,의정부시,0,3,0,3,1,0,2019-12-25
9228,경기,이천시,1,0,1,2,2,1,2019-01-25
9229,경기,이천시,1,0,0,1,1,0,2019-02-25
9230,경기,이천시,4,0,3,7,5,0,2019-03-25
9231,경기,이천시,1,1,1,3,3,0,2019-04-25
9232,경기,이천시,5,1,8,14,7,0,2019-05-25
9233,경기,이천시,4,0,3,7,5,0,2019-06-25
9234,경기,이천시,10,0,1,11,6,1,2019-07-25
9235,경기,이천시,1,1,0,2,2,0,2019-08-25
9236,경기,이천시,3,0,0,3,2,0,2019-09-25
9237,경기,이천시,4,0,1,5,4,0,2019-10-25
9238,경기,이천시,2,0,1,3,3,0,2019-11-25
9239,경기,이천시,1,0,1,2,2,1,2019-12-25
9240,경기,파주시,5,1,1,7,5,0,2019-01-25
9241,경기,파주시,5,0,3,8,7,1,2019-02-25
9242,경기,파주시,3,1,1,5,5,0,2019-03-25
9243,경기,파주시,3,1,2,6,6,0,2019-04-25
9244,경기,파주시,4,1,0,5,4,0,2019-05-25
9245,경기,파주시,9,0,0,9,6,0,2019-06-25
9246,경기,파주시,5,0,2,7,5,0,2019-07-25
9247,경기,파주시,3,0,2,5,4,0,2019-08-25
9248,경기,파주시,1,1,1,3,3,0,2019-09-25
9249,경기,파주시,5,1,3,9,7,0,2019-10-25
9250,경기,파주시,6,0,0,6,5,0,2019-11-25
9251,경기,파주시,7,0,0,7,6,0,2019-12-25
9252,경기,평택시,21,1,4,26,12,0,2019-01-25
9253,경기,평택시,5,2,0,7,4,0,2019-02-25
9254,경기,평택시,6,2,1,9,7,0,2019-03-25
9255,경기,평택시,10,4,0,14,8,0,2019-04-25
9256,경기,평택시,17,1,1,19,9,0,2019-05-25
9257,경기,평택시,19,2,5,26,11,0,2019-06-25
9258,경기,평택시,8,1,0,9,7,0,2019-07-25
9259,경기,평택시,16,1,1,18,10,0,2019-08-25
9260,경기,평택시,15,0,6,21,16,0,2019-09-25
9261,경기,평택시,13,1,9,23,15,0,2019-10-25
9262,경기,평택시,5,0,3,8,7,0,2019-11-25
9263,경기,평택시,10,0,1,11,7,0,2019-12-25
9264,경기,포천시,0,0,1,1,1,0,2019-01-25
9265,경기,포천시,4,0,1,5,4,0,2019-02-25
9266,경기,포천시,2,0,0,2,2,0,2019-03-25
9267,경기,포천시,2,0,0,2,2,0,2019-04-25
9268,경기,포천시,3,0,1,4,3,0,2019-05-25
9269,경기,포천시,4,0,2,6,4,0,2019-06-25
9270,경기,포천시,1,0,1,2,1,0,2019-07-25
9271,경기,포천시,8,0,2,10,4,0,2019-08-25
9272,경기,포천시,2,0,1,3,3,0,2019-09-25
9273,경기,포천시,4,2,1,7,6,0,2019-10-25
9274,경기,포천시,3,1,0,4,3,0,2019-11-25
9275,경기,포천시,3,0,0,3,2,0,2019-12-25
9276,경기,하남시,2,1,2,5,3,0,2019-01-25
9277,경기,하남시,1,0,0,1,1,0,2019-02-25
9278,경기,하남시,7,0,0,7,5,0,2019-03-25
9279,경기,하남시,7,1,1,9,6,0,2019-04-25
9280,경기,하남시,1,0,1,2,2,0,2019-05-25
9281,경기,하남시,3,2,0,5,5,0,2019-06-25
9282,경기,하남시,1,0,0,1,1,0,2019-07-25
9283,경기,하남시,6,2,2,10,8,0,2019-08-25
9284,경기,하남시,5,1,1,7,7,0,2019-09-25
9285,경기,하남시,0,1,1,2,2,0,2019-10-25
9286,경기,하남시,1,1,1,3,3,0,2019-11-25
9287,경기,하남시,2,1,2,5,3,0,2019-12-25
9288,경기,화성시,4,1,3,8,7,0,2019-01-25
9289,경기,화성시,9,1,3,13,8,0,2019-02-25
9290,경기,화성시,14,2,0,16,9,0,2019-03-25
9291,경기,화성시,7,0,0,7,7,0,2019-04-25
9292,경기,화성시,17,1,0,18,7,0,2019-05-25
9293,경기,화성시,19,1,4,24,16,0,2019-06-25
9294,경기,화성시,10,1,1,12,7,0,2019-07-25
9295,경기,화성시,2,0,2,4,4,0,2019-08-25
9296,경기,화성시,11,1,1,13,10,0,2019-09-25
9297,경기,화성시,20,0,3,23,12,2,2019-10-25
9298,경기,화성시,10,0,2,12,8,0,2019-11-25
9299,경기,화성시,16,1,0,17,8,0,2019-12-25
9300,경기,가평군,0,0,1,1,1,0,2019-01-26
9301,경기,가평군,0,0,0,0,1,1,2019-02-26
9302,경기,가평군,0,0,0,0,0,0,2019-03-26
9303,경기,가평군,3,0,2,5,1,0,2019-04-26
9304,경기,가평군,3,0,0,3,2,0,2019-05-26
9305,경기,가평군,2,0,2,4,1,0,2019-06-26
9306,경기,가평군,1,0,0,1,1,0,2019-07-26
9307,경기,가평군,3,0,0,3,1,0,2019-08-26
9308,경기,가평군,4,0,1,5,3,0,2019-09-26
9309,경기,가평군,3,0,0,3,1,0,2019-10-26
9310,경기,가평군,0,0,0,0,0,0,2019-11-26
9311,경기,가평군,0,0,0,0,0,0,2019-12-26
9312,경기,고양시,23,3,3,29,11,1,2019-01-26
9313,경기,고양시,11,1,4,16,10,0,2019-02-26
9314,경기,고양시,12,1,5,18,14,0,2019-03-26
9315,경기,고양시,14,8,2,24,12,0,2019-04-26
9316,경기,고양시,24,1,4,29,10,0,2019-05-26
9317,경기,고양시,4,3,2,9,9,0,2019-06-26
9318,경기,고양시,14,2,4,20,14,1,2019-07-26
9319,경기,고양시,12,3,3,18,10,0,2019-08-26
9320,경기,고양시,8,1,4,13,11,0,2019-09-26
9321,경기,고양시,25,4,3,32,18,0,2019-10-26
9322,경기,고양시,9,3,1,13,11,0,2019-11-26
9323,경기,고양시,14,2,5,21,12,0,2019-12-26
9324,경기,과천시,4,0,0,4,2,0,2019-01-26
9325,경기,과천시,0,0,1,1,1,0,2019-02-26
9326,경기,과천시,0,0,0,0,0,0,2019-03-26
9327,경기,과천시,0,0,1,1,1,0,2019-04-26
9328,경기,과천시,0,0,0,0,0,0,2019-05-26
9329,경기,과천시,0,0,0,0,0,0,2019-06-26
9330,경기,과천시,0,0,0,0,0,0,2019-07-26
9331,경기,과천시,0,0,0,0,0,0,2019-08-26
9332,경기,과천시,0,0,1,1,1,0,2019-09-26
9333,경기,과천시,0,0,0,0,0,0,2019-10-26
9334,경기,과천시,2,0,0,2,1,0,2019-11-26
9335,경기,과천시,0,0,0,0,0,0,2019-12-26
9336,경기,광명시,4,1,1,6,5,0,2019-01-26
9337,경기,광명시,1,0,0,1,1,0,2019-02-26
9338,경기,광명시,2,1,2,5,4,0,2019-03-26
9339,경기,광명시,2,2,2,6,3,0,2019-04-26
9340,경기,광명시,3,0,1,4,4,0,2019-05-26
9341,경기,광명시,3,0,0,3,3,0,2019-06-26
9342,경기,광명시,3,1,0,4,4,0,2019-07-26
9343,경기,광명시,1,0,0,1,1,0,2019-08-26
9344,경기,광명시,3,0,3,6,6,0,2019-09-26
9345,경기,광명시,0,1,0,1,1,0,2019-10-26
9346,경기,광명시,0,2,0,2,2,0,2019-11-26
9347,경기,광명시,1,2,0,3,4,1,2019-12-26
9348,경기,광주시,4,1,2,7,3,0,2019-01-26
9349,경기,광주시,9,0,0,9,6,0,2019-02-26
9350,경기,광주시,4,0,1,5,3,0,2019-03-26
9351,경기,광주시,5,0,3,8,6,0,2019-04-26
9352,경기,광주시,1,2,0,3,3,0,2019-05-26
9353,경기,광주시,7,0,2,9,6,0,2019-06-26
9354,경기,광주시,3,1,0,4,3,0,2019-07-26
9355,경기,광주시,6,0,0,6,6,0,2019-08-26
9356,경기,광주시,5,1,2,8,7,0,2019-09-26
9357,경기,광주시,12,0,1,13,7,0,2019-10-26
9358,경기,광주시,4,0,2,6,5,0,2019-11-26
9359,경기,광주시,6,0,1,7,6,0,2019-12-26
9360,경기,구리시,1,0,0,1,1,0,2019-01-26
9361,경기,구리시,0,0,0,0,0,0,2019-02-26
9362,경기,구리시,0,0,0,0,0,0,2019-03-26
9363,경기,구리시,1,0,0,1,1,0,2019-04-26
9364,경기,구리시,2,0,1,3,2,0,2019-05-26
9365,경기,구리시,7,0,0,7,4,0,2019-06-26
9366,경기,구리시,3,0,0,3,3,0,2019-07-26
9367,경기,구리시,3,0,0,3,2,0,2019-08-26
9368,경기,구리시,0,0,2,2,2,0,2019-09-26
9369,경기,구리시,2,1,1,4,3,0,2019-10-26
9370,경기,구리시,2,0,1,3,2,0,2019-11-26
9371,경기,구리시,0,0,0,0,0,0,2019-12-26
9372,경기,군포시,1,1,1,3,3,1,2019-01-26
9373,경기,군포시,1,0,1,2,2,0,2019-02-26
9374,경기,군포시,11,0,0,11,5,0,2019-03-26
9375,경기,군포시,2,0,2,4,4,0,2019-04-26
9376,경기,군포시,0,1,0,1,1,0,2019-05-26
9377,경기,군포시,4,0,0,4,2,0,2019-06-26
9378,경기,군포시,3,0,2,5,5,0,2019-07-26
9379,경기,군포시,1,0,1,2,1,0,2019-08-26
9380,경기,군포시,1,0,0,1,1,0,2019-09-26
9381,경기,군포시,1,0,1,2,1,0,2019-10-26
9382,경기,군포시,0,1,0,1,1,0,2019-11-26
9383,경기,군포시,1,0,0,1,1,0,2019-12-26
9384,경기,김포시,10,1,3,14,8,0,2019-01-26
9385,경기,김포시,8,1,0,9,3,0,2019-02-26
9386,경기,김포시,17,0,3,20,8,0,2019-03-26
9387,경기,김포시,1,0,0,1,1,0,2019-04-26
9388,경기,김포시,2,1,0,3,2,0,2019-05-26
9389,경기,김포시,3,0,0,3,2,0,2019-06-26
9390,경기,김포시,1,2,0,3,3,0,2019-07-26
9391,경기,김포시,7,0,0,7,4,0,2019-08-26
9392,경기,김포시,8,1,1,10,8,0,2019-09-26
9393,경기,김포시,5,0,3,8,4,0,2019-10-26
9394,경기,김포시,3,0,1,4,3,0,2019-11-26
9395,경기,김포시,3,0,0,3,3,0,2019-12-26
9396,경기,남양주시,7,0,0,7,5,0,2019-01-26
9397,경기,남양주시,10,0,0,10,6,0,2019-02-26
9398,경기,남양주시,7,0,1,8,7,0,2019-03-26
9399,경기,남양주시,4,0,1,5,3,0,2019-04-26
9400,경기,남양주시,2,1,2,5,4,0,2019-05-26
9401,경기,남양주시,6,2,2,10,7,0,2019-06-26
9402,경기,남양주시,9,0,1,10,5,0,2019-07-26
9403,경기,남양주시,11,2,0,13,7,0,2019-08-26
9404,경기,남양주시,3,2,1,6,6,1,2019-09-26
9405,경기,남양주시,2,0,2,4,4,0,2019-10-26
9406,경기,남양주시,6,1,0,7,5,0,2019-11-26
9407,경기,남양주시,11,0,1,12,7,0,2019-12-26
9408,경기,동두천시,0,0,0,0,0,0,2019-01-26
9409,경기,동두천시,0,0,0,0,0,0,2019-02-26
9410,경기,동두천시,0,0,0,0,0,0,2019-03-26
9411,경기,동두천시,0,0,0,0,0,0,2019-04-26
9412,경기,동두천시,0,0,0,0,0,0,2019-05-26
9413,경기,동두천시,1,0,1,2,2,0,2019-06-26
9414,경기,동두천시,1,0,0,1,1,0,2019-07-26
9415,경기,동두천시,0,0,0,0,0,0,2019-08-26
9416,경기,동두천시,1,0,1,2,2,0,2019-09-26
9417,경기,동두천시,0,0,0,0,0,0,2019-10-26
9418,경기,동두천시,0,0,0,0,0,0,2019-11-26
9419,경기,동두천시,2,0,1,3,2,0,2019-12-26
9420,경기,부천시,12,3,4,19,13,0,2019-01-26
9421,경기,부천시,35,1,1,37,18,1,2019-02-26
9422,경기,부천시,11,0,1,12,11,0,2019-03-26
9423,경기,부천시,18,0,5,23,11,0,2019-04-26
9424,경기,부천시,8,2,2,12,9,0,2019-05-26
9425,경기,부천시,8,0,1,9,7,0,2019-06-26
9426,경기,부천시,6,2,1,9,7,0,2019-07-26
9427,경기,부천시,11,2,3,16,13,0,2019-08-26
9428,경기,부천시,10,1,3,14,13,0,2019-09-26
9429,경기,부천시,12,0,1,13,10,0,2019-10-26
9430,경기,부천시,10,1,2,13,12,0,2019-11-26
9431,경기,부천시,3,1,0,4,4,0,2019-12-26
9432,경기,성남시,11,1,5,17,11,0,2019-01-26
9433,경기,성남시,15,3,4,22,16,0,2019-02-26
9434,경기,성남시,12,1,5,18,13,0,2019-03-26
9435,경기,성남시,5,4,4,13,9,1,2019-04-26
9436,경기,성남시,4,0,0,4,4,0,2019-05-26
9437,경기,성남시,11,1,1,13,9,0,2019-06-26
9438,경기,성남시,5,0,1,6,5,0,2019-07-26
9439,경기,성남시,14,3,8,25,21,1,2019-08-26
9440,경기,성남시,14,9,4,27,9,0,2019-09-26
9441,경기,성남시,11,1,4,16,10,0,2019-10-26
9442,경기,성남시,13,3,2,18,11,0,2019-11-26
9443,경기,성남시,17,2,4,23,16,0,2019-12-26
9444,경기,수원시,12,4,2,18,13,0,2019-01-26
9445,경기,수원시,7,0,0,7,6,0,2019-02-26
9446,경기,수원시,17,9,9,35,20,0,2019-03-26
9447,경기,수원시,19,5,5,29,21,0,2019-04-26
9448,경기,수원시,14,5,1,20,14,0,2019-05-26
9449,경기,수원시,10,1,3,14,10,0,2019-06-26
9450,경기,수원시,20,1,3,24,13,0,2019-07-26
9451,경기,수원시,13,0,6,19,13,0,2019-08-26
9452,경기,수원시,20,3,1,24,14,0,2019-09-26
9453,경기,수원시,30,4,7,41,24,0,2019-10-26
9454,경기,수원시,19,2,1,22,17,1,2019-11-26
9455,경기,수원시,16,1,4,21,17,0,2019-12-26
9456,경기,시흥시,9,0,2,11,8,0,2019-01-26
9457,경기,시흥시,9,1,5,15,10,0,2019-02-26
9458,경기,시흥시,4,3,1,8,4,0,2019-03-26
9459,경기,시흥시,13,0,1,14,6,0,2019-04-26
9460,경기,시흥시,8,0,4,12,9,0,2019-05-26
9461,경기,시흥시,7,0,4,11,6,0,2019-06-26
9462,경기,시흥시,8,3,1,12,7,0,2019-07-26
9463,경기,시흥시,7,1,0,8,6,0,2019-08-26
9464,경기,시흥시,6,1,2,9,5,0,2019-09-26
9465,경기,시흥시,10,0,6,16,10,1,2019-10-26
9466,경기,시흥시,12,1,3,16,11,0,2019-11-26
9467,경기,시흥시,4,2,1,7,6,0,2019-12-26
9468,경기,안산시,8,0,3,11,10,0,2019-01-26
9469,경기,안산시,21,0,0,21,13,0,2019-02-26
9470,경기,안산시,10,1,6,17,12,0,2019-03-26
9471,경기,안산시,13,0,2,15,10,0,2019-04-26
9472,경기,안산시,6,2,7,15,11,0,2019-05-26
9473,경기,안산시,7,0,6,13,12,0,2019-06-26
9474,경기,안산시,16,3,8,27,14,0,2019-07-26
9475,경기,안산시,15,3,3,21,12,0,2019-08-26
9476,경기,안산시,11,0,6,17,12,0,2019-09-26
9477,경기,안산시,8,1,4,13,9,0,2019-10-26
9478,경기,안산시,12,0,3,15,8,0,2019-11-26
9479,경기,안산시,8,0,3,11,7,1,2019-12-26
9480,경기,안성시,2,0,0,2,2,0,2019-01-26
9481,경기,안성시,1,0,1,2,2,0,2019-02-26
9482,경기,안성시,1,0,1,2,1,0,2019-03-26
9483,경기,안성시,6,0,0,6,5,0,2019-04-26
9484,경기,안성시,4,1,1,6,4,0,2019-05-26
9485,경기,안성시,1,0,0,1,1,0,2019-06-26
9486,경기,안성시,1,1,0,2,2,0,2019-07-26
9487,경기,안성시,1,0,2,3,3,0,2019-08-26
9488,경기,안성시,3,1,0,4,4,0,2019-09-26
9489,경기,안성시,7,1,4,12,5,0,2019-10-26
9490,경기,안성시,2,0,2,4,2,0,2019-11-26
9491,경기,안성시,6,0,0,6,4,0,2019-12-26
9492,경기,안양시,5,0,2,7,5,0,2019-01-26
9493,경기,안양시,1,0,0,1,1,0,2019-02-26
9494,경기,안양시,5,0,3,8,6,0,2019-03-26
9495,경기,안양시,0,0,5,5,5,0,2019-04-26
9496,경기,안양시,7,2,2,11,8,0,2019-05-26
9497,경기,안양시,3,1,2,6,4,0,2019-06-26
9498,경기,안양시,7,0,1,8,7,0,2019-07-26
9499,경기,안양시,3,0,5,8,7,0,2019-08-26
9500,경기,안양시,2,1,0,3,3,0,2019-09-26
9501,경기,안양시,8,1,3,12,7,0,2019-10-26
9502,경기,안양시,7,0,3,10,8,0,2019-11-26
9503,경기,안양시,4,1,0,5,4,0,2019-12-26
9504,경기,양주시,3,0,0,3,2,0,2019-01-26
9505,경기,양주시,4,0,0,4,3,0,2019-02-26
9506,경기,양주시,6,0,0,6,4,0,2019-03-26
9507,경기,양주시,0,0,1,1,1,0,2019-04-26
9508,경기,양주시,0,0,0,0,0,0,2019-05-26
9509,경기,양주시,4,0,0,4,3,0,2019-06-26
9510,경기,양주시,8,0,1,9,4,0,2019-07-26
9511,경기,양주시,4,0,0,4,3,0,2019-08-26
9512,경기,양주시,5,1,2,8,5,0,2019-09-26
9513,경기,양주시,10,0,1,11,3,0,2019-10-26
9514,경기,양주시,3,0,0,3,2,0,2019-11-26
9515,경기,양주시,8,0,3,11,7,0,2019-12-26
9516,경기,양평군,0,0,0,0,0,0,2019-01-26
9517,경기,양평군,1,0,0,1,1,0,2019-02-26
9518,경기,양평군,2,0,0,2,1,0,2019-03-26
9519,경기,양평군,1,0,1,2,2,0,2019-04-26
9520,경기,양평군,3,0,1,4,4,0,2019-05-26
9521,경기,양평군,1,0,0,1,1,0,2019-06-26
9522,경기,양평군,0,1,0,1,1,0,2019-07-26
9523,경기,양평군,4,0,1,5,2,0,2019-08-26
9524,경기,양평군,0,0,1,1,1,0,2019-09-26
9525,경기,양평군,1,0,0,1,1,0,2019-10-26
9526,경기,양평군,0,0,0,0,0,0,2019-11-26
9527,경기,양평군,0,0,0,0,0,0,2019-12-26
9528,경기,여주시,0,0,1,1,1,0,2019-01-26
9529,경기,여주시,0,0,0,0,0,0,2019-02-26
9530,경기,여주시,0,0,0,0,1,1,2019-03-26
9531,경기,여주시,0,0,1,1,1,0,2019-04-26
9532,경기,여주시,10,0,0,10,3,0,2019-05-26
9533,경기,여주시,4,0,1,5,3,0,2019-06-26
9534,경기,여주시,2,0,1,3,3,0,2019-07-26
9535,경기,여주시,0,0,0,0,0,0,2019-08-26
9536,경기,여주시,2,2,4,8,4,0,2019-09-26
9537,경기,여주시,5,0,5,10,4,0,2019-10-26
9538,경기,여주시,7,0,2,9,4,0,2019-11-26
9539,경기,여주시,2,0,0,2,2,0,2019-12-26
9540,경기,연천군,0,0,0,0,0,0,2019-01-26
9541,경기,연천군,0,0,0,0,0,0,2019-02-26
9542,경기,연천군,1,0,0,1,1,0,2019-03-26
9543,경기,연천군,0,0,0,0,0,0,2019-04-26
9544,경기,연천군,0,0,0,0,1,1,2019-05-26
9545,경기,연천군,0,0,0,0,0,0,2019-06-26
9546,경기,연천군,0,0,0,0,0,0,2019-07-26
9547,경기,연천군,0,0,2,2,2,0,2019-08-26
9548,경기,연천군,1,0,1,2,1,0,2019-09-26
9549,경기,연천군,0,0,0,0,0,0,2019-10-26
9550,경기,연천군,1,0,0,1,1,1,2019-11-26
9551,경기,연천군,1,0,0,1,1,0,2019-12-26
9552,경기,오산시,0,0,0,0,0,0,2019-01-26
9553,경기,오산시,2,0,0,2,2,0,2019-02-26
9554,경기,오산시,10,0,0,10,4,0,2019-03-26
9555,경기,오산시,5,7,0,12,4,0,2019-04-26
9556,경기,오산시,0,0,0,0,0,0,2019-05-26
9557,경기,오산시,6,0,1,7,4,0,2019-06-26
9558,경기,오산시,4,0,2,6,4,0,2019-07-26
9559,경기,오산시,3,0,0,3,3,0,2019-08-26
9560,경기,오산시,3,0,1,4,4,0,2019-09-26
9561,경기,오산시,1,0,0,1,1,0,2019-10-26
9562,경기,오산시,5,0,0,5,4,0,2019-11-26
9563,경기,오산시,3,1,0,4,2,0,2019-12-26
9564,경기,용인시,25,2,5,32,8,0,2019-01-26
9565,경기,용인시,10,2,1,13,8,0,2019-02-26
9566,경기,용인시,8,1,3,12,7,0,2019-03-26
9567,경기,용인시,6,0,7,13,8,1,2019-04-26
9568,경기,용인시,1,1,1,3,2,0,2019-05-26
9569,경기,용인시,3,2,2,7,4,0,2019-06-26
9570,경기,용인시,11,4,0,15,12,0,2019-07-26
9571,경기,용인시,18,2,3,23,14,0,2019-08-26
9572,경기,용인시,7,11,0,18,7,0,2019-09-26
9573,경기,용인시,17,6,2,25,17,0,2019-10-26
9574,경기,용인시,7,1,4,12,11,0,2019-11-26
9575,경기,용인시,12,0,2,14,10,0,2019-12-26
9576,경기,의왕시,0,0,0,0,0,0,2019-01-26
9577,경기,의왕시,2,0,0,2,2,0,2019-02-26
9578,경기,의왕시,0,0,0,0,0,0,2019-03-26
9579,경기,의왕시,0,0,0,0,0,0,2019-04-26
9580,경기,의왕시,0,2,0,2,2,0,2019-05-26
9581,경기,의왕시,0,0,1,1,1,0,2019-06-26
9582,경기,의왕시,0,0,0,0,0,0,2019-07-26
9583,경기,의왕시,2,0,0,2,1,0,2019-08-26
9584,경기,의왕시,1,0,1,2,2,0,2019-09-26
9585,경기,의왕시,2,1,0,3,3,0,2019-10-26
9586,경기,의왕시,0,0,0,0,0,0,2019-11-26
9587,경기,의왕시,0,0,0,0,0,0,2019-12-26
9588,경기,의정부시,6,1,1,8,5,0,2019-01-26
9589,경기,의정부시,5,2,4,11,4,0,2019-02-26
9590,경기,의정부시,9,3,3,15,10,0,2019-03-26
9591,경기,의정부시,2,1,0,3,3,0,2019-04-26
9592,경기,의정부시,4,0,0,4,2,0,2019-05-26
9593,경기,의정부시,1,0,1,2,2,0,2019-06-26
9594,경기,의정부시,6,3,1,10,6,0,2019-07-26
9595,경기,의정부시,4,1,0,5,4,0,2019-08-26
9596,경기,의정부시,6,1,0,7,6,0,2019-09-26
9597,경기,의정부시,8,0,0,8,4,0,2019-10-26
9598,경기,의정부시,4,1,2,7,6,0,2019-11-26
9599,경기,의정부시,7,0,1,8,5,0,2019-12-26
9600,경기,이천시,2,0,1,3,2,0,2019-01-26
9601,경기,이천시,1,0,0,1,1,0,2019-02-26
9602,경기,이천시,0,1,1,2,2,0,2019-03-26
9603,경기,이천시,2,0,1,3,4,1,2019-04-26
9604,경기,이천시,4,0,3,7,3,0,2019-05-26
9605,경기,이천시,2,0,1,3,2,0,2019-06-26
9606,경기,이천시,5,0,0,5,3,0,2019-07-26
9607,경기,이천시,6,0,2,8,3,0,2019-08-26
9608,경기,이천시,0,0,0,0,1,2,2019-09-26
9609,경기,이천시,11,0,0,11,3,0,2019-10-26
9610,경기,이천시,2,0,0,2,1,0,2019-11-26
9611,경기,이천시,2,1,1,4,4,0,2019-12-26
9612,경기,파주시,7,1,0,8,4,0,2019-01-26
9613,경기,파주시,7,1,3,11,8,0,2019-02-26
9614,경기,파주시,5,0,1,6,4,0,2019-03-26
9615,경기,파주시,9,1,1,11,5,0,2019-04-26
9616,경기,파주시,6,2,4,12,6,0,2019-05-26
9617,경기,파주시,8,0,1,9,6,0,2019-06-26
9618,경기,파주시,0,0,3,3,3,0,2019-07-26
9619,경기,파주시,2,0,1,3,2,0,2019-08-26
9620,경기,파주시,4,0,1,5,5,0,2019-09-26
9621,경기,파주시,6,1,1,8,6,0,2019-10-26
9622,경기,파주시,3,0,2,5,5,0,2019-11-26
9623,경기,파주시,7,0,0,7,3,0,2019-12-26
9624,경기,평택시,6,0,0,6,6,0,2019-01-26
9625,경기,평택시,10,3,2,15,9,0,2019-02-26
9626,경기,평택시,8,1,3,12,7,0,2019-03-26
9627,경기,평택시,3,0,0,3,3,0,2019-04-26
9628,경기,평택시,2,1,0,3,4,1,2019-05-26
9629,경기,평택시,11,1,3,15,9,0,2019-06-26
9630,경기,평택시,7,5,2,14,11,0,2019-07-26
9631,경기,평택시,19,0,3,22,13,0,2019-08-26
9632,경기,평택시,14,1,4,19,10,0,2019-09-26
9633,경기,평택시,15,3,3,21,15,0,2019-10-26
9634,경기,평택시,11,1,1,13,7,0,2019-11-26
9635,경기,평택시,17,1,4,22,13,0,2019-12-26
9636,경기,포천시,2,0,1,3,3,0,2019-01-26
9637,경기,포천시,4,0,2,6,3,0,2019-02-26
9638,경기,포천시,3,0,3,6,5,0,2019-03-26
9639,경기,포천시,4,0,1,5,2,0,2019-04-26
9640,경기,포천시,8,1,1,10,5,0,2019-05-26
9641,경기,포천시,3,0,2,5,2,0,2019-06-26
9642,경기,포천시,5,0,1,6,5,0,2019-07-26
9643,경기,포천시,2,0,0,2,2,0,2019-08-26
9644,경기,포천시,2,0,0,2,2,0,2019-09-26
9645,경기,포천시,2,0,2,4,3,0,2019-10-26
9646,경기,포천시,7,0,1,8,5,0,2019-11-26
9647,경기,포천시,5,1,0,6,3,0,2019-12-26
9648,경기,하남시,5,1,2,8,3,0,2019-01-26
9649,경기,하남시,4,1,2,7,4,0,2019-02-26
9650,경기,하남시,1,0,1,2,2,0,2019-03-26
9651,경기,하남시,1,0,2,3,3,0,2019-04-26
9652,경기,하남시,2,0,1,3,3,0,2019-05-26
9653,경기,하남시,5,2,0,7,7,1,2019-06-26
9654,경기,하남시,3,1,2,6,4,0,2019-07-26
9655,경기,하남시,2,1,0,3,1,0,2019-08-26
9656,경기,하남시,1,0,0,1,1,0,2019-09-26
9657,경기,하남시,5,0,0,5,3,0,2019-10-26
9658,경기,하남시,3,0,3,6,5,0,2019-11-26
9659,경기,하남시,1,1,0,2,2,0,2019-12-26
9660,경기,화성시,7,0,3,10,6,0,2019-01-26
9661,경기,화성시,4,0,0,4,3,0,2019-02-26
9662,경기,화성시,6,2,3,11,9,0,2019-03-26
9663,경기,화성시,15,0,2,17,14,0,2019-04-26
9664,경기,화성시,5,1,4,10,8,1,2019-05-26
9665,경기,화성시,13,0,4,17,12,0,2019-06-26
9666,경기,화성시,8,1,8,17,8,0,2019-07-26
9667,경기,화성시,13,3,4,20,13,1,2019-08-26
9668,경기,화성시,8,1,2,11,8,0,2019-09-26
9669,경기,화성시,11,2,4,17,13,0,2019-10-26
9670,경기,화성시,2,0,3,5,5,0,2019-11-26
9671,경기,화성시,3,3,2,8,5,0,2019-12-26
9672,경기,가평군,1,0,0,1,1,0,2019-01-27
9673,경기,가평군,0,0,0,0,0,0,2019-02-27
9674,경기,가평군,0,0,0,0,0,0,2019-03-27
9675,경기,가평군,3,0,0,3,2,0,2019-04-27
9676,경기,가평군,0,0,0,0,0,0,2019-05-27
9677,경기,가평군,0,1,2,3,2,0,2019-06-27
9678,경기,가평군,1,0,0,1,1,0,2019-07-27
9679,경기,가평군,2,0,1,3,2,0,2019-08-27
9680,경기,가평군,0,0,0,0,0,0,2019-09-27
9681,경기,가평군,5,0,0,5,3,0,2019-10-27
9682,경기,가평군,0,0,1,1,1,0,2019-11-27
9683,경기,가평군,5,0,0,5,4,0,2019-12-27
9684,경기,고양시,1,0,5,6,4,0,2019-01-27
9685,경기,고양시,15,1,8,24,14,0,2019-02-27
9686,경기,고양시,8,3,8,19,11,0,2019-03-27
9687,경기,고양시,15,4,8,27,18,0,2019-04-27
9688,경기,고양시,12,1,1,14,12,0,2019-05-27
9689,경기,고양시,17,0,1,18,8,0,2019-06-27
9690,경기,고양시,10,2,4,16,12,0,2019-07-27
9691,경기,고양시,2,3,1,6,6,0,2019-08-27
9692,경기,고양시,6,3,4,13,10,0,2019-09-27
9693,경기,고양시,9,2,3,14,7,0,2019-10-27
9694,경기,고양시,13,0,2,15,11,0,2019-11-27
9695,경기,고양시,19,2,3,24,18,1,2019-12-27
9696,경기,과천시,0,0,0,0,0,0,2019-01-27
9697,경기,과천시,1,0,0,1,1,0,2019-02-27
9698,경기,과천시,0,0,1,1,1,0,2019-03-27
9699,경기,과천시,0,0,0,0,0,0,2019-04-27
9700,경기,과천시,0,0,0,0,0,0,2019-05-27
9701,경기,과천시,0,0,0,0,0,0,2019-06-27
9702,경기,과천시,2,0,2,4,2,0,2019-07-27
9703,경기,과천시,1,0,0,1,1,0,2019-08-27
9704,경기,과천시,3,0,0,3,2,0,2019-09-27
9705,경기,과천시,0,0,1,1,1,0,2019-10-27
9706,경기,과천시,0,0,1,1,1,0,2019-11-27
9707,경기,과천시,1,0,0,1,1,0,2019-12-27
9708,경기,광명시,0,0,1,1,1,0,2019-01-27
9709,경기,광명시,6,0,0,6,4,0,2019-02-27
9710,경기,광명시,4,0,1,5,3,0,2019-03-27
9711,경기,광명시,1,0,2,3,3,0,2019-04-27
9712,경기,광명시,2,0,1,3,4,1,2019-05-27
9713,경기,광명시,1,0,0,1,1,0,2019-06-27
9714,경기,광명시,6,0,0,6,5,0,2019-07-27
9715,경기,광명시,5,0,1,6,4,0,2019-08-27
9716,경기,광명시,2,0,4,6,4,0,2019-09-27
9717,경기,광명시,0,1,0,1,1,0,2019-10-27
9718,경기,광명시,1,0,0,1,1,0,2019-11-27
9719,경기,광명시,3,0,0,3,2,0,2019-12-27
9720,경기,광주시,5,0,0,5,2,0,2019-01-27
9721,경기,광주시,0,0,1,1,1,0,2019-02-27
9722,경기,광주시,7,0,3,10,8,0,2019-03-27
9723,경기,광주시,4,0,2,6,6,0,2019-04-27
9724,경기,광주시,2,0,0,2,2,0,2019-05-27
9725,경기,광주시,0,0,2,2,2,0,2019-06-27
9726,경기,광주시,9,1,2,12,8,0,2019-07-27
9727,경기,광주시,7,1,1,9,8,1,2019-08-27
9728,경기,광주시,8,0,1,9,6,0,2019-09-27
9729,경기,광주시,3,0,1,4,4,0,2019-10-27
9730,경기,광주시,3,1,0,4,3,0,2019-11-27
9731,경기,광주시,2,1,1,4,2,0,2019-12-27
9732,경기,구리시,4,0,0,4,2,0,2019-01-27
9733,경기,구리시,2,0,0,2,2,0,2019-02-27
9734,경기,구리시,1,0,2,3,2,0,2019-03-27
9735,경기,구리시,7,0,1,8,4,0,2019-04-27
9736,경기,구리시,2,0,0,2,1,0,2019-05-27
9737,경기,구리시,0,0,0,0,0,0,2019-06-27
9738,경기,구리시,3,0,0,3,3,0,2019-07-27
9739,경기,구리시,7,5,2,14,6,0,2019-08-27
9740,경기,구리시,3,0,0,3,3,0,2019-09-27
9741,경기,구리시,0,0,1,1,1,0,2019-10-27
9742,경기,구리시,6,1,1,8,7,0,2019-11-27
9743,경기,구리시,0,0,0,0,0,0,2019-12-27
9744,경기,군포시,0,0,0,0,0,0,2019-01-27
9745,경기,군포시,2,1,1,4,3,0,2019-02-27
9746,경기,군포시,2,0,0,2,2,0,2019-03-27
9747,경기,군포시,6,2,0,8,3,0,2019-04-27
9748,경기,군포시,0,0,1,1,1,0,2019-05-27
9749,경기,군포시,2,0,1,3,2,0,2019-06-27
9750,경기,군포시,7,0,1,8,3,0,2019-07-27
9751,경기,군포시,3,1,1,5,4,0,2019-08-27
9752,경기,군포시,1,0,0,1,1,0,2019-09-27
9753,경기,군포시,5,0,3,8,2,0,2019-10-27
9754,경기,군포시,3,2,2,7,6,0,2019-11-27
9755,경기,군포시,1,0,2,3,3,0,2019-12-27
9756,경기,김포시,6,1,1,8,4,0,2019-01-27
9757,경기,김포시,11,2,0,13,4,0,2019-02-27
9758,경기,김포시,3,0,1,4,3,0,2019-03-27
9759,경기,김포시,10,0,6,16,6,0,2019-04-27
9760,경기,김포시,2,0,0,2,2,0,2019-05-27
9761,경기,김포시,5,0,0,5,4,0,2019-06-27
9762,경기,김포시,1,2,0,3,2,0,2019-07-27
9763,경기,김포시,4,0,2,6,2,0,2019-08-27
9764,경기,김포시,9,0,2,11,7,0,2019-09-27
9765,경기,김포시,2,2,1,5,3,0,2019-10-27
9766,경기,김포시,3,0,2,5,5,1,2019-11-27
9767,경기,김포시,8,0,4,12,8,0,2019-12-27
9768,경기,남양주시,8,1,0,9,4,0,2019-01-27
9769,경기,남양주시,1,0,0,1,1,0,2019-02-27
9770,경기,남양주시,8,0,1,9,5,0,2019-03-27
9771,경기,남양주시,20,1,4,25,12,0,2019-04-27
9772,경기,남양주시,5,2,0,7,6,0,2019-05-27
9773,경기,남양주시,6,0,0,6,4,0,2019-06-27
9774,경기,남양주시,12,1,0,13,6,0,2019-07-27
9775,경기,남양주시,3,0,2,5,4,0,2019-08-27
9776,경기,남양주시,8,1,0,9,8,0,2019-09-27
9777,경기,남양주시,6,0,0,6,5,0,2019-10-27
9778,경기,남양주시,4,1,2,7,5,0,2019-11-27
9779,경기,남양주시,6,1,2,9,6,0,2019-12-27
9780,경기,동두천시,1,0,1,2,2,0,2019-01-27
9781,경기,동두천시,0,0,0,0,0,0,2019-02-27
9782,경기,동두천시,1,0,3,4,2,0,2019-03-27
9783,경기,동두천시,1,0,0,1,1,0,2019-04-27
9784,경기,동두천시,0,0,0,0,0,0,2019-05-27
9785,경기,동두천시,0,0,0,0,0,0,2019-06-27
9786,경기,동두천시,1,0,1,2,1,0,2019-07-27
9787,경기,동두천시,5,0,1,6,3,0,2019-08-27
9788,경기,동두천시,0,1,1,2,2,0,2019-09-27
9789,경기,동두천시,4,0,1,5,2,0,2019-10-27
9790,경기,동두천시,1,0,0,1,1,0,2019-11-27
9791,경기,동두천시,5,0,1,6,3,0,2019-12-27
9792,경기,부천시,8,0,0,8,7,0,2019-01-27
9793,경기,부천시,6,0,2,8,7,0,2019-02-27
9794,경기,부천시,6,1,2,9,7,0,2019-03-27
9795,경기,부천시,19,1,4,24,20,0,2019-04-27
9796,경기,부천시,9,0,1,10,9,0,2019-05-27
9797,경기,부천시,13,0,1,14,9,0,2019-06-27
9798,경기,부천시,15,1,3,19,12,0,2019-07-27
9799,경기,부천시,9,2,1,12,9,0,2019-08-27
9800,경기,부천시,10,3,3,16,13,0,2019-09-27
9801,경기,부천시,12,2,4,18,12,0,2019-10-27
9802,경기,부천시,14,1,3,18,14,0,2019-11-27
9803,경기,부천시,11,2,0,13,12,0,2019-12-27
9804,경기,성남시,10,4,4,18,10,0,2019-01-27
9805,경기,성남시,12,0,2,14,13,1,2019-02-27
9806,경기,성남시,10,3,4,17,13,0,2019-03-27
9807,경기,성남시,9,0,3,12,9,0,2019-04-27
9808,경기,성남시,9,0,3,12,11,0,2019-05-27
9809,경기,성남시,17,3,7,27,10,0,2019-06-27
9810,경기,성남시,17,3,6,26,15,0,2019-07-27
9811,경기,성남시,12,1,1,14,11,0,2019-08-27
9812,경기,성남시,22,2,5,29,11,0,2019-09-27
9813,경기,성남시,11,2,3,16,12,1,2019-10-27
9814,경기,성남시,4,0,0,4,3,0,2019-11-27
9815,경기,성남시,1,2,3,6,6,0,2019-12-27
9816,경기,수원시,7,1,3,11,8,0,2019-01-27
9817,경기,수원시,12,1,5,18,13,0,2019-02-27
9818,경기,수원시,7,1,5,13,10,0,2019-03-27
9819,경기,수원시,6,3,3,12,8,0,2019-04-27
9820,경기,수원시,10,3,5,18,13,0,2019-05-27
9821,경기,수원시,16,1,2,19,17,0,2019-06-27
9822,경기,수원시,14,5,4,23,18,0,2019-07-27
9823,경기,수원시,11,2,1,14,10,0,2019-08-27
9824,경기,수원시,19,4,4,27,17,0,2019-09-27
9825,경기,수원시,17,2,2,21,15,0,2019-10-27
9826,경기,수원시,12,2,4,18,14,0,2019-11-27
9827,경기,수원시,10,4,3,17,14,0,2019-12-27
9828,경기,시흥시,6,0,1,7,3,0,2019-01-27
9829,경기,시흥시,7,0,1,8,4,0,2019-02-27
9830,경기,시흥시,5,0,3,8,6,0,2019-03-27
9831,경기,시흥시,16,1,6,23,8,0,2019-04-27
9832,경기,시흥시,8,0,2,10,6,0,2019-05-27
9833,경기,시흥시,4,0,5,9,7,0,2019-06-27
9834,경기,시흥시,7,0,2,9,6,0,2019-07-27
9835,경기,시흥시,2,1,3,6,5,0,2019-08-27
9836,경기,시흥시,6,0,3,9,8,0,2019-09-27
9837,경기,시흥시,12,1,4,17,7,0,2019-10-27
9838,경기,시흥시,10,3,3,16,11,0,2019-11-27
9839,경기,시흥시,3,0,3,6,5,0,2019-12-27
9840,경기,안산시,11,0,2,13,8,1,2019-01-27
9841,경기,안산시,22,1,10,33,21,0,2019-02-27
9842,경기,안산시,10,0,2,12,8,0,2019-03-27
9843,경기,안산시,15,2,5,22,13,0,2019-04-27
9844,경기,안산시,7,3,0,10,7,0,2019-05-27
9845,경기,안산시,13,2,2,17,12,0,2019-06-27
9846,경기,안산시,11,0,1,12,9,0,2019-07-27
9847,경기,안산시,13,0,1,14,10,0,2019-08-27
9848,경기,안산시,19,1,3,23,15,0,2019-09-27
9849,경기,안산시,14,1,3,18,11,0,2019-10-27
9850,경기,안산시,7,1,3,11,10,0,2019-11-27
9851,경기,안산시,9,1,0,10,8,0,2019-12-27
9852,경기,안성시,2,2,1,5,4,0,2019-01-27
9853,경기,안성시,1,0,1,2,1,0,2019-02-27
9854,경기,안성시,4,0,0,4,3,0,2019-03-27
9855,경기,안성시,8,0,1,9,6,0,2019-04-27
9856,경기,안성시,3,2,0,5,3,0,2019-05-27
9857,경기,안성시,2,0,2,4,3,0,2019-06-27
9858,경기,안성시,0,4,0,4,1,0,2019-07-27
9859,경기,안성시,0,0,1,1,1,0,2019-08-27
9860,경기,안성시,9,2,1,12,9,0,2019-09-27
9861,경기,안성시,1,0,1,2,2,0,2019-10-27
9862,경기,안성시,8,1,0,9,5,0,2019-11-27
9863,경기,안성시,5,0,1,6,2,0,2019-12-27
9864,경기,안양시,11,1,1,13,7,0,2019-01-27
9865,경기,안양시,5,0,1,6,3,0,2019-02-27
9866,경기,안양시,3,0,2,5,5,0,2019-03-27
9867,경기,안양시,10,0,2,12,7,0,2019-04-27
9868,경기,안양시,7,0,0,7,4,0,2019-05-27
9869,경기,안양시,4,0,4,8,7,0,2019-06-27
9870,경기,안양시,5,0,0,5,4,0,2019-07-27
9871,경기,안양시,4,0,0,4,4,0,2019-08-27
9872,경기,안양시,5,1,4,10,5,0,2019-09-27
9873,경기,안양시,1,0,0,1,1,0,2019-10-27
9874,경기,안양시,4,1,3,8,6,0,2019-11-27
9875,경기,안양시,5,1,0,6,4,0,2019-12-27
9876,경기,양주시,1,1,0,2,2,0,2019-01-27
9877,경기,양주시,6,2,2,10,7,1,2019-02-27
9878,경기,양주시,4,0,1,5,2,0,2019-03-27
9879,경기,양주시,5,1,3,9,3,0,2019-04-27
9880,경기,양주시,6,0,0,6,4,0,2019-05-27
9881,경기,양주시,2,0,1,3,2,0,2019-06-27
9882,경기,양주시,6,0,0,6,6,0,2019-07-27
9883,경기,양주시,0,0,0,0,0,0,2019-08-27
9884,경기,양주시,2,0,1,3,2,0,2019-09-27
9885,경기,양주시,6,0,1,7,3,0,2019-10-27
9886,경기,양주시,7,0,1,8,5,0,2019-11-27
9887,경기,양주시,1,0,0,1,1,0,2019-12-27
9888,경기,양평군,5,0,0,5,1,0,2019-01-27
9889,경기,양평군,1,0,0,1,1,0,2019-02-27
9890,경기,양평군,2,0,0,2,2,0,2019-03-27
9891,경기,양평군,1,0,1,2,1,0,2019-04-27
9892,경기,양평군,2,0,2,4,2,0,2019-05-27
9893,경기,양평군,1,0,0,1,1,0,2019-06-27
9894,경기,양평군,3,0,1,4,3,0,2019-07-27
9895,경기,양평군,0,0,0,0,0,0,2019-08-27
9896,경기,양평군,1,0,0,1,1,0,2019-09-27
9897,경기,양평군,6,0,0,6,4,0,2019-10-27
9898,경기,양평군,2,0,1,3,2,0,2019-11-27
9899,경기,양평군,0,0,0,0,0,0,2019-12-27
9900,경기,여주시,0,0,0,0,0,0,2019-01-27
9901,경기,여주시,2,0,1,3,2,0,2019-02-27
9902,경기,여주시,1,0,0,1,1,0,2019-03-27
9903,경기,여주시,15,1,3,19,5,0,2019-04-27
9904,경기,여주시,6,0,2,8,5,0,2019-05-27
9905,경기,여주시,3,0,3,6,4,0,2019-06-27
9906,경기,여주시,2,0,2,4,4,0,2019-07-27
9907,경기,여주시,5,0,1,6,2,0,2019-08-27
9908,경기,여주시,4,0,4,8,3,0,2019-09-27
9909,경기,여주시,1,0,0,1,1,0,2019-10-27
9910,경기,여주시,4,0,0,4,2,0,2019-11-27
9911,경기,여주시,0,0,0,0,0,0,2019-12-27
9912,경기,연천군,0,0,0,0,0,0,2019-01-27
9913,경기,연천군,0,0,0,0,0,0,2019-02-27
9914,경기,연천군,0,0,3,3,1,0,2019-03-27
9915,경기,연천군,1,0,0,1,1,0,2019-04-27
9916,경기,연천군,0,0,0,0,0,0,2019-05-27
9917,경기,연천군,4,0,0,4,1,0,2019-06-27
9918,경기,연천군,0,0,2,2,2,0,2019-07-27
9919,경기,연천군,0,0,0,0,0,0,2019-08-27
9920,경기,연천군,2,0,1,3,2,0,2019-09-27
9921,경기,연천군,0,0,0,0,0,0,2019-10-27
9922,경기,연천군,1,0,0,1,1,0,2019-11-27
9923,경기,연천군,1,0,1,2,1,0,2019-12-27
9924,경기,오산시,0,0,0,0,0,0,2019-01-27
9925,경기,오산시,2,0,1,3,3,0,2019-02-27
9926,경기,오산시,6,0,0,6,3,0,2019-03-27
9927,경기,오산시,2,0,0,2,2,0,2019-04-27
9928,경기,오산시,3,1,0,4,2,0,2019-05-27
9929,경기,오산시,6,0,0,6,2,0,2019-06-27
9930,경기,오산시,7,1,4,12,6,0,2019-07-27
9931,경기,오산시,3,1,0,4,4,0,2019-08-27
9932,경기,오산시,3,1,0,4,2,0,2019-09-27
9933,경기,오산시,8,0,0,8,3,0,2019-10-27
9934,경기,오산시,10,0,1,11,6,0,2019-11-27
9935,경기,오산시,4,1,0,5,3,0,2019-12-27
9936,경기,용인시,4,1,2,7,3,0,2019-01-27
9937,경기,용인시,16,1,3,20,11,0,2019-02-27
9938,경기,용인시,1,1,3,5,5,0,2019-03-27
9939,경기,용인시,22,0,3,25,13,0,2019-04-27
9940,경기,용인시,14,2,1,17,11,0,2019-05-27
9941,경기,용인시,20,3,4,27,12,0,2019-06-27
9942,경기,용인시,21,14,3,38,17,0,2019-07-27
9943,경기,용인시,10,1,2,13,10,0,2019-08-27
9944,경기,용인시,6,0,1,7,4,0,2019-09-27
9945,경기,용인시,7,1,2,10,8,0,2019-10-27
9946,경기,용인시,7,0,5,12,9,0,2019-11-27
9947,경기,용인시,4,2,0,6,5,0,2019-12-27
9948,경기,의왕시,0,0,0,0,0,0,2019-01-27
9949,경기,의왕시,1,0,0,1,1,0,2019-02-27
9950,경기,의왕시,2,1,0,3,2,0,2019-03-27
9951,경기,의왕시,1,0,0,1,1,0,2019-04-27
9952,경기,의왕시,2,0,1,3,3,0,2019-05-27
9953,경기,의왕시,1,0,1,2,2,0,2019-06-27
9954,경기,의왕시,1,0,1,2,1,0,2019-07-27
9955,경기,의왕시,3,0,0,3,3,0,2019-08-27
9956,경기,의왕시,2,0,0,2,2,0,2019-09-27
9957,경기,의왕시,1,0,0,1,1,0,2019-10-27
9958,경기,의왕시,2,0,0,2,1,0,2019-11-27
9959,경기,의왕시,3,0,1,4,2,0,2019-12-27
9960,경기,의정부시,3,1,1,5,3,0,2019-01-27
9961,경기,의정부시,3,7,1,11,5,0,2019-02-27
9962,경기,의정부시,1,0,0,1,1,0,2019-03-27
9963,경기,의정부시,2,3,2,7,6,0,2019-04-27
9964,경기,의정부시,11,3,2,16,6,0,2019-05-27
9965,경기,의정부시,8,0,1,9,4,0,2019-06-27
9966,경기,의정부시,5,2,0,7,3,0,2019-07-27
9967,경기,의정부시,4,0,0,4,2,0,2019-08-27
9968,경기,의정부시,4,0,3,7,7,0,2019-09-27
9969,경기,의정부시,3,0,1,4,4,0,2019-10-27
9970,경기,의정부시,6,2,2,10,6,0,2019-11-27
9971,경기,의정부시,4,0,2,6,6,0,2019-12-27
9972,경기,이천시,3,0,1,4,2,0,2019-01-27
9973,경기,이천시,0,1,0,1,1,0,2019-02-27
9974,경기,이천시,1,0,0,1,1,0,2019-03-27
9975,경기,이천시,5,2,3,10,5,0,2019-04-27
9976,경기,이천시,2,0,1,3,2,0,2019-05-27
9977,경기,이천시,2,0,0,2,2,0,2019-06-27
9978,경기,이천시,6,1,3,10,5,0,2019-07-27
9979,경기,이천시,11,0,1,12,7,0,2019-08-27
9980,경기,이천시,4,1,3,8,4,0,2019-09-27
9981,경기,이천시,3,0,1,4,3,0,2019-10-27
9982,경기,이천시,7,0,0,7,6,0,2019-11-27
9983,경기,이천시,2,0,1,3,3,0,2019-12-27
9984,경기,파주시,9,0,0,9,3,0,2019-01-27
9985,경기,파주시,6,1,2,9,5,0,2019-02-27
9986,경기,파주시,6,1,2,9,5,0,2019-03-27
9987,경기,파주시,2,0,1,3,3,0,2019-04-27
9988,경기,파주시,5,0,2,7,4,0,2019-05-27
9989,경기,파주시,2,1,3,6,6,1,2019-06-27
9990,경기,파주시,3,0,0,3,1,0,2019-07-27
9991,경기,파주시,3,2,2,7,6,0,2019-08-27
9992,경기,파주시,1,0,0,1,1,0,2019-09-27
9993,경기,파주시,3,2,0,5,2,0,2019-10-27
9994,경기,파주시,8,2,1,11,7,0,2019-11-27
9995,경기,파주시,5,5,0,10,5,1,2019-12-27
9996,경기,평택시,11,1,1,13,5,0,2019-01-27
9997,경기,평택시,7,4,5,16,9,0,2019-02-27
9998,경기,평택시,9,3,5,17,11,0,2019-03-27
9999,경기,평택시,24,3,6,33,13,0,2019-04-27
10000,경기,평택시,10,3,3,16,11,0,2019-05-27
10001,경기,평택시,5,0,1,6,3,0,2019-06-27
10002,경기,평택시,5,1,1,7,6,0,2019-07-27
10003,경기,평택시,6,0,1,7,5,0,2019-08-27
10004,경기,평택시,26,1,4,31,17,0,2019-09-27
10005,경기,평택시,8,3,1,12,9,0,2019-10-27
10006,경기,평택시,14,2,5,21,14,0,2019-11-27
10007,경기,평택시,17,0,3,20,12,0,2019-12-27
10008,경기,포천시,0,0,0,0,0,0,2019-01-27
10009,경기,포천시,0,0,3,3,2,0,2019-02-27
10010,경기,포천시,8,2,0,10,3,0,2019-03-27
10011,경기,포천시,5,1,1,7,5,0,2019-04-27
10012,경기,포천시,4,0,1,5,3,0,2019-05-27
10013,경기,포천시,4,0,1,5,4,0,2019-06-27
10014,경기,포천시,2,0,0,2,2,0,2019-07-27
10015,경기,포천시,1,0,0,1,1,0,2019-08-27
10016,경기,포천시,3,0,0,3,2,0,2019-09-27
10017,경기,포천시,4,0,0,4,3,0,2019-10-27
10018,경기,포천시,12,0,11,23,3,0,2019-11-27
10019,경기,포천시,1,1,0,2,2,0,2019-12-27
10020,경기,하남시,0,0,1,1,1,0,2019-01-27
10021,경기,하남시,5,1,1,7,3,0,2019-02-27
10022,경기,하남시,6,2,0,8,5,0,2019-03-27
10023,경기,하남시,3,0,1,4,3,0,2019-04-27
10024,경기,하남시,2,0,1,3,3,0,2019-05-27
10025,경기,하남시,3,1,2,6,4,0,2019-06-27
10026,경기,하남시,8,1,1,10,6,0,2019-07-27
10027,경기,하남시,0,1,2,3,2,0,2019-08-27
10028,경기,하남시,3,0,0,3,3,1,2019-09-27
10029,경기,하남시,3,0,2,5,5,1,2019-10-27
10030,경기,하남시,4,1,0,5,3,0,2019-11-27
10031,경기,하남시,3,1,0,4,4,0,2019-12-27
10032,경기,화성시,14,0,6,20,10,1,2019-01-27
10033,경기,화성시,6,0,3,9,7,0,2019-02-27
10034,경기,화성시,6,1,1,8,6,0,2019-03-27
10035,경기,화성시,13,1,5,19,11,0,2019-04-27
10036,경기,화성시,7,1,5,13,9,0,2019-05-27
10037,경기,화성시,7,2,6,15,7,0,2019-06-27
10038,경기,화성시,7,0,2,9,4,0,2019-07-27
10039,경기,화성시,11,2,1,14,10,0,2019-08-27
10040,경기,화성시,13,0,3,16,11,0,2019-09-27
10041,경기,화성시,9,2,2,13,5,0,2019-10-27
10042,경기,화성시,13,0,4,17,11,0,2019-11-27
10043,경기,화성시,18,1,1,20,12,0,2019-12-27
10044,경기,가평군,0,0,0,0,0,0,2019-01-28
10045,경기,가평군,3,0,0,3,2,0,2019-02-28
10046,경기,가평군,0,0,0,0,0,0,2019-03-28
10047,경기,가평군,2,1,0,3,2,0,2019-04-28
10048,경기,가평군,1,0,0,1,1,0,2019-05-28
10049,경기,가평군,0,0,0,0,0,0,2019-06-28
10050,경기,가평군,4,0,0,4,3,0,2019-07-28
10051,경기,가평군,0,0,0,0,0,0,2019-08-28
10052,경기,가평군,2,0,0,2,1,0,2019-09-28
10053,경기,가평군,2,0,1,3,1,0,2019-10-28
10054,경기,가평군,0,0,1,1,1,0,2019-11-28
10055,경기,가평군,0,0,1,1,1,1,2019-12-28
10056,경기,고양시,10,1,1,12,11,0,2019-01-28
10057,경기,고양시,2,0,3,5,6,1,2019-02-28
10058,경기,고양시,12,4,2,18,12,0,2019-03-28
10059,경기,고양시,13,4,4,21,14,0,2019-04-28
10060,경기,고양시,10,1,5,16,13,0,2019-05-28
10061,경기,고양시,13,0,6,19,11,0,2019-06-28
10062,경기,고양시,7,0,1,8,4,0,2019-07-28
10063,경기,고양시,9,0,3,12,8,0,2019-08-28
10064,경기,고양시,9,2,7,18,15,0,2019-09-28
10065,경기,고양시,8,2,6,16,13,0,2019-10-28
10066,경기,고양시,16,1,2,19,17,1,2019-11-28
10067,경기,고양시,9,1,2,12,7,0,2019-12-28
10068,경기,과천시,0,0,1,1,1,0,2019-01-28
10069,경기,과천시,0,0,1,1,1,0,2019-02-28
10070,경기,과천시,0,0,0,0,0,0,2019-03-28
10071,경기,과천시,0,0,0,0,0,0,2019-04-28
10072,경기,과천시,0,0,0,0,0,0,2019-05-28
10073,경기,과천시,2,0,1,3,3,0,2019-06-28
10074,경기,과천시,0,0,0,0,0,0,2019-07-28
10075,경기,과천시,0,0,1,1,1,0,2019-08-28
10076,경기,과천시,2,0,0,2,1,0,2019-09-28
10077,경기,과천시,1,1,0,2,2,0,2019-10-28
10078,경기,과천시,0,0,0,0,0,0,2019-11-28
10079,경기,과천시,0,0,0,0,0,0,2019-12-28
10080,경기,광명시,7,3,4,14,7,0,2019-01-28
10081,경기,광명시,6,2,2,10,7,0,2019-02-28
10082,경기,광명시,5,0,2,7,5,0,2019-03-28
10083,경기,광명시,1,1,0,2,2,0,2019-04-28
10084,경기,광명시,7,1,2,10,5,0,2019-05-28
10085,경기,광명시,0,1,0,1,1,0,2019-06-28
10086,경기,광명시,2,1,0,3,3,0,2019-07-28
10087,경기,광명시,3,0,1,4,4,0,2019-08-28
10088,경기,광명시,1,1,3,5,5,0,2019-09-28
10089,경기,광명시,7,0,3,10,7,0,2019-10-28
10090,경기,광명시,1,4,1,6,6,0,2019-11-28
10091,경기,광명시,1,2,1,4,3,0,2019-12-28
10092,경기,광주시,11,0,0,11,6,0,2019-01-28
10093,경기,광주시,10,1,3,14,7,0,2019-02-28
10094,경기,광주시,10,0,2,12,6,0,2019-03-28
10095,경기,광주시,3,0,3,6,5,0,2019-04-28
10096,경기,광주시,7,0,1,8,7,0,2019-05-28
10097,경기,광주시,5,0,1,6,5,0,2019-06-28
10098,경기,광주시,5,0,2,7,4,0,2019-07-28
10099,경기,광주시,3,0,2,5,4,0,2019-08-28
10100,경기,광주시,5,0,0,5,4,0,2019-09-28
10101,경기,광주시,16,1,1,18,8,0,2019-10-28
10102,경기,광주시,7,4,0,11,5,0,2019-11-28
10103,경기,광주시,8,1,0,9,8,0,2019-12-28
10104,경기,구리시,2,2,0,4,2,0,2019-01-28
10105,경기,구리시,1,1,3,5,5,0,2019-02-28
10106,경기,구리시,4,0,1,5,3,0,2019-03-28
10107,경기,구리시,0,0,0,0,0,0,2019-04-28
10108,경기,구리시,3,1,2,6,2,0,2019-05-28
10109,경기,구리시,1,0,1,2,2,0,2019-06-28
10110,경기,구리시,4,0,0,4,2,0,2019-07-28
10111,경기,구리시,1,4,0,5,2,0,2019-08-28
10112,경기,구리시,3,3,0,6,2,0,2019-09-28
10113,경기,구리시,1,0,0,1,1,0,2019-10-28
10114,경기,구리시,2,0,0,2,2,0,2019-11-28
10115,경기,구리시,0,2,0,2,1,0,2019-12-28
10116,경기,군포시,1,0,2,3,2,0,2019-01-28
10117,경기,군포시,0,0,0,0,0,0,2019-02-28
10118,경기,군포시,0,0,0,0,0,0,2019-03-28
10119,경기,군포시,0,0,0,0,0,0,2019-04-28
10120,경기,군포시,1,0,0,1,1,0,2019-05-28
10121,경기,군포시,4,0,0,4,2,0,2019-06-28
10122,경기,군포시,1,1,0,2,1,0,2019-07-28
10123,경기,군포시,0,0,0,0,0,0,2019-08-28
10124,경기,군포시,1,0,1,2,2,0,2019-09-28
10125,경기,군포시,0,1,0,1,1,0,2019-10-28
10126,경기,군포시,1,0,0,1,1,0,2019-11-28
10127,경기,군포시,1,0,1,2,1,0,2019-12-28
10128,경기,김포시,8,0,2,10,6,0,2019-01-28
10129,경기,김포시,12,1,0,13,7,0,2019-02-28
10130,경기,김포시,1,0,0,1,1,0,2019-03-28
10131,경기,김포시,7,0,2,9,6,0,2019-04-28
10132,경기,김포시,2,1,1,4,4,0,2019-05-28
10133,경기,김포시,2,0,2,4,4,0,2019-06-28
10134,경기,김포시,1,1,0,2,2,0,2019-07-28
10135,경기,김포시,3,0,1,4,3,0,2019-08-28
10136,경기,김포시,4,0,1,5,4,0,2019-09-28
10137,경기,김포시,4,1,2,7,6,0,2019-10-28
10138,경기,김포시,8,1,3,12,5,0,2019-11-28
10139,경기,김포시,11,2,3,16,6,0,2019-12-28
10140,경기,남양주시,5,0,2,7,6,0,2019-01-28
10141,경기,남양주시,19,1,0,20,5,0,2019-02-28
10142,경기,남양주시,7,1,1,9,7,0,2019-03-28
10143,경기,남양주시,3,1,2,6,5,0,2019-04-28
10144,경기,남양주시,12,0,2,14,9,0,2019-05-28
10145,경기,남양주시,2,2,2,6,5,0,2019-06-28
10146,경기,남양주시,7,2,0,9,5,0,2019-07-28
10147,경기,남양주시,4,1,1,6,6,0,2019-08-28
10148,경기,남양주시,8,0,1,9,5,0,2019-09-28
10149,경기,남양주시,7,6,1,14,7,0,2019-10-28
10150,경기,남양주시,3,4,2,9,5,0,2019-11-28
10151,경기,남양주시,1,0,1,2,2,0,2019-12-28
10152,경기,동두천시,1,0,1,2,2,0,2019-01-28
10153,경기,동두천시,3,0,0,3,3,0,2019-02-28
10154,경기,동두천시,2,1,1,4,2,0,2019-03-28
10155,경기,동두천시,0,0,0,0,0,0,2019-04-28
10156,경기,동두천시,1,0,0,1,1,0,2019-05-28
10157,경기,동두천시,1,0,0,1,1,0,2019-06-28
10158,경기,동두천시,0,2,0,2,1,0,2019-07-28
10159,경기,동두천시,1,0,0,1,1,0,2019-08-28
10160,경기,동두천시,1,0,1,2,2,0,2019-09-28
10161,경기,동두천시,4,0,0,4,1,0,2019-10-28
10162,경기,동두천시,0,0,0,0,0,0,2019-11-28
10163,경기,동두천시,0,0,0,0,0,0,2019-12-28
10164,경기,부천시,8,2,2,12,12,0,2019-01-28
10165,경기,부천시,2,4,4,10,7,0,2019-02-28
10166,경기,부천시,5,1,2,8,8,0,2019-03-28
10167,경기,부천시,17,1,2,20,13,0,2019-04-28
10168,경기,부천시,14,0,2,16,13,0,2019-05-28
10169,경기,부천시,15,1,1,17,13,0,2019-06-28
10170,경기,부천시,9,0,2,11,6,0,2019-07-28
10171,경기,부천시,8,3,1,12,10,0,2019-08-28
10172,경기,부천시,14,0,2,16,11,0,2019-09-28
10173,경기,부천시,24,1,5,30,17,0,2019-10-28
10174,경기,부천시,7,1,2,10,8,0,2019-11-28
10175,경기,부천시,6,3,3,12,9,0,2019-12-28
10176,경기,성남시,13,4,11,28,14,0,2019-01-28
10177,경기,성남시,6,0,5,11,8,0,2019-02-28
10178,경기,성남시,13,0,2,15,10,0,2019-03-28
10179,경기,성남시,1,1,3,5,3,0,2019-04-28
10180,경기,성남시,17,2,7,26,12,0,2019-05-28
10181,경기,성남시,16,5,4,25,13,0,2019-06-28
10182,경기,성남시,6,2,1,9,6,0,2019-07-28
10183,경기,성남시,9,1,0,10,9,0,2019-08-28
10184,경기,성남시,20,5,1,26,11,0,2019-09-28
10185,경기,성남시,9,0,1,10,8,0,2019-10-28
10186,경기,성남시,9,1,4,14,10,0,2019-11-28
10187,경기,성남시,11,4,5,20,16,2,2019-12-28
10188,경기,수원시,10,0,5,15,14,0,2019-01-28
10189,경기,수원시,15,0,1,16,12,0,2019-02-28
10190,경기,수원시,19,4,2,25,19,0,2019-03-28
10191,경기,수원시,9,0,2,11,10,0,2019-04-28
10192,경기,수원시,18,3,3,24,17,0,2019-05-28
10193,경기,수원시,9,0,1,10,9,0,2019-06-28
10194,경기,수원시,11,1,2,14,11,0,2019-07-28
10195,경기,수원시,19,2,0,21,12,0,2019-08-28
10196,경기,수원시,29,0,5,34,20,0,2019-09-28
10197,경기,수원시,13,6,4,23,18,1,2019-10-28
10198,경기,수원시,11,5,2,18,15,0,2019-11-28
10199,경기,수원시,7,1,1,9,8,0,2019-12-28
10200,경기,시흥시,4,0,1,5,5,0,2019-01-28
10201,경기,시흥시,4,0,3,7,6,0,2019-02-28
10202,경기,시흥시,11,0,1,12,10,0,2019-03-28
10203,경기,시흥시,6,0,1,7,6,0,2019-04-28
10204,경기,시흥시,12,0,3,15,14,0,2019-05-28
10205,경기,시흥시,9,1,1,11,10,0,2019-06-28
10206,경기,시흥시,7,0,0,7,2,0,2019-07-28
10207,경기,시흥시,6,1,3,10,9,0,2019-08-28
10208,경기,시흥시,4,0,3,7,7,0,2019-09-28
10209,경기,시흥시,16,1,5,22,12,0,2019-10-28
10210,경기,시흥시,18,6,1,25,7,0,2019-11-28
10211,경기,시흥시,5,1,1,7,5,0,2019-12-28
10212,경기,안산시,16,2,2,20,11,0,2019-01-28
10213,경기,안산시,14,0,1,15,12,0,2019-02-28
10214,경기,안산시,6,0,2,8,8,0,2019-03-28
10215,경기,안산시,9,0,1,10,9,0,2019-04-28
10216,경기,안산시,10,1,4,15,14,0,2019-05-28
10217,경기,안산시,14,1,8,23,11,0,2019-06-28
10218,경기,안산시,2,1,4,7,4,0,2019-07-28
10219,경기,안산시,8,0,2,10,9,0,2019-08-28
10220,경기,안산시,18,0,5,23,14,0,2019-09-28
10221,경기,안산시,9,1,3,13,13,0,2019-10-28
10222,경기,안산시,6,0,6,12,11,0,2019-11-28
10223,경기,안산시,14,0,4,18,15,0,2019-12-28
10224,경기,안성시,11,0,0,11,6,0,2019-01-28
10225,경기,안성시,5,0,3,8,6,0,2019-02-28
10226,경기,안성시,2,0,0,2,3,1,2019-03-28
10227,경기,안성시,2,1,1,4,3,0,2019-04-28
10228,경기,안성시,3,0,0,3,2,0,2019-05-28
10229,경기,안성시,7,0,1,8,5,0,2019-06-28
10230,경기,안성시,0,0,0,0,0,0,2019-07-28
10231,경기,안성시,3,0,1,4,4,0,2019-08-28
10232,경기,안성시,17,3,3,23,9,0,2019-09-28
10233,경기,안성시,4,0,2,6,5,0,2019-10-28
10234,경기,안성시,1,0,2,3,2,0,2019-11-28
10235,경기,안성시,5,1,0,6,2,0,2019-12-28
10236,경기,안양시,1,1,0,2,2,0,2019-01-28
10237,경기,안양시,2,1,1,4,3,0,2019-02-28
10238,경기,안양시,5,0,3,8,5,0,2019-03-28
10239,경기,안양시,4,0,1,5,5,0,2019-04-28
10240,경기,안양시,4,2,4,10,4,0,2019-05-28
10241,경기,안양시,3,0,1,4,4,0,2019-06-28
10242,경기,안양시,2,0,0,2,1,0,2019-07-28
10243,경기,안양시,4,0,3,7,5,0,2019-08-28
10244,경기,안양시,1,2,1,4,3,0,2019-09-28
10245,경기,안양시,6,2,4,12,9,1,2019-10-28
10246,경기,안양시,7,1,3,11,7,0,2019-11-28
10247,경기,안양시,7,1,5,13,8,0,2019-12-28
10248,경기,양주시,2,0,3,5,4,0,2019-01-28
10249,경기,양주시,6,0,0,6,4,0,2019-02-28
10250,경기,양주시,6,0,0,6,3,0,2019-03-28
10251,경기,양주시,2,0,1,3,3,0,2019-04-28
10252,경기,양주시,9,0,2,11,6,0,2019-05-28
10253,경기,양주시,3,0,0,3,2,0,2019-06-28
10254,경기,양주시,2,1,2,5,4,0,2019-07-28
10255,경기,양주시,4,0,0,4,3,0,2019-08-28
10256,경기,양주시,7,0,0,7,5,1,2019-09-28
10257,경기,양주시,9,0,4,13,8,0,2019-10-28
10258,경기,양주시,3,0,1,4,3,0,2019-11-28
10259,경기,양주시,4,0,0,4,1,0,2019-12-28
10260,경기,양평군,0,0,0,0,0,0,2019-01-28
10261,경기,양평군,2,0,1,3,1,0,2019-02-28
10262,경기,양평군,1,0,2,3,3,0,2019-03-28
10263,경기,양평군,1,0,2,3,2,0,2019-04-28
10264,경기,양평군,3,0,0,3,1,0,2019-05-28
10265,경기,양평군,1,1,0,2,3,1,2019-06-28
10266,경기,양평군,0,0,0,0,0,0,2019-07-28
10267,경기,양평군,2,0,1,3,2,0,2019-08-28
10268,경기,양평군,0,0,0,0,0,0,2019-09-28
10269,경기,양평군,0,0,0,0,0,0,2019-10-28
10270,경기,양평군,1,0,1,2,2,0,2019-11-28
10271,경기,양평군,0,1,0,1,1,0,2019-12-28
10272,경기,여주시,2,0,1,3,2,0,2019-01-28
10273,경기,여주시,0,0,0,0,0,0,2019-02-28
10274,경기,여주시,1,0,2,3,3,0,2019-03-28
10275,경기,여주시,1,0,0,1,1,0,2019-04-28
10276,경기,여주시,8,0,1,9,7,0,2019-05-28
10277,경기,여주시,2,0,0,2,2,0,2019-06-28
10278,경기,여주시,0,0,1,1,1,0,2019-07-28
10279,경기,여주시,5,0,1,6,2,0,2019-08-28
10280,경기,여주시,2,0,2,4,4,0,2019-09-28
10281,경기,여주시,1,0,0,1,1,0,2019-10-28
10282,경기,여주시,0,0,0,0,0,0,2019-11-28
10283,경기,여주시,4,0,2,6,3,0,2019-12-28
10284,경기,연천군,0,0,0,0,0,0,2019-01-28
10285,경기,연천군,0,0,0,0,0,0,2019-02-28
10286,경기,연천군,2,0,0,2,1,0,2019-03-28
10287,경기,연천군,2,0,0,2,1,0,2019-04-28
10288,경기,연천군,0,0,0,0,0,0,2019-05-28
10289,경기,연천군,0,0,1,1,1,0,2019-06-28
10290,경기,연천군,4,0,1,5,2,0,2019-07-28
10291,경기,연천군,0,0,0,0,0,0,2019-08-28
10292,경기,연천군,0,0,0,0,0,0,2019-09-28
10293,경기,연천군,1,0,0,1,1,0,2019-10-28
10294,경기,연천군,0,0,0,0,1,1,2019-11-28
10295,경기,연천군,0,0,0,0,0,0,2019-12-28
10296,경기,오산시,0,0,0,0,0,0,2019-01-28
10297,경기,오산시,5,0,0,5,3,0,2019-02-28
10298,경기,오산시,3,0,1,4,4,0,2019-03-28
10299,경기,오산시,4,2,0,6,3,0,2019-04-28
10300,경기,오산시,8,0,1,9,5,0,2019-05-28
10301,경기,오산시,7,1,2,10,7,0,2019-06-28
10302,경기,오산시,2,0,2,4,1,0,2019-07-28
10303,경기,오산시,3,0,3,6,4,0,2019-08-28
10304,경기,오산시,0,0,1,1,1,0,2019-09-28
10305,경기,오산시,6,0,0,6,4,0,2019-10-28
10306,경기,오산시,7,1,0,8,4,0,2019-11-28
10307,경기,오산시,3,1,0,4,3,0,2019-12-28
10308,경기,용인시,18,1,9,28,7,0,2019-01-28
10309,경기,용인시,5,2,4,11,5,0,2019-02-28
10310,경기,용인시,16,1,10,27,17,1,2019-03-28
10311,경기,용인시,2,0,0,2,2,0,2019-04-28
10312,경기,용인시,19,4,10,33,11,0,2019-05-28
10313,경기,용인시,12,6,3,21,12,0,2019-06-28
10314,경기,용인시,4,7,0,11,5,0,2019-07-28
10315,경기,용인시,11,2,3,16,13,0,2019-08-28
10316,경기,용인시,20,0,2,22,10,0,2019-09-28
10317,경기,용인시,18,2,0,20,10,0,2019-10-28
10318,경기,용인시,16,2,7,25,18,0,2019-11-28
10319,경기,용인시,6,5,2,13,5,0,2019-12-28
10320,경기,의왕시,4,5,0,9,2,0,2019-01-28
10321,경기,의왕시,2,0,1,3,1,0,2019-02-28
10322,경기,의왕시,0,0,0,0,0,0,2019-03-28
10323,경기,의왕시,1,1,1,3,2,0,2019-04-28
10324,경기,의왕시,1,0,1,2,2,0,2019-05-28
10325,경기,의왕시,1,0,0,1,1,0,2019-06-28
10326,경기,의왕시,3,0,1,4,2,0,2019-07-28
10327,경기,의왕시,0,0,1,1,1,0,2019-08-28
10328,경기,의왕시,1,0,0,1,1,0,2019-09-28
10329,경기,의왕시,2,0,1,3,3,0,2019-10-28
10330,경기,의왕시,4,1,1,6,3,0,2019-11-28
10331,경기,의왕시,2,1,0,3,3,0,2019-12-28
10332,경기,의정부시,3,0,3,6,5,1,2019-01-28
10333,경기,의정부시,4,2,0,6,6,0,2019-02-28
10334,경기,의정부시,3,1,1,5,4,1,2019-03-28
10335,경기,의정부시,6,0,0,6,4,0,2019-04-28
10336,경기,의정부시,6,0,3,9,8,0,2019-05-28
10337,경기,의정부시,3,0,0,3,2,0,2019-06-28
10338,경기,의정부시,2,3,1,6,6,0,2019-07-28
10339,경기,의정부시,1,0,1,2,2,0,2019-08-28
10340,경기,의정부시,4,1,0,5,4,0,2019-09-28
10341,경기,의정부시,6,0,0,6,6,0,2019-10-28
10342,경기,의정부시,2,2,2,6,5,0,2019-11-28
10343,경기,의정부시,6,2,1,9,8,0,2019-12-28
10344,경기,이천시,2,0,1,3,3,0,2019-01-28
10345,경기,이천시,2,0,0,2,2,0,2019-02-28
10346,경기,이천시,2,1,1,4,3,0,2019-03-28
10347,경기,이천시,0,0,1,1,1,0,2019-04-28
10348,경기,이천시,5,2,5,12,6,0,2019-05-28
10349,경기,이천시,2,0,2,4,3,0,2019-06-28
10350,경기,이천시,5,2,0,7,4,0,2019-07-28
10351,경기,이천시,3,0,3,6,5,0,2019-08-28
10352,경기,이천시,15,1,2,18,4,1,2019-09-28
10353,경기,이천시,9,0,3,12,5,0,2019-10-28
10354,경기,이천시,13,1,1,15,7,0,2019-11-28
10355,경기,이천시,1,0,0,1,1,0,2019-12-28
10356,경기,파주시,8,1,2,11,9,0,2019-01-28
10357,경기,파주시,5,0,1,6,4,0,2019-02-28
10358,경기,파주시,4,1,1,6,5,0,2019-03-28
10359,경기,파주시,0,0,0,0,0,0,2019-04-28
10360,경기,파주시,3,1,0,4,4,0,2019-05-28
10361,경기,파주시,15,2,0,17,6,0,2019-06-28
10362,경기,파주시,5,0,0,5,4,0,2019-07-28
10363,경기,파주시,0,0,1,1,1,0,2019-08-28
10364,경기,파주시,5,0,4,9,8,0,2019-09-28
10365,경기,파주시,5,0,0,5,4,0,2019-10-28
10366,경기,파주시,5,0,0,5,5,0,2019-11-28
10367,경기,파주시,1,1,0,2,2,0,2019-12-28
10368,경기,평택시,14,2,4,20,10,0,2019-01-28
10369,경기,평택시,3,1,4,8,4,0,2019-02-28
10370,경기,평택시,11,0,1,12,8,0,2019-03-28
10371,경기,평택시,11,2,2,15,9,0,2019-04-28
10372,경기,평택시,12,2,1,15,11,0,2019-05-28
10373,경기,평택시,1,2,3,6,5,0,2019-06-28
10374,경기,평택시,16,4,1,21,10,0,2019-07-28
10375,경기,평택시,11,0,0,11,6,0,2019-08-28
10376,경기,평택시,10,3,5,18,15,0,2019-09-28
10377,경기,평택시,21,5,4,30,19,0,2019-10-28
10378,경기,평택시,18,3,2,23,10,0,2019-11-28
10379,경기,평택시,11,0,0,11,6,0,2019-12-28
10380,경기,포천시,3,2,2,7,4,0,2019-01-28
10381,경기,포천시,0,0,2,2,2,0,2019-02-28
10382,경기,포천시,1,1,1,3,3,0,2019-03-28
10383,경기,포천시,3,2,1,6,3,0,2019-04-28
10384,경기,포천시,3,0,0,3,2,0,2019-05-28
10385,경기,포천시,5,5,1,11,3,0,2019-06-28
10386,경기,포천시,3,0,0,3,2,0,2019-07-28
10387,경기,포천시,3,0,0,3,2,0,2019-08-28
10388,경기,포천시,6,3,1,10,3,0,2019-09-28
10389,경기,포천시,2,1,0,3,3,0,2019-10-28
10390,경기,포천시,1,0,1,2,2,0,2019-11-28
10391,경기,포천시,5,0,0,5,1,0,2019-12-28
10392,경기,하남시,2,0,0,2,2,0,2019-01-28
10393,경기,하남시,0,0,1,1,1,0,2019-02-28
10394,경기,하남시,5,0,1,6,5,0,2019-03-28
10395,경기,하남시,5,1,1,7,2,0,2019-04-28
10396,경기,하남시,1,0,1,2,3,1,2019-05-28
10397,경기,하남시,3,0,1,4,3,0,2019-06-28
10398,경기,하남시,6,1,0,7,5,0,2019-07-28
10399,경기,하남시,2,1,1,4,2,0,2019-08-28
10400,경기,하남시,3,0,0,3,2,0,2019-09-28
10401,경기,하남시,6,0,2,8,6,0,2019-10-28
10402,경기,하남시,0,0,2,2,2,0,2019-11-28
10403,경기,하남시,8,3,5,16,3,0,2019-12-28
10404,경기,화성시,7,0,2,9,6,0,2019-01-28
10405,경기,화성시,7,1,5,13,7,0,2019-02-28
10406,경기,화성시,14,2,10,26,8,0,2019-03-28
10407,경기,화성시,7,0,1,8,4,0,2019-04-28
10408,경기,화성시,31,5,6,42,20,0,2019-05-28
10409,경기,화성시,9,0,4,13,11,0,2019-06-28
10410,경기,화성시,0,0,1,1,1,0,2019-07-28
10411,경기,화성시,9,0,0,9,8,0,2019-08-28
10412,경기,화성시,21,2,2,25,11,0,2019-09-28
10413,경기,화성시,16,0,1,17,7,0,2019-10-28
10414,경기,화성시,17,1,3,21,12,0,2019-11-28
10415,경기,화성시,9,0,0,9,7,0,2019-12-28
10416,경기,가평군,0,0,0,0,0,0,2019-01-29
10418,경기,가평군,3,0,0,3,1,0,2019-03-29
10419,경기,가평군,1,0,0,1,1,0,2019-04-29
10420,경기,가평군,1,0,0,1,1,0,2019-05-29
10421,경기,가평군,1,0,1,2,2,0,2019-06-29
10422,경기,가평군,4,0,0,4,2,0,2019-07-29
10423,경기,가평군,1,0,0,1,1,0,2019-08-29
10424,경기,가평군,1,0,1,2,2,0,2019-09-29
10425,경기,가평군,3,0,0,3,2,0,2019-10-29
10426,경기,가평군,0,0,0,0,0,0,2019-11-29
10427,경기,가평군,0,0,0,0,0,0,2019-12-29
10428,경기,고양시,4,3,3,10,9,0,2019-01-29
10430,경기,고양시,10,1,2,13,10,0,2019-03-29
10431,경기,고양시,7,2,2,11,8,0,2019-04-29
10432,경기,고양시,11,1,5,17,11,0,2019-05-29
10433,경기,고양시,4,1,1,6,6,0,2019-06-29
10434,경기,고양시,9,0,4,13,9,0,2019-07-29
10435,경기,고양시,7,1,3,11,8,0,2019-08-29
10436,경기,고양시,17,2,1,20,10,0,2019-09-29
10437,경기,고양시,14,1,2,17,12,0,2019-10-29
10438,경기,고양시,10,0,5,15,12,0,2019-11-29
10439,경기,고양시,3,1,3,7,6,0,2019-12-29
10440,경기,과천시,0,0,1,1,1,0,2019-01-29
10442,경기,과천시,0,0,0,0,0,0,2019-03-29
10443,경기,과천시,0,0,0,0,0,0,2019-04-29
10444,경기,과천시,0,0,0,0,0,0,2019-05-29
10445,경기,과천시,0,0,1,1,1,0,2019-06-29
10446,경기,과천시,0,0,0,0,0,0,2019-07-29
10447,경기,과천시,0,0,0,0,0,0,2019-08-29
10448,경기,과천시,0,0,0,0,0,0,2019-09-29
10449,경기,과천시,1,1,0,2,1,0,2019-10-29
10450,경기,과천시,5,0,1,6,3,0,2019-11-29
10451,경기,과천시,0,0,0,0,0,0,2019-12-29
10452,경기,광명시,0,1,0,1,1,0,2019-01-29
10454,경기,광명시,2,1,2,5,5,0,2019-03-29
10455,경기,광명시,2,0,0,2,2,0,2019-04-29
10456,경기,광명시,4,2,1,7,5,0,2019-05-29
10457,경기,광명시,1,0,0,1,1,0,2019-06-29
10458,경기,광명시,1,1,0,2,2,0,2019-07-29
10459,경기,광명시,1,0,0,1,1,0,2019-08-29
10460,경기,광명시,1,0,2,3,2,0,2019-09-29
10461,경기,광명시,3,0,2,5,4,0,2019-10-29
10462,경기,광명시,4,0,1,5,4,0,2019-11-29
10463,경기,광명시,0,1,1,2,2,0,2019-12-29
10464,경기,광주시,7,0,3,10,7,0,2019-01-29
10466,경기,광주시,2,0,4,6,5,0,2019-03-29
10467,경기,광주시,15,2,2,19,9,0,2019-04-29
10468,경기,광주시,11,0,0,11,6,0,2019-05-29
10469,경기,광주시,2,0,0,2,2,0,2019-06-29
10470,경기,광주시,6,4,6,16,6,0,2019-07-29
10471,경기,광주시,2,1,2,5,5,0,2019-08-29
10472,경기,광주시,10,1,0,11,8,0,2019-09-29
10473,경기,광주시,10,1,3,14,10,0,2019-10-29
10474,경기,광주시,5,0,1,6,6,1,2019-11-29
10475,경기,광주시,8,2,0,10,7,0,2019-12-29
10476,경기,구리시,2,0,0,2,1,0,2019-01-29
10478,경기,구리시,0,0,0,0,0,0,2019-03-29
10479,경기,구리시,4,2,0,6,5,0,2019-04-29
10480,경기,구리시,1,0,0,1,1,0,2019-05-29
10481,경기,구리시,7,2,1,10,5,0,2019-06-29
10482,경기,구리시,0,0,1,1,1,0,2019-07-29
10483,경기,구리시,3,0,2,5,1,0,2019-08-29
10484,경기,구리시,4,0,0,4,2,0,2019-09-29
10485,경기,구리시,3,0,0,3,3,0,2019-10-29
10486,경기,구리시,2,0,3,5,4,0,2019-11-29
10487,경기,구리시,4,1,0,5,3,0,2019-12-29
10488,경기,군포시,2,2,0,4,3,0,2019-01-29
10490,경기,군포시,1,0,0,1,1,0,2019-03-29
10491,경기,군포시,2,1,0,3,2,0,2019-04-29
10492,경기,군포시,2,0,1,3,3,0,2019-05-29
10493,경기,군포시,2,0,0,2,2,0,2019-06-29
10494,경기,군포시,0,0,0,0,0,0,2019-07-29
10495,경기,군포시,4,1,0,5,4,0,2019-08-29
10496,경기,군포시,5,0,0,5,3,1,2019-09-29
10497,경기,군포시,4,5,0,9,3,0,2019-10-29
10498,경기,군포시,5,1,3,9,5,0,2019-11-29
10499,경기,군포시,0,0,0,0,0,0,2019-12-29
10500,경기,김포시,1,0,1,2,2,0,2019-01-29
10502,경기,김포시,3,2,2,7,6,0,2019-03-29
10503,경기,김포시,4,0,1,5,3,0,2019-04-29
10504,경기,김포시,12,0,1,13,8,0,2019-05-29
10505,경기,김포시,4,1,2,7,7,0,2019-06-29
10506,경기,김포시,13,0,4,17,7,0,2019-07-29
10507,경기,김포시,5,0,0,5,4,0,2019-08-29
10508,경기,김포시,5,0,1,6,4,0,2019-09-29
10509,경기,김포시,3,0,1,4,3,0,2019-10-29
10510,경기,김포시,11,0,3,14,10,0,2019-11-29
10511,경기,김포시,12,1,1,14,4,0,2019-12-29
10512,경기,남양주시,6,1,1,8,5,0,2019-01-29
10514,경기,남양주시,12,0,4,16,13,0,2019-03-29
10515,경기,남양주시,2,0,1,3,3,0,2019-04-29
10516,경기,남양주시,13,0,0,13,7,0,2019-05-29
10517,경기,남양주시,4,0,1,5,5,0,2019-06-29
10518,경기,남양주시,9,1,1,11,8,0,2019-07-29
10519,경기,남양주시,5,3,2,10,7,0,2019-08-29
10520,경기,남양주시,6,2,3,11,8,0,2019-09-29
10521,경기,남양주시,14,0,2,16,10,0,2019-10-29
10522,경기,남양주시,16,5,4,25,9,0,2019-11-29
10523,경기,남양주시,1,0,2,3,3,0,2019-12-29
10524,경기,동두천시,1,0,0,1,1,0,2019-01-29
10526,경기,동두천시,3,0,1,4,3,0,2019-03-29
10527,경기,동두천시,1,1,0,2,2,0,2019-04-29
10528,경기,동두천시,3,0,2,5,2,0,2019-05-29
10529,경기,동두천시,1,1,0,2,1,0,2019-06-29
10530,경기,동두천시,0,0,0,0,0,0,2019-07-29
10531,경기,동두천시,2,0,0,2,1,0,2019-08-29
10532,경기,동두천시,1,0,0,1,1,0,2019-09-29
10533,경기,동두천시,3,0,0,3,2,0,2019-10-29
10534,경기,동두천시,3,0,0,3,1,0,2019-11-29
10535,경기,동두천시,4,0,0,4,2,0,2019-12-29
10536,경기,부천시,7,1,0,8,7,0,2019-01-29
10538,경기,부천시,12,0,2,14,10,1,2019-03-29
10539,경기,부천시,1,0,0,1,1,0,2019-04-29
10540,경기,부천시,7,2,1,10,9,0,2019-05-29
10541,경기,부천시,4,1,1,6,6,0,2019-06-29
10542,경기,부천시,7,0,1,8,7,1,2019-07-29
10543,경기,부천시,17,0,3,20,12,0,2019-08-29
10544,경기,부천시,16,1,3,20,10,0,2019-09-29
10545,경기,부천시,8,1,3,12,11,0,2019-10-29
10546,경기,부천시,15,0,1,16,13,0,2019-11-29
10547,경기,부천시,13,0,2,15,9,0,2019-12-29
10548,경기,성남시,9,1,2,12,8,0,2019-01-29
10550,경기,성남시,4,5,3,12,8,1,2019-03-29
10551,경기,성남시,20,4,2,26,9,0,2019-04-29
10552,경기,성남시,11,0,6,17,17,0,2019-05-29
10553,경기,성남시,13,1,0,14,11,0,2019-06-29
10554,경기,성남시,21,1,4,26,15,1,2019-07-29
10555,경기,성남시,3,1,2,6,7,1,2019-08-29
10556,경기,성남시,11,8,7,26,13,1,2019-09-29
10557,경기,성남시,21,4,7,32,14,0,2019-10-29
10558,경기,성남시,16,0,3,19,14,1,2019-11-29
10559,경기,성남시,7,1,0,8,5,0,2019-12-29
10560,경기,수원시,20,1,5,26,19,0,2019-01-29
10562,경기,수원시,18,0,4,22,13,0,2019-03-29
10563,경기,수원시,8,0,2,10,7,0,2019-04-29
10564,경기,수원시,14,0,0,14,11,0,2019-05-29
10565,경기,수원시,19,1,3,23,16,0,2019-06-29
10566,경기,수원시,10,0,3,13,11,0,2019-07-29
10567,경기,수원시,8,0,3,11,9,0,2019-08-29
10568,경기,수원시,18,5,6,29,16,0,2019-09-29
10569,경기,수원시,11,1,3,15,12,0,2019-10-29
10570,경기,수원시,18,1,1,20,16,0,2019-11-29
10571,경기,수원시,13,0,1,14,8,0,2019-12-29
10572,경기,시흥시,2,0,3,5,3,0,2019-01-29
10574,경기,시흥시,9,0,1,10,8,0,2019-03-29
10575,경기,시흥시,6,0,4,10,9,0,2019-04-29
10576,경기,시흥시,21,0,5,26,7,0,2019-05-29
10577,경기,시흥시,6,1,2,9,8,0,2019-06-29
10578,경기,시흥시,8,0,1,9,8,0,2019-07-29
10579,경기,시흥시,8,1,6,15,11,0,2019-08-29
10580,경기,시흥시,4,0,2,6,3,0,2019-09-29
10581,경기,시흥시,5,0,1,6,6,0,2019-10-29
10582,경기,시흥시,5,0,0,5,5,0,2019-11-29
10583,경기,시흥시,10,0,1,11,5,0,2019-12-29
10584,경기,안산시,14,0,3,17,13,0,2019-01-29
10586,경기,안산시,10,1,2,13,9,0,2019-03-29
10587,경기,안산시,10,1,6,17,11,0,2019-04-29
10588,경기,안산시,6,0,5,11,8,0,2019-05-29
10589,경기,안산시,8,2,3,13,8,0,2019-06-29
10590,경기,안산시,7,0,2,9,7,0,2019-07-29
10591,경기,안산시,3,2,1,6,5,0,2019-08-29
10592,경기,안산시,12,0,2,14,11,0,2019-09-29
10593,경기,안산시,12,0,3,15,11,2,2019-10-29
10594,경기,안산시,13,4,1,18,12,0,2019-11-29
10595,경기,안산시,16,1,0,17,8,0,2019-12-29
10596,경기,안성시,0,0,1,1,1,0,2019-01-29
10598,경기,안성시,3,0,0,3,2,0,2019-03-29
10599,경기,안성시,3,2,0,5,3,0,2019-04-29
10600,경기,안성시,8,4,2,14,5,0,2019-05-29
10601,경기,안성시,5,1,1,7,5,0,2019-06-29
10602,경기,안성시,7,0,2,9,4,0,2019-07-29
10603,경기,안성시,4,0,1,5,5,1,2019-08-29
10604,경기,안성시,7,2,2,11,3,1,2019-09-29
10605,경기,안성시,3,0,0,3,2,0,2019-10-29
10606,경기,안성시,6,1,0,7,4,0,2019-11-29
10607,경기,안성시,1,2,1,4,2,0,2019-12-29
10608,경기,안양시,8,0,1,9,4,0,2019-01-29
10610,경기,안양시,6,1,4,11,7,0,2019-03-29
10611,경기,안양시,9,0,0,9,7,0,2019-04-29
10612,경기,안양시,2,0,2,4,3,0,2019-05-29
10613,경기,안양시,1,0,3,4,3,0,2019-06-29
10614,경기,안양시,9,0,7,16,9,0,2019-07-29
10615,경기,안양시,4,0,1,5,5,0,2019-08-29
10616,경기,안양시,2,2,0,4,2,0,2019-09-29
10617,경기,안양시,4,0,1,5,5,1,2019-10-29
10618,경기,안양시,5,3,1,9,7,1,2019-11-29
10619,경기,안양시,3,0,0,3,1,0,2019-12-29
10620,경기,양주시,0,0,1,1,1,0,2019-01-29
10622,경기,양주시,3,0,0,3,2,0,2019-03-29
10623,경기,양주시,6,1,4,11,7,0,2019-04-29
10624,경기,양주시,3,1,1,5,3,0,2019-05-29
10625,경기,양주시,2,0,1,3,3,0,2019-06-29
10626,경기,양주시,0,0,1,1,1,0,2019-07-29
10627,경기,양주시,1,0,0,1,1,0,2019-08-29
10628,경기,양주시,3,1,0,4,3,0,2019-09-29
10629,경기,양주시,2,0,2,4,4,0,2019-10-29
10630,경기,양주시,5,0,2,7,4,1,2019-11-29
10631,경기,양주시,2,0,0,2,2,0,2019-12-29
10632,경기,양평군,0,0,0,0,0,0,2019-01-29
10634,경기,양평군,1,0,1,2,2,0,2019-03-29
10635,경기,양평군,2,0,0,2,1,0,2019-04-29
10636,경기,양평군,4,1,0,5,4,0,2019-05-29
10637,경기,양평군,0,3,1,4,2,0,2019-06-29
10638,경기,양평군,4,2,1,7,4,0,2019-07-29
10639,경기,양평군,0,0,1,1,1,0,2019-08-29
10640,경기,양평군,2,0,0,2,2,0,2019-09-29
10641,경기,양평군,0,0,1,1,1,0,2019-10-29
10642,경기,양평군,0,0,1,1,1,0,2019-11-29
10643,경기,양평군,0,0,0,0,0,0,2019-12-29
10644,경기,여주시,5,0,0,5,3,0,2019-01-29
10646,경기,여주시,0,0,0,0,0,0,2019-03-29
10647,경기,여주시,0,0,0,0,0,0,2019-04-29
10648,경기,여주시,3,0,0,3,2,0,2019-05-29
10649,경기,여주시,1,0,0,1,1,0,2019-06-29
10650,경기,여주시,5,0,2,7,2,0,2019-07-29
10651,경기,여주시,0,0,0,0,0,0,2019-08-29
10652,경기,여주시,4,0,1,5,3,0,2019-09-29
10653,경기,여주시,2,0,0,2,2,0,2019-10-29
10654,경기,여주시,2,0,1,3,2,0,2019-11-29
10655,경기,여주시,0,1,1,2,2,0,2019-12-29
10656,경기,연천군,1,0,0,1,1,0,2019-01-29
10658,경기,연천군,0,0,0,0,0,0,2019-03-29
10659,경기,연천군,1,0,0,1,1,0,2019-04-29
10660,경기,연천군,0,1,0,1,1,0,2019-05-29
10661,경기,연천군,1,1,1,3,2,0,2019-06-29
10662,경기,연천군,0,0,0,0,0,0,2019-07-29
10663,경기,연천군,6,0,0,6,3,0,2019-08-29
10664,경기,연천군,0,0,0,0,0,0,2019-09-29
10665,경기,연천군,0,0,1,1,1,0,2019-10-29
10666,경기,연천군,2,0,1,3,2,0,2019-11-29
10667,경기,연천군,0,0,0,0,0,0,2019-12-29
10668,경기,오산시,0,0,0,0,0,0,2019-01-29
10670,경기,오산시,2,0,0,2,2,0,2019-03-29
10671,경기,오산시,0,0,0,0,0,0,2019-04-29
10672,경기,오산시,0,0,0,0,0,0,2019-05-29
10673,경기,오산시,6,0,0,6,4,0,2019-06-29
10674,경기,오산시,4,0,1,5,4,0,2019-07-29
10675,경기,오산시,4,1,0,5,3,0,2019-08-29
10676,경기,오산시,1,0,0,1,1,0,2019-09-29
10677,경기,오산시,1,0,2,3,3,0,2019-10-29
10678,경기,오산시,0,0,1,1,1,0,2019-11-29
10679,경기,오산시,3,0,1,4,3,0,2019-12-29
10680,경기,용인시,14,1,5,20,13,0,2019-01-29
10682,경기,용인시,17,3,5,25,14,1,2019-03-29
10683,경기,용인시,15,1,3,19,12,0,2019-04-29
10684,경기,용인시,10,5,5,20,12,0,2019-05-29
10685,경기,용인시,13,1,3,17,8,0,2019-06-29
10686,경기,용인시,9,0,1,10,9,0,2019-07-29
10687,경기,용인시,14,1,2,17,13,0,2019-08-29
10688,경기,용인시,4,1,2,7,4,0,2019-09-29
10689,경기,용인시,11,1,0,12,9,0,2019-10-29
10690,경기,용인시,7,2,4,13,9,0,2019-11-29
10691,경기,용인시,9,1,1,11,8,0,2019-12-29
10692,경기,의왕시,0,0,0,0,0,0,2019-01-29
10694,경기,의왕시,1,0,0,1,1,0,2019-03-29
10695,경기,의왕시,2,0,0,2,2,0,2019-04-29
10696,경기,의왕시,1,0,0,1,1,0,2019-05-29
10697,경기,의왕시,0,0,3,3,1,0,2019-06-29
10698,경기,의왕시,1,0,0,1,1,0,2019-07-29
10699,경기,의왕시,4,0,1,5,3,0,2019-08-29
10700,경기,의왕시,3,0,1,4,3,0,2019-09-29
10701,경기,의왕시,2,0,0,2,2,0,2019-10-29
10702,경기,의왕시,1,0,1,2,2,0,2019-11-29
10703,경기,의왕시,0,0,0,0,0,0,2019-12-29
10704,경기,의정부시,6,0,0,6,3,0,2019-01-29
10706,경기,의정부시,9,1,1,11,6,0,2019-03-29
10707,경기,의정부시,0,0,3,3,3,0,2019-04-29
10708,경기,의정부시,6,0,1,7,4,0,2019-05-29
10709,경기,의정부시,7,0,0,7,7,1,2019-06-29
10710,경기,의정부시,3,0,2,5,5,0,2019-07-29
10711,경기,의정부시,7,0,1,8,6,0,2019-08-29
10712,경기,의정부시,8,1,0,9,6,1,2019-09-29
10713,경기,의정부시,3,0,2,5,5,0,2019-10-29
10714,경기,의정부시,15,1,3,19,15,0,2019-11-29
10715,경기,의정부시,1,0,1,2,1,0,2019-12-29
10716,경기,이천시,4,0,0,4,4,0,2019-01-29
10718,경기,이천시,4,0,0,4,4,1,2019-03-29
10719,경기,이천시,5,0,2,7,5,0,2019-04-29
10720,경기,이천시,5,0,0,5,3,0,2019-05-29
10721,경기,이천시,3,0,3,6,4,0,2019-06-29
10722,경기,이천시,1,0,0,1,1,0,2019-07-29
10723,경기,이천시,4,0,2,6,5,0,2019-08-29
10724,경기,이천시,3,0,2,5,4,0,2019-09-29
10725,경기,이천시,4,2,2,8,7,0,2019-10-29
10726,경기,이천시,2,0,1,3,3,0,2019-11-29
10727,경기,이천시,1,1,1,3,3,0,2019-12-29
10728,경기,파주시,6,0,1,7,5,0,2019-01-29
10730,경기,파주시,6,0,1,7,5,0,2019-03-29
10731,경기,파주시,2,0,0,2,2,0,2019-04-29
10732,경기,파주시,1,1,1,3,2,0,2019-05-29
10733,경기,파주시,4,2,3,9,6,0,2019-06-29
10734,경기,파주시,10,0,3,13,8,0,2019-07-29
10735,경기,파주시,10,0,2,12,7,0,2019-08-29
10736,경기,파주시,2,0,1,3,2,0,2019-09-29
10737,경기,파주시,6,0,3,9,6,0,2019-10-29
10738,경기,파주시,4,2,2,8,5,0,2019-11-29
10739,경기,파주시,2,0,0,2,1,0,2019-12-29
10740,경기,평택시,10,4,1,15,9,0,2019-01-29
10742,경기,평택시,17,1,2,20,9,0,2019-03-29
10743,경기,평택시,9,0,0,9,9,1,2019-04-29
10744,경기,평택시,12,1,3,16,8,0,2019-05-29
10745,경기,평택시,4,1,1,6,5,0,2019-06-29
10746,경기,평택시,14,0,2,16,11,1,2019-07-29
10747,경기,평택시,9,3,1,13,8,0,2019-08-29
10748,경기,평택시,11,1,2,14,9,0,2019-09-29
10749,경기,평택시,13,0,6,19,12,0,2019-10-29
10750,경기,평택시,25,4,4,33,18,0,2019-11-29
10751,경기,평택시,20,6,2,28,10,0,2019-12-29
10752,경기,포천시,4,0,0,4,1,0,2019-01-29
10754,경기,포천시,2,0,0,2,2,1,2019-03-29
10755,경기,포천시,3,2,0,5,3,0,2019-04-29
10756,경기,포천시,0,0,0,0,0,0,2019-05-29
10757,경기,포천시,4,0,2,6,4,1,2019-06-29
10758,경기,포천시,1,2,2,5,4,0,2019-07-29
10759,경기,포천시,0,0,0,0,0,0,2019-08-29
10760,경기,포천시,2,0,0,2,2,0,2019-09-29
10761,경기,포천시,2,0,0,2,2,0,2019-10-29
10762,경기,포천시,1,1,1,3,3,0,2019-11-29
10763,경기,포천시,0,0,0,0,0,0,2019-12-29
10764,경기,하남시,1,0,0,1,1,0,2019-01-29
10766,경기,하남시,3,0,0,3,2,0,2019-03-29
10767,경기,하남시,1,0,2,3,3,0,2019-04-29
10768,경기,하남시,2,1,1,4,3,0,2019-05-29
10769,경기,하남시,3,5,2,10,5,1,2019-06-29
10770,경기,하남시,4,1,1,6,5,0,2019-07-29
10771,경기,하남시,0,0,1,1,1,0,2019-08-29
10772,경기,하남시,4,0,0,4,4,0,2019-09-29
10773,경기,하남시,4,1,0,5,5,0,2019-10-29
10774,경기,하남시,3,1,2,6,4,0,2019-11-29
10775,경기,하남시,3,0,2,5,2,0,2019-12-29
10776,경기,화성시,8,0,2,10,9,0,2019-01-29
10778,경기,화성시,4,0,4,8,5,0,2019-03-29
10779,경기,화성시,6,0,1,7,4,0,2019-04-29
10780,경기,화성시,14,2,2,18,9,0,2019-05-29
10781,경기,화성시,9,0,2,11,4,0,2019-06-29
10782,경기,화성시,15,0,2,17,11,0,2019-07-29
10783,경기,화성시,14,0,3,17,13,0,2019-08-29
10784,경기,화성시,4,0,0,4,3,0,2019-09-29
10785,경기,화성시,12,3,6,21,8,0,2019-10-29
10786,경기,화성시,14,2,2,18,11,0,2019-11-29
10787,경기,화성시,8,0,0,8,3,0,2019-12-29
10788,경기,가평군,3,0,0,3,1,0,2019-01-30
10790,경기,가평군,5,0,1,6,3,0,2019-03-30
10791,경기,가평군,0,0,0,0,0,0,2019-04-30
10792,경기,가평군,0,0,0,0,0,0,2019-05-30
10793,경기,가평군,6,0,0,6,2,0,2019-06-30
10794,경기,가평군,0,0,0,0,0,0,2019-07-30
10795,경기,가평군,0,0,1,1,1,0,2019-08-30
10796,경기,가평군,0,1,0,1,1,0,2019-09-30
10797,경기,가평군,2,0,0,2,1,0,2019-10-30
10798,경기,가평군,0,0,0,0,1,1,2019-11-30
10799,경기,가평군,0,1,0,1,1,0,2019-12-30
10800,경기,고양시,6,1,1,8,8,0,2019-01-30
10802,경기,고양시,14,6,2,22,18,0,2019-03-30
10803,경기,고양시,15,6,5,26,16,0,2019-04-30
10804,경기,고양시,11,1,1,13,10,0,2019-05-30
10805,경기,고양시,6,1,1,8,6,0,2019-06-30
10806,경기,고양시,4,2,1,7,5,0,2019-07-30
10807,경기,고양시,16,3,3,22,13,0,2019-08-30
10808,경기,고양시,15,0,7,22,13,1,2019-09-30
10809,경기,고양시,8,2,3,13,11,0,2019-10-30
10810,경기,고양시,9,1,1,11,8,0,2019-11-30
10811,경기,고양시,12,2,2,16,9,0,2019-12-30
10812,경기,과천시,1,0,1,2,2,0,2019-01-30
10814,경기,과천시,1,0,1,2,2,0,2019-03-30
10815,경기,과천시,0,0,0,0,0,0,2019-04-30
10816,경기,과천시,1,0,0,1,1,0,2019-05-30
10817,경기,과천시,0,0,0,0,0,0,2019-06-30
10818,경기,과천시,0,0,0,0,0,0,2019-07-30
10819,경기,과천시,0,0,0,0,0,0,2019-08-30
10820,경기,과천시,1,0,0,1,1,0,2019-09-30
10821,경기,과천시,0,0,0,0,0,0,2019-10-30
10822,경기,과천시,0,0,0,0,0,0,2019-11-30
10823,경기,과천시,0,0,0,0,0,0,2019-12-30
10824,경기,광명시,1,2,1,4,3,0,2019-01-30
10826,경기,광명시,3,0,0,3,2,0,2019-03-30
10827,경기,광명시,2,0,0,2,1,0,2019-04-30
10828,경기,광명시,1,0,0,1,1,0,2019-05-30
10829,경기,광명시,2,0,1,3,3,0,2019-06-30
10830,경기,광명시,1,4,2,7,2,0,2019-07-30
10831,경기,광명시,3,3,0,6,4,0,2019-08-30
10832,경기,광명시,1,0,0,1,1,0,2019-09-30
10833,경기,광명시,4,2,0,6,6,0,2019-10-30
10834,경기,광명시,2,1,1,4,3,0,2019-11-30
10835,경기,광명시,2,1,1,4,3,0,2019-12-30
10836,경기,광주시,14,0,2,16,9,0,2019-01-30
10838,경기,광주시,6,0,0,6,6,0,2019-03-30
10839,경기,광주시,7,0,2,9,5,0,2019-04-30
10840,경기,광주시,3,0,0,3,3,0,2019-05-30
10841,경기,광주시,2,0,0,2,2,0,2019-06-30
10842,경기,광주시,16,0,4,20,11,0,2019-07-30
10843,경기,광주시,5,0,0,5,4,0,2019-08-30
10844,경기,광주시,10,0,0,10,7,0,2019-09-30
10845,경기,광주시,6,1,0,7,5,0,2019-10-30
10846,경기,광주시,2,0,1,3,3,0,2019-11-30
10847,경기,광주시,8,0,0,8,6,0,2019-12-30
10848,경기,구리시,6,0,0,6,4,0,2019-01-30
10850,경기,구리시,1,0,0,1,1,0,2019-03-30
10851,경기,구리시,2,0,1,3,2,0,2019-04-30
10852,경기,구리시,0,0,0,0,0,0,2019-05-30
10853,경기,구리시,1,0,1,2,2,0,2019-06-30
10854,경기,구리시,0,0,1,1,1,0,2019-07-30
10855,경기,구리시,2,0,0,2,2,0,2019-08-30
10856,경기,구리시,1,1,1,3,2,0,2019-09-30
10857,경기,구리시,2,0,0,2,1,0,2019-10-30
10858,경기,구리시,0,1,0,1,1,0,2019-11-30
10859,경기,구리시,0,0,0,0,0,0,2019-12-30
10860,경기,군포시,0,0,0,0,0,0,2019-01-30
10862,경기,군포시,2,0,0,2,2,0,2019-03-30
10863,경기,군포시,3,4,1,8,3,0,2019-04-30
10864,경기,군포시,0,0,0,0,0,0,2019-05-30
10865,경기,군포시,0,0,1,1,1,0,2019-06-30
10866,경기,군포시,2,0,1,3,2,0,2019-07-30
10867,경기,군포시,1,0,1,2,1,0,2019-08-30
10868,경기,군포시,0,0,1,1,1,0,2019-09-30
10869,경기,군포시,5,0,1,6,3,0,2019-10-30
10870,경기,군포시,3,1,4,8,2,0,2019-11-30
10871,경기,군포시,0,2,1,3,3,0,2019-12-30
10872,경기,김포시,9,0,2,11,5,0,2019-01-30
10874,경기,김포시,4,0,1,5,4,0,2019-03-30
10875,경기,김포시,2,1,0,3,3,0,2019-04-30
10876,경기,김포시,5,1,5,11,7,0,2019-05-30
10877,경기,김포시,1,1,1,3,2,0,2019-06-30
10878,경기,김포시,4,1,2,7,7,0,2019-07-30
10879,경기,김포시,4,0,2,6,5,0,2019-08-30
10880,경기,김포시,5,0,0,5,5,0,2019-09-30
10881,경기,김포시,8,0,5,13,9,0,2019-10-30
10882,경기,김포시,3,2,2,7,6,0,2019-11-30
10883,경기,김포시,8,0,2,10,7,0,2019-12-30
10884,경기,남양주시,12,0,1,13,5,0,2019-01-30
10886,경기,남양주시,9,0,3,12,5,0,2019-03-30
10887,경기,남양주시,10,1,2,13,9,0,2019-04-30
10888,경기,남양주시,15,4,4,23,12,0,2019-05-30
10889,경기,남양주시,12,2,2,16,8,0,2019-06-30
10890,경기,남양주시,3,0,4,7,6,0,2019-07-30
10891,경기,남양주시,13,1,1,15,10,0,2019-08-30
10892,경기,남양주시,4,1,3,8,6,0,2019-09-30
10893,경기,남양주시,13,0,3,16,10,0,2019-10-30
10894,경기,남양주시,10,2,3,15,11,1,2019-11-30
10895,경기,남양주시,13,1,1,15,8,0,2019-12-30
10896,경기,동두천시,0,0,0,0,0,0,2019-01-30
10898,경기,동두천시,0,0,0,0,0,0,2019-03-30
10899,경기,동두천시,1,0,0,1,1,0,2019-04-30
10900,경기,동두천시,0,0,0,0,0,0,2019-05-30
10901,경기,동두천시,0,1,0,1,1,0,2019-06-30
10902,경기,동두천시,1,0,0,1,1,0,2019-07-30
10903,경기,동두천시,1,0,1,2,2,0,2019-08-30
10904,경기,동두천시,5,0,1,6,5,1,2019-09-30
10905,경기,동두천시,0,0,0,0,0,0,2019-10-30
10906,경기,동두천시,1,0,0,1,1,0,2019-11-30
10907,경기,동두천시,2,0,1,3,3,0,2019-12-30
10908,경기,부천시,8,0,2,10,6,0,2019-01-30
10910,경기,부천시,17,0,3,20,11,0,2019-03-30
10911,경기,부천시,5,0,2,7,6,0,2019-04-30
10912,경기,부천시,19,1,3,23,16,0,2019-05-30
10913,경기,부천시,13,1,3,17,11,0,2019-06-30
10914,경기,부천시,2,0,0,2,2,0,2019-07-30
10915,경기,부천시,17,3,1,21,16,1,2019-08-30
10916,경기,부천시,13,0,3,16,12,0,2019-09-30
10917,경기,부천시,11,1,4,16,9,0,2019-10-30
10918,경기,부천시,9,2,5,16,12,0,2019-11-30
10919,경기,부천시,10,0,5,15,11,0,2019-12-30
10920,경기,성남시,15,1,4,20,12,0,2019-01-30
10922,경기,성남시,18,1,7,26,14,0,2019-03-30
10923,경기,성남시,7,0,1,8,6,0,2019-04-30
10924,경기,성남시,12,0,1,13,10,0,2019-05-30
10925,경기,성남시,7,17,1,25,5,0,2019-06-30
10926,경기,성남시,9,1,4,14,8,0,2019-07-30
10927,경기,성남시,13,11,7,31,15,0,2019-08-30
10928,경기,성남시,15,0,5,20,15,0,2019-09-30
10929,경기,성남시,24,1,6,31,14,0,2019-10-30
10930,경기,성남시,16,4,1,21,12,0,2019-11-30
10931,경기,성남시,9,0,0,9,7,0,2019-12-30
10932,경기,수원시,6,0,1,7,5,0,2019-01-30
10934,경기,수원시,21,2,4,27,18,0,2019-03-30
10935,경기,수원시,18,3,5,26,22,0,2019-04-30
10936,경기,수원시,11,2,3,16,11,0,2019-05-30
10937,경기,수원시,13,0,4,17,11,0,2019-06-30
10938,경기,수원시,11,3,0,14,11,0,2019-07-30
10939,경기,수원시,9,0,2,11,9,0,2019-08-30
10940,경기,수원시,27,2,1,30,21,0,2019-09-30
10941,경기,수원시,12,0,9,21,12,0,2019-10-30
10942,경기,수원시,32,2,3,37,16,0,2019-11-30
10943,경기,수원시,20,1,1,22,16,1,2019-12-30
10944,경기,시흥시,6,1,1,8,8,0,2019-01-30
10946,경기,시흥시,11,0,2,13,8,0,2019-03-30
10947,경기,시흥시,8,0,2,10,7,0,2019-04-30
10948,경기,시흥시,4,0,5,9,9,0,2019-05-30
10949,경기,시흥시,6,0,0,6,2,0,2019-06-30
10950,경기,시흥시,4,1,0,5,4,0,2019-07-30
10951,경기,시흥시,9,1,3,13,10,0,2019-08-30
10952,경기,시흥시,6,0,2,8,7,0,2019-09-30
10953,경기,시흥시,1,1,4,6,5,0,2019-10-30
10954,경기,시흥시,17,0,1,18,10,0,2019-11-30
10955,경기,시흥시,4,0,4,8,6,0,2019-12-30
10956,경기,안산시,12,1,2,15,13,0,2019-01-30
10958,경기,안산시,11,1,5,17,12,0,2019-03-30
10959,경기,안산시,21,0,8,29,21,0,2019-04-30
10960,경기,안산시,11,0,2,13,8,0,2019-05-30
10961,경기,안산시,8,0,3,11,10,0,2019-06-30
10962,경기,안산시,12,4,3,19,10,0,2019-07-30
10963,경기,안산시,16,0,5,21,15,0,2019-08-30
10964,경기,안산시,12,0,1,13,10,0,2019-09-30
10965,경기,안산시,14,1,4,19,14,0,2019-10-30
10966,경기,안산시,16,2,6,24,15,0,2019-11-30
10967,경기,안산시,12,0,2,14,10,0,2019-12-30
10968,경기,안성시,0,0,1,1,1,0,2019-01-30
10970,경기,안성시,12,0,1,13,5,1,2019-03-30
10971,경기,안성시,5,15,0,20,2,0,2019-04-30
10972,경기,안성시,0,0,0,0,0,0,2019-05-30
10973,경기,안성시,1,0,0,1,1,0,2019-06-30
10974,경기,안성시,4,0,3,7,5,0,2019-07-30
10975,경기,안성시,0,0,2,2,2,0,2019-08-30
10976,경기,안성시,1,0,1,2,2,0,2019-09-30
10977,경기,안성시,6,2,2,10,6,0,2019-10-30
10978,경기,안성시,0,1,1,2,2,0,2019-11-30
10979,경기,안성시,1,2,1,4,4,1,2019-12-30
10980,경기,안양시,2,0,0,2,2,0,2019-01-30
10982,경기,안양시,8,2,0,10,6,0,2019-03-30
10983,경기,안양시,2,0,1,3,3,0,2019-04-30
10984,경기,안양시,5,1,1,7,6,0,2019-05-30
10985,경기,안양시,5,0,1,6,3,0,2019-06-30
10986,경기,안양시,9,0,0,9,5,0,2019-07-30
10987,경기,안양시,11,1,1,13,6,0,2019-08-30
10988,경기,안양시,5,1,2,8,6,0,2019-09-30
10989,경기,안양시,5,0,1,6,5,0,2019-10-30
10990,경기,안양시,8,0,0,8,5,0,2019-11-30
10991,경기,안양시,4,0,1,5,4,0,2019-12-30
10992,경기,양주시,7,0,3,10,7,0,2019-01-30
10994,경기,양주시,3,0,1,4,3,0,2019-03-30
10995,경기,양주시,1,0,1,2,2,0,2019-04-30
10996,경기,양주시,2,0,0,2,2,0,2019-05-30
10997,경기,양주시,4,0,0,4,2,0,2019-06-30
10998,경기,양주시,10,2,3,15,9,0,2019-07-30
10999,경기,양주시,1,0,1,2,2,0,2019-08-30
11000,경기,양주시,6,0,0,6,4,0,2019-09-30
11001,경기,양주시,1,0,2,3,2,0,2019-10-30
11002,경기,양주시,5,1,0,6,4,0,2019-11-30
11003,경기,양주시,6,0,1,7,4,0,2019-12-30
11004,경기,양평군,0,0,0,0,0,0,2019-01-30
11006,경기,양평군,2,0,1,3,1,0,2019-03-30
11007,경기,양평군,0,0,0,0,0,0,2019-04-30
11008,경기,양평군,0,0,0,0,0,0,2019-05-30
11009,경기,양평군,0,1,0,1,1,0,2019-06-30
11010,경기,양평군,0,0,0,0,0,0,2019-07-30
11011,경기,양평군,2,1,0,3,2,0,2019-08-30
11012,경기,양평군,3,0,0,3,2,0,2019-09-30
11013,경기,양평군,5,0,0,5,4,0,2019-10-30
11014,경기,양평군,1,0,0,1,1,0,2019-11-30
11015,경기,양평군,3,4,0,7,3,0,2019-12-30
11016,경기,여주시,0,0,0,0,0,0,2019-01-30
11018,경기,여주시,5,0,1,6,4,0,2019-03-30
11019,경기,여주시,3,0,0,3,1,0,2019-04-30
11020,경기,여주시,1,0,0,1,1,0,2019-05-30
11021,경기,여주시,0,0,0,0,0,0,2019-06-30
11022,경기,여주시,4,0,4,8,3,0,2019-07-30
11023,경기,여주시,18,0,4,22,5,0,2019-08-30
11024,경기,여주시,0,0,0,0,0,0,2019-09-30
11025,경기,여주시,1,0,0,1,1,0,2019-10-30
11026,경기,여주시,2,0,0,2,2,0,2019-11-30
11027,경기,여주시,2,0,0,2,1,0,2019-12-30
11028,경기,연천군,0,0,0,0,0,0,2019-01-30
11030,경기,연천군,1,0,0,1,1,0,2019-03-30
11031,경기,연천군,1,0,0,1,1,0,2019-04-30
11032,경기,연천군,0,0,0,0,0,0,2019-05-30
11033,경기,연천군,0,0,0,0,0,0,2019-06-30
11034,경기,연천군,2,0,0,2,1,0,2019-07-30
11035,경기,연천군,6,0,1,7,3,0,2019-08-30
11036,경기,연천군,0,0,1,1,1,0,2019-09-30
11037,경기,연천군,0,0,0,0,0,0,2019-10-30
11038,경기,연천군,0,0,0,0,0,0,2019-11-30
11039,경기,연천군,0,0,0,0,0,0,2019-12-30
11040,경기,오산시,3,0,1,4,1,0,2019-01-30
11042,경기,오산시,8,1,3,12,4,0,2019-03-30
11043,경기,오산시,5,2,1,8,4,0,2019-04-30
11044,경기,오산시,5,0,1,6,3,0,2019-05-30
11045,경기,오산시,0,1,1,2,2,0,2019-06-30
11046,경기,오산시,3,0,1,4,2,0,2019-07-30
11047,경기,오산시,6,0,0,6,4,0,2019-08-30
11048,경기,오산시,5,0,1,6,4,0,2019-09-30
11049,경기,오산시,10,0,1,11,8,0,2019-10-30
11050,경기,오산시,3,0,1,4,4,0,2019-11-30
11051,경기,오산시,1,0,0,1,1,0,2019-12-30
11052,경기,용인시,8,0,4,12,10,0,2019-01-30
11054,경기,용인시,12,0,2,14,8,0,2019-03-30
11055,경기,용인시,7,1,1,9,8,1,2019-04-30
11056,경기,용인시,11,3,4,18,13,0,2019-05-30
11057,경기,용인시,8,7,7,22,8,0,2019-06-30
11058,경기,용인시,7,3,0,10,5,0,2019-07-30
11059,경기,용인시,13,3,8,24,16,1,2019-08-30
11060,경기,용인시,8,1,1,10,9,0,2019-09-30
11061,경기,용인시,12,2,5,19,17,0,2019-10-30
11062,경기,용인시,7,1,1,9,9,1,2019-11-30
11063,경기,용인시,10,1,2,13,9,0,2019-12-30
11064,경기,의왕시,1,0,0,1,1,0,2019-01-30
11066,경기,의왕시,1,0,0,1,1,0,2019-03-30
11067,경기,의왕시,0,0,0,0,0,0,2019-04-30
11068,경기,의왕시,0,0,0,0,0,0,2019-05-30
11069,경기,의왕시,0,0,1,1,1,0,2019-06-30
11070,경기,의왕시,3,0,0,3,1,0,2019-07-30
11071,경기,의왕시,4,0,1,5,3,0,2019-08-30
11072,경기,의왕시,0,1,1,2,2,0,2019-09-30
11073,경기,의왕시,5,0,0,5,2,0,2019-10-30
11074,경기,의왕시,7,1,0,8,2,0,2019-11-30
11075,경기,의왕시,1,0,0,1,1,0,2019-12-30
11076,경기,의정부시,3,0,0,3,3,0,2019-01-30
11078,경기,의정부시,4,1,0,5,5,0,2019-03-30
11079,경기,의정부시,2,0,5,7,6,0,2019-04-30
11080,경기,의정부시,3,0,1,4,2,0,2019-05-30
11081,경기,의정부시,0,1,0,1,1,0,2019-06-30
11082,경기,의정부시,4,1,1,6,5,0,2019-07-30
11083,경기,의정부시,4,0,0,4,4,0,2019-08-30
11084,경기,의정부시,4,1,1,6,5,0,2019-09-30
11085,경기,의정부시,7,3,2,12,8,0,2019-10-30
11086,경기,의정부시,7,3,3,13,8,0,2019-11-30
11087,경기,의정부시,8,0,5,13,10,0,2019-12-30
11088,경기,이천시,1,1,2,4,3,0,2019-01-30
11090,경기,이천시,7,0,0,7,4,0,2019-03-30
11091,경기,이천시,1,1,1,3,3,0,2019-04-30
11092,경기,이천시,9,0,1,10,5,2,2019-05-30
11093,경기,이천시,6,0,0,6,2,0,2019-06-30
11094,경기,이천시,2,0,0,2,2,0,2019-07-30
11095,경기,이천시,2,0,2,4,4,0,2019-08-30
11096,경기,이천시,0,0,1,1,1,0,2019-09-30
11097,경기,이천시,4,0,2,6,5,0,2019-10-30
11098,경기,이천시,6,0,0,6,6,1,2019-11-30
11099,경기,이천시,8,0,1,9,4,0,2019-12-30
11100,경기,파주시,8,0,2,10,7,0,2019-01-30
11102,경기,파주시,12,1,2,15,10,0,2019-03-30
11103,경기,파주시,3,0,1,4,4,0,2019-04-30
11104,경기,파주시,5,0,0,5,4,0,2019-05-30
11105,경기,파주시,10,0,1,11,4,1,2019-06-30
11106,경기,파주시,7,0,4,11,4,0,2019-07-30
11107,경기,파주시,2,1,1,4,4,0,2019-08-30
11108,경기,파주시,4,0,3,7,8,1,2019-09-30
11109,경기,파주시,13,1,1,15,10,1,2019-10-30
11110,경기,파주시,8,1,1,10,8,0,2019-11-30
11111,경기,파주시,1,0,1,2,2,0,2019-12-30
11112,경기,평택시,7,0,5,12,8,0,2019-01-30
11114,경기,평택시,22,4,5,31,11,0,2019-03-30
11115,경기,평택시,11,1,0,12,9,1,2019-04-30
11116,경기,평택시,6,0,0,6,5,0,2019-05-30
11117,경기,평택시,10,2,0,12,5,0,2019-06-30
11118,경기,평택시,5,2,0,7,6,0,2019-07-30
11119,경기,평택시,15,0,2,17,10,0,2019-08-30
11120,경기,평택시,9,1,2,12,8,0,2019-09-30
11121,경기,평택시,21,1,1,23,16,0,2019-10-30
11122,경기,평택시,6,2,5,13,8,0,2019-11-30
11123,경기,평택시,8,4,3,15,10,0,2019-12-30
11124,경기,포천시,1,0,0,1,1,0,2019-01-30
11126,경기,포천시,2,1,0,3,3,0,2019-03-30
11127,경기,포천시,5,0,1,6,3,0,2019-04-30
11128,경기,포천시,4,0,0,4,2,0,2019-05-30
11129,경기,포천시,6,0,5,11,4,0,2019-06-30
11130,경기,포천시,2,2,0,4,5,1,2019-07-30
11131,경기,포천시,1,0,1,2,2,0,2019-08-30
11132,경기,포천시,0,0,2,2,2,0,2019-09-30
11133,경기,포천시,2,1,0,3,4,1,2019-10-30
11134,경기,포천시,3,13,0,16,3,0,2019-11-30
11135,경기,포천시,3,0,0,3,3,0,2019-12-30
11136,경기,하남시,4,0,0,4,2,0,2019-01-30
11138,경기,하남시,6,3,1,10,6,0,2019-03-30
11139,경기,하남시,5,0,1,6,4,0,2019-04-30
11140,경기,하남시,1,1,0,2,2,0,2019-05-30
11141,경기,하남시,2,0,0,2,2,0,2019-06-30
11142,경기,하남시,0,2,1,3,2,0,2019-07-30
11143,경기,하남시,0,0,1,1,1,0,2019-08-30
11144,경기,하남시,2,0,1,3,3,0,2019-09-30
11145,경기,하남시,4,0,1,5,3,0,2019-10-30
11146,경기,하남시,6,2,0,8,4,0,2019-11-30
11147,경기,하남시,1,0,0,1,1,0,2019-12-30
11148,경기,화성시,10,0,1,11,10,0,2019-01-30
11150,경기,화성시,11,0,1,12,5,0,2019-03-30
11151,경기,화성시,13,2,6,21,9,0,2019-04-30
11152,경기,화성시,10,0,3,13,10,0,2019-05-30
11153,경기,화성시,2,0,0,2,2,0,2019-06-30
11154,경기,화성시,10,1,4,15,10,0,2019-07-30
11155,경기,화성시,5,1,1,7,6,0,2019-08-30
11156,경기,화성시,5,0,2,7,5,0,2019-09-30
11157,경기,화성시,12,4,6,22,13,0,2019-10-30
11158,경기,화성시,10,0,2,12,10,0,2019-11-30
11159,경기,화성시,8,0,2,10,8,0,2019-12-30
11160,경기,가평군,0,0,0,0,0,0,2019-01-31
11162,경기,가평군,0,0,1,1,1,0,2019-03-31
11164,경기,가평군,3,0,0,3,2,0,2019-05-31
11166,경기,가평군,5,0,0,5,3,0,2019-07-31
11167,경기,가평군,0,0,1,1,1,0,2019-08-31
11169,경기,가평군,0,0,0,0,0,0,2019-10-31
11171,경기,가평군,1,2,0,3,2,0,2019-12-31
11172,경기,고양시,3,3,0,6,5,0,2019-01-31
11174,경기,고양시,19,1,0,20,10,0,2019-03-31
11176,경기,고양시,21,1,4,26,10,0,2019-05-31
11178,경기,고양시,10,0,1,11,9,0,2019-07-31
11179,경기,고양시,7,2,2,11,10,1,2019-08-31
11181,경기,고양시,22,2,4,28,14,0,2019-10-31
11183,경기,고양시,12,1,2,15,9,0,2019-12-31
11184,경기,과천시,0,1,0,1,1,0,2019-01-31
11186,경기,과천시,0,0,0,0,0,0,2019-03-31
11188,경기,과천시,0,0,0,0,0,0,2019-05-31
11190,경기,과천시,0,0,0,0,0,0,2019-07-31
11191,경기,과천시,0,0,0,0,0,0,2019-08-31
11193,경기,과천시,0,0,0,0,1,1,2019-10-31
11195,경기,과천시,3,0,0,3,3,0,2019-12-31
11196,경기,광명시,2,0,1,3,3,0,2019-01-31
11198,경기,광명시,2,0,0,2,2,0,2019-03-31
11200,경기,광명시,2,2,0,4,4,0,2019-05-31
11202,경기,광명시,0,0,1,1,1,0,2019-07-31
11203,경기,광명시,0,1,0,1,1,0,2019-08-31
11205,경기,광명시,3,3,1,7,5,0,2019-10-31
11207,경기,광명시,2,2,0,4,3,0,2019-12-31
11208,경기,광주시,10,1,3,14,4,0,2019-01-31
11210,경기,광주시,8,0,3,11,6,0,2019-03-31
11212,경기,광주시,17,0,1,18,4,0,2019-05-31
11214,경기,광주시,5,0,5,10,7,0,2019-07-31
11215,경기,광주시,5,0,0,5,5,0,2019-08-31
11217,경기,광주시,4,0,2,6,6,0,2019-10-31
11219,경기,광주시,5,0,1,6,6,0,2019-12-31
11220,경기,구리시,0,0,0,0,0,0,2019-01-31
11222,경기,구리시,1,0,0,1,1,0,2019-03-31
11224,경기,구리시,0,0,1,1,1,0,2019-05-31
11226,경기,구리시,3,0,0,3,1,0,2019-07-31
11227,경기,구리시,1,0,0,1,1,0,2019-08-31
11229,경기,구리시,1,1,0,2,2,0,2019-10-31
11231,경기,구리시,2,0,1,3,2,0,2019-12-31
11232,경기,군포시,1,0,0,1,2,1,2019-01-31
11234,경기,군포시,1,0,1,2,1,0,2019-03-31
11236,경기,군포시,6,2,3,11,3,0,2019-05-31
11238,경기,군포시,1,0,0,1,1,0,2019-07-31
11239,경기,군포시,0,1,0,1,1,0,2019-08-31
11241,경기,군포시,2,0,1,3,3,0,2019-10-31
11243,경기,군포시,2,0,0,2,2,0,2019-12-31
11244,경기,김포시,3,1,0,4,4,0,2019-01-31
11246,경기,김포시,2,0,0,2,1,0,2019-03-31
11248,경기,김포시,3,0,3,6,4,0,2019-05-31
11250,경기,김포시,1,1,2,4,4,0,2019-07-31
11251,경기,김포시,26,1,1,28,7,0,2019-08-31
11253,경기,김포시,7,1,2,10,8,0,2019-10-31
11255,경기,김포시,3,1,1,5,5,0,2019-12-31
11256,경기,남양주시,5,0,2,7,4,0,2019-01-31
11258,경기,남양주시,4,1,0,5,4,0,2019-03-31
11260,경기,남양주시,6,1,3,10,7,0,2019-05-31
11262,경기,남양주시,7,0,0,7,6,0,2019-07-31
11263,경기,남양주시,6,2,2,10,6,0,2019-08-31
11265,경기,남양주시,10,0,2,12,9,0,2019-10-31
11267,경기,남양주시,7,0,2,9,7,0,2019-12-31
11268,경기,동두천시,0,1,2,3,3,0,2019-01-31
11270,경기,동두천시,3,0,0,3,1,0,2019-03-31
11272,경기,동두천시,0,0,0,0,0,0,2019-05-31
11274,경기,동두천시,0,0,0,0,0,0,2019-07-31
11275,경기,동두천시,1,1,0,2,2,0,2019-08-31
11277,경기,동두천시,0,0,1,1,1,0,2019-10-31
11279,경기,동두천시,1,0,0,1,1,0,2019-12-31
11280,경기,부천시,13,1,5,19,16,1,2019-01-31
11282,경기,부천시,3,1,2,6,4,0,2019-03-31
11284,경기,부천시,7,0,0,7,7,0,2019-05-31
11286,경기,부천시,9,2,2,13,8,0,2019-07-31
11287,경기,부천시,17,3,2,22,17,0,2019-08-31
11289,경기,부천시,10,1,1,12,10,0,2019-10-31
11291,경기,부천시,9,0,3,12,7,0,2019-12-31
11292,경기,성남시,2,0,3,5,5,0,2019-01-31
11294,경기,성남시,5,1,0,6,5,0,2019-03-31
11296,경기,성남시,18,4,0,22,13,0,2019-05-31
11298,경기,성남시,13,2,6,21,9,0,2019-07-31
11299,경기,성남시,8,2,4,14,11,0,2019-08-31
11301,경기,성남시,13,0,2,15,7,0,2019-10-31
11303,경기,성남시,12,3,2,17,12,0,2019-12-31
11304,경기,수원시,16,0,7,23,21,0,2019-01-31
11306,경기,수원시,23,1,2,26,17,0,2019-03-31
11308,경기,수원시,13,2,4,19,17,0,2019-05-31
11310,경기,수원시,10,2,2,14,9,0,2019-07-31
11311,경기,수원시,23,0,3,26,19,0,2019-08-31
11313,경기,수원시,25,2,4,31,21,0,2019-10-31
11315,경기,수원시,16,0,0,16,9,0,2019-12-31
11316,경기,시흥시,6,0,2,8,6,0,2019-01-31
11318,경기,시흥시,7,0,0,7,4,0,2019-03-31
11320,경기,시흥시,14,1,3,18,9,0,2019-05-31
11322,경기,시흥시,9,0,2,11,8,0,2019-07-31
11323,경기,시흥시,12,0,2,14,11,0,2019-08-31
11325,경기,시흥시,11,0,2,13,10,0,2019-10-31
11327,경기,시흥시,9,0,3,12,10,0,2019-12-31
11328,경기,안산시,20,0,5,25,19,0,2019-01-31
11330,경기,안산시,18,1,1,20,11,0,2019-03-31
11332,경기,안산시,13,0,0,13,9,0,2019-05-31
11334,경기,안산시,11,3,6,20,15,0,2019-07-31
11335,경기,안산시,15,1,4,20,16,0,2019-08-31
11337,경기,안산시,11,2,4,17,10,0,2019-10-31
11339,경기,안산시,14,2,2,18,11,0,2019-12-31
11340,경기,안성시,5,0,1,6,5,0,2019-01-31
11342,경기,안성시,1,0,0,1,1,0,2019-03-31
11344,경기,안성시,12,2,1,15,3,0,2019-05-31
11346,경기,안성시,9,0,3,12,4,0,2019-07-31
11347,경기,안성시,8,0,0,8,2,0,2019-08-31
11349,경기,안성시,7,1,0,8,4,0,2019-10-31
11351,경기,안성시,3,0,3,6,2,0,2019-12-31
11352,경기,안양시,3,0,0,3,3,0,2019-01-31
11354,경기,안양시,5,0,1,6,5,1,2019-03-31
11356,경기,안양시,7,0,1,8,6,0,2019-05-31
11358,경기,안양시,7,0,3,10,7,0,2019-07-31
11359,경기,안양시,9,0,2,11,5,0,2019-08-31
11361,경기,안양시,6,3,3,12,6,1,2019-10-31
11363,경기,안양시,5,1,1,7,4,0,2019-12-31
11364,경기,양주시,2,0,0,2,3,2,2019-01-31
11366,경기,양주시,3,0,0,3,1,0,2019-03-31
11368,경기,양주시,9,0,0,9,4,0,2019-05-31
11370,경기,양주시,1,0,0,1,1,0,2019-07-31
11371,경기,양주시,7,0,0,7,2,0,2019-08-31
11373,경기,양주시,7,0,0,7,5,0,2019-10-31
11375,경기,양주시,7,1,1,9,4,0,2019-12-31
11376,경기,양평군,0,0,0,0,0,0,2019-01-31
11378,경기,양평군,1,0,0,1,1,0,2019-03-31
11380,경기,양평군,4,0,0,4,2,0,2019-05-31
11382,경기,양평군,3,0,0,3,1,0,2019-07-31
11383,경기,양평군,4,1,3,8,6,0,2019-08-31
11385,경기,양평군,3,2,0,5,3,0,2019-10-31
11387,경기,양평군,0,0,0,0,0,0,2019-12-31
11388,경기,여주시,0,0,2,2,2,0,2019-01-31
11390,경기,여주시,2,0,1,3,1,0,2019-03-31
11392,경기,여주시,1,0,1,2,2,0,2019-05-31
11394,경기,여주시,1,0,0,1,1,0,2019-07-31
11395,경기,여주시,4,0,0,4,1,0,2019-08-31
11397,경기,여주시,6,0,0,6,4,0,2019-10-31
11399,경기,여주시,1,0,0,1,1,0,2019-12-31
11400,경기,연천군,0,0,0,0,1,1,2019-01-31
11402,경기,연천군,0,0,0,0,0,0,2019-03-31
11404,경기,연천군,2,0,0,2,1,0,2019-05-31
11406,경기,연천군,0,0,0,0,0,0,2019-07-31
11407,경기,연천군,4,0,3,7,1,0,2019-08-31
11409,경기,연천군,0,0,0,0,0,0,2019-10-31
11411,경기,연천군,0,0,0,0,0,0,2019-12-31
11412,경기,오산시,0,0,1,1,2,1,2019-01-31
11414,경기,오산시,1,0,1,2,2,0,2019-03-31
11416,경기,오산시,2,0,1,3,3,0,2019-05-31
11418,경기,오산시,6,0,1,7,5,0,2019-07-31
11419,경기,오산시,0,0,1,1,1,0,2019-08-31
11421,경기,오산시,2,0,2,4,4,0,2019-10-31
11423,경기,오산시,1,0,2,3,3,0,2019-12-31
11424,경기,용인시,9,1,3,13,9,0,2019-01-31
11426,경기,용인시,1,0,1,2,4,2,2019-03-31
11428,경기,용인시,18,2,1,21,14,0,2019-05-31
11430,경기,용인시,12,5,2,19,11,0,2019-07-31
11431,경기,용인시,12,2,3,17,11,0,2019-08-31
11433,경기,용인시,16,4,1,21,15,0,2019-10-31
11435,경기,용인시,11,3,5,19,13,0,2019-12-31
11436,경기,의왕시,5,2,0,7,1,0,2019-01-31
11438,경기,의왕시,0,0,1,1,1,0,2019-03-31
11440,경기,의왕시,0,0,1,1,1,0,2019-05-31
11442,경기,의왕시,2,0,0,2,2,0,2019-07-31
11443,경기,의왕시,0,0,0,0,0,0,2019-08-31
11445,경기,의왕시,1,0,0,1,1,0,2019-10-31
11447,경기,의왕시,3,0,0,3,2,0,2019-12-31
11448,경기,의정부시,6,2,3,11,6,0,2019-01-31
11450,경기,의정부시,2,3,1,6,2,0,2019-03-31
11452,경기,의정부시,3,2,1,6,3,0,2019-05-31
11454,경기,의정부시,4,0,0,4,4,0,2019-07-31
11455,경기,의정부시,8,2,2,12,5,0,2019-08-31
11457,경기,의정부시,8,1,6,15,7,1,2019-10-31
11459,경기,의정부시,5,3,1,9,5,0,2019-12-31
11460,경기,이천시,2,0,0,2,1,0,2019-01-31
11462,경기,이천시,2,0,0,2,2,0,2019-03-31
11464,경기,이천시,4,0,0,4,4,0,2019-05-31
11466,경기,이천시,6,1,0,7,2,0,2019-07-31
11467,경기,이천시,3,0,2,5,5,0,2019-08-31
11469,경기,이천시,5,0,1,6,4,0,2019-10-31
11471,경기,이천시,7,1,1,9,3,0,2019-12-31
11472,경기,파주시,3,0,0,3,3,0,2019-01-31
11474,경기,파주시,2,0,1,3,2,0,2019-03-31
11476,경기,파주시,6,0,0,6,5,0,2019-05-31
11478,경기,파주시,5,0,0,5,5,1,2019-07-31
11479,경기,파주시,3,0,0,3,3,0,2019-08-31
11481,경기,파주시,7,2,1,10,7,0,2019-10-31
11483,경기,파주시,5,0,4,9,8,0,2019-12-31
11484,경기,평택시,6,0,2,8,8,1,2019-01-31
11486,경기,평택시,16,0,0,16,8,0,2019-03-31
11488,경기,평택시,11,6,4,21,15,0,2019-05-31
11490,경기,평택시,10,1,1,12,9,0,2019-07-31
11491,경기,평택시,9,6,4,19,12,0,2019-08-31
11493,경기,평택시,13,1,4,18,14,1,2019-10-31
11495,경기,평택시,8,1,3,12,9,0,2019-12-31
11496,경기,포천시,0,0,2,2,1,0,2019-01-31
11498,경기,포천시,4,1,0,5,3,0,2019-03-31
11500,경기,포천시,4,0,0,4,2,0,2019-05-31
11502,경기,포천시,5,0,1,6,4,0,2019-07-31
11503,경기,포천시,2,0,0,2,1,0,2019-08-31
11505,경기,포천시,11,1,0,12,6,0,2019-10-31
11507,경기,포천시,4,0,3,7,4,0,2019-12-31
11508,경기,하남시,3,1,1,5,4,0,2019-01-31
11510,경기,하남시,0,0,0,0,0,0,2019-03-31
11512,경기,하남시,7,0,0,7,6,0,2019-05-31
11514,경기,하남시,1,0,0,1,1,0,2019-07-31
11515,경기,하남시,1,0,0,1,1,0,2019-08-31
11517,경기,하남시,0,0,1,1,1,0,2019-10-31
11519,경기,하남시,3,0,0,3,3,0,2019-12-31
11520,경기,화성시,8,0,2,10,9,0,2019-01-31
11522,경기,화성시,3,0,0,3,2,0,2019-03-31
11524,경기,화성시,7,2,2,11,9,0,2019-05-31
11526,경기,화성시,4,0,1,5,5,0,2019-07-31
11527,경기,화성시,8,2,4,14,9,0,2019-08-31
11529,경기,화성시,19,0,4,23,10,0,2019-10-31
11531,경기,화성시,9,3,1,13,8,0,2019-12-31
0,인천,강화군,1,0,0,1,1,0,2018-01-01
1,인천,강화군,1,0,0,1,1,0,2018-02-01
2,인천,강화군,0,0,1,1,1,0,2018-03-01
3,인천,강화군,0,0,0,0,0,0,2018-04-01
4,인천,강화군,1,0,0,1,1,0,2018-05-01
5,인천,강화군,0,0,0,0,0,0,2018-06-01
6,인천,강화군,5,0,3,8,3,0,2018-07-01
7,인천,강화군,0,0,0,0,0,0,2018-08-01
8,인천,강화군,1,0,0,1,1,0,2018-09-01
9,인천,강화군,0,4,0,4,1,0,2018-10-01
10,인천,강화군,0,0,2,2,1,0,2018-11-01
11,인천,강화군,0,0,0,0,0,0,2018-12-01
12,인천,계양구,1,1,1,3,3,0,2018-01-01
13,인천,계양구,1,0,3,4,4,0,2018-02-01
14,인천,계양구,2,0,0,2,1,0,2018-03-01
15,인천,계양구,0,0,0,0,0,0,2018-04-01
16,인천,계양구,3,0,0,3,2,0,2018-05-01
17,인천,계양구,2,0,0,2,1,0,2018-06-01
18,인천,계양구,1,1,3,5,4,0,2018-07-01
19,인천,계양구,1,0,0,1,1,0,2018-08-01
20,인천,계양구,0,1,0,1,1,0,2018-09-01
21,인천,계양구,4,0,0,4,3,0,2018-10-01
22,인천,계양구,0,0,0,0,0,0,2018-11-01
23,인천,계양구,1,0,1,2,2,0,2018-12-01
24,인천,남동구,4,0,0,4,2,0,2018-01-01
25,인천,남동구,7,2,4,13,9,0,2018-02-01
26,인천,남동구,5,0,2,7,3,0,2018-03-01
27,인천,남동구,1,0,1,2,2,0,2018-04-01
28,인천,남동구,5,0,1,6,4,0,2018-05-01
29,인천,남동구,2,2,0,4,4,0,2018-06-01
30,인천,남동구,3,0,1,4,2,0,2018-07-01
31,인천,남동구,2,1,0,3,3,0,2018-08-01
32,인천,남동구,2,0,0,2,1,0,2018-09-01
33,인천,남동구,1,0,1,2,2,0,2018-10-01
34,인천,남동구,11,0,2,13,9,0,2018-11-01
35,인천,남동구,4,1,0,5,3,0,2018-12-01
36,인천,동구,0,0,0,0,0,0,2018-01-01
37,인천,동구,0,0,1,1,1,0,2018-02-01
38,인천,동구,0,0,0,0,0,0,2018-03-01
39,인천,동구,0,0,1,1,1,0,2018-04-01
40,인천,동구,0,0,0,0,0,0,2018-05-01
41,인천,동구,0,0,0,0,0,0,2018-06-01
42,인천,동구,1,0,0,1,1,0,2018-07-01
43,인천,동구,0,0,1,1,1,0,2018-08-01
44,인천,동구,0,0,0,0,0,0,2018-09-01
45,인천,동구,0,0,0,0,0,0,2018-10-01
46,인천,동구,0,0,1,1,1,0,2018-11-01
47,인천,동구,0,0,0,0,0,0,2018-12-01
48,인천,미추홀구,3,0,1,4,2,0,2018-01-01
49,인천,미추홀구,0,0,0,0,0,0,2018-02-01
50,인천,미추홀구,9,0,0,9,3,0,2018-03-01
51,인천,미추홀구,3,1,2,6,3,0,2018-04-01
52,인천,미추홀구,4,0,1,5,4,0,2018-05-01
53,인천,미추홀구,6,1,1,8,5,0,2018-06-01
54,인천,미추홀구,5,0,1,6,4,0,2018-07-01
55,인천,미추홀구,2,0,0,2,3,1,2018-08-01
56,인천,미추홀구,2,0,1,3,3,0,2018-09-01
57,인천,미추홀구,1,1,1,3,2,0,2018-10-01
58,인천,미추홀구,7,1,1,9,6,0,2018-11-01
59,인천,미추홀구,1,0,0,1,1,0,2018-12-01
60,인천,부평구,2,0,2,4,3,0,2018-01-01
61,인천,부평구,7,2,1,10,6,1,2018-02-01
62,인천,부평구,9,0,0,9,3,0,2018-03-01
63,인천,부평구,2,0,2,4,2,0,2018-04-01
64,인천,부평구,1,0,0,1,1,0,2018-05-01
65,인천,부평구,1,1,1,3,2,0,2018-06-01
66,인천,부평구,9,1,2,12,8,0,2018-07-01
67,인천,부평구,3,0,1,4,4,0,2018-08-01
68,인천,부평구,1,1,0,2,2,0,2018-09-01
69,인천,부평구,4,1,0,5,5,0,2018-10-01
70,인천,부평구,1,0,0,1,1,0,2018-11-01
71,인천,부평구,4,0,0,4,2,0,2018-12-01
72,인천,서구,8,0,1,9,5,0,2018-01-01
73,인천,서구,7,0,3,10,8,0,2018-02-01
74,인천,서구,11,0,2,13,8,0,2018-03-01
75,인천,서구,1,0,2,3,1,0,2018-04-01
76,인천,서구,8,0,1,9,5,0,2018-05-01
77,인천,서구,4,0,0,4,3,0,2018-06-01
78,인천,서구,4,0,1,5,4,0,2018-07-01
79,인천,서구,4,0,1,5,5,0,2018-08-01
80,인천,서구,2,2,1,5,4,0,2018-09-01
81,인천,서구,8,0,1,9,6,1,2018-10-01
82,인천,서구,5,0,2,7,5,0,2018-11-01
83,인천,서구,4,0,0,4,3,0,2018-12-01
84,인천,연수구,3,0,0,3,2,0,2018-01-01
85,인천,연수구,1,0,0,1,1,0,2018-02-01
86,인천,연수구,2,0,0,2,1,0,2018-03-01
87,인천,연수구,0,0,0,0,0,0,2018-04-01
88,인천,연수구,1,0,1,2,1,0,2018-05-01
89,인천,연수구,2,0,2,4,3,0,2018-06-01
90,인천,연수구,1,1,0,2,2,0,2018-07-01
91,인천,연수구,3,0,2,5,3,0,2018-08-01
92,인천,연수구,2,0,1,3,3,0,2018-09-01
93,인천,연수구,2,0,1,3,3,0,2018-10-01
94,인천,연수구,1,0,0,1,1,0,2018-11-01
95,인천,연수구,0,0,1,1,1,0,2018-12-01
96,인천,옹진군,0,0,0,0,0,0,2018-01-01
97,인천,옹진군,0,0,0,0,0,0,2018-03-01
98,인천,옹진군,1,0,0,1,1,0,2018-04-01
99,인천,옹진군,0,0,0,0,0,0,2018-05-01
100,인천,옹진군,0,0,0,0,0,0,2018-06-01
101,인천,옹진군,2,0,0,2,1,0,2018-07-01
102,인천,옹진군,0,0,0,0,0,0,2018-08-01
103,인천,옹진군,0,0,0,0,0,0,2018-09-01
104,인천,옹진군,1,0,2,3,1,0,2018-10-01
105,인천,옹진군,0,0,0,0,0,0,2018-11-01
106,인천,옹진군,0,0,0,0,0,0,2018-12-01
107,인천,중구,0,0,0,0,0,0,2018-01-01
108,인천,중구,0,0,0,0,0,0,2018-02-01
109,인천,중구,0,0,0,0,0,0,2018-03-01
110,인천,중구,0,0,0,0,0,0,2018-04-01
111,인천,중구,1,1,1,3,2,0,2018-05-01
112,인천,중구,0,0,0,0,0,0,2018-06-01
113,인천,중구,0,0,1,1,1,0,2018-07-01
114,인천,중구,2,0,1,3,3,0,2018-08-01
115,인천,중구,11,0,2,13,5,0,2018-09-01
116,인천,중구,3,0,0,3,2,0,2018-10-01
117,인천,중구,1,3,0,4,2,0,2018-11-01
118,인천,중구,1,0,0,1,1,0,2018-12-01
119,인천,강화군,0,0,0,0,0,0,2018-01-02
120,인천,강화군,0,0,0,0,0,0,2018-02-02
121,인천,강화군,0,0,1,1,1,0,2018-03-02
122,인천,강화군,3,0,0,3,1,0,2018-04-02
123,인천,강화군,0,0,0,0,0,0,2018-05-02
124,인천,강화군,0,0,0,0,0,0,2018-06-02
125,인천,강화군,0,0,0,0,0,0,2018-07-02
126,인천,강화군,0,0,0,0,0,0,2018-08-02
127,인천,강화군,0,0,0,0,0,0,2018-09-02
128,인천,강화군,1,0,0,1,1,0,2018-10-02
129,인천,강화군,1,0,0,1,1,0,2018-11-02
130,인천,강화군,1,0,1,2,1,0,2018-12-02
131,인천,계양구,0,0,0,0,0,0,2018-01-02
132,인천,계양구,0,0,0,0,0,0,2018-02-02
133,인천,계양구,1,0,0,1,1,0,2018-03-02
134,인천,계양구,0,0,0,0,0,0,2018-04-02
135,인천,계양구,0,0,0,0,0,0,2018-05-02
136,인천,계양구,3,0,0,3,3,0,2018-06-02
137,인천,계양구,5,0,1,6,5,0,2018-07-02
138,인천,계양구,2,0,1,3,2,0,2018-08-02
139,인천,계양구,2,0,0,2,1,0,2018-09-02
140,인천,계양구,0,0,2,2,2,0,2018-10-02
141,인천,계양구,2,0,1,3,3,0,2018-11-02
142,인천,계양구,2,0,1,3,2,0,2018-12-02
143,인천,남동구,3,0,2,5,3,0,2018-01-02
144,인천,남동구,7,0,4,11,7,0,2018-02-02
145,인천,남동구,8,0,2,10,3,0,2018-03-02
146,인천,남동구,5,0,2,7,4,0,2018-04-02
147,인천,남동구,3,0,1,4,3,0,2018-05-02
148,인천,남동구,13,3,4,20,8,0,2018-06-02
149,인천,남동구,10,0,0,10,7,0,2018-07-02
150,인천,남동구,3,0,0,3,2,0,2018-08-02
151,인천,남동구,5,0,0,5,5,0,2018-09-02
152,인천,남동구,4,0,1,5,5,0,2018-10-02
153,인천,남동구,6,0,7,13,10,0,2018-11-02
154,인천,남동구,4,0,0,4,2,0,2018-12-02
155,인천,동구,2,0,0,2,1,0,2018-01-02
156,인천,동구,0,0,0,0,0,0,2018-02-02
157,인천,동구,1,1,0,2,1,0,2018-03-02
158,인천,동구,0,0,0,0,0,0,2018-04-02
159,인천,동구,0,0,0,0,0,0,2018-05-02
160,인천,동구,0,0,3,3,2,0,2018-06-02
161,인천,동구,0,0,1,1,1,0,2018-07-02
162,인천,동구,0,0,0,0,0,0,2018-08-02
163,인천,동구,0,0,1,1,1,0,2018-09-02
164,인천,동구,0,0,0,0,0,0,2018-10-02
165,인천,동구,0,0,0,0,0,0,2018-11-02
166,인천,동구,0,0,0,0,0,0,2018-12-02
167,인천,미추홀구,3,0,0,3,3,0,2018-01-02
168,인천,미추홀구,2,0,0,2,2,0,2018-02-02
169,인천,미추홀구,3,0,1,4,3,0,2018-03-02
170,인천,미추홀구,3,0,1,4,4,0,2018-04-02
171,인천,미추홀구,2,0,0,2,2,0,2018-05-02
172,인천,미추홀구,1,0,2,3,3,0,2018-06-02
173,인천,미추홀구,2,0,0,2,1,0,2018-07-02
174,인천,미추홀구,4,0,0,4,2,0,2018-08-02
175,인천,미추홀구,4,0,2,6,3,0,2018-09-02
176,인천,미추홀구,4,0,1,5,3,0,2018-10-02
177,인천,미추홀구,0,0,2,2,2,0,2018-11-02
178,인천,미추홀구,1,3,0,4,3,0,2018-12-02
179,인천,부평구,5,0,3,8,5,0,2018-01-02
180,인천,부평구,4,0,0,4,4,0,2018-02-02
181,인천,부평구,2,0,1,3,2,0,2018-03-02
182,인천,부평구,0,0,0,0,0,0,2018-04-02
183,인천,부평구,5,0,0,5,3,0,2018-05-02
184,인천,부평구,2,0,2,4,4,0,2018-06-02
185,인천,부평구,8,0,3,11,7,0,2018-07-02
186,인천,부평구,0,0,0,0,0,0,2018-08-02
187,인천,부평구,2,0,1,3,3,0,2018-09-02
188,인천,부평구,5,0,1,6,5,0,2018-10-02
189,인천,부평구,3,0,3,6,6,0,2018-11-02
190,인천,부평구,3,0,0,3,2,0,2018-12-02
191,인천,서구,3,0,1,4,2,0,2018-01-02
192,인천,서구,10,0,2,12,7,0,2018-02-02
193,인천,서구,3,0,0,3,2,0,2018-03-02
194,인천,서구,2,0,2,4,3,0,2018-04-02
195,인천,서구,5,0,1,6,5,0,2018-05-02
196,인천,서구,1,0,4,5,5,0,2018-06-02
197,인천,서구,5,0,2,7,6,0,2018-07-02
198,인천,서구,4,0,0,4,2,0,2018-08-02
199,인천,서구,9,1,0,10,2,0,2018-09-02
200,인천,서구,0,0,1,1,1,0,2018-10-02
201,인천,서구,3,0,1,4,4,0,2018-11-02
202,인천,서구,1,0,1,2,2,0,2018-12-02
203,인천,연수구,2,0,0,2,1,0,2018-01-02
204,인천,연수구,3,0,0,3,2,0,2018-02-02
205,인천,연수구,4,0,1,5,2,0,2018-03-02
206,인천,연수구,0,0,1,1,1,0,2018-04-02
207,인천,연수구,4,0,0,4,2,0,2018-05-02
208,인천,연수구,2,0,0,2,1,0,2018-06-02
209,인천,연수구,1,0,0,1,1,0,2018-07-02
210,인천,연수구,0,0,2,2,2,0,2018-08-02
211,인천,연수구,4,0,0,4,3,0,2018-09-02
212,인천,연수구,3,0,2,5,3,0,2018-10-02
213,인천,연수구,1,0,0,1,1,0,2018-11-02
214,인천,연수구,5,0,0,5,1,0,2018-12-02
215,인천,옹진군,0,0,0,0,0,0,2018-01-02
216,인천,옹진군,0,0,0,0,0,0,2018-03-02
217,인천,옹진군,0,0,0,0,0,0,2018-04-02
218,인천,옹진군,0,0,0,0,0,0,2018-05-02
219,인천,옹진군,0,0,0,0,0,0,2018-06-02
220,인천,옹진군,0,0,0,0,0,0,2018-07-02
221,인천,옹진군,0,0,0,0,0,0,2018-08-02
222,인천,옹진군,0,0,0,0,0,0,2018-09-02
223,인천,옹진군,0,0,0,0,0,0,2018-10-02
224,인천,옹진군,0,0,0,0,0,0,2018-11-02
225,인천,옹진군,0,0,0,0,0,0,2018-12-02
226,인천,중구,0,0,0,0,0,0,2018-01-02
227,인천,중구,1,0,0,1,1,0,2018-02-02
228,인천,중구,2,0,1,3,2,0,2018-03-02
229,인천,중구,2,0,0,2,1,0,2018-04-02
230,인천,중구,4,1,0,5,3,0,2018-05-02
231,인천,중구,0,0,0,0,0,0,2018-06-02
232,인천,중구,0,0,0,0,0,0,2018-07-02
233,인천,중구,1,0,0,1,1,0,2018-08-02
234,인천,중구,1,0,0,1,1,0,2018-09-02
235,인천,중구,0,0,0,0,0,0,2018-10-02
236,인천,중구,3,0,1,4,2,0,2018-11-02
237,인천,중구,0,0,0,0,0,0,2018-12-02
238,인천,강화군,0,0,0,0,0,0,2018-01-03
239,인천,강화군,0,0,0,0,0,0,2018-02-03
240,인천,강화군,0,0,0,0,0,0,2018-03-03
241,인천,강화군,0,0,0,0,0,0,2018-04-03
242,인천,강화군,0,0,0,0,0,0,2018-05-03
243,인천,강화군,0,0,0,0,0,0,2018-06-03
244,인천,강화군,0,0,0,0,0,0,2018-07-03
245,인천,강화군,0,0,0,0,0,0,2018-08-03
246,인천,강화군,1,0,0,1,1,0,2018-09-03
247,인천,강화군,0,0,2,2,1,0,2018-10-03
248,인천,강화군,0,0,0,0,0,0,2018-11-03
249,인천,강화군,0,0,0,0,0,0,2018-12-03
250,인천,계양구,3,0,2,5,4,0,2018-01-03
251,인천,계양구,3,1,4,8,5,0,2018-02-03
252,인천,계양구,1,0,0,1,1,0,2018-03-03
253,인천,계양구,1,0,3,4,4,0,2018-04-03
254,인천,계양구,0,0,1,1,1,0,2018-05-03
255,인천,계양구,6,3,1,10,6,0,2018-06-03
256,인천,계양구,1,0,1,2,2,0,2018-07-03
257,인천,계양구,0,0,0,0,0,0,2018-08-03
258,인천,계양구,0,0,1,1,1,0,2018-09-03
259,인천,계양구,1,0,0,1,1,0,2018-10-03
260,인천,계양구,1,0,1,2,2,0,2018-11-03
261,인천,계양구,1,0,0,1,1,0,2018-12-03
262,인천,남동구,4,0,0,4,3,0,2018-01-03
263,인천,남동구,18,2,4,24,14,0,2018-02-03
264,인천,남동구,7,1,2,10,5,0,2018-03-03
265,인천,남동구,5,0,5,10,8,0,2018-04-03
266,인천,남동구,5,0,1,6,5,0,2018-05-03
267,인천,남동구,5,0,1,6,4,0,2018-06-03
268,인천,남동구,0,1,2,3,3,0,2018-07-03
269,인천,남동구,7,1,0,8,4,0,2018-08-03
270,인천,남동구,6,0,3,9,6,0,2018-09-03
271,인천,남동구,6,0,0,6,5,0,2018-10-03
272,인천,남동구,3,0,0,3,2,0,2018-11-03
273,인천,남동구,10,1,2,13,9,0,2018-12-03
274,인천,동구,0,0,0,0,0,0,2018-01-03
275,인천,동구,0,0,0,0,0,0,2018-02-03
276,인천,동구,0,0,0,0,0,0,2018-03-03
277,인천,동구,1,0,0,1,1,0,2018-04-03
278,인천,동구,0,0,0,0,0,0,2018-05-03
279,인천,동구,0,0,0,0,0,0,2018-06-03
280,인천,동구,2,0,0,2,1,0,2018-07-03
281,인천,동구,0,0,0,0,0,0,2018-08-03
282,인천,동구,0,0,0,0,0,0,2018-09-03
283,인천,동구,1,0,0,1,1,0,2018-10-03
284,인천,동구,0,0,0,0,0,0,2018-11-03
285,인천,동구,0,0,0,0,0,0,2018-12-03
286,인천,미추홀구,5,0,0,5,3,0,2018-01-03
287,인천,미추홀구,4,1,1,6,6,0,2018-02-03
288,인천,미추홀구,5,1,2,8,5,1,2018-03-03
289,인천,미추홀구,2,0,0,2,2,0,2018-04-03
290,인천,미추홀구,5,1,2,8,5,0,2018-05-03
291,인천,미추홀구,1,0,2,3,2,0,2018-06-03
292,인천,미추홀구,0,0,0,0,0,0,2018-07-03
293,인천,미추홀구,1,0,0,1,1,0,2018-08-03
294,인천,미추홀구,5,3,0,8,6,0,2018-09-03
295,인천,미추홀구,1,1,0,2,2,0,2018-10-03
296,인천,미추홀구,3,0,1,4,4,1,2018-11-03
297,인천,미추홀구,2,0,0,2,2,0,2018-12-03
298,인천,부평구,1,0,1,2,2,0,2018-01-03
299,인천,부평구,10,0,0,10,7,0,2018-02-03
300,인천,부평구,8,0,0,8,3,0,2018-03-03
301,인천,부평구,1,0,0,1,1,0,2018-04-03
302,인천,부평구,9,0,0,9,5,0,2018-05-03
303,인천,부평구,4,0,0,4,3,0,2018-06-03
304,인천,부평구,2,0,1,3,3,0,2018-07-03
305,인천,부평구,1,1,1,3,3,0,2018-08-03
306,인천,부평구,0,0,0,0,0,0,2018-09-03
307,인천,부평구,9,0,3,12,3,1,2018-10-03
308,인천,부평구,10,0,2,12,8,0,2018-11-03
309,인천,부평구,1,0,0,1,1,0,2018-12-03
310,인천,서구,3,1,2,6,6,0,2018-01-03
311,인천,서구,7,0,3,10,8,0,2018-02-03
312,인천,서구,2,0,0,2,2,0,2018-03-03
313,인천,서구,0,0,0,0,0,0,2018-04-03
314,인천,서구,4,0,1,5,4,0,2018-05-03
315,인천,서구,3,0,1,4,4,0,2018-06-03
316,인천,서구,3,0,0,3,3,0,2018-07-03
317,인천,서구,4,0,1,5,4,0,2018-08-03
318,인천,서구,8,0,2,10,6,0,2018-09-03
319,인천,서구,0,0,1,1,1,0,2018-10-03
320,인천,서구,3,0,0,3,3,1,2018-11-03
321,인천,서구,3,0,1,4,4,0,2018-12-03
322,인천,연수구,1,0,0,1,1,0,2018-01-03
323,인천,연수구,3,0,0,3,2,0,2018-02-03
324,인천,연수구,0,0,0,0,0,0,2018-03-03
325,인천,연수구,1,0,1,2,2,0,2018-04-03
326,인천,연수구,6,0,1,7,5,0,2018-05-03
327,인천,연수구,2,0,1,3,1,0,2018-06-03
328,인천,연수구,3,0,2,5,4,1,2018-07-03
329,인천,연수구,0,0,0,0,0,0,2018-08-03
330,인천,연수구,3,0,1,4,4,0,2018-09-03
331,인천,연수구,1,0,0,1,1,0,2018-10-03
332,인천,연수구,5,0,2,7,6,0,2018-11-03
333,인천,연수구,0,0,0,0,0,0,2018-12-03
334,인천,옹진군,0,0,0,0,0,0,2018-01-03
335,인천,옹진군,0,0,0,0,0,0,2018-03-03
336,인천,옹진군,0,0,0,0,0,0,2018-04-03
337,인천,옹진군,0,0,0,0,0,0,2018-05-03
338,인천,옹진군,0,0,0,0,0,0,2018-06-03
339,인천,옹진군,0,0,0,0,0,0,2018-07-03
340,인천,옹진군,0,0,0,0,0,0,2018-08-03
341,인천,옹진군,0,0,0,0,0,0,2018-09-03
342,인천,옹진군,0,0,0,0,0,0,2018-10-03
343,인천,옹진군,0,0,0,0,0,0,2018-11-03
344,인천,옹진군,0,0,0,0,0,0,2018-12-03
345,인천,중구,1,0,0,1,1,0,2018-01-03
346,인천,중구,1,0,1,2,2,0,2018-02-03
347,인천,중구,2,0,1,3,3,0,2018-03-03
348,인천,중구,0,0,0,0,0,0,2018-04-03
349,인천,중구,1,0,0,1,1,0,2018-05-03
350,인천,중구,0,0,0,0,0,0,2018-06-03
351,인천,중구,3,0,0,3,2,0,2018-07-03
352,인천,중구,5,1,0,6,3,0,2018-08-03
353,인천,중구,0,0,0,0,0,0,2018-09-03
354,인천,중구,0,0,0,0,0,0,2018-10-03
355,인천,중구,1,0,1,2,2,0,2018-11-03
356,인천,중구,0,0,1,1,1,0,2018-12-03
357,인천,강화군,0,0,0,0,0,0,2018-01-04
358,인천,강화군,0,0,0,0,0,0,2018-02-04
359,인천,강화군,0,0,0,0,0,0,2018-03-04
360,인천,강화군,0,0,0,0,0,0,2018-04-04
361,인천,강화군,0,0,1,1,1,0,2018-05-04
362,인천,강화군,0,0,0,0,0,0,2018-06-04
363,인천,강화군,1,0,0,1,1,0,2018-07-04
364,인천,강화군,0,0,0,0,0,0,2018-08-04
365,인천,강화군,1,0,1,2,2,0,2018-09-04
366,인천,강화군,0,0,0,0,0,0,2018-10-04
367,인천,강화군,0,0,0,0,0,0,2018-11-04
368,인천,강화군,0,0,0,0,0,0,2018-12-04
369,인천,계양구,1,0,0,1,1,0,2018-01-04
370,인천,계양구,8,0,2,10,3,0,2018-02-04
371,인천,계양구,1,0,1,2,2,0,2018-03-04
372,인천,계양구,2,0,2,4,4,0,2018-04-04
373,인천,계양구,1,0,2,3,3,0,2018-05-04
374,인천,계양구,0,0,5,5,4,0,2018-06-04
375,인천,계양구,1,0,2,3,4,1,2018-07-04
376,인천,계양구,1,2,0,3,2,0,2018-08-04
377,인천,계양구,2,0,0,2,2,0,2018-09-04
378,인천,계양구,1,0,0,1,1,0,2018-10-04
379,인천,계양구,3,0,0,3,1,0,2018-11-04
380,인천,계양구,1,0,1,2,2,0,2018-12-04
381,인천,남동구,7,0,0,7,4,0,2018-01-04
382,인천,남동구,9,0,1,10,5,0,2018-02-04
383,인천,남동구,3,0,3,6,4,0,2018-03-04
384,인천,남동구,6,0,1,7,6,0,2018-04-04
385,인천,남동구,3,1,1,5,5,0,2018-05-04
386,인천,남동구,4,0,1,5,4,0,2018-06-04
387,인천,남동구,3,0,0,3,2,0,2018-07-04
388,인천,남동구,7,1,0,8,6,0,2018-08-04
389,인천,남동구,7,0,2,9,6,0,2018-09-04
390,인천,남동구,6,2,4,12,9,0,2018-10-04
391,인천,남동구,1,0,5,6,6,0,2018-11-04
392,인천,남동구,4,0,1,5,4,0,2018-12-04
393,인천,동구,0,1,0,1,1,0,2018-01-04
394,인천,동구,2,0,0,2,2,0,2018-02-04
395,인천,동구,0,0,0,0,0,0,2018-03-04
396,인천,동구,0,0,0,0,0,0,2018-04-04
397,인천,동구,0,0,1,1,1,0,2018-05-04
398,인천,동구,0,0,0,0,0,0,2018-06-04
399,인천,동구,0,0,0,0,0,0,2018-07-04
400,인천,동구,0,0,0,0,0,0,2018-08-04
401,인천,동구,2,0,1,3,2,0,2018-09-04
402,인천,동구,0,0,0,0,0,0,2018-10-04
403,인천,동구,0,0,0,0,0,0,2018-11-04
404,인천,동구,1,0,0,1,1,0,2018-12-04
405,인천,미추홀구,3,0,0,3,2,0,2018-01-04
406,인천,미추홀구,5,1,0,6,4,0,2018-02-04
407,인천,미추홀구,0,0,0,0,0,0,2018-03-04
408,인천,미추홀구,1,1,2,4,3,0,2018-04-04
409,인천,미추홀구,1,0,1,2,2,0,2018-05-04
410,인천,미추홀구,2,2,0,4,4,0,2018-06-04
411,인천,미추홀구,5,0,1,6,3,0,2018-07-04
412,인천,미추홀구,3,0,0,3,2,0,2018-08-04
413,인천,미추홀구,0,1,1,2,2,0,2018-09-04
414,인천,미추홀구,9,0,2,11,5,0,2018-10-04
415,인천,미추홀구,3,3,2,8,3,0,2018-11-04
416,인천,미추홀구,1,0,0,1,1,0,2018-12-04
417,인천,부평구,3,0,0,3,3,0,2018-01-04
418,인천,부평구,13,0,1,14,8,0,2018-02-04
419,인천,부평구,5,0,0,5,4,0,2018-03-04
420,인천,부평구,4,0,3,7,5,0,2018-04-04
421,인천,부평구,2,0,0,2,2,0,2018-05-04
422,인천,부평구,1,0,0,1,1,0,2018-06-04
423,인천,부평구,5,0,0,5,4,0,2018-07-04
424,인천,부평구,5,1,1,7,5,0,2018-08-04
425,인천,부평구,4,1,1,6,3,0,2018-09-04
426,인천,부평구,1,0,2,3,2,0,2018-10-04
427,인천,부평구,0,0,0,0,0,0,2018-11-04
428,인천,부평구,1,0,1,2,2,0,2018-12-04
429,인천,서구,3,0,1,4,1,0,2018-01-04
430,인천,서구,6,0,2,8,5,0,2018-02-04
431,인천,서구,2,0,1,3,3,0,2018-03-04
432,인천,서구,1,0,0,1,1,0,2018-04-04
433,인천,서구,4,0,3,7,7,0,2018-05-04
434,인천,서구,2,0,0,2,2,0,2018-06-04
435,인천,서구,2,0,1,3,4,1,2018-07-04
436,인천,서구,5,0,1,6,2,0,2018-08-04
437,인천,서구,10,0,3,13,9,0,2018-09-04
438,인천,서구,2,0,1,3,3,0,2018-10-04
439,인천,서구,1,0,1,2,2,0,2018-11-04
440,인천,서구,3,0,1,4,4,1,2018-12-04
441,인천,연수구,1,0,3,4,4,0,2018-01-04
442,인천,연수구,5,0,0,5,2,0,2018-02-04
443,인천,연수구,1,0,0,1,1,0,2018-03-04
444,인천,연수구,2,0,1,3,2,0,2018-04-04
445,인천,연수구,2,0,0,2,2,0,2018-05-04
446,인천,연수구,1,0,1,2,2,0,2018-06-04
447,인천,연수구,1,0,0,1,1,0,2018-07-04
448,인천,연수구,2,0,0,2,2,0,2018-08-04
449,인천,연수구,1,0,2,3,3,0,2018-09-04
450,인천,연수구,2,0,0,2,2,0,2018-10-04
451,인천,연수구,1,0,0,1,1,0,2018-11-04
452,인천,연수구,0,0,0,0,0,0,2018-12-04
453,인천,옹진군,0,0,0,0,0,0,2018-01-04
454,인천,옹진군,0,0,0,0,0,0,2018-03-04
455,인천,옹진군,0,0,0,0,0,0,2018-04-04
456,인천,옹진군,0,0,0,0,0,0,2018-05-04
457,인천,옹진군,0,0,0,0,1,1,2018-06-04
458,인천,옹진군,0,0,0,0,0,0,2018-07-04
459,인천,옹진군,0,0,0,0,0,0,2018-08-04
460,인천,옹진군,0,0,0,0,0,0,2018-09-04
461,인천,옹진군,0,1,0,1,1,0,2018-10-04
462,인천,옹진군,2,0,0,2,1,0,2018-11-04
463,인천,옹진군,1,0,0,1,1,0,2018-12-04
464,인천,중구,3,0,0,3,2,0,2018-01-04
465,인천,중구,1,0,1,2,3,1,2018-02-04
466,인천,중구,0,0,0,0,0,0,2018-03-04
467,인천,중구,3,0,1,4,1,0,2018-04-04
468,인천,중구,5,0,1,6,3,0,2018-05-04
469,인천,중구,3,0,0,3,1,0,2018-06-04
470,인천,중구,3,0,1,4,4,0,2018-07-04
471,인천,중구,3,0,0,3,3,0,2018-08-04
472,인천,중구,0,0,1,1,1,0,2018-09-04
473,인천,중구,5,0,1,6,4,0,2018-10-04
474,인천,중구,3,0,2,5,2,0,2018-11-04
475,인천,중구,1,1,0,2,1,0,2018-12-04
476,인천,강화군,0,0,1,1,1,0,2018-01-05
477,인천,강화군,0,0,0,0,0,0,2018-02-05
478,인천,강화군,0,0,0,0,0,0,2018-03-05
479,인천,강화군,2,0,3,5,2,1,2018-04-05
480,인천,강화군,5,0,0,5,2,0,2018-05-05
481,인천,강화군,0,0,0,0,0,0,2018-06-05
482,인천,강화군,2,0,0,2,1,0,2018-07-05
483,인천,강화군,0,0,1,1,1,0,2018-08-05
484,인천,강화군,1,0,0,1,1,0,2018-09-05
485,인천,강화군,2,0,0,2,1,0,2018-10-05
486,인천,강화군,0,0,0,0,0,0,2018-11-05
487,인천,강화군,0,0,0,0,0,0,2018-12-05
488,인천,계양구,0,0,0,0,0,0,2018-01-05
489,인천,계양구,4,0,0,4,3,0,2018-02-05
490,인천,계양구,3,0,2,5,4,0,2018-03-05
491,인천,계양구,1,1,1,3,2,0,2018-04-05
492,인천,계양구,3,0,0,3,3,0,2018-05-05
493,인천,계양구,0,0,1,1,1,0,2018-06-05
494,인천,계양구,0,0,0,0,0,0,2018-07-05
495,인천,계양구,0,1,0,1,1,0,2018-08-05
496,인천,계양구,1,0,0,1,1,0,2018-09-05
497,인천,계양구,0,0,0,0,0,0,2018-10-05
498,인천,계양구,2,0,0,2,2,0,2018-11-05
499,인천,계양구,2,0,0,2,1,0,2018-12-05
500,인천,남동구,2,0,1,3,3,0,2018-01-05
501,인천,남동구,13,0,1,14,8,0,2018-02-05
502,인천,남동구,4,0,6,10,7,0,2018-03-05
503,인천,남동구,5,1,1,7,7,0,2018-04-05
504,인천,남동구,2,0,0,2,2,0,2018-05-05
505,인천,남동구,4,0,1,5,5,0,2018-06-05
506,인천,남동구,9,0,1,10,6,0,2018-07-05
507,인천,남동구,1,0,2,3,2,0,2018-08-05
508,인천,남동구,9,0,5,14,9,0,2018-09-05
509,인천,남동구,6,3,1,10,7,0,2018-10-05
510,인천,남동구,1,0,0,1,1,0,2018-11-05
511,인천,남동구,12,0,3,15,11,1,2018-12-05
512,인천,동구,0,0,0,0,0,0,2018-01-05
513,인천,동구,0,1,1,2,1,0,2018-02-05
514,인천,동구,0,0,1,1,1,0,2018-03-05
515,인천,동구,0,0,0,0,0,0,2018-04-05
516,인천,동구,0,0,0,0,0,0,2018-05-05
517,인천,동구,1,0,1,2,2,0,2018-06-05
518,인천,동구,1,0,1,2,2,0,2018-07-05
519,인천,동구,0,0,0,0,0,0,2018-08-05
520,인천,동구,0,0,0,0,0,0,2018-09-05
521,인천,동구,0,1,0,1,1,0,2018-10-05
522,인천,동구,0,0,0,0,0,0,2018-11-05
523,인천,동구,0,0,0,0,0,0,2018-12-05
524,인천,미추홀구,3,0,0,3,2,0,2018-01-05
525,인천,미추홀구,2,0,2,4,4,0,2018-02-05
526,인천,미추홀구,5,2,1,8,6,0,2018-03-05
527,인천,미추홀구,2,1,0,3,3,0,2018-04-05
528,인천,미추홀구,7,0,1,8,5,0,2018-05-05
529,인천,미추홀구,2,2,1,5,4,0,2018-06-05
530,인천,미추홀구,2,1,1,4,4,0,2018-07-05
531,인천,미추홀구,4,0,1,5,3,0,2018-08-05
532,인천,미추홀구,2,1,1,4,4,0,2018-09-05
533,인천,미추홀구,4,0,2,6,5,1,2018-10-05
534,인천,미추홀구,5,2,0,7,7,0,2018-11-05
535,인천,미추홀구,2,0,0,2,2,0,2018-12-05
536,인천,부평구,1,0,4,5,3,0,2018-01-05
537,인천,부평구,8,0,4,12,6,0,2018-02-05
538,인천,부평구,6,1,1,8,5,0,2018-03-05
539,인천,부평구,9,2,1,12,6,0,2018-04-05
540,인천,부평구,3,1,1,5,4,0,2018-05-05
541,인천,부평구,8,0,1,9,8,0,2018-06-05
542,인천,부평구,2,1,2,5,3,0,2018-07-05
543,인천,부평구,2,0,0,2,2,0,2018-08-05
544,인천,부평구,3,0,0,3,3,0,2018-09-05
545,인천,부평구,3,0,1,4,4,0,2018-10-05
546,인천,부평구,1,0,1,2,2,0,2018-11-05
547,인천,부평구,15,0,2,17,9,0,2018-12-05
548,인천,서구,3,1,1,5,3,0,2018-01-05
549,인천,서구,6,0,1,7,5,0,2018-02-05
550,인천,서구,5,1,4,10,8,0,2018-03-05
551,인천,서구,5,0,0,5,3,0,2018-04-05
552,인천,서구,3,0,0,3,2,0,2018-05-05
553,인천,서구,16,0,4,20,9,0,2018-06-05
554,인천,서구,3,0,0,3,3,0,2018-07-05
555,인천,서구,2,0,2,4,2,0,2018-08-05
556,인천,서구,3,0,2,5,3,0,2018-09-05
557,인천,서구,5,0,0,5,5,0,2018-10-05
558,인천,서구,3,1,2,6,5,0,2018-11-05
559,인천,서구,5,0,0,5,3,0,2018-12-05
560,인천,연수구,5,0,1,6,4,0,2018-01-05
561,인천,연수구,2,1,2,5,3,0,2018-02-05
562,인천,연수구,0,0,0,0,0,0,2018-03-05
563,인천,연수구,1,0,2,3,3,0,2018-04-05
564,인천,연수구,2,0,2,4,4,0,2018-05-05
565,인천,연수구,1,0,2,3,2,0,2018-06-05
566,인천,연수구,0,0,0,0,0,0,2018-07-05
567,인천,연수구,0,0,0,0,0,0,2018-08-05
568,인천,연수구,1,0,0,1,1,0,2018-09-05
569,인천,연수구,3,0,2,5,5,0,2018-10-05
570,인천,연수구,1,0,0,1,3,2,2018-11-05
571,인천,연수구,2,0,1,3,2,0,2018-12-05
572,인천,옹진군,0,0,0,0,0,0,2018-01-05
573,인천,옹진군,0,0,0,0,0,0,2018-03-05
574,인천,옹진군,0,0,2,2,1,0,2018-04-05
575,인천,옹진군,0,0,0,0,0,0,2018-05-05
576,인천,옹진군,0,0,0,0,0,0,2018-06-05
577,인천,옹진군,0,0,0,0,0,0,2018-07-05
578,인천,옹진군,0,0,0,0,0,0,2018-08-05
579,인천,옹진군,0,0,0,0,0,0,2018-09-05
580,인천,옹진군,0,0,0,0,0,0,2018-10-05
581,인천,옹진군,0,0,0,0,0,0,2018-11-05
582,인천,옹진군,0,0,0,0,0,0,2018-12-05
583,인천,중구,0,0,0,0,0,0,2018-01-05
584,인천,중구,0,0,1,1,1,0,2018-02-05
585,인천,중구,2,0,0,2,2,0,2018-03-05
586,인천,중구,2,0,0,2,2,0,2018-04-05
587,인천,중구,2,0,6,8,3,0,2018-05-05
588,인천,중구,0,0,3,3,1,0,2018-06-05
589,인천,중구,5,0,0,5,4,0,2018-07-05
590,인천,중구,1,0,0,1,1,0,2018-08-05
591,인천,중구,2,0,1,3,3,0,2018-09-05
592,인천,중구,2,0,1,3,2,0,2018-10-05
593,인천,중구,0,0,0,0,0,0,2018-11-05
594,인천,중구,0,0,0,0,0,0,2018-12-05
595,인천,강화군,0,0,0,0,0,0,2018-01-06
596,인천,강화군,0,0,0,0,0,0,2018-02-06
597,인천,강화군,0,0,0,0,0,0,2018-03-06
598,인천,강화군,0,0,0,0,0,0,2018-04-06
599,인천,강화군,0,0,0,0,0,0,2018-05-06
600,인천,강화군,0,0,0,0,0,0,2018-06-06
601,인천,강화군,2,0,0,2,1,0,2018-07-06
602,인천,강화군,0,0,1,1,1,0,2018-08-06
603,인천,강화군,0,0,0,0,0,0,2018-09-06
604,인천,강화군,0,0,1,1,1,0,2018-10-06
605,인천,강화군,0,0,1,1,1,0,2018-11-06
606,인천,강화군,1,0,0,1,1,0,2018-12-06
607,인천,계양구,3,0,2,5,5,0,2018-01-06
608,인천,계양구,2,0,1,3,3,0,2018-02-06
609,인천,계양구,4,0,2,6,3,0,2018-03-06
610,인천,계양구,7,0,0,7,3,0,2018-04-06
611,인천,계양구,3,0,0,3,1,0,2018-05-06
612,인천,계양구,6,0,6,12,6,0,2018-06-06
613,인천,계양구,2,0,0,2,2,0,2018-07-06
614,인천,계양구,2,0,1,3,4,1,2018-08-06
615,인천,계양구,3,2,0,5,2,0,2018-09-06
616,인천,계양구,0,1,1,2,2,0,2018-10-06
617,인천,계양구,1,0,0,1,1,0,2018-11-06
618,인천,계양구,2,0,0,2,2,0,2018-12-06
619,인천,남동구,2,0,0,2,2,0,2018-01-06
620,인천,남동구,9,0,0,9,7,0,2018-02-06
621,인천,남동구,3,0,0,3,3,0,2018-03-06
622,인천,남동구,6,0,1,7,4,0,2018-04-06
623,인천,남동구,7,0,3,10,3,0,2018-05-06
624,인천,남동구,4,0,2,6,4,0,2018-06-06
625,인천,남동구,4,0,0,4,3,0,2018-07-06
626,인천,남동구,4,3,1,8,5,0,2018-08-06
627,인천,남동구,4,1,1,6,6,0,2018-09-06
628,인천,남동구,2,0,2,4,4,0,2018-10-06
629,인천,남동구,4,0,1,5,4,0,2018-11-06
630,인천,남동구,1,0,0,1,1,0,2018-12-06
631,인천,동구,1,0,0,1,1,0,2018-01-06
632,인천,동구,0,0,0,0,0,0,2018-02-06
633,인천,동구,0,0,0,0,0,0,2018-03-06
634,인천,동구,0,0,1,1,1,0,2018-04-06
635,인천,동구,0,0,0,0,0,0,2018-05-06
636,인천,동구,0,1,0,1,1,0,2018-06-06
637,인천,동구,1,0,0,1,1,0,2018-07-06
638,인천,동구,0,0,1,1,1,0,2018-08-06
639,인천,동구,2,1,1,4,2,0,2018-09-06
640,인천,동구,2,0,0,2,2,0,2018-10-06
641,인천,동구,1,0,0,1,1,0,2018-11-06
642,인천,동구,0,0,0,0,0,0,2018-12-06
643,인천,미추홀구,3,0,0,3,3,0,2018-01-06
644,인천,미추홀구,11,1,2,14,7,0,2018-02-06
645,인천,미추홀구,5,0,0,5,4,0,2018-03-06
646,인천,미추홀구,1,1,2,4,3,0,2018-04-06
647,인천,미추홀구,1,1,0,2,1,0,2018-05-06
648,인천,미추홀구,4,0,2,6,5,0,2018-06-06
649,인천,미추홀구,2,0,2,4,4,0,2018-07-06
650,인천,미추홀구,1,0,0,1,1,0,2018-08-06
651,인천,미추홀구,5,0,0,5,4,0,2018-09-06
652,인천,미추홀구,1,0,1,2,1,0,2018-10-06
653,인천,미추홀구,5,0,1,6,6,0,2018-11-06
654,인천,미추홀구,0,0,0,0,0,0,2018-12-06
655,인천,부평구,7,0,1,8,7,0,2018-01-06
656,인천,부평구,5,0,1,6,4,0,2018-02-06
657,인천,부평구,1,0,1,2,2,0,2018-03-06
658,인천,부평구,5,0,1,6,4,0,2018-04-06
659,인천,부평구,1,0,1,2,1,0,2018-05-06
660,인천,부평구,4,0,1,5,2,0,2018-06-06
661,인천,부평구,0,1,0,1,1,0,2018-07-06
662,인천,부평구,6,0,0,6,4,0,2018-08-06
663,인천,부평구,3,0,0,3,2,0,2018-09-06
664,인천,부평구,8,0,2,10,5,1,2018-10-06
665,인천,부평구,0,0,0,0,0,0,2018-11-06
666,인천,부평구,0,0,0,0,0,0,2018-12-06
667,인천,서구,2,0,0,2,2,0,2018-01-06
668,인천,서구,5,0,2,7,5,1,2018-02-06
669,인천,서구,4,0,1,5,4,0,2018-03-06
670,인천,서구,3,1,0,4,2,0,2018-04-06
671,인천,서구,2,0,0,2,1,0,2018-05-06
672,인천,서구,3,0,2,5,5,0,2018-06-06
673,인천,서구,0,0,0,0,0,0,2018-07-06
674,인천,서구,6,0,1,7,5,0,2018-08-06
675,인천,서구,0,3,3,6,4,0,2018-09-06
676,인천,서구,7,0,2,9,6,0,2018-10-06
677,인천,서구,3,0,0,3,3,0,2018-11-06
678,인천,서구,1,0,0,1,1,0,2018-12-06
679,인천,연수구,0,0,1,1,2,1,2018-01-06
680,인천,연수구,4,0,1,5,5,0,2018-02-06
681,인천,연수구,1,0,1,2,2,0,2018-03-06
682,인천,연수구,2,0,2,4,4,0,2018-04-06
683,인천,연수구,3,0,0,3,2,0,2018-05-06
684,인천,연수구,0,1,0,1,1,0,2018-06-06
685,인천,연수구,2,0,0,2,2,0,2018-07-06
686,인천,연수구,1,0,0,1,1,0,2018-08-06
687,인천,연수구,2,0,0,2,2,0,2018-09-06
688,인천,연수구,1,0,0,1,1,0,2018-10-06
689,인천,연수구,1,0,1,2,2,0,2018-11-06
690,인천,연수구,0,0,2,2,2,0,2018-12-06
691,인천,옹진군,0,0,0,0,0,0,2018-01-06
692,인천,옹진군,0,0,1,1,1,0,2018-03-06
693,인천,옹진군,0,0,0,0,0,0,2018-04-06
694,인천,옹진군,0,0,0,0,0,0,2018-05-06
695,인천,옹진군,0,0,0,0,0,0,2018-06-06
696,인천,옹진군,0,0,0,0,0,0,2018-07-06
697,인천,옹진군,0,0,0,0,0,0,2018-08-06
698,인천,옹진군,0,0,0,0,0,0,2018-09-06
699,인천,옹진군,2,0,0,2,1,0,2018-10-06
700,인천,옹진군,2,0,0,2,1,0,2018-11-06
701,인천,옹진군,0,0,0,0,0,0,2018-12-06
702,인천,중구,0,0,0,0,0,0,2018-01-06
703,인천,중구,1,0,2,3,2,0,2018-02-06
704,인천,중구,0,0,0,0,0,0,2018-03-06
705,인천,중구,1,0,0,1,1,0,2018-04-06
706,인천,중구,0,1,0,1,1,0,2018-05-06
707,인천,중구,4,0,1,5,3,0,2018-06-06
708,인천,중구,2,0,0,2,3,1,2018-07-06
709,인천,중구,2,0,3,5,3,0,2018-08-06
710,인천,중구,0,0,0,0,0,0,2018-09-06
711,인천,중구,0,0,1,1,1,0,2018-10-06
712,인천,중구,0,0,1,1,1,0,2018-11-06
713,인천,중구,1,0,0,1,1,0,2018-12-06
714,인천,강화군,0,0,0,0,0,0,2018-01-07
715,인천,강화군,0,0,0,0,0,0,2018-02-07
716,인천,강화군,0,0,0,0,0,0,2018-03-07
717,인천,강화군,0,0,0,0,0,0,2018-04-07
718,인천,강화군,0,0,1,1,1,0,2018-05-07
719,인천,강화군,0,0,0,0,0,0,2018-06-07
720,인천,강화군,0,0,1,1,1,0,2018-07-07
721,인천,강화군,0,0,0,0,0,0,2018-08-07
722,인천,강화군,0,0,0,0,0,0,2018-09-07
723,인천,강화군,0,0,0,0,0,0,2018-10-07
724,인천,강화군,2,0,0,2,1,0,2018-11-07
725,인천,강화군,0,0,0,0,0,0,2018-12-07
726,인천,계양구,1,0,2,3,2,0,2018-01-07
727,인천,계양구,4,0,0,4,2,0,2018-02-07
728,인천,계양구,1,0,0,1,1,0,2018-03-07
729,인천,계양구,5,0,2,7,4,0,2018-04-07
730,인천,계양구,0,0,2,2,2,0,2018-05-07
731,인천,계양구,1,0,0,1,1,0,2018-06-07
732,인천,계양구,3,0,0,3,3,0,2018-07-07
733,인천,계양구,4,0,0,4,4,0,2018-08-07
734,인천,계양구,2,2,0,4,3,0,2018-09-07
735,인천,계양구,2,2,1,5,3,0,2018-10-07
736,인천,계양구,1,0,2,3,3,0,2018-11-07
737,인천,계양구,0,1,1,2,2,0,2018-12-07
738,인천,남동구,4,1,1,6,4,0,2018-01-07
739,인천,남동구,4,0,0,4,3,0,2018-02-07
740,인천,남동구,0,0,1,1,1,0,2018-03-07
741,인천,남동구,4,0,1,5,4,0,2018-04-07
742,인천,남동구,2,1,1,4,3,0,2018-05-07
743,인천,남동구,1,0,1,2,2,0,2018-06-07
744,인천,남동구,5,0,0,5,4,0,2018-07-07
745,인천,남동구,2,0,0,2,2,0,2018-08-07
746,인천,남동구,3,2,2,7,5,0,2018-09-07
747,인천,남동구,3,0,1,4,2,0,2018-10-07
748,인천,남동구,4,1,0,5,5,0,2018-11-07
749,인천,남동구,8,1,0,9,7,0,2018-12-07
750,인천,동구,0,0,0,0,0,0,2018-01-07
751,인천,동구,0,0,1,1,1,0,2018-02-07
752,인천,동구,1,0,0,1,1,0,2018-03-07
753,인천,동구,0,0,0,0,0,0,2018-04-07
754,인천,동구,0,0,0,0,0,0,2018-05-07
755,인천,동구,2,0,0,2,2,0,2018-06-07
756,인천,동구,0,0,0,0,0,0,2018-07-07
757,인천,동구,0,0,0,0,0,0,2018-08-07
758,인천,동구,0,0,0,0,0,0,2018-09-07
759,인천,동구,0,0,0,0,0,0,2018-10-07
760,인천,동구,0,0,0,0,0,0,2018-11-07
761,인천,동구,0,0,0,0,0,0,2018-12-07
762,인천,미추홀구,8,1,1,10,6,0,2018-01-07
763,인천,미추홀구,10,0,3,13,9,1,2018-02-07
764,인천,미추홀구,5,0,0,5,3,0,2018-03-07
765,인천,미추홀구,4,0,0,4,2,0,2018-04-07
766,인천,미추홀구,1,1,0,2,2,0,2018-05-07
767,인천,미추홀구,4,0,2,6,3,0,2018-06-07
768,인천,미추홀구,6,0,0,6,3,0,2018-07-07
769,인천,미추홀구,3,0,0,3,2,0,2018-08-07
770,인천,미추홀구,1,0,1,2,2,0,2018-09-07
771,인천,미추홀구,4,0,2,6,3,0,2018-10-07
772,인천,미추홀구,1,0,1,2,2,0,2018-11-07
773,인천,미추홀구,4,1,1,6,5,1,2018-12-07
774,인천,부평구,8,0,0,8,3,0,2018-01-07
775,인천,부평구,3,0,1,4,2,0,2018-02-07
776,인천,부평구,1,0,0,1,1,0,2018-03-07
777,인천,부평구,3,0,1,4,1,0,2018-04-07
778,인천,부평구,5,0,1,6,4,0,2018-05-07
779,인천,부평구,2,0,1,3,2,0,2018-06-07
780,인천,부평구,2,0,1,3,2,0,2018-07-07
781,인천,부평구,3,0,0,3,2,0,2018-08-07
782,인천,부평구,1,0,2,3,3,0,2018-09-07
783,인천,부평구,0,0,1,1,1,0,2018-10-07
784,인천,부평구,2,0,2,4,4,0,2018-11-07
785,인천,부평구,5,0,3,8,7,0,2018-12-07
786,인천,서구,4,0,2,6,3,0,2018-01-07
787,인천,서구,4,1,5,10,7,0,2018-02-07
788,인천,서구,4,0,2,6,5,0,2018-03-07
789,인천,서구,0,1,0,1,1,0,2018-04-07
790,인천,서구,6,1,0,7,4,0,2018-05-07
791,인천,서구,2,0,2,4,3,0,2018-06-07
792,인천,서구,3,1,1,5,3,0,2018-07-07
793,인천,서구,6,0,0,6,3,0,2018-08-07
794,인천,서구,7,0,2,9,6,0,2018-09-07
795,인천,서구,3,0,1,4,3,0,2018-10-07
796,인천,서구,5,0,1,6,4,0,2018-11-07
797,인천,서구,4,0,0,4,3,0,2018-12-07
798,인천,연수구,0,0,2,2,1,0,2018-01-07
799,인천,연수구,1,0,0,1,1,0,2018-02-07
800,인천,연수구,2,0,1,3,2,0,2018-03-07
801,인천,연수구,6,0,2,8,4,0,2018-04-07
802,인천,연수구,2,1,0,3,3,0,2018-05-07
803,인천,연수구,1,0,3,4,3,0,2018-06-07
804,인천,연수구,3,0,3,6,4,0,2018-07-07
805,인천,연수구,4,1,1,6,4,0,2018-08-07
806,인천,연수구,3,0,1,4,3,0,2018-09-07
807,인천,연수구,1,0,0,1,1,0,2018-10-07
808,인천,연수구,3,0,1,4,3,0,2018-11-07
809,인천,연수구,2,0,0,2,1,0,2018-12-07
810,인천,옹진군,0,0,0,0,0,0,2018-01-07
811,인천,옹진군,0,0,0,0,0,0,2018-03-07
812,인천,옹진군,0,0,0,0,0,0,2018-04-07
813,인천,옹진군,0,0,0,0,0,0,2018-05-07
814,인천,옹진군,0,0,0,0,0,0,2018-06-07
815,인천,옹진군,0,0,0,0,0,0,2018-07-07
816,인천,옹진군,0,0,0,0,0,0,2018-08-07
817,인천,옹진군,0,0,0,0,0,0,2018-09-07
818,인천,옹진군,0,0,0,0,0,0,2018-10-07
819,인천,옹진군,0,0,0,0,0,0,2018-11-07
820,인천,옹진군,0,0,0,0,0,0,2018-12-07
821,인천,중구,2,0,0,2,1,0,2018-01-07
822,인천,중구,0,0,1,1,1,0,2018-02-07
823,인천,중구,1,0,0,1,1,0,2018-03-07
824,인천,중구,4,1,3,8,4,0,2018-04-07
825,인천,중구,0,0,0,0,0,0,2018-05-07
826,인천,중구,0,0,0,0,0,0,2018-06-07
827,인천,중구,3,0,4,7,4,0,2018-07-07
828,인천,중구,5,0,1,6,1,0,2018-08-07
829,인천,중구,1,0,0,1,1,0,2018-09-07
830,인천,중구,4,0,0,4,2,0,2018-10-07
831,인천,중구,2,0,0,2,1,0,2018-11-07
832,인천,중구,0,0,1,1,1,0,2018-12-07
833,인천,강화군,1,0,0,1,1,0,2018-01-08
834,인천,강화군,0,0,1,1,1,0,2018-02-08
835,인천,강화군,0,0,1,1,1,0,2018-03-08
836,인천,강화군,0,0,0,0,0,0,2018-04-08
837,인천,강화군,0,0,0,0,0,0,2018-05-08
838,인천,강화군,0,0,0,0,0,0,2018-06-08
839,인천,강화군,0,0,1,1,1,0,2018-07-08
840,인천,강화군,1,0,1,2,2,0,2018-08-08
841,인천,강화군,0,0,0,0,0,0,2018-09-08
842,인천,강화군,0,0,1,1,1,0,2018-10-08
843,인천,강화군,0,0,1,1,1,0,2018-11-08
844,인천,강화군,0,1,0,1,1,0,2018-12-08
845,인천,계양구,3,0,0,3,3,0,2018-01-08
846,인천,계양구,9,0,1,10,2,0,2018-02-08
847,인천,계양구,2,0,0,2,1,0,2018-03-08
848,인천,계양구,0,0,0,0,0,0,2018-04-08
849,인천,계양구,2,0,0,2,2,0,2018-05-08
850,인천,계양구,2,0,1,3,2,0,2018-06-08
851,인천,계양구,1,0,1,2,2,0,2018-07-08
852,인천,계양구,1,0,0,1,1,0,2018-08-08
853,인천,계양구,3,0,2,5,4,0,2018-09-08
854,인천,계양구,0,0,2,2,2,0,2018-10-08
855,인천,계양구,5,0,2,7,5,0,2018-11-08
856,인천,계양구,4,0,0,4,4,0,2018-12-08
857,인천,남동구,1,0,1,2,2,0,2018-01-08
858,인천,남동구,3,0,0,3,3,0,2018-02-08
859,인천,남동구,7,0,1,8,7,0,2018-03-08
860,인천,남동구,3,1,2,6,5,0,2018-04-08
861,인천,남동구,4,0,1,5,4,0,2018-05-08
862,인천,남동구,3,1,0,4,4,0,2018-06-08
863,인천,남동구,1,0,1,2,2,0,2018-07-08
864,인천,남동구,0,0,1,1,1,0,2018-08-08
865,인천,남동구,14,0,4,18,11,0,2018-09-08
866,인천,남동구,8,0,1,9,6,0,2018-10-08
867,인천,남동구,4,0,1,5,4,0,2018-11-08
868,인천,남동구,2,0,2,4,4,0,2018-12-08
869,인천,동구,1,0,0,1,1,0,2018-01-08
870,인천,동구,1,0,0,1,1,0,2018-02-08
871,인천,동구,0,0,0,0,0,0,2018-03-08
872,인천,동구,0,0,0,0,0,0,2018-04-08
873,인천,동구,0,0,0,0,0,0,2018-05-08
874,인천,동구,0,0,2,2,2,0,2018-06-08
875,인천,동구,0,0,0,0,0,0,2018-07-08
876,인천,동구,0,0,0,0,0,0,2018-08-08
877,인천,동구,1,0,1,2,2,0,2018-09-08
878,인천,동구,0,0,0,0,0,0,2018-10-08
879,인천,동구,0,0,0,0,0,0,2018-11-08
880,인천,동구,1,0,0,1,1,0,2018-12-08
881,인천,미추홀구,3,0,2,5,4,0,2018-01-08
882,인천,미추홀구,5,0,0,5,3,0,2018-02-08
883,인천,미추홀구,1,1,1,3,3,0,2018-03-08
884,인천,미추홀구,0,0,0,0,0,0,2018-04-08
885,인천,미추홀구,1,1,2,4,4,0,2018-05-08
886,인천,미추홀구,0,1,0,1,1,0,2018-06-08
887,인천,미추홀구,2,0,0,2,2,0,2018-07-08
888,인천,미추홀구,6,0,0,6,6,0,2018-08-08
889,인천,미추홀구,5,1,3,9,3,0,2018-09-08
890,인천,미추홀구,3,0,0,3,2,0,2018-10-08
891,인천,미추홀구,1,0,2,3,3,0,2018-11-08
892,인천,미추홀구,1,0,0,1,1,0,2018-12-08
893,인천,부평구,1,0,1,2,1,0,2018-01-08
894,인천,부평구,11,1,0,12,7,0,2018-02-08
895,인천,부평구,1,4,4,9,6,0,2018-03-08
896,인천,부평구,6,0,1,7,4,0,2018-04-08
897,인천,부평구,3,0,1,4,3,0,2018-05-08
898,인천,부평구,0,0,1,1,1,0,2018-06-08
899,인천,부평구,2,0,1,3,3,0,2018-07-08
900,인천,부평구,2,0,0,2,1,0,2018-08-08
901,인천,부평구,2,0,0,2,2,0,2018-09-08
902,인천,부평구,1,0,1,2,2,0,2018-10-08
903,인천,부평구,7,2,3,12,9,0,2018-11-08
904,인천,부평구,1,0,0,1,1,0,2018-12-08
905,인천,서구,0,0,1,1,2,1,2018-01-08
906,인천,서구,2,0,2,4,4,0,2018-02-08
907,인천,서구,7,1,1,9,7,0,2018-03-08
908,인천,서구,4,0,0,4,4,0,2018-04-08
909,인천,서구,5,0,3,8,6,0,2018-05-08
910,인천,서구,2,0,1,3,3,0,2018-06-08
911,인천,서구,6,0,3,9,4,0,2018-07-08
912,인천,서구,1,0,2,3,4,1,2018-08-08
913,인천,서구,7,0,2,9,5,0,2018-09-08
914,인천,서구,4,0,2,6,3,0,2018-10-08
915,인천,서구,5,0,0,5,5,0,2018-11-08
916,인천,서구,3,0,1,4,3,0,2018-12-08
917,인천,연수구,1,0,0,1,1,0,2018-01-08
918,인천,연수구,8,0,1,9,5,0,2018-02-08
919,인천,연수구,0,0,0,0,0,0,2018-03-08
920,인천,연수구,4,0,1,5,3,0,2018-04-08
921,인천,연수구,1,0,2,3,3,0,2018-05-08
922,인천,연수구,1,0,6,7,3,0,2018-06-08
923,인천,연수구,0,0,0,0,0,0,2018-07-08
924,인천,연수구,0,0,0,0,0,0,2018-08-08
925,인천,연수구,2,0,0,2,1,0,2018-09-08
926,인천,연수구,1,0,0,1,1,0,2018-10-08
927,인천,연수구,3,0,1,4,3,0,2018-11-08
928,인천,연수구,2,0,0,2,1,0,2018-12-08
929,인천,옹진군,0,0,0,0,0,0,2018-01-08
930,인천,옹진군,0,0,0,0,0,0,2018-03-08
931,인천,옹진군,0,0,0,0,0,0,2018-04-08
932,인천,옹진군,0,0,0,0,0,0,2018-05-08
933,인천,옹진군,0,0,0,0,0,0,2018-06-08
934,인천,옹진군,0,0,0,0,0,0,2018-07-08
935,인천,옹진군,0,0,0,0,0,0,2018-08-08
936,인천,옹진군,0,0,0,0,0,0,2018-09-08
937,인천,옹진군,2,0,0,2,1,0,2018-10-08
938,인천,옹진군,0,0,0,0,0,0,2018-11-08
939,인천,옹진군,0,0,0,0,0,0,2018-12-08
940,인천,중구,1,0,0,1,1,0,2018-01-08
941,인천,중구,4,0,2,6,3,0,2018-02-08
942,인천,중구,3,1,0,4,3,0,2018-03-08
943,인천,중구,0,0,3,3,2,0,2018-04-08
944,인천,중구,1,1,0,2,1,0,2018-05-08
945,인천,중구,0,0,0,0,0,0,2018-06-08
946,인천,중구,1,0,0,1,1,0,2018-07-08
947,인천,중구,0,0,0,0,0,0,2018-08-08
948,인천,중구,1,0,0,1,1,0,2018-09-08
949,인천,중구,2,0,0,2,2,0,2018-10-08
950,인천,중구,0,0,1,1,1,0,2018-11-08
951,인천,중구,0,0,0,0,0,0,2018-12-08
952,인천,강화군,1,0,0,1,1,0,2018-01-09
953,인천,강화군,1,0,0,1,1,0,2018-02-09
954,인천,강화군,0,0,1,1,1,0,2018-03-09
955,인천,강화군,0,0,0,0,0,0,2018-04-09
956,인천,강화군,0,0,0,0,0,0,2018-05-09
957,인천,강화군,0,0,0,0,0,0,2018-06-09
958,인천,강화군,0,0,0,0,0,0,2018-07-09
959,인천,강화군,0,0,0,0,0,0,2018-08-09
960,인천,강화군,0,0,0,0,0,0,2018-09-09
961,인천,강화군,0,0,0,0,0,0,2018-10-09
962,인천,강화군,1,0,0,1,1,0,2018-11-09
963,인천,강화군,0,0,0,0,0,0,2018-12-09
964,인천,계양구,1,0,0,1,1,0,2018-01-09
965,인천,계양구,2,1,4,7,5,0,2018-02-09
966,인천,계양구,0,0,0,0,0,0,2018-03-09
967,인천,계양구,1,0,1,2,2,0,2018-04-09
968,인천,계양구,2,0,0,2,2,0,2018-05-09
969,인천,계양구,4,0,1,5,1,0,2018-06-09
970,인천,계양구,1,0,1,2,2,0,2018-07-09
971,인천,계양구,2,0,0,2,2,0,2018-08-09
972,인천,계양구,4,1,1,6,4,0,2018-09-09
973,인천,계양구,1,0,2,3,2,0,2018-10-09
974,인천,계양구,2,0,0,2,2,0,2018-11-09
975,인천,계양구,0,0,0,0,0,0,2018-12-09
976,인천,남동구,12,1,3,16,10,0,2018-01-09
977,인천,남동구,18,0,0,18,9,0,2018-02-09
978,인천,남동구,2,0,0,2,2,0,2018-03-09
979,인천,남동구,6,1,4,11,7,1,2018-04-09
980,인천,남동구,6,0,2,8,6,0,2018-05-09
981,인천,남동구,11,0,2,13,8,1,2018-06-09
982,인천,남동구,4,0,0,4,3,0,2018-07-09
983,인천,남동구,4,0,0,4,3,0,2018-08-09
984,인천,남동구,5,0,3,8,6,0,2018-09-09
985,인천,남동구,10,1,0,11,4,0,2018-10-09
986,인천,남동구,3,0,0,3,2,0,2018-11-09
987,인천,남동구,5,0,0,5,1,0,2018-12-09
988,인천,동구,1,0,1,2,2,0,2018-01-09
989,인천,동구,0,0,0,0,0,0,2018-02-09
990,인천,동구,0,0,0,0,0,0,2018-03-09
991,인천,동구,0,0,0,0,0,0,2018-04-09
992,인천,동구,0,0,0,0,0,0,2018-05-09
993,인천,동구,0,0,0,0,0,0,2018-06-09
994,인천,동구,4,0,0,4,2,0,2018-07-09
995,인천,동구,2,0,3,5,3,0,2018-08-09
996,인천,동구,0,0,0,0,0,0,2018-09-09
997,인천,동구,0,0,0,0,0,0,2018-10-09
998,인천,동구,0,0,0,0,0,0,2018-11-09
999,인천,동구,0,0,0,0,0,0,2018-12-09
1000,인천,미추홀구,5,0,1,6,4,0,2018-01-09
1001,인천,미추홀구,3,1,1,5,4,0,2018-02-09
1002,인천,미추홀구,2,0,0,2,1,0,2018-03-09
1003,인천,미추홀구,2,0,1,3,3,0,2018-04-09
1004,인천,미추홀구,5,1,1,7,5,0,2018-05-09
1005,인천,미추홀구,1,0,0,1,1,0,2018-06-09
1006,인천,미추홀구,3,1,0,4,4,0,2018-07-09
1007,인천,미추홀구,6,1,1,8,7,0,2018-08-09
1008,인천,미추홀구,5,0,0,5,3,0,2018-09-09
1009,인천,미추홀구,6,0,1,7,4,0,2018-10-09
1010,인천,미추홀구,4,0,1,5,3,0,2018-11-09
1011,인천,미추홀구,2,0,0,2,2,0,2018-12-09
1012,인천,부평구,5,0,2,7,5,0,2018-01-09
1013,인천,부평구,4,0,2,6,6,0,2018-02-09
1014,인천,부평구,4,0,0,4,3,0,2018-03-09
1015,인천,부평구,5,0,0,5,3,0,2018-04-09
1016,인천,부평구,4,0,5,9,6,0,2018-05-09
1017,인천,부평구,2,0,3,5,4,0,2018-06-09
1018,인천,부평구,3,0,0,3,3,0,2018-07-09
1019,인천,부평구,0,0,0,0,0,0,2018-08-09
1020,인천,부평구,2,0,0,2,2,0,2018-09-09
1021,인천,부평구,4,0,2,6,3,0,2018-10-09
1022,인천,부평구,5,0,0,5,2,0,2018-11-09
1023,인천,부평구,2,1,1,4,3,0,2018-12-09
1024,인천,서구,4,1,3,8,7,0,2018-01-09
1025,인천,서구,3,0,2,5,4,0,2018-02-09
1026,인천,서구,1,0,0,1,1,0,2018-03-09
1027,인천,서구,3,0,0,3,2,0,2018-04-09
1028,인천,서구,1,0,0,1,1,0,2018-05-09
1029,인천,서구,2,1,0,3,3,0,2018-06-09
1030,인천,서구,2,0,2,4,4,0,2018-07-09
1031,인천,서구,5,0,2,7,4,0,2018-08-09
1032,인천,서구,0,0,0,0,0,0,2018-09-09
1033,인천,서구,1,0,3,4,4,0,2018-10-09
1034,인천,서구,5,0,2,7,5,0,2018-11-09
1035,인천,서구,2,0,0,2,1,0,2018-12-09
1036,인천,연수구,3,0,0,3,3,0,2018-01-09
1037,인천,연수구,0,0,0,0,0,0,2018-02-09
1038,인천,연수구,4,0,1,5,5,0,2018-03-09
1039,인천,연수구,0,0,0,0,0,0,2018-04-09
1040,인천,연수구,2,0,1,3,2,0,2018-05-09
1041,인천,연수구,1,0,0,1,1,0,2018-06-09
1042,인천,연수구,0,0,0,0,0,0,2018-07-09
1043,인천,연수구,3,0,1,4,3,0,2018-08-09
1044,인천,연수구,0,0,0,0,0,0,2018-09-09
1045,인천,연수구,4,0,0,4,3,0,2018-10-09
1046,인천,연수구,0,0,1,1,1,0,2018-11-09
1047,인천,연수구,1,0,0,1,1,0,2018-12-09
1048,인천,옹진군,0,0,0,0,0,0,2018-01-09
1049,인천,옹진군,1,0,0,1,1,0,2018-03-09
1050,인천,옹진군,0,0,0,0,0,0,2018-04-09
1051,인천,옹진군,0,0,0,0,0,0,2018-05-09
1052,인천,옹진군,0,0,0,0,0,0,2018-06-09
1053,인천,옹진군,0,0,0,0,0,0,2018-07-09
1054,인천,옹진군,0,0,0,0,0,0,2018-08-09
1055,인천,옹진군,0,0,0,0,0,0,2018-09-09
1056,인천,옹진군,0,0,0,0,0,0,2018-10-09
1057,인천,옹진군,0,0,0,0,0,0,2018-11-09
1058,인천,옹진군,0,0,0,0,0,0,2018-12-09
1059,인천,중구,1,0,0,1,1,0,2018-01-09
1060,인천,중구,0,0,0,0,0,0,2018-02-09
1061,인천,중구,3,0,1,4,2,0,2018-03-09
1062,인천,중구,5,0,2,7,2,0,2018-04-09
1063,인천,중구,2,0,2,4,3,0,2018-05-09
1064,인천,중구,0,0,0,0,0,0,2018-06-09
1065,인천,중구,2,0,1,3,3,0,2018-07-09
1066,인천,중구,2,0,2,4,2,0,2018-08-09
1067,인천,중구,1,0,0,1,1,0,2018-09-09
1068,인천,중구,10,0,0,10,5,0,2018-10-09
1069,인천,중구,0,0,0,0,0,0,2018-11-09
1070,인천,중구,0,0,0,0,0,0,2018-12-09
1071,인천,강화군,0,0,0,0,0,0,2018-01-10
1072,인천,강화군,1,0,0,1,1,0,2018-02-10
1073,인천,강화군,0,0,0,0,0,0,2018-03-10
1074,인천,강화군,0,0,0,0,0,0,2018-04-10
1075,인천,강화군,1,0,0,1,1,0,2018-05-10
1076,인천,강화군,2,0,1,3,1,0,2018-06-10
1077,인천,강화군,0,0,1,1,1,0,2018-07-10
1078,인천,강화군,6,0,1,7,3,0,2018-08-10
1079,인천,강화군,0,0,0,0,0,0,2018-09-10
1080,인천,강화군,1,0,0,1,1,0,2018-10-10
1081,인천,강화군,0,0,0,0,0,0,2018-11-10
1082,인천,강화군,0,0,1,1,1,0,2018-12-10
1083,인천,계양구,3,0,2,5,5,0,2018-01-10
1084,인천,계양구,0,0,0,0,0,0,2018-02-10
1085,인천,계양구,4,0,1,5,3,0,2018-03-10
1086,인천,계양구,1,0,0,1,1,0,2018-04-10
1087,인천,계양구,4,0,3,7,5,0,2018-05-10
1088,인천,계양구,0,0,0,0,0,0,2018-06-10
1089,인천,계양구,0,0,0,0,1,1,2018-07-10
1090,인천,계양구,4,0,2,6,4,0,2018-08-10
1091,인천,계양구,2,1,1,4,4,0,2018-09-10
1092,인천,계양구,2,0,0,2,2,0,2018-10-10
1093,인천,계양구,1,0,0,1,1,0,2018-11-10
1094,인천,계양구,2,0,1,3,3,0,2018-12-10
1095,인천,남동구,18,0,3,21,13,0,2018-01-10
1096,인천,남동구,3,0,0,3,3,0,2018-02-10
1097,인천,남동구,6,0,1,7,5,0,2018-03-10
1098,인천,남동구,5,0,4,9,6,0,2018-04-10
1099,인천,남동구,6,0,2,8,5,0,2018-05-10
1100,인천,남동구,5,0,2,7,4,0,2018-06-10
1101,인천,남동구,7,1,1,9,6,0,2018-07-10
1102,인천,남동구,0,0,0,0,0,0,2018-08-10
1103,인천,남동구,11,0,0,11,8,0,2018-09-10
1104,인천,남동구,4,0,2,6,4,0,2018-10-10
1105,인천,남동구,1,1,0,2,2,0,2018-11-10
1106,인천,남동구,10,0,0,10,6,0,2018-12-10
1107,인천,동구,0,0,0,0,0,0,2018-01-10
1108,인천,동구,0,0,0,0,0,0,2018-02-10
1109,인천,동구,3,0,0,3,1,0,2018-03-10
1110,인천,동구,0,0,0,0,0,0,2018-04-10
1111,인천,동구,0,0,1,1,1,0,2018-05-10
1112,인천,동구,0,0,0,0,0,0,2018-06-10
1113,인천,동구,0,0,0,0,0,0,2018-07-10
1114,인천,동구,0,1,1,2,2,0,2018-08-10
1115,인천,동구,1,0,0,1,1,0,2018-09-10
1116,인천,동구,0,0,0,0,0,0,2018-10-10
1117,인천,동구,2,0,0,2,1,0,2018-11-10
1118,인천,동구,0,0,0,0,0,0,2018-12-10
1119,인천,미추홀구,3,1,0,4,4,0,2018-01-10
1120,인천,미추홀구,2,2,1,5,5,0,2018-02-10
1121,인천,미추홀구,8,0,0,8,5,0,2018-03-10
1122,인천,미추홀구,1,0,0,1,1,0,2018-04-10
1123,인천,미추홀구,0,0,0,0,0,0,2018-05-10
1124,인천,미추홀구,4,2,1,7,5,0,2018-06-10
1125,인천,미추홀구,6,1,3,10,4,1,2018-07-10
1126,인천,미추홀구,1,1,0,2,2,0,2018-08-10
1127,인천,미추홀구,5,0,2,7,7,0,2018-09-10
1128,인천,미추홀구,9,0,3,12,4,1,2018-10-10
1129,인천,미추홀구,0,0,1,1,1,0,2018-11-10
1130,인천,미추홀구,2,0,0,2,2,0,2018-12-10
1131,인천,부평구,5,0,1,6,5,0,2018-01-10
1132,인천,부평구,8,0,2,10,6,0,2018-02-10
1133,인천,부평구,6,0,2,8,4,0,2018-03-10
1134,인천,부평구,7,1,5,13,6,0,2018-04-10
1135,인천,부평구,4,0,2,6,4,0,2018-05-10
1136,인천,부평구,3,0,1,4,3,0,2018-06-10
1137,인천,부평구,8,0,0,8,3,0,2018-07-10
1138,인천,부평구,7,0,0,7,3,0,2018-08-10
1139,인천,부평구,6,2,1,9,5,0,2018-09-10
1140,인천,부평구,1,0,3,4,4,0,2018-10-10
1141,인천,부평구,6,1,1,8,4,0,2018-11-10
1142,인천,부평구,4,0,0,4,3,0,2018-12-10
1143,인천,서구,7,1,5,13,12,0,2018-01-10
1144,인천,서구,6,0,5,11,6,0,2018-02-10
1145,인천,서구,5,0,0,5,4,0,2018-03-10
1146,인천,서구,2,0,0,2,2,0,2018-04-10
1147,인천,서구,2,0,1,3,3,0,2018-05-10
1148,인천,서구,9,0,1,10,5,0,2018-06-10
1149,인천,서구,1,0,1,2,2,0,2018-07-10
1150,인천,서구,6,1,3,10,4,0,2018-08-10
1151,인천,서구,3,0,1,4,4,0,2018-09-10
1152,인천,서구,3,1,0,4,3,0,2018-10-10
1153,인천,서구,1,0,0,1,1,0,2018-11-10
1154,인천,서구,2,0,1,3,3,0,2018-12-10
1155,인천,연수구,6,0,1,7,4,0,2018-01-10
1156,인천,연수구,2,1,5,8,7,0,2018-02-10
1157,인천,연수구,8,0,1,9,3,0,2018-03-10
1158,인천,연수구,2,0,0,2,2,0,2018-04-10
1159,인천,연수구,0,0,3,3,2,0,2018-05-10
1160,인천,연수구,0,0,1,1,1,0,2018-06-10
1161,인천,연수구,4,0,1,5,3,0,2018-07-10
1162,인천,연수구,4,0,0,4,3,0,2018-08-10
1163,인천,연수구,1,0,0,1,1,0,2018-09-10
1164,인천,연수구,0,0,1,1,1,0,2018-10-10
1165,인천,연수구,0,0,1,1,1,0,2018-11-10
1166,인천,연수구,1,0,2,3,3,0,2018-12-10
1167,인천,옹진군,0,0,0,0,0,0,2018-01-10
1168,인천,옹진군,0,0,0,0,0,0,2018-03-10
1169,인천,옹진군,0,0,0,0,0,0,2018-04-10
1170,인천,옹진군,0,0,0,0,0,0,2018-05-10
1171,인천,옹진군,0,0,0,0,0,0,2018-06-10
1172,인천,옹진군,0,0,0,0,0,0,2018-07-10
1173,인천,옹진군,0,0,0,0,0,0,2018-08-10
1174,인천,옹진군,0,0,0,0,0,0,2018-09-10
1175,인천,옹진군,0,0,0,0,0,0,2018-10-10
1176,인천,옹진군,0,0,0,0,0,0,2018-11-10
1177,인천,옹진군,0,0,0,0,0,0,2018-12-10
1178,인천,중구,0,0,1,1,1,0,2018-01-10
1179,인천,중구,0,0,1,1,1,0,2018-02-10
1180,인천,중구,0,0,0,0,0,0,2018-03-10
1181,인천,중구,5,0,0,5,4,0,2018-04-10
1182,인천,중구,0,1,0,1,1,0,2018-05-10
1183,인천,중구,1,0,1,2,2,0,2018-06-10
1184,인천,중구,5,0,2,7,5,0,2018-07-10
1185,인천,중구,2,0,0,2,1,0,2018-08-10
1186,인천,중구,1,1,0,2,1,0,2018-09-10
1187,인천,중구,0,0,0,0,0,0,2018-10-10
1188,인천,중구,0,0,0,0,0,0,2018-11-10
1189,인천,중구,3,0,0,3,2,0,2018-12-10
1190,인천,강화군,0,0,0,0,0,0,2018-01-11
1191,인천,강화군,0,0,1,1,1,0,2018-02-11
1192,인천,강화군,0,0,0,0,0,0,2018-03-11
1193,인천,강화군,0,0,0,0,0,0,2018-04-11
1194,인천,강화군,2,0,0,2,1,0,2018-05-11
1195,인천,강화군,0,0,1,1,1,0,2018-06-11
1196,인천,강화군,0,0,1,1,1,0,2018-07-11
1197,인천,강화군,3,0,4,7,3,0,2018-08-11
1198,인천,강화군,0,0,0,0,0,0,2018-09-11
1199,인천,강화군,0,0,1,1,1,0,2018-10-11
1200,인천,강화군,3,0,0,3,1,0,2018-11-11
1201,인천,강화군,0,0,1,1,1,0,2018-12-11
1202,인천,계양구,5,0,1,6,3,0,2018-01-11
1203,인천,계양구,3,0,0,3,1,0,2018-02-11
1204,인천,계양구,1,0,0,1,1,0,2018-03-11
1205,인천,계양구,3,0,0,3,3,0,2018-04-11
1206,인천,계양구,2,1,1,4,3,0,2018-05-11
1207,인천,계양구,2,0,2,4,4,0,2018-06-11
1208,인천,계양구,0,0,1,1,1,0,2018-07-11
1209,인천,계양구,1,0,0,1,1,0,2018-08-11
1210,인천,계양구,1,0,0,1,1,0,2018-09-11
1211,인천,계양구,0,0,1,1,2,1,2018-10-11
1212,인천,계양구,0,0,0,0,0,0,2018-11-11
1213,인천,계양구,1,0,0,1,1,0,2018-12-11
1214,인천,남동구,9,1,3,13,8,0,2018-01-11
1215,인천,남동구,3,0,1,4,3,0,2018-02-11
1216,인천,남동구,0,1,1,2,2,0,2018-03-11
1217,인천,남동구,6,0,1,7,4,0,2018-04-11
1218,인천,남동구,11,1,0,12,9,0,2018-05-11
1219,인천,남동구,5,0,2,7,6,0,2018-06-11
1220,인천,남동구,4,1,0,5,5,0,2018-07-11
1221,인천,남동구,1,1,0,2,2,0,2018-08-11
1222,인천,남동구,2,0,1,3,3,0,2018-09-11
1223,인천,남동구,2,0,0,2,2,0,2018-10-11
1224,인천,남동구,2,0,0,2,2,0,2018-11-11
1225,인천,남동구,6,0,0,6,5,0,2018-12-11
1226,인천,동구,0,0,0,0,0,0,2018-01-11
1227,인천,동구,0,0,0,0,0,0,2018-02-11
1228,인천,동구,0,0,0,0,0,0,2018-03-11
1229,인천,동구,0,0,0,0,0,0,2018-04-11
1230,인천,동구,1,0,0,1,1,0,2018-05-11
1231,인천,동구,0,0,1,1,1,0,2018-06-11
1232,인천,동구,1,0,0,1,1,0,2018-07-11
1233,인천,동구,0,0,0,0,0,0,2018-08-11
1234,인천,동구,0,0,0,0,0,0,2018-09-11
1235,인천,동구,0,0,0,0,0,0,2018-10-11
1236,인천,동구,1,0,0,1,1,0,2018-11-11
1237,인천,동구,0,0,0,0,0,0,2018-12-11
1238,인천,미추홀구,1,0,2,3,2,0,2018-01-11
1239,인천,미추홀구,4,0,0,4,2,0,2018-02-11
1240,인천,미추홀구,0,0,0,0,0,0,2018-03-11
1241,인천,미추홀구,2,1,1,4,4,0,2018-04-11
1242,인천,미추홀구,3,0,1,4,3,0,2018-05-11
1243,인천,미추홀구,6,1,1,8,5,0,2018-06-11
1244,인천,미추홀구,2,0,3,5,4,0,2018-07-11
1245,인천,미추홀구,0,0,0,0,0,0,2018-08-11
1246,인천,미추홀구,3,0,2,5,4,0,2018-09-11
1247,인천,미추홀구,2,0,0,2,2,0,2018-10-11
1248,인천,미추홀구,4,0,0,4,4,0,2018-11-11
1249,인천,미추홀구,2,0,0,2,2,0,2018-12-11
1250,인천,부평구,3,1,1,5,5,0,2018-01-11
1251,인천,부평구,10,0,1,11,5,0,2018-02-11
1252,인천,부평구,4,0,1,5,3,0,2018-03-11
1253,인천,부평구,3,0,0,3,2,0,2018-04-11
1254,인천,부평구,4,0,0,4,4,0,2018-05-11
1255,인천,부평구,4,0,1,5,3,0,2018-06-11
1256,인천,부평구,4,0,0,4,3,0,2018-07-11
1257,인천,부평구,1,0,0,1,1,0,2018-08-11
1258,인천,부평구,2,0,1,3,2,0,2018-09-11
1259,인천,부평구,2,0,0,2,1,0,2018-10-11
1260,인천,부평구,3,0,1,4,4,0,2018-11-11
1261,인천,부평구,3,0,1,4,3,0,2018-12-11
1262,인천,서구,4,2,2,8,8,0,2018-01-11
1263,인천,서구,6,1,2,9,5,0,2018-02-11
1264,인천,서구,4,0,0,4,3,0,2018-03-11
1265,인천,서구,8,0,2,10,4,0,2018-04-11
1266,인천,서구,2,2,3,7,5,0,2018-05-11
1267,인천,서구,4,0,3,7,5,0,2018-06-11
1268,인천,서구,3,0,1,4,3,0,2018-07-11
1269,인천,서구,2,0,2,4,3,0,2018-08-11
1270,인천,서구,3,0,0,3,1,0,2018-09-11
1271,인천,서구,9,0,2,11,7,0,2018-10-11
1272,인천,서구,3,0,1,4,3,0,2018-11-11
1273,인천,서구,7,0,2,9,6,0,2018-12-11
1274,인천,연수구,0,0,1,1,1,0,2018-01-11
1275,인천,연수구,2,0,2,4,3,0,2018-02-11
1276,인천,연수구,5,0,5,10,2,0,2018-03-11
1277,인천,연수구,2,0,0,2,2,0,2018-04-11
1278,인천,연수구,1,0,2,3,1,0,2018-05-11
1279,인천,연수구,0,0,2,2,2,0,2018-06-11
1280,인천,연수구,0,1,2,3,3,0,2018-07-11
1281,인천,연수구,1,0,0,1,1,0,2018-08-11
1282,인천,연수구,1,0,0,1,1,0,2018-09-11
1283,인천,연수구,1,0,1,2,1,0,2018-10-11
1284,인천,연수구,0,0,0,0,0,0,2018-11-11
1285,인천,연수구,0,0,0,0,0,0,2018-12-11
1286,인천,옹진군,0,0,0,0,0,0,2018-01-11
1287,인천,옹진군,0,0,0,0,0,0,2018-03-11
1288,인천,옹진군,0,0,0,0,0,0,2018-04-11
1289,인천,옹진군,0,0,0,0,0,0,2018-05-11
1290,인천,옹진군,0,0,0,0,0,0,2018-06-11
1291,인천,옹진군,0,0,0,0,0,0,2018-07-11
1292,인천,옹진군,2,0,0,2,1,0,2018-08-11
1293,인천,옹진군,0,0,0,0,0,0,2018-09-11
1294,인천,옹진군,0,0,0,0,0,0,2018-10-11
1295,인천,옹진군,0,0,0,0,0,0,2018-11-11
1296,인천,옹진군,0,0,0,0,0,0,2018-12-11
1297,인천,중구,0,0,1,1,1,0,2018-01-11
1298,인천,중구,1,0,1,2,2,0,2018-02-11
1299,인천,중구,0,0,0,0,0,0,2018-03-11
1300,인천,중구,0,0,0,0,0,0,2018-04-11
1301,인천,중구,1,1,0,2,2,0,2018-05-11
1302,인천,중구,1,0,0,1,1,0,2018-06-11
1303,인천,중구,5,0,0,5,4,0,2018-07-11
1304,인천,중구,1,1,2,4,2,0,2018-08-11
1305,인천,중구,1,0,1,2,1,0,2018-09-11
1306,인천,중구,0,0,0,0,0,0,2018-10-11
1307,인천,중구,0,0,0,0,0,0,2018-11-11
1308,인천,중구,3,0,1,4,3,0,2018-12-11
1309,인천,강화군,0,0,2,2,2,0,2018-01-12
1310,인천,강화군,0,0,1,1,1,0,2018-02-12
1311,인천,강화군,0,0,0,0,0,0,2018-03-12
1312,인천,강화군,1,0,0,1,1,0,2018-04-12
1313,인천,강화군,1,0,0,1,1,0,2018-05-12
1314,인천,강화군,0,0,0,0,0,0,2018-06-12
1315,인천,강화군,0,0,0,0,0,0,2018-07-12
1316,인천,강화군,0,0,0,0,0,0,2018-08-12
1317,인천,강화군,1,0,0,1,1,0,2018-09-12
1318,인천,강화군,2,0,1,3,3,0,2018-10-12
1319,인천,강화군,0,0,0,0,0,0,2018-11-12
1320,인천,강화군,0,0,0,0,0,0,2018-12-12
1321,인천,계양구,3,0,0,3,3,1,2018-01-12
1322,인천,계양구,5,0,0,5,3,0,2018-02-12
1323,인천,계양구,1,0,1,2,3,1,2018-03-12
1324,인천,계양구,2,0,0,2,2,0,2018-04-12
1325,인천,계양구,4,0,2,6,4,0,2018-05-12
1326,인천,계양구,0,0,1,1,1,0,2018-06-12
1327,인천,계양구,1,0,0,1,1,0,2018-07-12
1328,인천,계양구,4,0,0,4,2,0,2018-08-12
1329,인천,계양구,3,0,2,5,4,0,2018-09-12
1330,인천,계양구,2,0,0,2,1,0,2018-10-12
1331,인천,계양구,1,0,2,3,2,0,2018-11-12
1332,인천,계양구,2,1,0,3,2,0,2018-12-12
1333,인천,남동구,13,0,1,14,10,0,2018-01-12
1334,인천,남동구,10,1,0,11,5,0,2018-02-12
1335,인천,남동구,2,0,1,3,3,0,2018-03-12
1336,인천,남동구,3,0,2,5,5,0,2018-04-12
1337,인천,남동구,11,0,1,12,8,0,2018-05-12
1338,인천,남동구,10,0,2,12,10,0,2018-06-12
1339,인천,남동구,1,0,0,1,1,0,2018-07-12
1340,인천,남동구,5,0,1,6,5,0,2018-08-12
1341,인천,남동구,7,1,7,15,7,0,2018-09-12
1342,인천,남동구,4,1,0,5,4,0,2018-10-12
1343,인천,남동구,4,0,0,4,3,0,2018-11-12
1344,인천,남동구,4,1,0,5,4,0,2018-12-12
1345,인천,동구,3,0,0,3,1,0,2018-01-12
1346,인천,동구,0,0,0,0,0,0,2018-02-12
1347,인천,동구,0,0,0,0,0,0,2018-03-12
1348,인천,동구,1,0,0,1,1,0,2018-04-12
1349,인천,동구,0,0,0,0,0,0,2018-05-12
1350,인천,동구,0,0,0,0,0,0,2018-06-12
1351,인천,동구,2,0,0,2,2,0,2018-07-12
1352,인천,동구,0,0,0,0,0,0,2018-08-12
1353,인천,동구,0,0,0,0,0,0,2018-09-12
1354,인천,동구,0,0,0,0,0,0,2018-10-12
1355,인천,동구,0,0,0,0,0,0,2018-11-12
1356,인천,동구,0,0,0,0,0,0,2018-12-12
1357,인천,미추홀구,9,2,2,13,10,0,2018-01-12
1358,인천,미추홀구,6,0,0,6,4,0,2018-02-12
1359,인천,미추홀구,4,0,1,5,4,0,2018-03-12
1360,인천,미추홀구,3,1,0,4,3,0,2018-04-12
1361,인천,미추홀구,0,1,0,1,1,0,2018-05-12
1362,인천,미추홀구,2,1,0,3,2,0,2018-06-12
1363,인천,미추홀구,6,0,1,7,3,0,2018-07-12
1364,인천,미추홀구,2,0,0,2,2,1,2018-08-12
1365,인천,미추홀구,1,0,1,2,2,0,2018-09-12
1366,인천,미추홀구,1,0,0,1,1,0,2018-10-12
1367,인천,미추홀구,1,0,0,1,1,0,2018-11-12
1368,인천,미추홀구,1,1,2,4,4,0,2018-12-12
1369,인천,부평구,6,1,2,9,7,1,2018-01-12
1370,인천,부평구,3,0,1,4,3,0,2018-02-12
1371,인천,부평구,1,0,0,1,1,0,2018-03-12
1372,인천,부평구,2,0,4,6,5,0,2018-04-12
1373,인천,부평구,3,0,0,3,2,0,2018-05-12
1374,인천,부평구,2,0,0,2,1,0,2018-06-12
1375,인천,부평구,1,0,2,3,3,0,2018-07-12
1376,인천,부평구,0,0,0,0,0,0,2018-08-12
1377,인천,부평구,3,0,1,4,4,0,2018-09-12
1378,인천,부평구,2,0,0,2,2,0,2018-10-12
1379,인천,부평구,2,0,1,3,2,0,2018-11-12
1380,인천,부평구,1,0,0,1,1,0,2018-12-12
1381,인천,서구,10,0,4,14,13,0,2018-01-12
1382,인천,서구,2,0,1,3,3,0,2018-02-12
1383,인천,서구,3,0,2,5,4,0,2018-03-12
1384,인천,서구,9,1,6,16,5,0,2018-04-12
1385,인천,서구,8,0,1,9,6,0,2018-05-12
1386,인천,서구,1,0,2,3,3,0,2018-06-12
1387,인천,서구,0,0,1,1,1,0,2018-07-12
1388,인천,서구,2,0,0,2,2,0,2018-08-12
1389,인천,서구,3,0,1,4,5,1,2018-09-12
1390,인천,서구,1,0,0,1,1,0,2018-10-12
1391,인천,서구,1,0,2,3,3,0,2018-11-12
1392,인천,서구,3,0,0,3,2,0,2018-12-12
1393,인천,연수구,5,0,0,5,4,0,2018-01-12
1394,인천,연수구,2,0,0,2,1,0,2018-02-12
1395,인천,연수구,1,0,0,1,1,0,2018-03-12
1396,인천,연수구,10,0,0,10,6,1,2018-04-12
1397,인천,연수구,2,0,0,2,2,0,2018-05-12
1398,인천,연수구,0,0,0,0,0,0,2018-06-12
1399,인천,연수구,1,0,1,2,1,0,2018-07-12
1400,인천,연수구,1,0,0,1,2,1,2018-08-12
1401,인천,연수구,9,0,2,11,3,0,2018-09-12
1402,인천,연수구,0,0,0,0,0,0,2018-10-12
1403,인천,연수구,3,0,1,4,3,0,2018-11-12
1404,인천,연수구,5,0,0,5,3,0,2018-12-12
1405,인천,옹진군,0,0,0,0,0,0,2018-01-12
1406,인천,옹진군,1,0,1,2,1,0,2018-03-12
1407,인천,옹진군,0,0,0,0,0,0,2018-04-12
1408,인천,옹진군,1,0,0,1,1,0,2018-05-12
1409,인천,옹진군,0,0,0,0,0,0,2018-06-12
1410,인천,옹진군,0,0,0,0,0,0,2018-07-12
1411,인천,옹진군,0,0,0,0,0,0,2018-08-12
1412,인천,옹진군,0,0,0,0,0,0,2018-09-12
1413,인천,옹진군,0,0,0,0,0,0,2018-10-12
1414,인천,옹진군,0,0,0,0,0,0,2018-11-12
1415,인천,옹진군,0,0,0,0,0,0,2018-12-12
1416,인천,중구,0,0,1,1,1,0,2018-01-12
1417,인천,중구,0,0,1,1,1,0,2018-02-12
1418,인천,중구,0,0,0,0,0,0,2018-03-12
1419,인천,중구,0,0,0,0,0,0,2018-04-12
1420,인천,중구,3,0,1,4,3,0,2018-05-12
1421,인천,중구,0,0,0,0,0,0,2018-06-12
1422,인천,중구,0,0,0,0,0,0,2018-07-12
1423,인천,중구,3,0,0,3,1,0,2018-08-12
1424,인천,중구,2,0,1,3,3,0,2018-09-12
1425,인천,중구,7,0,0,7,4,0,2018-10-12
1426,인천,중구,3,0,0,3,2,0,2018-11-12
1427,인천,중구,1,0,1,2,2,0,2018-12-12
1428,인천,강화군,0,0,0,0,0,0,2018-01-13
1429,인천,강화군,0,0,1,1,1,0,2018-02-13
1430,인천,강화군,0,0,0,0,0,0,2018-03-13
1431,인천,강화군,0,0,1,1,1,0,2018-04-13
1432,인천,강화군,0,0,1,1,1,0,2018-05-13
1433,인천,강화군,0,0,1,1,1,0,2018-06-13
1434,인천,강화군,2,0,0,2,1,0,2018-07-13
1435,인천,강화군,0,0,0,0,0,0,2018-08-13
1436,인천,강화군,0,0,0,0,0,0,2018-09-13
1437,인천,강화군,0,0,0,0,0,0,2018-10-13
1438,인천,강화군,0,0,0,0,0,0,2018-11-13
1439,인천,강화군,0,0,0,0,0,0,2018-12-13
1440,인천,계양구,2,0,1,3,2,0,2018-01-13
1441,인천,계양구,9,1,0,10,5,0,2018-02-13
1442,인천,계양구,2,0,0,2,2,0,2018-03-13
1443,인천,계양구,0,0,1,1,1,0,2018-04-13
1444,인천,계양구,0,0,0,0,0,0,2018-05-13
1445,인천,계양구,3,0,0,3,3,0,2018-06-13
1446,인천,계양구,6,0,1,7,5,0,2018-07-13
1447,인천,계양구,4,0,0,4,2,0,2018-08-13
1448,인천,계양구,2,0,0,2,1,0,2018-09-13
1449,인천,계양구,4,0,0,4,2,0,2018-10-13
1450,인천,계양구,2,0,1,3,3,0,2018-11-13
1451,인천,계양구,4,1,0,5,4,0,2018-12-13
1452,인천,남동구,8,1,2,11,8,1,2018-01-13
1453,인천,남동구,8,0,2,10,7,0,2018-02-13
1454,인천,남동구,0,2,2,4,3,0,2018-03-13
1455,인천,남동구,5,0,1,6,4,0,2018-04-13
1456,인천,남동구,2,0,0,2,2,0,2018-05-13
1457,인천,남동구,5,1,0,6,3,0,2018-06-13
1458,인천,남동구,5,1,0,6,5,0,2018-07-13
1459,인천,남동구,20,2,3,25,6,0,2018-08-13
1460,인천,남동구,3,0,1,4,4,0,2018-09-13
1461,인천,남동구,6,0,5,11,6,0,2018-10-13
1462,인천,남동구,2,0,0,2,2,0,2018-11-13
1463,인천,남동구,9,0,0,9,7,0,2018-12-13
1464,인천,동구,0,0,0,0,0,0,2018-01-13
1465,인천,동구,1,0,0,1,1,0,2018-02-13
1466,인천,동구,1,0,0,1,1,0,2018-03-13
1467,인천,동구,0,0,0,0,0,0,2018-04-13
1468,인천,동구,0,0,0,0,0,0,2018-05-13
1469,인천,동구,0,0,0,0,0,0,2018-06-13
1470,인천,동구,0,0,2,2,2,0,2018-07-13
1471,인천,동구,2,0,0,2,1,0,2018-08-13
1472,인천,동구,1,0,0,1,1,0,2018-09-13
1473,인천,동구,0,0,0,0,0,0,2018-10-13
1474,인천,동구,0,0,0,0,0,0,2018-11-13
1475,인천,동구,0,0,0,0,0,0,2018-12-13
1476,인천,미추홀구,6,0,1,7,3,0,2018-01-13
1477,인천,미추홀구,4,0,3,7,6,0,2018-02-13
1478,인천,미추홀구,5,1,0,6,6,0,2018-03-13
1479,인천,미추홀구,5,1,1,7,6,0,2018-04-13
1480,인천,미추홀구,1,1,0,2,2,0,2018-05-13
1481,인천,미추홀구,1,0,0,1,1,0,2018-06-13
1482,인천,미추홀구,0,0,0,0,0,0,2018-07-13
1483,인천,미추홀구,3,1,4,8,2,0,2018-08-13
1484,인천,미추홀구,5,1,0,6,4,0,2018-09-13
1485,인천,미추홀구,2,0,0,2,1,0,2018-10-13
1486,인천,미추홀구,1,0,1,2,2,0,2018-11-13
1487,인천,미추홀구,5,0,2,7,6,0,2018-12-13
1488,인천,부평구,6,0,3,9,4,0,2018-01-13
1489,인천,부평구,10,0,1,11,4,0,2018-02-13
1490,인천,부평구,2,0,1,3,3,0,2018-03-13
1491,인천,부평구,6,2,0,8,6,0,2018-04-13
1492,인천,부평구,0,0,1,1,1,0,2018-05-13
1493,인천,부평구,3,0,0,3,2,0,2018-06-13
1494,인천,부평구,3,0,1,4,3,0,2018-07-13
1495,인천,부평구,1,0,1,2,2,0,2018-08-13
1496,인천,부평구,1,0,0,1,1,0,2018-09-13
1497,인천,부평구,2,0,3,5,5,0,2018-10-13
1498,인천,부평구,0,0,1,1,1,0,2018-11-13
1499,인천,부평구,1,1,1,3,3,0,2018-12-13
1500,인천,서구,6,2,5,13,8,0,2018-01-13
1501,인천,서구,7,0,1,8,6,0,2018-02-13
1502,인천,서구,7,0,0,7,5,0,2018-03-13
1503,인천,서구,3,0,2,5,4,0,2018-04-13
1504,인천,서구,4,0,5,9,6,0,2018-05-13
1505,인천,서구,4,0,1,5,5,0,2018-06-13
1506,인천,서구,2,0,2,4,4,0,2018-07-13
1507,인천,서구,9,0,1,10,6,0,2018-08-13
1508,인천,서구,11,0,1,12,7,0,2018-09-13
1509,인천,서구,6,0,1,7,3,0,2018-10-13
1510,인천,서구,2,0,2,4,4,0,2018-11-13
1511,인천,서구,3,0,2,5,5,0,2018-12-13
1512,인천,연수구,1,0,1,2,1,0,2018-01-13
1513,인천,연수구,5,0,0,5,4,0,2018-02-13
1514,인천,연수구,3,0,0,3,2,0,2018-03-13
1515,인천,연수구,1,1,2,4,3,0,2018-04-13
1516,인천,연수구,2,0,0,2,1,0,2018-05-13
1517,인천,연수구,2,0,0,2,1,0,2018-06-13
1518,인천,연수구,1,0,2,3,3,0,2018-07-13
1519,인천,연수구,0,0,0,0,0,0,2018-08-13
1520,인천,연수구,5,0,1,6,5,0,2018-09-13
1521,인천,연수구,0,1,2,3,2,0,2018-10-13
1522,인천,연수구,0,0,0,0,0,0,2018-11-13
1523,인천,연수구,6,2,0,8,6,0,2018-12-13
1524,인천,옹진군,0,0,0,0,0,0,2018-01-13
1525,인천,옹진군,0,0,0,0,0,0,2018-03-13
1526,인천,옹진군,0,0,0,0,0,0,2018-04-13
1527,인천,옹진군,0,0,0,0,0,0,2018-05-13
1528,인천,옹진군,0,0,2,2,1,0,2018-06-13
1529,인천,옹진군,0,0,0,0,0,0,2018-07-13
1530,인천,옹진군,0,0,0,0,0,0,2018-08-13
1531,인천,옹진군,0,0,0,0,0,0,2018-09-13
1532,인천,옹진군,0,0,0,0,0,0,2018-10-13
1533,인천,옹진군,0,0,0,0,0,0,2018-11-13
1534,인천,옹진군,0,0,0,0,0,0,2018-12-13
1535,인천,중구,1,0,0,1,1,0,2018-01-13
1536,인천,중구,3,1,2,6,3,0,2018-02-13
1537,인천,중구,0,0,0,0,0,0,2018-03-13
1538,인천,중구,3,2,1,6,4,0,2018-04-13
1539,인천,중구,0,0,0,0,0,0,2018-05-13
1540,인천,중구,3,0,1,4,3,0,2018-06-13
1541,인천,중구,3,0,0,3,2,0,2018-07-13
1542,인천,중구,2,1,1,4,1,0,2018-08-13
1543,인천,중구,5,0,2,7,3,0,2018-09-13
1544,인천,중구,5,0,0,5,2,0,2018-10-13
1545,인천,중구,1,0,0,1,1,0,2018-11-13
1546,인천,중구,4,0,2,6,4,0,2018-12-13
1547,인천,강화군,0,0,2,2,1,0,2018-01-14
1548,인천,강화군,0,0,0,0,0,0,2018-02-14
1549,인천,강화군,9,10,0,19,2,0,2018-03-14
1550,인천,강화군,0,0,0,0,0,0,2018-04-14
1551,인천,강화군,0,0,0,0,0,0,2018-05-14
1552,인천,강화군,2,0,0,2,1,0,2018-06-14
1553,인천,강화군,0,0,1,1,1,0,2018-07-14
1554,인천,강화군,0,0,0,0,0,0,2018-08-14
1555,인천,강화군,1,0,1,2,2,0,2018-09-14
1556,인천,강화군,1,0,1,2,1,0,2018-10-14
1557,인천,강화군,1,0,0,1,1,0,2018-11-14
1558,인천,강화군,0,0,0,0,0,0,2018-12-14
1559,인천,계양구,3,0,0,3,1,0,2018-01-14
1560,인천,계양구,0,0,1,1,1,0,2018-02-14
1561,인천,계양구,2,0,0,2,2,0,2018-03-14
1562,인천,계양구,3,0,1,4,4,0,2018-04-14
1563,인천,계양구,3,0,0,3,2,0,2018-05-14
1564,인천,계양구,3,0,2,5,3,0,2018-06-14
1565,인천,계양구,3,0,0,3,2,0,2018-07-14
1566,인천,계양구,3,0,0,3,2,0,2018-08-14
1567,인천,계양구,3,0,1,4,3,0,2018-09-14
1568,인천,계양구,3,0,0,3,3,0,2018-10-14
1569,인천,계양구,2,1,0,3,2,0,2018-11-14
1570,인천,계양구,2,1,0,3,3,0,2018-12-14
1571,인천,남동구,2,0,3,5,4,0,2018-01-14
1572,인천,남동구,7,0,1,8,4,0,2018-02-14
1573,인천,남동구,4,0,2,6,6,0,2018-03-14
1574,인천,남동구,12,0,3,15,11,0,2018-04-14
1575,인천,남동구,2,1,0,3,2,0,2018-05-14
1576,인천,남동구,6,0,0,6,4,0,2018-06-14
1577,인천,남동구,1,0,3,4,3,0,2018-07-14
1578,인천,남동구,6,0,0,6,2,0,2018-08-14
1579,인천,남동구,12,0,2,14,12,0,2018-09-14
1580,인천,남동구,7,0,0,7,5,0,2018-10-14
1581,인천,남동구,4,2,1,7,6,0,2018-11-14
1582,인천,남동구,4,0,1,5,4,0,2018-12-14
1583,인천,동구,1,0,0,1,2,1,2018-01-14
1584,인천,동구,0,0,0,0,0,0,2018-02-14
1585,인천,동구,1,3,0,4,2,0,2018-03-14
1586,인천,동구,0,0,0,0,0,0,2018-04-14
1587,인천,동구,0,0,1,1,1,0,2018-05-14
1588,인천,동구,1,0,0,1,1,0,2018-06-14
1589,인천,동구,0,0,2,2,2,0,2018-07-14
1590,인천,동구,0,0,0,0,0,0,2018-08-14
1591,인천,동구,0,0,0,0,0,0,2018-09-14
1592,인천,동구,0,0,0,0,0,0,2018-10-14
1593,인천,동구,0,0,0,0,0,0,2018-11-14
1594,인천,동구,0,0,0,0,0,0,2018-12-14
1595,인천,미추홀구,7,3,0,10,6,0,2018-01-14
1596,인천,미추홀구,1,0,0,1,1,0,2018-02-14
1597,인천,미추홀구,1,0,0,1,1,0,2018-03-14
1598,인천,미추홀구,2,1,0,3,3,0,2018-04-14
1599,인천,미추홀구,2,1,1,4,4,0,2018-05-14
1600,인천,미추홀구,1,1,0,2,2,0,2018-06-14
1601,인천,미추홀구,1,1,0,2,2,0,2018-07-14
1602,인천,미추홀구,6,2,4,12,4,0,2018-08-14
1603,인천,미추홀구,5,1,2,8,6,0,2018-09-14
1604,인천,미추홀구,3,0,1,4,3,0,2018-10-14
1605,인천,미추홀구,4,0,1,5,3,0,2018-11-14
1606,인천,미추홀구,5,3,2,10,5,0,2018-12-14
1607,인천,부평구,4,1,1,6,3,0,2018-01-14
1608,인천,부평구,3,0,0,3,3,0,2018-02-14
1609,인천,부평구,1,0,1,2,2,0,2018-03-14
1610,인천,부평구,7,0,1,8,6,0,2018-04-14
1611,인천,부평구,6,0,0,6,4,0,2018-05-14
1612,인천,부평구,1,0,3,4,2,0,2018-06-14
1613,인천,부평구,4,0,1,5,5,0,2018-07-14
1614,인천,부평구,1,0,0,1,1,0,2018-08-14
1615,인천,부평구,3,0,1,4,4,0,2018-09-14
1616,인천,부평구,1,0,1,2,2,0,2018-10-14
1617,인천,부평구,8,0,3,11,5,0,2018-11-14
1618,인천,부평구,4,0,0,4,4,0,2018-12-14
1619,인천,서구,2,0,1,3,2,0,2018-01-14
1620,인천,서구,3,0,1,4,3,0,2018-02-14
1621,인천,서구,5,0,0,5,5,0,2018-03-14
1622,인천,서구,5,0,1,6,3,0,2018-04-14
1623,인천,서구,9,0,2,11,6,0,2018-05-14
1624,인천,서구,0,0,1,1,1,0,2018-06-14
1625,인천,서구,10,0,1,11,6,0,2018-07-14
1626,인천,서구,13,0,1,14,9,0,2018-08-14
1627,인천,서구,3,1,3,7,7,0,2018-09-14
1628,인천,서구,2,0,1,3,3,0,2018-10-14
1629,인천,서구,6,0,0,6,5,1,2018-11-14
1630,인천,서구,1,0,0,1,1,0,2018-12-14
1631,인천,연수구,3,0,0,3,2,0,2018-01-14
1632,인천,연수구,2,0,1,3,2,0,2018-02-14
1633,인천,연수구,4,0,0,4,1,0,2018-03-14
1634,인천,연수구,7,1,0,8,4,0,2018-04-14
1635,인천,연수구,2,0,0,2,1,0,2018-05-14
1636,인천,연수구,2,0,0,2,1,0,2018-06-14
1637,인천,연수구,2,0,0,2,2,0,2018-07-14
1638,인천,연수구,0,0,1,1,1,0,2018-08-14
1639,인천,연수구,1,0,2,3,2,0,2018-09-14
1640,인천,연수구,1,0,3,4,3,0,2018-10-14
1641,인천,연수구,0,0,1,1,1,0,2018-11-14
1642,인천,연수구,5,0,2,7,4,0,2018-12-14
1643,인천,옹진군,0,0,0,0,0,0,2018-01-14
1644,인천,옹진군,0,0,0,0,0,0,2018-03-14
1645,인천,옹진군,0,0,0,0,0,0,2018-04-14
1646,인천,옹진군,0,0,0,0,0,0,2018-05-14
1647,인천,옹진군,0,0,0,0,0,0,2018-06-14
1648,인천,옹진군,1,0,0,1,1,0,2018-07-14
1649,인천,옹진군,0,0,0,0,0,0,2018-08-14
1650,인천,옹진군,0,0,0,0,0,0,2018-09-14
1651,인천,옹진군,0,0,0,0,0,0,2018-10-14
1652,인천,옹진군,0,0,0,0,0,0,2018-11-14
1653,인천,옹진군,0,0,0,0,0,0,2018-12-14
1654,인천,중구,1,0,2,3,2,0,2018-01-14
1655,인천,중구,1,0,0,1,1,0,2018-02-14
1656,인천,중구,0,0,0,0,0,0,2018-03-14
1657,인천,중구,0,0,0,0,0,0,2018-04-14
1658,인천,중구,4,0,0,4,3,0,2018-05-14
1659,인천,중구,1,0,1,2,2,0,2018-06-14
1660,인천,중구,0,1,4,5,1,0,2018-07-14
1661,인천,중구,1,0,0,1,1,0,2018-08-14
1662,인천,중구,2,0,0,2,3,1,2018-09-14
1663,인천,중구,6,0,1,7,3,0,2018-10-14
1664,인천,중구,1,0,1,2,2,0,2018-11-14
1665,인천,중구,1,0,0,1,1,0,2018-12-14
1666,인천,강화군,0,0,0,0,0,0,2018-01-15
1667,인천,강화군,0,0,0,0,0,0,2018-02-15
1668,인천,강화군,0,0,0,0,0,0,2018-03-15
1669,인천,강화군,0,0,0,0,0,0,2018-04-15
1670,인천,강화군,0,0,0,0,0,0,2018-05-15
1671,인천,강화군,0,0,0,0,0,0,2018-06-15
1672,인천,강화군,2,0,2,4,2,0,2018-07-15
1673,인천,강화군,0,0,0,0,0,0,2018-08-15
1674,인천,강화군,1,0,0,1,1,0,2018-09-15
1675,인천,강화군,0,0,0,0,0,0,2018-10-15
1676,인천,강화군,0,0,0,0,0,0,2018-11-15
1677,인천,강화군,0,0,0,0,0,0,2018-12-15
1678,인천,계양구,6,0,0,6,3,0,2018-01-15
1679,인천,계양구,0,1,0,1,1,0,2018-02-15
1680,인천,계양구,2,0,0,2,2,0,2018-03-15
1681,인천,계양구,3,0,1,4,2,0,2018-04-15
1682,인천,계양구,0,0,0,0,0,0,2018-05-15
1683,인천,계양구,1,0,0,1,1,0,2018-06-15
1684,인천,계양구,2,0,0,2,1,0,2018-07-15
1685,인천,계양구,3,0,0,3,1,0,2018-08-15
1686,인천,계양구,1,0,0,1,1,0,2018-09-15
1687,인천,계양구,1,0,1,2,2,0,2018-10-15
1688,인천,계양구,0,0,0,0,0,0,2018-11-15
1689,인천,계양구,3,1,1,5,4,0,2018-12-15
1690,인천,남동구,6,0,2,8,8,0,2018-01-15
1691,인천,남동구,1,0,1,2,2,0,2018-02-15
1692,인천,남동구,2,0,1,3,3,0,2018-03-15
1693,인천,남동구,5,2,0,7,4,0,2018-04-15
1694,인천,남동구,7,0,1,8,5,0,2018-05-15
1695,인천,남동구,5,0,1,6,2,0,2018-06-15
1696,인천,남동구,2,0,1,3,3,0,2018-07-15
1697,인천,남동구,8,0,0,8,5,0,2018-08-15
1698,인천,남동구,1,0,0,1,1,0,2018-09-15
1699,인천,남동구,1,0,2,3,2,0,2018-10-15
1700,인천,남동구,12,0,2,14,8,0,2018-11-15
1701,인천,남동구,2,4,1,7,4,0,2018-12-15
1702,인천,동구,0,0,1,1,1,0,2018-01-15
1703,인천,동구,0,0,0,0,0,0,2018-02-15
1704,인천,동구,0,0,0,0,0,0,2018-03-15
1705,인천,동구,0,0,0,0,0,0,2018-04-15
1706,인천,동구,0,0,0,0,0,0,2018-05-15
1707,인천,동구,0,0,0,0,0,0,2018-06-15
1708,인천,동구,0,0,0,0,0,0,2018-07-15
1709,인천,동구,0,1,0,1,1,0,2018-08-15
1710,인천,동구,0,0,0,0,0,0,2018-09-15
1711,인천,동구,0,0,1,1,1,0,2018-10-15
1712,인천,동구,0,0,0,0,0,0,2018-11-15
1713,인천,동구,0,0,0,0,0,0,2018-12-15
1714,인천,미추홀구,6,0,7,13,7,0,2018-01-15
1715,인천,미추홀구,3,0,1,4,1,0,2018-02-15
1716,인천,미추홀구,1,0,1,2,2,0,2018-03-15
1717,인천,미추홀구,4,0,2,6,4,0,2018-04-15
1718,인천,미추홀구,3,1,2,6,6,0,2018-05-15
1719,인천,미추홀구,2,0,1,3,3,0,2018-06-15
1720,인천,미추홀구,1,0,0,1,1,0,2018-07-15
1721,인천,미추홀구,2,2,0,4,2,0,2018-08-15
1722,인천,미추홀구,2,0,1,3,3,0,2018-09-15
1723,인천,미추홀구,0,0,0,0,0,0,2018-10-15
1724,인천,미추홀구,6,0,0,6,2,0,2018-11-15
1725,인천,미추홀구,11,1,1,13,4,0,2018-12-15
1726,인천,부평구,4,0,4,8,5,0,2018-01-15
1727,인천,부평구,0,0,0,0,0,0,2018-02-15
1728,인천,부평구,0,0,0,0,0,0,2018-03-15
1729,인천,부평구,2,0,0,2,1,0,2018-04-15
1730,인천,부평구,3,0,1,4,4,0,2018-05-15
1731,인천,부평구,3,0,2,5,4,0,2018-06-15
1732,인천,부평구,3,0,1,4,3,0,2018-07-15
1733,인천,부평구,3,1,1,5,3,0,2018-08-15
1734,인천,부평구,0,0,0,0,0,0,2018-09-15
1735,인천,부평구,1,0,3,4,4,0,2018-10-15
1736,인천,부평구,5,0,0,5,4,0,2018-11-15
1737,인천,부평구,5,0,0,5,5,0,2018-12-15
1738,인천,서구,1,0,4,5,5,0,2018-01-15
1739,인천,서구,4,0,1,5,3,0,2018-02-15
1740,인천,서구,4,0,3,7,5,0,2018-03-15
1741,인천,서구,1,0,0,1,1,0,2018-04-15
1742,인천,서구,5,0,0,5,4,0,2018-05-15
1743,인천,서구,2,0,2,4,4,0,2018-06-15
1744,인천,서구,1,0,0,1,1,0,2018-07-15
1745,인천,서구,2,0,2,4,3,0,2018-08-15
1746,인천,서구,8,0,0,8,6,1,2018-09-15
1747,인천,서구,2,0,3,5,4,0,2018-10-15
1748,인천,서구,1,0,3,4,4,1,2018-11-15
1749,인천,서구,5,4,1,10,4,0,2018-12-15
1750,인천,연수구,0,0,0,0,0,0,2018-01-15
1751,인천,연수구,0,0,0,0,0,0,2018-02-15
1752,인천,연수구,0,0,0,0,1,1,2018-03-15
1753,인천,연수구,0,0,0,0,0,0,2018-04-15
1754,인천,연수구,1,0,0,1,1,0,2018-05-15
1755,인천,연수구,1,0,1,2,1,0,2018-06-15
1756,인천,연수구,0,0,3,3,3,0,2018-07-15
1757,인천,연수구,1,1,3,5,3,0,2018-08-15
1758,인천,연수구,0,0,1,1,1,0,2018-09-15
1759,인천,연수구,0,0,2,2,2,0,2018-10-15
1760,인천,연수구,6,0,2,8,3,0,2018-11-15
1761,인천,연수구,6,0,3,9,7,0,2018-12-15
1762,인천,옹진군,0,0,0,0,0,0,2018-01-15
1763,인천,옹진군,0,0,0,0,0,0,2018-03-15
1764,인천,옹진군,0,0,0,0,0,0,2018-04-15
1765,인천,옹진군,0,1,0,1,1,0,2018-05-15
1766,인천,옹진군,0,0,0,0,0,0,2018-06-15
1767,인천,옹진군,0,0,0,0,0,0,2018-07-15
1768,인천,옹진군,0,0,0,0,0,0,2018-08-15
1769,인천,옹진군,0,1,0,1,1,1,2018-09-15
1770,인천,옹진군,0,0,0,0,0,0,2018-10-15
1771,인천,옹진군,0,0,0,0,0,0,2018-11-15
1772,인천,옹진군,0,0,0,0,0,0,2018-12-15
1773,인천,중구,1,0,0,1,1,0,2018-01-15
1774,인천,중구,1,0,0,1,1,0,2018-02-15
1775,인천,중구,1,0,0,1,1,0,2018-03-15
1776,인천,중구,2,0,0,2,1,0,2018-04-15
1777,인천,중구,1,0,0,1,1,0,2018-05-15
1778,인천,중구,2,0,0,2,1,0,2018-06-15
1779,인천,중구,0,1,0,1,1,0,2018-07-15
1780,인천,중구,0,0,1,1,1,0,2018-08-15
1781,인천,중구,2,0,0,2,2,0,2018-09-15
1782,인천,중구,3,0,1,4,2,0,2018-10-15
1783,인천,중구,3,0,1,4,4,0,2018-11-15
1784,인천,중구,1,0,0,1,1,0,2018-12-15
1785,인천,강화군,0,0,1,1,1,0,2018-01-16
1786,인천,강화군,0,0,0,0,0,0,2018-02-16
1787,인천,강화군,0,0,0,0,0,0,2018-03-16
1788,인천,강화군,0,0,0,0,0,0,2018-04-16
1789,인천,강화군,0,0,0,0,0,0,2018-05-16
1790,인천,강화군,0,0,0,0,0,0,2018-06-16
1791,인천,강화군,0,0,0,0,1,1,2018-07-16
1792,인천,강화군,0,0,0,0,0,0,2018-08-16
1793,인천,강화군,0,0,0,0,0,0,2018-09-16
1794,인천,강화군,0,0,1,1,1,0,2018-10-16
1795,인천,강화군,0,0,0,0,0,0,2018-11-16
1796,인천,강화군,0,0,0,0,0,0,2018-12-16
1797,인천,계양구,2,0,0,2,2,0,2018-01-16
1798,인천,계양구,1,0,0,1,1,0,2018-02-16
1799,인천,계양구,2,0,0,2,2,0,2018-03-16
1800,인천,계양구,3,0,0,3,3,0,2018-04-16
1801,인천,계양구,1,0,1,2,2,0,2018-05-16
1802,인천,계양구,3,0,0,3,2,0,2018-06-16
1803,인천,계양구,0,0,2,2,2,0,2018-07-16
1804,인천,계양구,1,0,0,1,1,0,2018-08-16
1805,인천,계양구,2,0,1,3,1,0,2018-09-16
1806,인천,계양구,1,0,0,1,1,0,2018-10-16
1807,인천,계양구,3,0,0,3,3,0,2018-11-16
1808,인천,계양구,0,0,0,0,0,0,2018-12-16
1809,인천,남동구,6,1,0,7,5,0,2018-01-16
1810,인천,남동구,2,0,1,3,2,0,2018-02-16
1811,인천,남동구,2,0,1,3,3,0,2018-03-16
1812,인천,남동구,4,0,1,5,5,0,2018-04-16
1813,인천,남동구,4,0,0,4,4,0,2018-05-16
1814,인천,남동구,6,0,5,11,6,0,2018-06-16
1815,인천,남동구,5,0,2,7,7,0,2018-07-16
1816,인천,남동구,2,0,0,2,2,0,2018-08-16
1817,인천,남동구,7,0,0,7,5,1,2018-09-16
1818,인천,남동구,1,0,3,4,3,0,2018-10-16
1819,인천,남동구,2,0,1,3,4,1,2018-11-16
1820,인천,남동구,6,0,0,6,4,0,2018-12-16
1821,인천,동구,0,0,0,0,0,0,2018-01-16
1822,인천,동구,0,0,0,0,0,0,2018-02-16
1823,인천,동구,0,0,0,0,0,0,2018-03-16
1824,인천,동구,2,0,0,2,2,0,2018-04-16
1825,인천,동구,0,0,0,0,0,0,2018-05-16
1826,인천,동구,0,0,0,0,0,0,2018-06-16
1827,인천,동구,0,0,0,0,0,0,2018-07-16
1828,인천,동구,0,1,0,1,1,0,2018-08-16
1829,인천,동구,0,0,0,0,0,0,2018-09-16
1830,인천,동구,1,0,0,1,1,0,2018-10-16
1831,인천,동구,0,0,0,0,0,0,2018-11-16
1832,인천,동구,0,0,0,0,0,0,2018-12-16
1833,인천,미추홀구,6,0,0,6,3,0,2018-01-16
1834,인천,미추홀구,2,0,0,2,1,0,2018-02-16
1835,인천,미추홀구,7,1,4,12,10,0,2018-03-16
1836,인천,미추홀구,0,0,0,0,0,0,2018-04-16
1837,인천,미추홀구,6,1,0,7,2,0,2018-05-16
1838,인천,미추홀구,2,0,0,2,2,0,2018-06-16
1839,인천,미추홀구,4,1,1,6,5,0,2018-07-16
1840,인천,미추홀구,1,1,1,3,3,0,2018-08-16
1841,인천,미추홀구,2,0,1,3,2,0,2018-09-16
1842,인천,미추홀구,1,1,3,5,3,0,2018-10-16
1843,인천,미추홀구,4,0,0,4,3,0,2018-11-16
1844,인천,미추홀구,6,0,0,6,4,0,2018-12-16
1845,인천,부평구,1,0,0,1,1,0,2018-01-16
1846,인천,부평구,6,0,0,6,4,0,2018-02-16
1847,인천,부평구,4,0,2,6,4,0,2018-03-16
1848,인천,부평구,3,0,1,4,2,0,2018-04-16
1849,인천,부평구,2,0,0,2,1,0,2018-05-16
1850,인천,부평구,1,0,0,1,1,0,2018-06-16
1851,인천,부평구,1,0,1,2,2,0,2018-07-16
1852,인천,부평구,1,0,0,1,1,0,2018-08-16
1853,인천,부평구,3,0,0,3,3,0,2018-09-16
1854,인천,부평구,2,0,1,3,3,0,2018-10-16
1855,인천,부평구,2,0,2,4,3,0,2018-11-16
1856,인천,부평구,4,0,1,5,2,0,2018-12-16
1857,인천,서구,6,0,3,9,6,0,2018-01-16
1858,인천,서구,0,0,0,0,0,0,2018-02-16
1859,인천,서구,0,0,0,0,0,0,2018-03-16
1860,인천,서구,3,0,0,3,3,0,2018-04-16
1861,인천,서구,5,0,0,5,4,0,2018-05-16
1862,인천,서구,4,0,1,5,5,0,2018-06-16
1863,인천,서구,1,0,1,2,2,0,2018-07-16
1864,인천,서구,4,0,2,6,5,0,2018-08-16
1865,인천,서구,2,1,2,5,4,0,2018-09-16
1866,인천,서구,5,0,1,6,4,0,2018-10-16
1867,인천,서구,2,0,0,2,1,0,2018-11-16
1868,인천,서구,9,0,2,11,4,0,2018-12-16
1869,인천,연수구,4,0,1,5,2,0,2018-01-16
1870,인천,연수구,0,0,0,0,1,1,2018-02-16
1871,인천,연수구,3,0,1,4,3,0,2018-03-16
1872,인천,연수구,0,0,0,0,0,0,2018-04-16
1873,인천,연수구,2,0,1,3,3,0,2018-05-16
1874,인천,연수구,1,0,0,1,1,0,2018-06-16
1875,인천,연수구,2,0,0,2,1,0,2018-07-16
1876,인천,연수구,1,0,0,1,1,0,2018-08-16
1877,인천,연수구,3,0,1,4,3,0,2018-09-16
1878,인천,연수구,0,1,0,1,1,0,2018-10-16
1879,인천,연수구,3,0,1,4,4,1,2018-11-16
1880,인천,연수구,0,1,3,4,2,0,2018-12-16
1881,인천,옹진군,0,0,0,0,0,0,2018-01-16
1882,인천,옹진군,0,0,0,0,0,0,2018-03-16
1883,인천,옹진군,0,0,0,0,0,0,2018-04-16
1884,인천,옹진군,0,0,0,0,0,0,2018-05-16
1885,인천,옹진군,0,0,0,0,0,0,2018-06-16
1886,인천,옹진군,0,0,0,0,0,0,2018-07-16
1887,인천,옹진군,0,0,0,0,0,0,2018-08-16
1888,인천,옹진군,0,0,0,0,0,0,2018-09-16
1889,인천,옹진군,0,0,0,0,0,0,2018-10-16
1890,인천,옹진군,0,0,0,0,0,0,2018-11-16
1891,인천,옹진군,0,0,0,0,0,0,2018-12-16
1892,인천,중구,3,0,1,4,2,0,2018-01-16
1893,인천,중구,2,0,4,6,3,0,2018-02-16
1894,인천,중구,0,0,0,0,0,0,2018-03-16
1895,인천,중구,6,0,2,8,5,0,2018-04-16
1896,인천,중구,4,0,0,4,2,0,2018-05-16
1897,인천,중구,0,0,1,1,1,0,2018-06-16
1898,인천,중구,0,0,1,1,1,0,2018-07-16
1899,인천,중구,0,0,0,0,0,0,2018-08-16
1900,인천,중구,0,0,0,0,0,0,2018-09-16
1901,인천,중구,0,0,0,0,0,0,2018-10-16
1902,인천,중구,3,0,0,3,1,0,2018-11-16
1903,인천,중구,0,0,1,1,1,0,2018-12-16
1904,인천,강화군,0,0,0,0,0,0,2018-01-17
1905,인천,강화군,0,0,0,0,0,0,2018-02-17
1906,인천,강화군,0,1,0,1,1,0,2018-03-17
1907,인천,강화군,0,0,1,1,1,0,2018-04-17
1908,인천,강화군,0,0,0,0,0,0,2018-05-17
1909,인천,강화군,0,0,1,1,1,0,2018-06-17
1910,인천,강화군,0,0,0,0,0,0,2018-07-17
1911,인천,강화군,0,0,1,1,1,0,2018-08-17
1912,인천,강화군,0,0,0,0,0,0,2018-09-17
1913,인천,강화군,2,0,1,3,2,0,2018-10-17
1914,인천,강화군,1,0,1,2,1,0,2018-11-17
1915,인천,강화군,0,0,0,0,0,0,2018-12-17
1916,인천,계양구,2,0,0,2,1,0,2018-01-17
1917,인천,계양구,0,0,1,1,1,0,2018-02-17
1918,인천,계양구,0,0,1,1,1,0,2018-03-17
1919,인천,계양구,1,0,1,2,2,0,2018-04-17
1920,인천,계양구,2,0,1,3,3,0,2018-05-17
1921,인천,계양구,4,1,0,5,4,0,2018-06-17
1922,인천,계양구,2,0,1,3,2,0,2018-07-17
1923,인천,계양구,3,0,0,3,2,0,2018-08-17
1924,인천,계양구,0,0,1,1,1,0,2018-09-17
1925,인천,계양구,3,0,3,6,3,0,2018-10-17
1926,인천,계양구,2,0,1,3,3,0,2018-11-17
1927,인천,계양구,5,0,0,5,3,0,2018-12-17
1928,인천,남동구,6,0,1,7,5,0,2018-01-17
1929,인천,남동구,0,0,1,1,1,0,2018-02-17
1930,인천,남동구,8,0,0,8,7,0,2018-03-17
1931,인천,남동구,2,0,1,3,3,0,2018-04-17
1932,인천,남동구,4,0,0,4,3,0,2018-05-17
1933,인천,남동구,2,0,0,2,2,0,2018-06-17
1934,인천,남동구,5,2,0,7,7,0,2018-07-17
1935,인천,남동구,7,0,4,11,8,0,2018-08-17
1936,인천,남동구,5,0,1,6,4,0,2018-09-17
1937,인천,남동구,10,0,0,10,8,0,2018-10-17
1938,인천,남동구,9,0,6,15,9,0,2018-11-17
1939,인천,남동구,8,0,3,11,8,0,2018-12-17
1940,인천,동구,1,0,1,2,1,0,2018-01-17
1941,인천,동구,0,0,0,0,0,0,2018-02-17
1942,인천,동구,0,0,0,0,0,0,2018-03-17
1943,인천,동구,0,0,0,0,0,0,2018-04-17
1944,인천,동구,0,0,0,0,0,0,2018-05-17
1945,인천,동구,4,0,0,4,1,0,2018-06-17
1946,인천,동구,0,0,0,0,0,0,2018-07-17
1947,인천,동구,4,0,0,4,1,0,2018-08-17
1948,인천,동구,0,0,0,0,0,0,2018-09-17
1949,인천,동구,0,0,0,0,0,0,2018-10-17
1950,인천,동구,0,0,0,0,0,0,2018-11-17
1951,인천,동구,0,0,0,0,0,0,2018-12-17
1952,인천,미추홀구,4,0,0,4,4,0,2018-01-17
1953,인천,미추홀구,3,0,0,3,1,0,2018-02-17
1954,인천,미추홀구,1,0,1,2,2,0,2018-03-17
1955,인천,미추홀구,3,1,2,6,5,0,2018-04-17
1956,인천,미추홀구,6,0,2,8,5,0,2018-05-17
1957,인천,미추홀구,5,1,1,7,4,0,2018-06-17
1958,인천,미추홀구,2,0,0,2,1,0,2018-07-17
1959,인천,미추홀구,1,1,1,3,3,0,2018-08-17
1960,인천,미추홀구,2,3,0,5,5,0,2018-09-17
1961,인천,미추홀구,4,2,1,7,5,0,2018-10-17
1962,인천,미추홀구,4,0,1,5,4,0,2018-11-17
1963,인천,미추홀구,3,0,0,3,3,0,2018-12-17
1964,인천,부평구,4,0,0,4,3,0,2018-01-17
1965,인천,부평구,6,0,2,8,7,0,2018-02-17
1966,인천,부평구,3,0,1,4,3,0,2018-03-17
1967,인천,부평구,1,0,0,1,1,0,2018-04-17
1968,인천,부평구,3,0,1,4,4,0,2018-05-17
1969,인천,부평구,0,0,0,0,0,0,2018-06-17
1970,인천,부평구,2,0,1,3,2,0,2018-07-17
1971,인천,부평구,0,0,0,0,0,0,2018-08-17
1972,인천,부평구,1,0,1,2,2,0,2018-09-17
1973,인천,부평구,1,0,1,2,2,0,2018-10-17
1974,인천,부평구,10,0,0,10,5,0,2018-11-17
1975,인천,부평구,1,0,0,1,1,0,2018-12-17
1976,인천,서구,9,0,1,10,7,0,2018-01-17
1977,인천,서구,0,0,0,0,0,0,2018-02-17
1978,인천,서구,7,1,6,14,7,0,2018-03-17
1979,인천,서구,3,0,0,3,2,0,2018-04-17
1980,인천,서구,2,0,1,3,3,0,2018-05-17
1981,인천,서구,5,1,1,7,4,0,2018-06-17
1982,인천,서구,7,0,0,7,3,0,2018-07-17
1983,인천,서구,4,0,0,4,4,0,2018-08-17
1984,인천,서구,1,0,1,2,2,0,2018-09-17
1985,인천,서구,3,0,1,4,2,0,2018-10-17
1986,인천,서구,1,0,1,2,2,0,2018-11-17
1987,인천,서구,1,1,2,4,4,0,2018-12-17
1988,인천,연수구,0,0,1,1,1,0,2018-01-17
1989,인천,연수구,2,0,0,2,2,0,2018-02-17
1990,인천,연수구,1,1,2,4,2,0,2018-03-17
1991,인천,연수구,0,0,1,1,1,0,2018-04-17
1992,인천,연수구,3,1,0,4,2,0,2018-05-17
1993,인천,연수구,0,0,0,0,0,0,2018-06-17
1994,인천,연수구,4,0,0,4,4,0,2018-07-17
1995,인천,연수구,2,0,0,2,2,0,2018-08-17
1996,인천,연수구,1,0,4,5,4,0,2018-09-17
1997,인천,연수구,7,0,0,7,3,0,2018-10-17
1998,인천,연수구,0,0,1,1,1,0,2018-11-17
1999,인천,연수구,0,0,0,0,0,0,2018-12-17
2000,인천,옹진군,0,0,0,0,0,0,2018-01-17
2001,인천,옹진군,0,0,0,0,0,0,2018-03-17
2002,인천,옹진군,0,0,0,0,0,0,2018-04-17
2003,인천,옹진군,0,0,0,0,0,0,2018-05-17
2004,인천,옹진군,0,0,0,0,0,0,2018-06-17
2005,인천,옹진군,2,0,0,2,1,0,2018-07-17
2006,인천,옹진군,0,0,0,0,0,0,2018-08-17
2007,인천,옹진군,0,0,0,0,0,0,2018-09-17
2008,인천,옹진군,0,0,0,0,0,0,2018-10-17
2009,인천,옹진군,0,0,0,0,0,0,2018-11-17
2010,인천,옹진군,0,0,0,0,0,0,2018-12-17
2011,인천,중구,1,0,1,2,1,0,2018-01-17
2012,인천,중구,0,1,0,1,1,0,2018-02-17
2013,인천,중구,0,0,0,0,0,0,2018-03-17
2014,인천,중구,0,0,0,0,0,0,2018-04-17
2015,인천,중구,2,0,1,3,3,0,2018-05-17
2016,인천,중구,5,2,4,11,4,0,2018-06-17
2017,인천,중구,1,0,0,1,1,0,2018-07-17
2018,인천,중구,0,0,4,4,1,0,2018-08-17
2019,인천,중구,0,0,0,0,0,0,2018-09-17
2020,인천,중구,0,0,0,0,0,0,2018-10-17
2021,인천,중구,4,0,0,4,2,0,2018-11-17
2022,인천,중구,9,0,3,12,5,0,2018-12-17
2023,인천,강화군,0,0,0,0,0,0,2018-01-18
2024,인천,강화군,0,0,1,1,1,0,2018-02-18
2025,인천,강화군,0,0,0,0,0,0,2018-03-18
2026,인천,강화군,0,0,0,0,0,0,2018-04-18
2027,인천,강화군,0,0,0,0,0,0,2018-05-18
2028,인천,강화군,1,0,1,2,1,0,2018-06-18
2029,인천,강화군,2,0,0,2,1,0,2018-07-18
2030,인천,강화군,0,0,3,3,1,0,2018-08-18
2031,인천,강화군,0,0,0,0,0,0,2018-09-18
2032,인천,강화군,0,0,0,0,0,0,2018-10-18
2033,인천,강화군,0,0,0,0,0,0,2018-11-18
2034,인천,강화군,0,0,0,0,0,0,2018-12-18
2035,인천,계양구,1,0,0,1,1,0,2018-01-18
2036,인천,계양구,0,0,0,0,0,0,2018-02-18
2037,인천,계양구,2,0,0,2,2,0,2018-03-18
2038,인천,계양구,1,7,1,9,2,0,2018-04-18
2039,인천,계양구,6,0,1,7,5,0,2018-05-18
2040,인천,계양구,1,0,0,1,1,0,2018-06-18
2041,인천,계양구,2,0,2,4,2,0,2018-07-18
2042,인천,계양구,6,0,1,7,5,0,2018-08-18
2043,인천,계양구,0,0,1,1,1,0,2018-09-18
2044,인천,계양구,2,0,1,3,2,0,2018-10-18
2045,인천,계양구,4,0,3,7,4,0,2018-11-18
2046,인천,계양구,3,1,0,4,4,0,2018-12-18
2047,인천,남동구,5,1,1,7,5,0,2018-01-18
2048,인천,남동구,1,0,1,2,2,0,2018-02-18
2049,인천,남동구,2,1,1,4,4,1,2018-03-18
2050,인천,남동구,5,0,0,5,4,0,2018-04-18
2051,인천,남동구,6,0,1,7,5,0,2018-05-18
2052,인천,남동구,6,0,2,8,5,0,2018-06-18
2053,인천,남동구,11,0,1,12,5,0,2018-07-18
2054,인천,남동구,7,2,4,13,7,0,2018-08-18
2055,인천,남동구,8,0,2,10,9,0,2018-09-18
2056,인천,남동구,7,1,5,13,8,0,2018-10-18
2057,인천,남동구,4,1,1,6,4,0,2018-11-18
2058,인천,남동구,2,1,1,4,3,0,2018-12-18
2059,인천,동구,2,0,1,3,1,0,2018-01-18
2060,인천,동구,0,0,0,0,0,0,2018-02-18
2061,인천,동구,0,0,3,3,1,0,2018-03-18
2062,인천,동구,0,0,0,0,0,0,2018-04-18
2063,인천,동구,1,0,0,1,1,0,2018-05-18
2064,인천,동구,0,0,1,1,1,0,2018-06-18
2065,인천,동구,0,0,0,0,0,0,2018-07-18
2066,인천,동구,0,0,0,0,0,0,2018-08-18
2067,인천,동구,0,0,0,0,0,0,2018-09-18
2068,인천,동구,0,0,2,2,1,0,2018-10-18
2069,인천,동구,0,0,1,1,1,0,2018-11-18
2070,인천,동구,0,0,0,0,0,0,2018-12-18
2071,인천,미추홀구,3,1,1,5,4,0,2018-01-18
2072,인천,미추홀구,3,0,1,4,3,0,2018-02-18
2073,인천,미추홀구,0,0,1,1,1,0,2018-03-18
2074,인천,미추홀구,5,1,0,6,3,0,2018-04-18
2075,인천,미추홀구,4,2,1,7,5,0,2018-05-18
2076,인천,미추홀구,5,1,4,10,7,0,2018-06-18
2077,인천,미추홀구,3,0,2,5,3,0,2018-07-18
2078,인천,미추홀구,6,2,0,8,3,0,2018-08-18
2079,인천,미추홀구,5,1,2,8,7,0,2018-09-18
2080,인천,미추홀구,1,1,2,4,4,0,2018-10-18
2081,인천,미추홀구,0,1,0,1,1,0,2018-11-18
2082,인천,미추홀구,3,0,0,3,3,0,2018-12-18
2083,인천,부평구,3,0,3,6,3,0,2018-01-18
2084,인천,부평구,5,0,1,6,4,0,2018-02-18
2085,인천,부평구,2,0,2,4,3,0,2018-03-18
2086,인천,부평구,2,1,2,5,6,1,2018-04-18
2087,인천,부평구,4,0,5,9,4,0,2018-05-18
2088,인천,부평구,2,0,3,5,5,0,2018-06-18
2089,인천,부평구,2,0,1,3,3,0,2018-07-18
2090,인천,부평구,3,0,1,4,3,0,2018-08-18
2091,인천,부평구,6,1,2,9,4,0,2018-09-18
2092,인천,부평구,0,0,0,0,0,0,2018-10-18
2093,인천,부평구,4,0,3,7,2,0,2018-11-18
2094,인천,부평구,4,0,0,4,3,0,2018-12-18
2095,인천,서구,4,0,2,6,4,0,2018-01-18
2096,인천,서구,1,0,0,1,1,0,2018-02-18
2097,인천,서구,1,0,0,1,1,0,2018-03-18
2098,인천,서구,5,0,0,5,2,0,2018-04-18
2099,인천,서구,2,0,0,2,2,0,2018-05-18
2100,인천,서구,4,0,0,4,4,0,2018-06-18
2101,인천,서구,5,0,1,6,4,0,2018-07-18
2102,인천,서구,1,0,3,4,3,0,2018-08-18
2103,인천,서구,4,0,0,4,4,0,2018-09-18
2104,인천,서구,2,0,4,6,5,0,2018-10-18
2105,인천,서구,6,0,4,10,5,0,2018-11-18
2106,인천,서구,1,0,0,1,1,0,2018-12-18
2107,인천,연수구,1,0,1,2,2,0,2018-01-18
2108,인천,연수구,0,0,0,0,0,0,2018-02-18
2109,인천,연수구,4,0,1,5,2,0,2018-03-18
2110,인천,연수구,2,0,0,2,2,0,2018-04-18
2111,인천,연수구,5,0,1,6,4,0,2018-05-18
2112,인천,연수구,1,0,0,1,1,0,2018-06-18
2113,인천,연수구,1,0,0,1,1,0,2018-07-18
2114,인천,연수구,3,1,0,4,3,0,2018-08-18
2115,인천,연수구,1,0,1,2,2,0,2018-09-18
2116,인천,연수구,1,0,2,3,2,0,2018-10-18
2117,인천,연수구,1,0,0,1,1,0,2018-11-18
2118,인천,연수구,1,0,1,2,2,0,2018-12-18
2119,인천,옹진군,0,0,0,0,0,0,2018-01-18
2120,인천,옹진군,0,0,0,0,0,0,2018-03-18
2121,인천,옹진군,0,0,0,0,0,0,2018-04-18
2122,인천,옹진군,0,0,0,0,0,0,2018-05-18
2123,인천,옹진군,0,0,0,0,0,0,2018-06-18
2124,인천,옹진군,0,0,0,0,0,0,2018-07-18
2125,인천,옹진군,0,0,0,0,0,0,2018-08-18
2126,인천,옹진군,0,0,0,0,0,0,2018-09-18
2127,인천,옹진군,0,0,0,0,0,0,2018-10-18
2128,인천,옹진군,0,0,0,0,0,0,2018-11-18
2129,인천,옹진군,0,0,0,0,0,0,2018-12-18
2130,인천,중구,2,0,0,2,2,0,2018-01-18
2131,인천,중구,0,0,1,1,1,0,2018-02-18
2132,인천,중구,1,1,0,2,2,0,2018-03-18
2133,인천,중구,0,0,0,0,0,0,2018-04-18
2134,인천,중구,2,0,0,2,2,0,2018-05-18
2135,인천,중구,0,0,0,0,0,0,2018-06-18
2136,인천,중구,2,0,1,3,2,0,2018-07-18
2137,인천,중구,0,0,1,1,1,0,2018-08-18
2138,인천,중구,3,0,2,5,2,0,2018-09-18
2139,인천,중구,1,0,0,1,1,0,2018-10-18
2140,인천,중구,0,0,1,1,1,0,2018-11-18
2141,인천,중구,5,0,0,5,4,1,2018-12-18
2142,인천,강화군,0,0,0,0,0,0,2018-01-19
2143,인천,강화군,0,0,0,0,0,0,2018-02-19
2144,인천,강화군,0,0,0,0,0,0,2018-03-19
2145,인천,강화군,0,0,0,0,0,0,2018-04-19
2146,인천,강화군,2,0,0,2,1,0,2018-05-19
2147,인천,강화군,0,0,0,0,0,0,2018-06-19
2148,인천,강화군,1,0,1,2,2,0,2018-07-19
2149,인천,강화군,0,0,0,0,0,0,2018-08-19
2150,인천,강화군,0,0,1,1,1,0,2018-09-19
2151,인천,강화군,3,0,1,4,1,0,2018-10-19
2152,인천,강화군,0,0,0,0,0,0,2018-11-19
2153,인천,강화군,0,0,0,0,0,0,2018-12-19
2154,인천,계양구,1,1,0,2,2,1,2018-01-19
2155,인천,계양구,3,1,2,6,4,0,2018-02-19
2156,인천,계양구,3,0,2,5,5,0,2018-03-19
2157,인천,계양구,4,0,0,4,2,0,2018-04-19
2158,인천,계양구,7,0,3,10,5,0,2018-05-19
2159,인천,계양구,0,0,0,0,0,0,2018-06-19
2160,인천,계양구,4,0,1,5,4,0,2018-07-19
2161,인천,계양구,6,1,0,7,4,2,2018-08-19
2162,인천,계양구,3,0,0,3,2,0,2018-09-19
2163,인천,계양구,6,0,3,9,2,0,2018-10-19
2164,인천,계양구,2,0,0,2,1,0,2018-11-19
2165,인천,계양구,2,0,1,3,3,0,2018-12-19
2166,인천,남동구,10,0,2,12,9,0,2018-01-19
2167,인천,남동구,3,1,0,4,3,0,2018-02-19
2168,인천,남동구,2,0,0,2,2,0,2018-03-19
2169,인천,남동구,3,0,1,4,3,0,2018-04-19
2170,인천,남동구,7,1,2,10,5,0,2018-05-19
2171,인천,남동구,7,0,7,14,9,0,2018-06-19
2172,인천,남동구,7,0,1,8,7,0,2018-07-19
2173,인천,남동구,4,1,0,5,3,0,2018-08-19
2174,인천,남동구,11,0,3,14,11,0,2018-09-19
2175,인천,남동구,5,0,6,11,8,0,2018-10-19
2176,인천,남동구,4,2,1,7,7,0,2018-11-19
2177,인천,남동구,6,1,1,8,4,0,2018-12-19
2178,인천,동구,0,0,1,1,1,0,2018-01-19
2179,인천,동구,3,0,2,5,1,0,2018-02-19
2180,인천,동구,0,0,0,0,0,0,2018-03-19
2181,인천,동구,0,0,0,0,0,0,2018-04-19
2182,인천,동구,0,0,0,0,0,0,2018-05-19
2183,인천,동구,0,0,0,0,0,0,2018-06-19
2184,인천,동구,0,0,0,0,0,0,2018-07-19
2185,인천,동구,3,0,2,5,2,0,2018-08-19
2186,인천,동구,1,1,0,2,2,0,2018-09-19
2187,인천,동구,1,0,0,1,1,0,2018-10-19
2188,인천,동구,0,0,0,0,0,0,2018-11-19
2189,인천,동구,0,0,0,0,0,0,2018-12-19
2190,인천,미추홀구,2,0,1,3,3,0,2018-01-19
2191,인천,미추홀구,4,0,0,4,3,0,2018-02-19
2192,인천,미추홀구,2,1,0,3,3,0,2018-03-19
2193,인천,미추홀구,0,0,2,2,2,0,2018-04-19
2194,인천,미추홀구,14,1,0,15,6,0,2018-05-19
2195,인천,미추홀구,2,0,1,3,3,0,2018-06-19
2196,인천,미추홀구,3,0,0,3,1,0,2018-07-19
2197,인천,미추홀구,3,0,1,4,3,0,2018-08-19
2198,인천,미추홀구,1,1,0,2,2,0,2018-09-19
2199,인천,미추홀구,1,1,0,2,2,0,2018-10-19
2200,인천,미추홀구,2,0,2,4,3,0,2018-11-19
2201,인천,미추홀구,3,1,0,4,4,0,2018-12-19
2202,인천,부평구,4,0,0,4,3,0,2018-01-19
2203,인천,부평구,1,0,1,2,2,0,2018-02-19
2204,인천,부평구,4,2,1,7,2,0,2018-03-19
2205,인천,부평구,1,0,1,2,2,0,2018-04-19
2206,인천,부평구,3,0,0,3,3,0,2018-05-19
2207,인천,부평구,2,0,0,2,2,0,2018-06-19
2208,인천,부평구,8,0,0,8,7,0,2018-07-19
2209,인천,부평구,1,0,0,1,1,0,2018-08-19
2210,인천,부평구,5,0,0,5,3,0,2018-09-19
2211,인천,부평구,3,0,1,4,3,0,2018-10-19
2212,인천,부평구,0,0,0,0,0,0,2018-11-19
2213,인천,부평구,1,0,0,1,1,0,2018-12-19
2214,인천,서구,2,0,4,6,5,0,2018-01-19
2215,인천,서구,7,0,0,7,6,0,2018-02-19
2216,인천,서구,1,0,2,3,2,0,2018-03-19
2217,인천,서구,9,0,1,10,8,0,2018-04-19
2218,인천,서구,1,0,2,3,3,0,2018-05-19
2219,인천,서구,3,0,1,4,3,0,2018-06-19
2220,인천,서구,5,0,1,6,3,0,2018-07-19
2221,인천,서구,1,0,1,2,3,1,2018-08-19
2222,인천,서구,4,0,1,5,4,1,2018-09-19
2223,인천,서구,5,0,1,6,5,0,2018-10-19
2224,인천,서구,4,0,0,4,3,0,2018-11-19
2225,인천,서구,1,0,0,1,1,0,2018-12-19
2226,인천,연수구,2,1,3,6,3,0,2018-01-19
2227,인천,연수구,0,0,0,0,0,0,2018-02-19
2228,인천,연수구,6,0,0,6,3,0,2018-03-19
2229,인천,연수구,1,0,0,1,1,0,2018-04-19
2230,인천,연수구,1,1,1,3,3,0,2018-05-19
2231,인천,연수구,0,0,1,1,1,0,2018-06-19
2232,인천,연수구,2,0,1,3,3,0,2018-07-19
2233,인천,연수구,6,1,0,7,2,0,2018-08-19
2234,인천,연수구,5,0,0,5,2,0,2018-09-19
2235,인천,연수구,2,0,0,2,2,2,2018-10-19
2236,인천,연수구,3,0,1,4,2,0,2018-11-19
2237,인천,연수구,1,0,3,4,2,0,2018-12-19
2238,인천,옹진군,0,0,0,0,0,0,2018-01-19
2239,인천,옹진군,0,0,0,0,0,0,2018-03-19
2240,인천,옹진군,0,0,0,0,0,0,2018-04-19
2241,인천,옹진군,0,0,0,0,0,0,2018-05-19
2242,인천,옹진군,0,0,0,0,0,0,2018-06-19
2243,인천,옹진군,0,0,0,0,0,0,2018-07-19
2244,인천,옹진군,0,0,0,0,0,0,2018-08-19
2245,인천,옹진군,0,0,0,0,0,0,2018-09-19
2246,인천,옹진군,0,0,0,0,0,0,2018-10-19
2247,인천,옹진군,0,0,0,0,0,0,2018-11-19
2248,인천,옹진군,0,0,0,0,0,0,2018-12-19
2249,인천,중구,1,0,1,2,2,0,2018-01-19
2250,인천,중구,2,0,0,2,1,0,2018-02-19
2251,인천,중구,0,0,0,0,0,0,2018-03-19
2252,인천,중구,2,0,1,3,2,1,2018-04-19
2253,인천,중구,4,0,1,5,3,0,2018-05-19
2254,인천,중구,1,1,0,2,2,0,2018-06-19
2255,인천,중구,0,0,0,0,0,0,2018-07-19
2256,인천,중구,3,2,0,5,2,0,2018-08-19
2257,인천,중구,0,0,1,1,2,1,2018-09-19
2258,인천,중구,0,0,0,0,0,0,2018-10-19
2259,인천,중구,1,1,0,2,2,0,2018-11-19
2260,인천,중구,2,1,1,4,3,0,2018-12-19
2261,인천,강화군,0,0,0,0,0,0,2018-01-20
2262,인천,강화군,0,0,0,0,0,0,2018-02-20
2263,인천,강화군,0,0,0,0,1,1,2018-03-20
2264,인천,강화군,0,0,0,0,0,0,2018-04-20
2265,인천,강화군,3,0,0,3,1,0,2018-05-20
2266,인천,강화군,0,0,0,0,0,0,2018-06-20
2267,인천,강화군,3,0,0,3,1,0,2018-07-20
2268,인천,강화군,3,0,0,3,2,0,2018-08-20
2269,인천,강화군,0,0,2,2,2,0,2018-09-20
2270,인천,강화군,0,0,0,0,0,0,2018-10-20
2271,인천,강화군,0,0,0,0,0,0,2018-11-20
2272,인천,강화군,0,0,0,0,0,0,2018-12-20
2273,인천,계양구,3,0,1,4,3,0,2018-01-20
2274,인천,계양구,3,0,0,3,1,0,2018-02-20
2275,인천,계양구,6,0,1,7,3,0,2018-03-20
2276,인천,계양구,1,0,1,2,2,0,2018-04-20
2277,인천,계양구,0,0,1,1,1,0,2018-05-20
2278,인천,계양구,0,0,0,0,0,0,2018-06-20
2279,인천,계양구,2,0,1,3,2,0,2018-07-20
2280,인천,계양구,1,0,0,1,1,0,2018-08-20
2281,인천,계양구,1,0,0,1,1,0,2018-09-20
2282,인천,계양구,3,1,0,4,4,0,2018-10-20
2283,인천,계양구,2,0,0,2,2,0,2018-11-20
2284,인천,계양구,0,1,0,1,1,0,2018-12-20
2285,인천,남동구,4,0,0,4,3,0,2018-01-20
2286,인천,남동구,6,0,2,8,4,0,2018-02-20
2287,인천,남동구,6,2,0,8,7,0,2018-03-20
2288,인천,남동구,2,0,0,2,2,0,2018-04-20
2289,인천,남동구,3,1,0,4,3,0,2018-05-20
2290,인천,남동구,5,0,3,8,7,0,2018-06-20
2291,인천,남동구,3,0,4,7,7,0,2018-07-20
2292,인천,남동구,8,1,1,10,8,0,2018-08-20
2293,인천,남동구,7,0,3,10,8,0,2018-09-20
2294,인천,남동구,7,0,3,10,7,0,2018-10-20
2295,인천,남동구,1,0,2,3,1,0,2018-11-20
2296,인천,남동구,2,0,1,3,3,0,2018-12-20
2297,인천,동구,0,0,0,0,0,0,2018-01-20
2298,인천,동구,0,0,0,0,0,0,2018-02-20
2299,인천,동구,0,0,0,0,0,0,2018-03-20
2300,인천,동구,0,0,0,0,0,0,2018-04-20
2301,인천,동구,0,0,0,0,0,0,2018-05-20
2302,인천,동구,0,0,0,0,0,0,2018-06-20
2303,인천,동구,0,0,0,0,0,0,2018-07-20
2304,인천,동구,1,0,0,1,1,0,2018-08-20
2305,인천,동구,0,0,0,0,0,0,2018-09-20
2306,인천,동구,1,0,0,1,2,1,2018-10-20
2307,인천,동구,0,0,0,0,0,0,2018-11-20
2308,인천,동구,5,0,0,5,1,0,2018-12-20
2309,인천,미추홀구,5,1,2,8,8,0,2018-01-20
2310,인천,미추홀구,0,0,0,0,0,0,2018-02-20
2311,인천,미추홀구,1,0,0,1,1,0,2018-03-20
2312,인천,미추홀구,1,0,0,1,1,0,2018-04-20
2313,인천,미추홀구,0,0,0,0,0,0,2018-05-20
2314,인천,미추홀구,3,0,2,5,4,0,2018-06-20
2315,인천,미추홀구,3,1,0,4,2,0,2018-07-20
2316,인천,미추홀구,6,0,1,7,5,1,2018-08-20
2317,인천,미추홀구,7,3,0,10,8,0,2018-09-20
2318,인천,미추홀구,5,2,2,9,7,0,2018-10-20
2319,인천,미추홀구,3,0,2,5,2,0,2018-11-20
2320,인천,미추홀구,4,0,0,4,3,0,2018-12-20
2321,인천,부평구,4,0,0,4,3,0,2018-01-20
2322,인천,부평구,3,0,1,4,4,0,2018-02-20
2323,인천,부평구,3,0,0,3,2,1,2018-03-20
2324,인천,부평구,2,0,2,4,3,0,2018-04-20
2325,인천,부평구,4,0,0,4,1,0,2018-05-20
2326,인천,부평구,3,0,1,4,4,0,2018-06-20
2327,인천,부평구,7,0,1,8,6,0,2018-07-20
2328,인천,부평구,8,0,0,8,5,0,2018-08-20
2329,인천,부평구,4,0,3,7,4,0,2018-09-20
2330,인천,부평구,3,0,1,4,4,0,2018-10-20
2331,인천,부평구,3,0,0,3,2,0,2018-11-20
2332,인천,부평구,6,0,0,6,6,0,2018-12-20
2333,인천,서구,0,0,1,1,1,0,2018-01-20
2334,인천,서구,1,0,0,1,1,0,2018-02-20
2335,인천,서구,6,0,1,7,4,0,2018-03-20
2336,인천,서구,5,0,3,8,4,0,2018-04-20
2337,인천,서구,1,0,0,1,1,0,2018-05-20
2338,인천,서구,2,0,1,3,3,0,2018-06-20
2339,인천,서구,3,0,2,5,5,0,2018-07-20
2340,인천,서구,9,0,1,10,6,0,2018-08-20
2341,인천,서구,2,0,2,4,4,0,2018-09-20
2342,인천,서구,5,0,1,6,5,0,2018-10-20
2343,인천,서구,2,1,1,4,4,0,2018-11-20
2344,인천,서구,4,0,1,5,4,0,2018-12-20
2345,인천,연수구,2,0,1,3,2,0,2018-01-20
2346,인천,연수구,1,0,3,4,2,0,2018-02-20
2347,인천,연수구,2,0,1,3,3,0,2018-03-20
2348,인천,연수구,0,0,0,0,0,0,2018-04-20
2349,인천,연수구,2,0,0,2,1,0,2018-05-20
2350,인천,연수구,0,0,2,2,3,1,2018-06-20
2351,인천,연수구,2,0,0,2,2,0,2018-07-20
2352,인천,연수구,2,0,1,3,3,0,2018-08-20
2353,인천,연수구,5,0,1,6,4,0,2018-09-20
2354,인천,연수구,1,0,1,2,2,0,2018-10-20
2355,인천,연수구,1,0,0,1,1,0,2018-11-20
2356,인천,연수구,0,0,2,2,2,0,2018-12-20
2357,인천,옹진군,0,0,0,0,0,0,2018-01-20
2358,인천,옹진군,0,0,0,0,0,0,2018-03-20
2359,인천,옹진군,0,0,0,0,0,0,2018-04-20
2360,인천,옹진군,0,0,0,0,0,0,2018-05-20
2361,인천,옹진군,0,0,0,0,0,0,2018-06-20
2362,인천,옹진군,0,0,0,0,0,0,2018-07-20
2363,인천,옹진군,0,0,0,0,0,0,2018-08-20
2364,인천,옹진군,0,0,0,0,0,0,2018-09-20
2365,인천,옹진군,0,0,1,1,1,0,2018-10-20
2366,인천,옹진군,0,0,0,0,0,0,2018-11-20
2367,인천,옹진군,0,1,0,1,1,0,2018-12-20
2368,인천,중구,0,0,0,0,1,1,2018-01-20
2369,인천,중구,1,0,0,1,1,0,2018-02-20
2370,인천,중구,0,0,1,1,1,0,2018-03-20
2371,인천,중구,1,0,0,1,1,0,2018-04-20
2372,인천,중구,0,0,0,0,0,0,2018-05-20
2373,인천,중구,2,0,0,2,1,0,2018-06-20
2374,인천,중구,3,0,0,3,2,0,2018-07-20
2375,인천,중구,0,0,0,0,0,0,2018-08-20
2376,인천,중구,2,0,2,4,1,0,2018-09-20
2377,인천,중구,2,0,1,3,2,0,2018-10-20
2378,인천,중구,0,0,0,0,0,0,2018-11-20
2379,인천,중구,1,0,0,1,1,0,2018-12-20
2380,인천,강화군,0,0,0,0,0,0,2018-01-21
2381,인천,강화군,0,0,0,0,0,0,2018-02-21
2382,인천,강화군,1,0,0,1,1,0,2018-03-21
2383,인천,강화군,0,0,1,1,1,0,2018-04-21
2384,인천,강화군,0,0,0,0,0,0,2018-05-21
2385,인천,강화군,2,0,0,2,2,0,2018-06-21
2386,인천,강화군,0,0,1,1,1,0,2018-07-21
2387,인천,강화군,0,0,0,0,0,0,2018-08-21
2388,인천,강화군,1,0,1,2,2,0,2018-09-21
2389,인천,강화군,1,0,0,1,1,0,2018-10-21
2390,인천,강화군,0,0,0,0,0,0,2018-11-21
2391,인천,강화군,2,0,0,2,2,0,2018-12-21
2392,인천,계양구,1,0,0,1,1,0,2018-01-21
2393,인천,계양구,1,0,0,1,1,0,2018-02-21
2394,인천,계양구,0,0,1,1,1,0,2018-03-21
2395,인천,계양구,6,0,1,7,6,0,2018-04-21
2396,인천,계양구,2,2,1,5,4,0,2018-05-21
2397,인천,계양구,4,2,0,6,2,0,2018-06-21
2398,인천,계양구,0,1,1,2,2,0,2018-07-21
2399,인천,계양구,4,0,3,7,5,0,2018-08-21
2400,인천,계양구,2,0,1,3,2,0,2018-09-21
2401,인천,계양구,4,0,0,4,2,0,2018-10-21
2402,인천,계양구,3,2,0,5,2,0,2018-11-21
2403,인천,계양구,1,0,0,1,1,0,2018-12-21
2404,인천,남동구,3,0,1,4,1,0,2018-01-21
2405,인천,남동구,6,1,2,9,4,0,2018-02-21
2406,인천,남동구,5,0,4,9,7,0,2018-03-21
2407,인천,남동구,4,0,1,5,3,0,2018-04-21
2408,인천,남동구,2,0,0,2,2,0,2018-05-21
2409,인천,남동구,5,1,1,7,6,0,2018-06-21
2410,인천,남동구,10,0,2,12,8,0,2018-07-21
2411,인천,남동구,5,1,0,6,4,0,2018-08-21
2412,인천,남동구,12,0,3,15,8,0,2018-09-21
2413,인천,남동구,6,0,0,6,1,0,2018-10-21
2414,인천,남동구,6,0,3,9,6,0,2018-11-21
2415,인천,남동구,1,0,1,2,3,1,2018-12-21
2416,인천,동구,1,0,0,1,1,0,2018-01-21
2417,인천,동구,0,0,0,0,0,0,2018-02-21
2418,인천,동구,0,0,0,0,0,0,2018-03-21
2419,인천,동구,0,0,0,0,0,0,2018-04-21
2420,인천,동구,0,0,0,0,0,0,2018-05-21
2421,인천,동구,0,0,0,0,0,0,2018-06-21
2422,인천,동구,1,0,0,1,1,0,2018-07-21
2423,인천,동구,1,0,1,2,2,0,2018-08-21
2424,인천,동구,0,0,0,0,0,0,2018-09-21
2425,인천,동구,0,0,0,0,0,0,2018-10-21
2426,인천,동구,0,0,0,0,0,0,2018-11-21
2427,인천,동구,1,0,0,1,1,0,2018-12-21
2428,인천,미추홀구,3,0,0,3,3,0,2018-01-21
2429,인천,미추홀구,0,0,0,0,0,0,2018-02-21
2430,인천,미추홀구,2,0,2,4,3,0,2018-03-21
2431,인천,미추홀구,2,0,2,4,3,0,2018-04-21
2432,인천,미추홀구,4,0,0,4,3,0,2018-05-21
2433,인천,미추홀구,7,2,1,10,7,0,2018-06-21
2434,인천,미추홀구,2,1,0,3,3,0,2018-07-21
2435,인천,미추홀구,1,0,0,1,1,0,2018-08-21
2436,인천,미추홀구,2,2,4,8,7,0,2018-09-21
2437,인천,미추홀구,2,1,2,5,5,0,2018-10-21
2438,인천,미추홀구,3,0,0,3,2,0,2018-11-21
2439,인천,미추홀구,0,0,1,1,1,0,2018-12-21
2440,인천,부평구,3,1,1,5,4,0,2018-01-21
2441,인천,부평구,0,0,0,0,0,0,2018-02-21
2442,인천,부평구,1,0,1,2,2,0,2018-03-21
2443,인천,부평구,4,0,0,4,4,0,2018-04-21
2444,인천,부평구,8,0,1,9,7,0,2018-05-21
2445,인천,부평구,1,0,0,1,1,0,2018-06-21
2446,인천,부평구,3,0,0,3,3,0,2018-07-21
2447,인천,부평구,2,0,2,4,2,0,2018-08-21
2448,인천,부평구,2,0,0,2,2,0,2018-09-21
2449,인천,부평구,0,0,1,1,1,0,2018-10-21
2450,인천,부평구,2,0,2,4,3,0,2018-11-21
2451,인천,부평구,2,0,1,3,3,0,2018-12-21
2452,인천,서구,1,0,0,1,1,0,2018-01-21
2453,인천,서구,2,1,1,4,3,0,2018-02-21
2454,인천,서구,1,0,1,2,2,0,2018-03-21
2455,인천,서구,1,0,2,3,2,0,2018-04-21
2456,인천,서구,4,0,2,6,5,0,2018-05-21
2457,인천,서구,0,0,1,1,1,0,2018-06-21
2458,인천,서구,1,0,1,2,3,1,2018-07-21
2459,인천,서구,0,0,0,0,0,0,2018-08-21
2460,인천,서구,6,0,1,7,6,0,2018-09-21
2461,인천,서구,1,0,0,1,1,0,2018-10-21
2462,인천,서구,0,0,1,1,1,0,2018-11-21
2463,인천,서구,3,0,2,5,4,0,2018-12-21
2464,인천,연수구,1,0,0,1,1,0,2018-01-21
2465,인천,연수구,5,0,0,5,3,0,2018-02-21
2466,인천,연수구,2,0,2,4,2,0,2018-03-21
2467,인천,연수구,4,0,0,4,3,0,2018-04-21
2468,인천,연수구,0,0,1,1,1,0,2018-05-21
2469,인천,연수구,2,0,0,2,1,0,2018-06-21
2470,인천,연수구,1,1,0,2,2,0,2018-07-21
2471,인천,연수구,3,0,0,3,1,0,2018-08-21
2472,인천,연수구,2,0,0,2,3,2,2018-09-21
2473,인천,연수구,0,0,1,1,1,0,2018-10-21
2474,인천,연수구,4,1,0,5,1,0,2018-11-21
2475,인천,연수구,1,0,0,1,1,0,2018-12-21
2476,인천,옹진군,0,0,0,0,0,0,2018-01-21
2477,인천,옹진군,0,0,0,0,0,0,2018-03-21
2478,인천,옹진군,0,0,0,0,0,0,2018-04-21
2479,인천,옹진군,0,0,0,0,0,0,2018-05-21
2480,인천,옹진군,1,0,0,1,1,0,2018-06-21
2481,인천,옹진군,0,0,0,0,0,0,2018-07-21
2482,인천,옹진군,0,0,0,0,0,0,2018-08-21
2483,인천,옹진군,0,0,0,0,0,0,2018-09-21
2484,인천,옹진군,0,0,0,0,0,0,2018-10-21
2485,인천,옹진군,0,0,0,0,0,0,2018-11-21
2486,인천,옹진군,0,0,0,0,0,0,2018-12-21
2487,인천,중구,0,0,0,0,0,0,2018-01-21
2488,인천,중구,0,0,1,1,1,0,2018-02-21
2489,인천,중구,1,0,0,1,1,0,2018-03-21
2490,인천,중구,3,0,2,5,1,0,2018-04-21
2491,인천,중구,0,0,0,0,0,0,2018-05-21
2492,인천,중구,0,0,0,0,0,0,2018-06-21
2493,인천,중구,0,0,0,0,0,0,2018-07-21
2494,인천,중구,0,0,1,1,1,0,2018-08-21
2495,인천,중구,0,0,0,0,0,0,2018-09-21
2496,인천,중구,1,0,0,1,1,0,2018-10-21
2497,인천,중구,0,0,1,1,1,0,2018-11-21
2498,인천,중구,0,0,0,0,0,0,2018-12-21
2499,인천,강화군,0,0,0,0,0,0,2018-01-22
2500,인천,강화군,0,0,1,1,1,0,2018-02-22
2501,인천,강화군,0,0,0,0,0,0,2018-03-22
2502,인천,강화군,0,0,0,0,0,0,2018-04-22
2503,인천,강화군,0,0,0,0,0,0,2018-05-22
2504,인천,강화군,0,0,1,1,1,0,2018-06-22
2505,인천,강화군,0,0,1,1,1,0,2018-07-22
2506,인천,강화군,0,0,0,0,0,0,2018-08-22
2507,인천,강화군,3,0,0,3,2,0,2018-09-22
2508,인천,강화군,0,0,0,0,0,0,2018-10-22
2509,인천,강화군,0,0,0,0,0,0,2018-11-22
2510,인천,강화군,0,0,1,1,1,0,2018-12-22
2511,인천,계양구,0,1,0,1,1,0,2018-01-22
2512,인천,계양구,0,0,1,1,1,0,2018-02-22
2513,인천,계양구,0,0,0,0,0,0,2018-03-22
2514,인천,계양구,2,0,1,3,2,0,2018-04-22
2515,인천,계양구,0,0,0,0,0,0,2018-05-22
2516,인천,계양구,0,0,1,1,1,0,2018-06-22
2517,인천,계양구,2,0,2,4,2,0,2018-07-22
2518,인천,계양구,0,0,0,0,0,0,2018-08-22
2519,인천,계양구,2,0,1,3,3,0,2018-09-22
2520,인천,계양구,0,0,1,1,1,0,2018-10-22
2521,인천,계양구,2,0,0,2,2,0,2018-11-22
2522,인천,계양구,1,0,1,2,2,0,2018-12-22
2523,인천,남동구,2,1,0,3,4,1,2018-01-22
2524,인천,남동구,2,0,2,4,3,0,2018-02-22
2525,인천,남동구,10,0,0,10,6,0,2018-03-22
2526,인천,남동구,2,0,0,2,2,0,2018-04-22
2527,인천,남동구,6,0,1,7,4,0,2018-05-22
2528,인천,남동구,12,0,3,15,7,0,2018-06-22
2529,인천,남동구,3,0,0,3,2,0,2018-07-22
2530,인천,남동구,3,0,0,3,3,0,2018-08-22
2531,인천,남동구,5,1,1,7,7,0,2018-09-22
2532,인천,남동구,9,1,0,10,7,0,2018-10-22
2533,인천,남동구,4,0,0,4,2,0,2018-11-22
2534,인천,남동구,7,0,5,12,8,0,2018-12-22
2535,인천,동구,0,0,0,0,0,0,2018-01-22
2536,인천,동구,2,0,2,4,1,0,2018-02-22
2537,인천,동구,0,0,0,0,0,0,2018-03-22
2538,인천,동구,1,0,0,1,1,0,2018-04-22
2539,인천,동구,0,0,0,0,0,0,2018-05-22
2540,인천,동구,0,0,0,0,0,0,2018-06-22
2541,인천,동구,0,0,0,0,0,0,2018-07-22
2542,인천,동구,1,0,1,2,2,0,2018-08-22
2543,인천,동구,3,2,0,5,1,0,2018-09-22
2544,인천,동구,0,0,0,0,0,0,2018-10-22
2545,인천,동구,0,0,0,0,0,0,2018-11-22
2546,인천,동구,1,0,0,1,1,0,2018-12-22
2547,인천,미추홀구,2,0,0,2,2,0,2018-01-22
2548,인천,미추홀구,6,1,1,8,6,0,2018-02-22
2549,인천,미추홀구,6,0,1,7,5,0,2018-03-22
2550,인천,미추홀구,0,0,4,4,3,0,2018-04-22
2551,인천,미추홀구,2,0,0,2,1,0,2018-05-22
2552,인천,미추홀구,1,0,0,1,1,0,2018-06-22
2553,인천,미추홀구,3,0,0,3,3,0,2018-07-22
2554,인천,미추홀구,5,0,0,5,3,0,2018-08-22
2555,인천,미추홀구,5,1,1,7,4,0,2018-09-22
2556,인천,미추홀구,6,1,2,9,3,0,2018-10-22
2557,인천,미추홀구,2,0,2,4,4,0,2018-11-22
2558,인천,미추홀구,2,0,1,3,3,0,2018-12-22
2559,인천,부평구,5,0,3,8,7,1,2018-01-22
2560,인천,부평구,1,0,1,2,2,0,2018-02-22
2561,인천,부평구,6,0,2,8,5,0,2018-03-22
2562,인천,부평구,4,0,0,4,3,1,2018-04-22
2563,인천,부평구,0,0,0,0,0,0,2018-05-22
2564,인천,부평구,7,0,3,10,6,0,2018-06-22
2565,인천,부평구,0,0,0,0,0,0,2018-07-22
2566,인천,부평구,3,0,2,5,4,0,2018-08-22
2567,인천,부평구,3,1,3,7,4,0,2018-09-22
2568,인천,부평구,3,0,2,5,4,0,2018-10-22
2569,인천,부평구,1,0,1,2,2,0,2018-11-22
2570,인천,부평구,1,0,0,1,1,0,2018-12-22
2571,인천,서구,1,0,1,2,3,1,2018-01-22
2572,인천,서구,1,0,1,2,2,0,2018-02-22
2573,인천,서구,4,0,0,4,2,0,2018-03-22
2574,인천,서구,4,0,0,4,2,0,2018-04-22
2575,인천,서구,4,0,1,5,4,0,2018-05-22
2576,인천,서구,4,0,1,5,3,0,2018-06-22
2577,인천,서구,7,0,1,8,5,0,2018-07-22
2578,인천,서구,4,0,1,5,4,0,2018-08-22
2579,인천,서구,2,0,1,3,3,0,2018-09-22
2580,인천,서구,4,0,0,4,4,0,2018-10-22
2581,인천,서구,2,0,1,3,3,0,2018-11-22
2582,인천,서구,3,0,0,3,3,0,2018-12-22
2583,인천,연수구,2,0,2,4,3,0,2018-01-22
2584,인천,연수구,5,0,0,5,2,0,2018-02-22
2585,인천,연수구,2,0,1,3,3,0,2018-03-22
2586,인천,연수구,3,0,2,5,3,0,2018-04-22
2587,인천,연수구,0,0,1,1,1,0,2018-05-22
2588,인천,연수구,1,1,0,2,1,0,2018-06-22
2589,인천,연수구,1,0,0,1,1,0,2018-07-22
2590,인천,연수구,5,0,1,6,3,0,2018-08-22
2591,인천,연수구,0,0,0,0,0,0,2018-09-22
2592,인천,연수구,2,0,0,2,1,0,2018-10-22
2593,인천,연수구,3,0,0,3,3,0,2018-11-22
2594,인천,연수구,5,0,1,6,2,0,2018-12-22
2595,인천,옹진군,0,0,0,0,0,0,2018-01-22
2596,인천,옹진군,0,0,0,0,0,0,2018-03-22
2597,인천,옹진군,0,0,0,0,0,0,2018-04-22
2598,인천,옹진군,0,0,0,0,0,0,2018-05-22
2599,인천,옹진군,0,0,0,0,0,0,2018-06-22
2600,인천,옹진군,0,0,0,0,0,0,2018-07-22
2601,인천,옹진군,0,0,0,0,0,0,2018-08-22
2602,인천,옹진군,0,0,0,0,0,0,2018-09-22
2603,인천,옹진군,0,0,0,0,0,0,2018-10-22
2604,인천,옹진군,0,0,0,0,0,0,2018-11-22
2605,인천,옹진군,0,0,0,0,0,0,2018-12-22
2606,인천,중구,3,0,0,3,2,1,2018-01-22
2607,인천,중구,2,0,0,2,1,0,2018-02-22
2608,인천,중구,0,1,0,1,1,0,2018-03-22
2609,인천,중구,0,0,1,1,1,0,2018-04-22
2610,인천,중구,1,0,0,1,1,0,2018-05-22
2611,인천,중구,3,0,0,3,2,0,2018-06-22
2612,인천,중구,4,0,1,5,1,0,2018-07-22
2613,인천,중구,3,1,3,7,3,0,2018-08-22
2614,인천,중구,1,0,0,1,1,0,2018-09-22
2615,인천,중구,2,1,0,3,2,0,2018-10-22
2616,인천,중구,3,0,1,4,2,0,2018-11-22
2617,인천,중구,0,0,0,0,0,0,2018-12-22
2618,인천,강화군,0,0,0,0,0,0,2018-01-23
2619,인천,강화군,1,0,1,2,2,0,2018-02-23
2620,인천,강화군,0,0,0,0,0,0,2018-03-23
2621,인천,강화군,0,0,0,0,0,0,2018-04-23
2622,인천,강화군,0,0,0,0,0,0,2018-05-23
2623,인천,강화군,0,0,0,0,0,0,2018-06-23
2624,인천,강화군,2,0,0,2,1,0,2018-07-23
2625,인천,강화군,0,0,0,0,0,0,2018-08-23
2626,인천,강화군,0,0,0,0,0,0,2018-09-23
2627,인천,강화군,0,0,0,0,0,0,2018-10-23
2628,인천,강화군,0,0,1,1,1,0,2018-11-23
2629,인천,강화군,1,0,1,2,2,0,2018-12-23
2630,인천,계양구,0,0,0,0,0,0,2018-01-23
2631,인천,계양구,1,1,1,3,2,0,2018-02-23
2632,인천,계양구,1,0,0,1,1,0,2018-03-23
2633,인천,계양구,2,0,0,2,1,0,2018-04-23
2634,인천,계양구,2,0,1,3,3,0,2018-05-23
2635,인천,계양구,3,0,1,4,3,0,2018-06-23
2636,인천,계양구,4,0,0,4,3,0,2018-07-23
2637,인천,계양구,2,1,0,3,3,0,2018-08-23
2638,인천,계양구,5,0,0,5,3,0,2018-09-23
2639,인천,계양구,3,0,2,5,5,0,2018-10-23
2640,인천,계양구,1,0,1,2,2,0,2018-11-23
2641,인천,계양구,1,0,1,2,2,0,2018-12-23
2642,인천,남동구,4,0,1,5,4,0,2018-01-23
2643,인천,남동구,6,0,4,10,7,0,2018-02-23
2644,인천,남동구,5,0,0,5,2,0,2018-03-23
2645,인천,남동구,3,0,1,4,4,0,2018-04-23
2646,인천,남동구,3,1,2,6,6,0,2018-05-23
2647,인천,남동구,5,0,1,6,3,0,2018-06-23
2648,인천,남동구,5,0,1,6,4,0,2018-07-23
2649,인천,남동구,0,0,1,1,1,0,2018-08-23
2650,인천,남동구,3,0,1,4,2,0,2018-09-23
2651,인천,남동구,7,0,3,10,7,0,2018-10-23
2652,인천,남동구,5,0,1,6,4,0,2018-11-23
2653,인천,남동구,1,0,0,1,1,0,2018-12-23
2654,인천,동구,0,0,0,0,0,0,2018-01-23
2655,인천,동구,1,0,0,1,1,0,2018-02-23
2656,인천,동구,0,0,0,0,0,0,2018-03-23
2657,인천,동구,0,0,0,0,0,0,2018-04-23
2658,인천,동구,0,0,0,0,0,0,2018-05-23
2659,인천,동구,0,0,0,0,0,0,2018-06-23
2660,인천,동구,0,0,0,0,0,0,2018-07-23
2661,인천,동구,0,0,0,0,0,0,2018-08-23
2662,인천,동구,0,0,0,0,0,0,2018-09-23
2663,인천,동구,0,0,0,0,0,0,2018-10-23
2664,인천,동구,0,0,1,1,1,0,2018-11-23
2665,인천,동구,0,0,0,0,0,0,2018-12-23
2666,인천,미추홀구,4,0,0,4,3,0,2018-01-23
2667,인천,미추홀구,2,0,0,2,2,0,2018-02-23
2668,인천,미추홀구,0,0,0,0,0,0,2018-03-23
2669,인천,미추홀구,1,0,2,3,2,0,2018-04-23
2670,인천,미추홀구,1,0,0,1,1,0,2018-05-23
2671,인천,미추홀구,0,2,2,4,4,0,2018-06-23
2672,인천,미추홀구,10,0,2,12,4,0,2018-07-23
2673,인천,미추홀구,2,0,1,3,3,0,2018-08-23
2674,인천,미추홀구,3,1,0,4,3,0,2018-09-23
2675,인천,미추홀구,0,1,2,3,3,0,2018-10-23
2676,인천,미추홀구,2,0,1,3,3,0,2018-11-23
2677,인천,미추홀구,3,0,1,4,3,0,2018-12-23
2678,인천,부평구,1,0,1,2,2,0,2018-01-23
2679,인천,부평구,2,0,0,2,2,0,2018-02-23
2680,인천,부평구,5,0,0,5,4,0,2018-03-23
2681,인천,부평구,3,0,1,4,3,0,2018-04-23
2682,인천,부평구,7,0,1,8,5,0,2018-05-23
2683,인천,부평구,3,0,1,4,3,0,2018-06-23
2684,인천,부평구,3,0,1,4,3,0,2018-07-23
2685,인천,부평구,3,1,0,4,3,0,2018-08-23
2686,인천,부평구,1,0,0,1,1,0,2018-09-23
2687,인천,부평구,2,0,0,2,2,0,2018-10-23
2688,인천,부평구,5,0,0,5,3,0,2018-11-23
2689,인천,부평구,5,0,0,5,2,0,2018-12-23
2690,인천,서구,3,0,2,5,4,0,2018-01-23
2691,인천,서구,7,0,1,8,4,0,2018-02-23
2692,인천,서구,3,0,1,4,4,0,2018-03-23
2693,인천,서구,1,0,1,2,2,0,2018-04-23
2694,인천,서구,3,0,0,3,2,0,2018-05-23
2695,인천,서구,2,0,0,2,2,0,2018-06-23
2696,인천,서구,4,1,3,8,4,0,2018-07-23
2697,인천,서구,1,2,0,3,3,0,2018-08-23
2698,인천,서구,0,1,3,4,2,0,2018-09-23
2699,인천,서구,2,0,0,2,1,0,2018-10-23
2700,인천,서구,5,0,1,6,5,0,2018-11-23
2701,인천,서구,2,0,1,3,2,0,2018-12-23
2702,인천,연수구,1,0,0,1,1,0,2018-01-23
2703,인천,연수구,3,2,2,7,5,0,2018-02-23
2704,인천,연수구,1,0,2,3,3,0,2018-03-23
2705,인천,연수구,1,0,2,3,3,0,2018-04-23
2706,인천,연수구,0,1,0,1,1,0,2018-05-23
2707,인천,연수구,1,0,1,2,2,1,2018-06-23
2708,인천,연수구,0,0,3,3,3,0,2018-07-23
2709,인천,연수구,4,0,1,5,3,0,2018-08-23
2710,인천,연수구,2,0,0,2,1,0,2018-09-23
2711,인천,연수구,1,0,0,1,1,0,2018-10-23
2712,인천,연수구,1,1,0,2,2,0,2018-11-23
2713,인천,연수구,0,0,0,0,0,0,2018-12-23
2714,인천,옹진군,0,0,1,1,1,0,2018-01-23
2715,인천,옹진군,0,0,0,0,0,0,2018-03-23
2716,인천,옹진군,0,0,0,0,0,0,2018-04-23
2717,인천,옹진군,0,0,0,0,0,0,2018-05-23
2718,인천,옹진군,0,0,0,0,0,0,2018-06-23
2719,인천,옹진군,0,0,0,0,0,0,2018-07-23
2720,인천,옹진군,0,0,0,0,0,0,2018-08-23
2721,인천,옹진군,0,0,0,0,0,0,2018-09-23
2722,인천,옹진군,1,0,1,2,1,0,2018-10-23
2723,인천,옹진군,0,0,0,0,0,0,2018-11-23
2724,인천,옹진군,0,0,0,0,0,0,2018-12-23
2725,인천,중구,3,0,0,3,2,0,2018-01-23
2726,인천,중구,0,0,0,0,0,0,2018-02-23
2727,인천,중구,0,0,0,0,0,0,2018-03-23
2728,인천,중구,2,0,0,2,1,0,2018-04-23
2729,인천,중구,0,0,1,1,1,0,2018-05-23
2730,인천,중구,5,1,2,8,4,0,2018-06-23
2731,인천,중구,0,0,0,0,0,0,2018-07-23
2732,인천,중구,0,0,0,0,0,0,2018-08-23
2733,인천,중구,1,0,0,1,1,0,2018-09-23
2734,인천,중구,3,0,1,4,2,0,2018-10-23
2735,인천,중구,5,0,1,6,3,1,2018-11-23
2736,인천,중구,0,0,0,0,0,0,2018-12-23
2737,인천,강화군,2,0,1,3,2,0,2018-01-24
2738,인천,강화군,0,0,0,0,0,0,2018-02-24
2739,인천,강화군,1,0,0,1,1,0,2018-03-24
2740,인천,강화군,0,0,0,0,0,0,2018-04-24
2741,인천,강화군,0,0,0,0,0,0,2018-05-24
2742,인천,강화군,0,0,1,1,1,0,2018-06-24
2743,인천,강화군,0,0,0,0,0,0,2018-07-24
2744,인천,강화군,0,0,0,0,0,0,2018-08-24
2745,인천,강화군,1,0,2,3,2,0,2018-09-24
2746,인천,강화군,0,0,1,1,2,1,2018-10-24
2747,인천,강화군,1,0,0,1,1,0,2018-11-24
2748,인천,강화군,0,0,0,0,0,0,2018-12-24
2749,인천,계양구,0,0,0,0,0,0,2018-01-24
2750,인천,계양구,2,0,0,2,3,1,2018-02-24
2751,인천,계양구,2,0,2,4,3,0,2018-03-24
2752,인천,계양구,0,0,1,1,1,0,2018-04-24
2753,인천,계양구,2,1,2,5,2,0,2018-05-24
2754,인천,계양구,2,0,1,3,3,0,2018-06-24
2755,인천,계양구,1,0,0,1,1,0,2018-07-24
2756,인천,계양구,5,0,0,5,4,0,2018-08-24
2757,인천,계양구,2,0,0,2,2,0,2018-09-24
2758,인천,계양구,10,0,1,11,2,0,2018-10-24
2759,인천,계양구,4,0,0,4,3,0,2018-11-24
2760,인천,계양구,2,0,0,2,2,0,2018-12-24
2761,인천,남동구,4,0,1,5,3,0,2018-01-24
2762,인천,남동구,10,0,2,12,4,0,2018-02-24
2763,인천,남동구,2,0,0,2,1,0,2018-03-24
2764,인천,남동구,6,0,2,8,5,0,2018-04-24
2765,인천,남동구,2,0,0,2,2,0,2018-05-24
2766,인천,남동구,4,0,2,6,3,0,2018-06-24
2767,인천,남동구,11,0,1,12,5,0,2018-07-24
2768,인천,남동구,5,1,0,6,6,0,2018-08-24
2769,인천,남동구,11,0,1,12,7,0,2018-09-24
2770,인천,남동구,3,1,0,4,3,0,2018-10-24
2771,인천,남동구,8,0,4,12,8,0,2018-11-24
2772,인천,남동구,9,2,1,12,8,0,2018-12-24
2773,인천,동구,2,0,0,2,1,0,2018-01-24
2774,인천,동구,0,0,0,0,0,0,2018-02-24
2775,인천,동구,0,0,0,0,0,0,2018-03-24
2776,인천,동구,0,0,0,0,0,0,2018-04-24
2777,인천,동구,0,0,0,0,0,0,2018-05-24
2778,인천,동구,0,0,0,0,0,0,2018-06-24
2779,인천,동구,1,0,0,1,1,0,2018-07-24
2780,인천,동구,0,0,0,0,0,0,2018-08-24
2781,인천,동구,2,0,0,2,1,0,2018-09-24
2782,인천,동구,0,0,0,0,0,0,2018-10-24
2783,인천,동구,1,0,3,4,1,0,2018-11-24
2784,인천,동구,2,0,0,2,1,0,2018-12-24
2785,인천,미추홀구,10,1,0,11,6,0,2018-01-24
2786,인천,미추홀구,0,2,0,2,2,1,2018-02-24
2787,인천,미추홀구,1,0,0,1,1,0,2018-03-24
2788,인천,미추홀구,2,0,0,2,2,0,2018-04-24
2789,인천,미추홀구,0,0,2,2,2,0,2018-05-24
2790,인천,미추홀구,4,2,0,6,3,0,2018-06-24
2791,인천,미추홀구,3,0,0,3,2,0,2018-07-24
2792,인천,미추홀구,0,0,0,0,0,0,2018-08-24
2793,인천,미추홀구,4,4,0,8,5,0,2018-09-24
2794,인천,미추홀구,3,0,2,5,4,0,2018-10-24
2795,인천,미추홀구,6,0,0,6,4,0,2018-11-24
2796,인천,미추홀구,5,0,0,5,5,1,2018-12-24
2797,인천,부평구,1,0,1,2,3,1,2018-01-24
2798,인천,부평구,8,0,0,8,5,0,2018-02-24
2799,인천,부평구,3,0,0,3,1,0,2018-03-24
2800,인천,부평구,1,0,1,2,2,0,2018-04-24
2801,인천,부평구,2,0,0,2,2,0,2018-05-24
2802,인천,부평구,8,0,1,9,3,0,2018-06-24
2803,인천,부평구,5,0,0,5,3,0,2018-07-24
2804,인천,부평구,3,0,0,3,3,0,2018-08-24
2805,인천,부평구,0,0,1,1,1,0,2018-09-24
2806,인천,부평구,3,0,1,4,4,1,2018-10-24
2807,인천,부평구,5,0,0,5,3,0,2018-11-24
2808,인천,부평구,1,1,1,3,3,0,2018-12-24
2809,인천,서구,6,0,3,9,5,0,2018-01-24
2810,인천,서구,3,0,0,3,3,1,2018-02-24
2811,인천,서구,2,0,1,3,2,0,2018-03-24
2812,인천,서구,9,1,1,11,7,0,2018-04-24
2813,인천,서구,3,0,2,5,3,0,2018-05-24
2814,인천,서구,2,0,2,4,4,0,2018-06-24
2815,인천,서구,1,0,1,2,2,0,2018-07-24
2816,인천,서구,1,0,0,1,1,0,2018-08-24
2817,인천,서구,4,0,0,4,3,0,2018-09-24
2818,인천,서구,2,0,0,2,2,0,2018-10-24
2819,인천,서구,3,0,0,3,3,1,2018-11-24
2820,인천,서구,11,0,1,12,6,0,2018-12-24
2821,인천,연수구,0,0,0,0,0,0,2018-01-24
2822,인천,연수구,0,0,2,2,1,0,2018-02-24
2823,인천,연수구,2,0,3,5,3,0,2018-03-24
2824,인천,연수구,2,0,0,2,2,0,2018-04-24
2825,인천,연수구,2,0,0,2,1,0,2018-05-24
2826,인천,연수구,1,0,0,1,1,0,2018-06-24
2827,인천,연수구,2,0,0,2,2,0,2018-07-24
2828,인천,연수구,0,0,0,0,0,0,2018-08-24
2829,인천,연수구,2,0,1,3,2,0,2018-09-24
2830,인천,연수구,11,0,1,12,6,0,2018-10-24
2831,인천,연수구,4,0,3,7,6,0,2018-11-24
2832,인천,연수구,0,0,0,0,0,0,2018-12-24
2833,인천,옹진군,0,0,0,0,0,0,2018-01-24
2834,인천,옹진군,0,0,0,0,0,0,2018-03-24
2835,인천,옹진군,0,0,0,0,0,0,2018-04-24
2836,인천,옹진군,0,0,0,0,0,0,2018-05-24
2837,인천,옹진군,0,0,0,0,0,0,2018-06-24
2838,인천,옹진군,0,0,1,1,1,0,2018-07-24
2839,인천,옹진군,0,0,0,0,0,0,2018-08-24
2840,인천,옹진군,0,0,0,0,0,0,2018-09-24
2841,인천,옹진군,0,0,0,0,0,0,2018-10-24
2842,인천,옹진군,0,0,0,0,0,0,2018-11-24
2843,인천,옹진군,0,0,0,0,0,0,2018-12-24
2844,인천,중구,0,0,0,0,0,0,2018-01-24
2845,인천,중구,2,0,0,2,2,0,2018-02-24
2846,인천,중구,0,0,0,0,0,0,2018-03-24
2847,인천,중구,3,0,1,4,3,0,2018-04-24
2848,인천,중구,12,0,0,12,3,0,2018-05-24
2849,인천,중구,3,0,0,3,1,0,2018-06-24
2850,인천,중구,3,0,0,3,2,1,2018-07-24
2851,인천,중구,1,0,0,1,1,0,2018-08-24
2852,인천,중구,4,0,0,4,1,0,2018-09-24
2853,인천,중구,3,0,1,4,1,0,2018-10-24
2854,인천,중구,6,0,3,9,6,0,2018-11-24
2855,인천,중구,4,0,3,7,2,0,2018-12-24
2856,인천,강화군,0,0,1,1,1,0,2018-01-25
2857,인천,강화군,0,0,0,0,0,0,2018-02-25
2858,인천,강화군,0,0,0,0,0,0,2018-03-25
2859,인천,강화군,1,0,1,2,2,0,2018-04-25
2860,인천,강화군,1,0,0,1,1,0,2018-05-25
2861,인천,강화군,0,0,0,0,0,0,2018-06-25
2862,인천,강화군,0,0,0,0,0,0,2018-07-25
2863,인천,강화군,1,0,0,1,1,0,2018-08-25
2864,인천,강화군,0,0,0,0,0,0,2018-09-25
2865,인천,강화군,0,0,1,1,1,0,2018-10-25
2866,인천,강화군,0,0,0,0,0,0,2018-11-25
2867,인천,강화군,0,0,0,0,0,0,2018-12-25
2868,인천,계양구,0,0,1,1,1,0,2018-01-25
2869,인천,계양구,1,0,0,1,1,0,2018-02-25
2870,인천,계양구,1,0,0,1,1,0,2018-03-25
2871,인천,계양구,2,0,1,3,2,0,2018-04-25
2872,인천,계양구,2,0,1,3,2,0,2018-05-25
2873,인천,계양구,0,0,0,0,0,0,2018-06-25
2874,인천,계양구,7,0,1,8,3,0,2018-07-25
2875,인천,계양구,0,0,0,0,0,0,2018-08-25
2876,인천,계양구,0,0,2,2,2,0,2018-09-25
2877,인천,계양구,3,0,1,4,3,0,2018-10-25
2878,인천,계양구,5,0,0,5,2,0,2018-11-25
2879,인천,계양구,3,0,1,4,4,1,2018-12-25
2880,인천,남동구,1,0,1,2,2,0,2018-01-25
2881,인천,남동구,11,0,0,11,5,0,2018-02-25
2882,인천,남동구,3,0,1,4,2,0,2018-03-25
2883,인천,남동구,3,0,1,4,3,0,2018-04-25
2884,인천,남동구,3,1,0,4,4,0,2018-05-25
2885,인천,남동구,10,0,1,11,7,0,2018-06-25
2886,인천,남동구,10,0,1,11,8,0,2018-07-25
2887,인천,남동구,5,0,0,5,3,0,2018-08-25
2888,인천,남동구,8,0,2,10,4,0,2018-09-25
2889,인천,남동구,3,0,0,3,1,0,2018-10-25
2890,인천,남동구,5,0,1,6,6,0,2018-11-25
2891,인천,남동구,3,0,0,3,2,0,2018-12-25
2892,인천,동구,0,0,0,0,0,0,2018-01-25
2893,인천,동구,0,0,1,1,1,0,2018-02-25
2894,인천,동구,0,0,0,0,0,0,2018-03-25
2895,인천,동구,0,0,0,0,0,0,2018-04-25
2896,인천,동구,0,0,0,0,0,0,2018-05-25
2897,인천,동구,0,0,0,0,0,0,2018-06-25
2898,인천,동구,0,0,0,0,0,0,2018-07-25
2899,인천,동구,0,0,0,0,0,0,2018-08-25
2900,인천,동구,0,0,0,0,0,0,2018-09-25
2901,인천,동구,0,0,0,0,0,0,2018-10-25
2902,인천,동구,0,0,0,0,0,0,2018-11-25
2903,인천,동구,0,0,0,0,0,0,2018-12-25
2904,인천,미추홀구,3,0,1,4,4,0,2018-01-25
2905,인천,미추홀구,5,4,1,10,3,0,2018-02-25
2906,인천,미추홀구,1,0,0,1,1,0,2018-03-25
2907,인천,미추홀구,1,0,1,2,2,0,2018-04-25
2908,인천,미추홀구,5,3,1,9,7,0,2018-05-25
2909,인천,미추홀구,2,1,0,3,3,0,2018-06-25
2910,인천,미추홀구,2,0,0,2,1,0,2018-07-25
2911,인천,미추홀구,3,0,0,3,3,0,2018-08-25
2912,인천,미추홀구,1,0,0,1,1,0,2018-09-25
2913,인천,미추홀구,1,0,2,3,3,0,2018-10-25
2914,인천,미추홀구,2,0,0,2,2,0,2018-11-25
2915,인천,미추홀구,0,2,0,2,2,0,2018-12-25
2916,인천,부평구,4,2,3,9,3,0,2018-01-25
2917,인천,부평구,7,0,1,8,4,0,2018-02-25
2918,인천,부평구,2,0,2,4,2,0,2018-03-25
2919,인천,부평구,1,0,0,1,1,0,2018-04-25
2920,인천,부평구,1,0,1,2,2,0,2018-05-25
2921,인천,부평구,4,0,0,4,3,0,2018-06-25
2922,인천,부평구,5,1,0,6,5,0,2018-07-25
2923,인천,부평구,2,0,2,4,4,0,2018-08-25
2924,인천,부평구,9,0,0,9,4,0,2018-09-25
2925,인천,부평구,2,0,1,3,3,0,2018-10-25
2926,인천,부평구,6,0,1,7,5,0,2018-11-25
2927,인천,부평구,0,0,1,1,1,0,2018-12-25
2928,인천,서구,3,0,1,4,1,0,2018-01-25
2929,인천,서구,1,0,2,3,3,0,2018-02-25
2930,인천,서구,0,0,1,1,1,0,2018-03-25
2931,인천,서구,1,0,0,1,1,0,2018-04-25
2932,인천,서구,2,0,1,3,3,0,2018-05-25
2933,인천,서구,1,0,0,1,1,0,2018-06-25
2934,인천,서구,2,0,5,7,5,0,2018-07-25
2935,인천,서구,6,0,0,6,5,1,2018-08-25
2936,인천,서구,6,0,0,6,3,0,2018-09-25
2937,인천,서구,2,0,0,2,2,0,2018-10-25
2938,인천,서구,4,0,0,4,3,0,2018-11-25
2939,인천,서구,11,3,2,16,6,0,2018-12-25
2940,인천,연수구,3,0,0,3,3,0,2018-01-25
2941,인천,연수구,3,0,2,5,2,0,2018-02-25
2942,인천,연수구,2,0,0,2,1,0,2018-03-25
2943,인천,연수구,1,0,0,1,1,0,2018-04-25
2944,인천,연수구,1,0,3,4,2,0,2018-05-25
2945,인천,연수구,1,0,0,1,1,0,2018-06-25
2946,인천,연수구,1,0,0,1,1,0,2018-07-25
2947,인천,연수구,4,0,0,4,2,0,2018-08-25
2948,인천,연수구,9,0,0,9,3,0,2018-09-25
2949,인천,연수구,1,0,0,1,1,0,2018-10-25
2950,인천,연수구,0,0,0,0,0,0,2018-11-25
2951,인천,연수구,0,0,0,0,0,0,2018-12-25
2952,인천,옹진군,0,0,0,0,0,0,2018-01-25
2953,인천,옹진군,0,0,0,0,0,0,2018-03-25
2954,인천,옹진군,0,0,0,0,0,0,2018-04-25
2955,인천,옹진군,3,0,1,4,2,0,2018-05-25
2956,인천,옹진군,0,0,0,0,0,0,2018-06-25
2957,인천,옹진군,0,0,0,0,0,0,2018-07-25
2958,인천,옹진군,0,0,0,0,0,0,2018-08-25
2959,인천,옹진군,0,0,0,0,0,0,2018-09-25
2960,인천,옹진군,0,0,0,0,0,0,2018-10-25
2961,인천,옹진군,0,0,0,0,0,0,2018-11-25
2962,인천,옹진군,0,0,0,0,0,0,2018-12-25
2963,인천,중구,4,0,0,4,2,0,2018-01-25
2964,인천,중구,0,0,0,0,0,0,2018-02-25
2965,인천,중구,0,0,0,0,0,0,2018-03-25
2966,인천,중구,0,0,0,0,0,0,2018-04-25
2967,인천,중구,0,0,1,1,1,0,2018-05-25
2968,인천,중구,4,0,0,4,4,0,2018-06-25
2969,인천,중구,3,0,0,3,2,0,2018-07-25
2970,인천,중구,0,0,0,0,0,0,2018-08-25
2971,인천,중구,0,0,7,7,3,0,2018-09-25
2972,인천,중구,2,0,0,2,1,0,2018-10-25
2973,인천,중구,0,0,0,0,0,0,2018-11-25
2974,인천,중구,0,0,0,0,0,0,2018-12-25
2975,인천,강화군,0,0,0,0,0,0,2018-01-26
2976,인천,강화군,0,0,0,0,0,0,2018-02-26
2977,인천,강화군,0,0,0,0,0,0,2018-03-26
2978,인천,강화군,1,0,0,1,1,0,2018-04-26
2979,인천,강화군,2,0,0,2,1,0,2018-05-26
2980,인천,강화군,0,0,0,0,0,0,2018-06-26
2981,인천,강화군,0,0,0,0,0,0,2018-07-26
2982,인천,강화군,0,0,0,0,0,0,2018-08-26
2983,인천,강화군,0,0,0,0,0,0,2018-09-26
2984,인천,강화군,0,0,0,0,0,0,2018-10-26
2985,인천,강화군,2,0,0,2,1,0,2018-11-26
2986,인천,강화군,0,0,0,0,0,0,2018-12-26
2987,인천,계양구,3,0,0,3,1,0,2018-01-26
2988,인천,계양구,1,0,0,1,1,0,2018-02-26
2989,인천,계양구,3,0,0,3,2,0,2018-03-26
2990,인천,계양구,3,0,0,3,2,0,2018-04-26
2991,인천,계양구,5,0,0,5,2,0,2018-05-26
2992,인천,계양구,1,0,0,1,1,0,2018-06-26
2993,인천,계양구,2,0,1,3,4,1,2018-07-26
2994,인천,계양구,3,0,4,7,5,0,2018-08-26
2995,인천,계양구,1,0,1,2,2,0,2018-09-26
2996,인천,계양구,5,0,2,7,5,0,2018-10-26
2997,인천,계양구,4,0,4,8,4,0,2018-11-26
2998,인천,계양구,4,0,0,4,2,0,2018-12-26
2999,인천,남동구,6,0,2,8,5,0,2018-01-26
3000,인천,남동구,8,4,4,16,6,0,2018-02-26
3001,인천,남동구,3,0,0,3,3,0,2018-03-26
3002,인천,남동구,0,1,0,1,1,0,2018-04-26
3003,인천,남동구,16,0,1,17,9,0,2018-05-26
3004,인천,남동구,5,0,1,6,3,0,2018-06-26
3005,인천,남동구,4,0,5,9,8,0,2018-07-26
3006,인천,남동구,3,0,0,3,3,0,2018-08-26
3007,인천,남동구,2,0,0,2,2,1,2018-09-26
3008,인천,남동구,9,0,1,10,6,0,2018-10-26
3009,인천,남동구,2,0,0,2,2,0,2018-11-26
3010,인천,남동구,11,1,0,12,8,0,2018-12-26
3011,인천,동구,0,0,0,0,0,0,2018-01-26
3012,인천,동구,0,0,0,0,0,0,2018-02-26
3013,인천,동구,2,0,0,2,1,0,2018-03-26
3014,인천,동구,0,0,0,0,0,0,2018-04-26
3015,인천,동구,1,0,0,1,1,0,2018-05-26
3016,인천,동구,2,0,0,2,1,0,2018-06-26
3017,인천,동구,1,0,0,1,1,0,2018-07-26
3018,인천,동구,0,0,0,0,0,0,2018-08-26
3019,인천,동구,0,0,0,0,0,0,2018-09-26
3020,인천,동구,0,0,1,1,1,0,2018-10-26
3021,인천,동구,0,0,2,2,1,0,2018-11-26
3022,인천,동구,0,0,0,0,0,0,2018-12-26
3023,인천,미추홀구,0,0,0,0,0,0,2018-01-26
3024,인천,미추홀구,1,0,1,2,2,0,2018-02-26
3025,인천,미추홀구,3,0,0,3,3,0,2018-03-26
3026,인천,미추홀구,7,0,3,10,4,0,2018-04-26
3027,인천,미추홀구,3,0,2,5,4,0,2018-05-26
3028,인천,미추홀구,1,0,0,1,1,0,2018-06-26
3029,인천,미추홀구,10,1,2,13,5,0,2018-07-26
3030,인천,미추홀구,3,0,0,3,2,0,2018-08-26
3031,인천,미추홀구,3,0,0,3,2,0,2018-09-26
3032,인천,미추홀구,3,0,0,3,2,0,2018-10-26
3033,인천,미추홀구,1,0,0,1,1,0,2018-11-26
3034,인천,미추홀구,0,1,0,1,1,1,2018-12-26
3035,인천,부평구,5,0,0,5,3,0,2018-01-26
3036,인천,부평구,3,0,0,3,3,0,2018-02-26
3037,인천,부평구,0,0,0,0,0,0,2018-03-26
3038,인천,부평구,1,0,2,3,3,0,2018-04-26
3039,인천,부평구,0,0,0,0,0,0,2018-05-26
3040,인천,부평구,2,0,1,3,3,0,2018-06-26
3041,인천,부평구,2,0,0,2,2,0,2018-07-26
3042,인천,부평구,4,0,0,4,3,0,2018-08-26
3043,인천,부평구,0,0,1,1,1,0,2018-09-26
3044,인천,부평구,0,0,0,0,0,0,2018-10-26
3045,인천,부평구,0,0,2,2,2,0,2018-11-26
3046,인천,부평구,3,0,0,3,3,0,2018-12-26
3047,인천,서구,2,0,2,4,3,0,2018-01-26
3048,인천,서구,6,0,2,8,3,0,2018-02-26
3049,인천,서구,0,0,1,1,2,1,2018-03-26
3050,인천,서구,4,1,1,6,4,0,2018-04-26
3051,인천,서구,2,0,1,3,3,0,2018-05-26
3052,인천,서구,5,0,1,6,4,0,2018-06-26
3053,인천,서구,3,1,1,5,4,0,2018-07-26
3054,인천,서구,1,0,0,1,1,0,2018-08-26
3055,인천,서구,5,0,0,5,2,0,2018-09-26
3056,인천,서구,11,0,4,15,10,0,2018-10-26
3057,인천,서구,0,1,2,3,2,0,2018-11-26
3058,인천,서구,2,0,1,3,3,0,2018-12-26
3059,인천,연수구,3,0,0,3,2,0,2018-01-26
3060,인천,연수구,0,0,0,0,0,0,2018-02-26
3061,인천,연수구,3,0,1,4,1,0,2018-03-26
3062,인천,연수구,2,0,0,2,2,0,2018-04-26
3063,인천,연수구,0,0,0,0,0,0,2018-05-26
3064,인천,연수구,5,0,0,5,3,0,2018-06-26
3065,인천,연수구,0,0,0,0,0,0,2018-07-26
3066,인천,연수구,1,0,0,1,1,0,2018-08-26
3067,인천,연수구,0,0,0,0,0,0,2018-09-26
3068,인천,연수구,1,0,1,2,2,0,2018-10-26
3069,인천,연수구,4,0,0,4,3,0,2018-11-26
3070,인천,연수구,0,0,0,0,0,0,2018-12-26
3071,인천,옹진군,0,0,0,0,0,0,2018-01-26
3072,인천,옹진군,0,0,0,0,0,0,2018-03-26
3073,인천,옹진군,0,0,0,0,0,0,2018-04-26
3074,인천,옹진군,1,0,1,2,1,0,2018-05-26
3075,인천,옹진군,0,0,0,0,0,0,2018-06-26
3076,인천,옹진군,0,0,0,0,0,0,2018-07-26
3077,인천,옹진군,0,0,0,0,0,0,2018-08-26
3078,인천,옹진군,0,0,0,0,0,0,2018-09-26
3079,인천,옹진군,0,0,0,0,0,0,2018-10-26
3080,인천,옹진군,0,0,0,0,0,0,2018-11-26
3081,인천,옹진군,0,0,0,0,0,0,2018-12-26
3082,인천,중구,0,0,0,0,0,0,2018-01-26
3083,인천,중구,0,1,1,2,3,1,2018-02-26
3084,인천,중구,1,0,0,1,1,0,2018-03-26
3085,인천,중구,2,0,1,3,2,1,2018-04-26
3086,인천,중구,2,0,1,3,3,0,2018-05-26
3087,인천,중구,0,0,0,0,0,0,2018-06-26
3088,인천,중구,0,0,1,1,1,0,2018-07-26
3089,인천,중구,0,0,1,1,1,0,2018-08-26
3090,인천,중구,0,0,0,0,0,0,2018-09-26
3091,인천,중구,1,0,0,1,1,0,2018-10-26
3092,인천,중구,2,0,1,3,2,0,2018-11-26
3093,인천,중구,3,0,0,3,1,0,2018-12-26
3094,인천,강화군,0,0,0,0,0,0,2018-01-27
3095,인천,강화군,0,0,0,0,0,0,2018-02-27
3096,인천,강화군,0,0,0,0,0,0,2018-03-27
3097,인천,강화군,1,0,1,2,2,0,2018-04-27
3098,인천,강화군,3,0,0,3,3,1,2018-05-27
3099,인천,강화군,0,0,0,0,0,0,2018-06-27
3100,인천,강화군,3,0,0,3,1,0,2018-07-27
3101,인천,강화군,1,0,0,1,1,0,2018-08-27
3102,인천,강화군,0,0,1,1,1,0,2018-09-27
3103,인천,강화군,0,0,1,1,1,0,2018-10-27
3104,인천,강화군,3,0,0,3,1,0,2018-11-27
3105,인천,강화군,0,0,0,0,0,0,2018-12-27
3106,인천,계양구,17,0,1,18,3,0,2018-01-27
3107,인천,계양구,0,0,2,2,1,0,2018-02-27
3108,인천,계양구,1,0,0,1,1,0,2018-03-27
3109,인천,계양구,5,0,0,5,3,0,2018-04-27
3110,인천,계양구,8,1,1,10,6,0,2018-05-27
3111,인천,계양구,1,0,1,2,2,0,2018-06-27
3112,인천,계양구,7,0,0,7,4,0,2018-07-27
3113,인천,계양구,4,0,1,5,3,0,2018-08-27
3114,인천,계양구,3,0,0,3,2,0,2018-09-27
3115,인천,계양구,1,1,3,5,3,0,2018-10-27
3116,인천,계양구,1,0,1,2,2,0,2018-11-27
3117,인천,계양구,2,0,0,2,2,0,2018-12-27
3118,인천,남동구,0,0,2,2,2,0,2018-01-27
3119,인천,남동구,6,0,1,7,5,0,2018-02-27
3120,인천,남동구,8,2,1,11,5,0,2018-03-27
3121,인천,남동구,3,0,1,4,4,0,2018-04-27
3122,인천,남동구,9,0,2,11,4,0,2018-05-27
3123,인천,남동구,7,0,2,9,6,0,2018-06-27
3124,인천,남동구,6,1,2,9,6,0,2018-07-27
3125,인천,남동구,10,2,2,14,5,0,2018-08-27
3126,인천,남동구,3,0,0,3,2,0,2018-09-27
3127,인천,남동구,9,0,3,12,6,0,2018-10-27
3128,인천,남동구,1,0,1,2,2,0,2018-11-27
3129,인천,남동구,5,0,0,5,3,0,2018-12-27
3130,인천,동구,0,0,0,0,0,0,2018-01-27
3131,인천,동구,1,0,0,1,1,0,2018-02-27
3132,인천,동구,0,0,0,0,0,0,2018-03-27
3133,인천,동구,0,0,0,0,0,0,2018-04-27
3134,인천,동구,0,0,0,0,0,0,2018-05-27
3135,인천,동구,0,0,0,0,0,0,2018-06-27
3136,인천,동구,0,0,0,0,0,0,2018-07-27
3137,인천,동구,0,0,0,0,0,0,2018-08-27
3138,인천,동구,0,0,0,0,0,0,2018-09-27
3139,인천,동구,0,0,0,0,0,0,2018-10-27
3140,인천,동구,0,0,1,1,1,0,2018-11-27
3141,인천,동구,0,0,0,0,0,0,2018-12-27
3142,인천,미추홀구,5,0,1,6,3,0,2018-01-27
3143,인천,미추홀구,6,0,0,6,2,0,2018-02-27
3144,인천,미추홀구,3,0,3,6,4,0,2018-03-27
3145,인천,미추홀구,0,1,0,1,1,0,2018-04-27
3146,인천,미추홀구,6,0,1,7,5,0,2018-05-27
3147,인천,미추홀구,1,0,0,1,1,0,2018-06-27
3148,인천,미추홀구,6,0,0,6,3,0,2018-07-27
3149,인천,미추홀구,3,0,1,4,2,1,2018-08-27
3150,인천,미추홀구,4,0,0,4,3,0,2018-09-27
3151,인천,미추홀구,4,0,1,5,6,1,2018-10-27
3152,인천,미추홀구,2,0,0,2,2,0,2018-11-27
3153,인천,미추홀구,1,0,1,2,2,0,2018-12-27
3154,인천,부평구,2,0,0,2,2,0,2018-01-27
3155,인천,부평구,2,0,0,2,2,0,2018-02-27
3156,인천,부평구,5,0,1,6,3,0,2018-03-27
3157,인천,부평구,3,0,1,4,4,0,2018-04-27
3158,인천,부평구,1,0,1,2,2,0,2018-05-27
3159,인천,부평구,2,0,0,2,1,0,2018-06-27
3160,인천,부평구,5,0,0,5,4,0,2018-07-27
3161,인천,부평구,3,0,1,4,2,0,2018-08-27
3162,인천,부평구,4,0,1,5,3,0,2018-09-27
3163,인천,부평구,1,0,0,1,1,0,2018-10-27
3164,인천,부평구,9,0,2,11,4,0,2018-11-27
3165,인천,부평구,2,0,1,3,3,0,2018-12-27
3166,인천,서구,0,0,1,1,1,0,2018-01-27
3167,인천,서구,12,0,1,13,5,0,2018-02-27
3168,인천,서구,5,0,3,8,5,0,2018-03-27
3169,인천,서구,5,0,0,5,3,0,2018-04-27
3170,인천,서구,1,0,0,1,1,0,2018-05-27
3171,인천,서구,3,0,0,3,3,0,2018-06-27
3172,인천,서구,5,0,0,5,3,0,2018-07-27
3173,인천,서구,2,0,2,4,3,0,2018-08-27
3174,인천,서구,1,0,1,2,1,0,2018-09-27
3175,인천,서구,3,0,3,6,3,0,2018-10-27
3176,인천,서구,4,1,1,6,6,0,2018-11-27
3177,인천,서구,8,0,2,10,6,0,2018-12-27
3178,인천,연수구,0,0,0,0,0,0,2018-01-27
3179,인천,연수구,3,0,0,3,2,0,2018-02-27
3180,인천,연수구,5,0,0,5,4,0,2018-03-27
3181,인천,연수구,7,1,0,8,4,0,2018-04-27
3182,인천,연수구,2,0,0,2,1,0,2018-05-27
3183,인천,연수구,3,0,0,3,2,0,2018-06-27
3184,인천,연수구,5,1,0,6,4,0,2018-07-27
3185,인천,연수구,0,0,1,1,1,0,2018-08-27
3186,인천,연수구,4,0,0,4,1,0,2018-09-27
3187,인천,연수구,0,0,1,1,1,0,2018-10-27
3188,인천,연수구,0,0,1,1,1,0,2018-11-27
3189,인천,연수구,1,0,0,1,1,0,2018-12-27
3190,인천,옹진군,0,0,0,0,0,0,2018-01-27
3191,인천,옹진군,0,0,0,0,0,0,2018-03-27
3192,인천,옹진군,0,0,1,1,1,0,2018-04-27
3193,인천,옹진군,0,0,0,0,0,0,2018-05-27
3194,인천,옹진군,0,0,0,0,0,0,2018-06-27
3195,인천,옹진군,0,0,0,0,0,0,2018-07-27
3196,인천,옹진군,0,0,0,0,0,0,2018-08-27
3197,인천,옹진군,0,0,0,0,0,0,2018-09-27
3198,인천,옹진군,0,0,0,0,0,0,2018-10-27
3199,인천,옹진군,0,0,0,0,0,0,2018-11-27
3200,인천,옹진군,0,0,0,0,0,0,2018-12-27
3201,인천,중구,3,0,0,3,2,0,2018-01-27
3202,인천,중구,0,0,0,0,0,0,2018-02-27
3203,인천,중구,0,0,0,0,0,0,2018-03-27
3204,인천,중구,1,0,0,1,1,0,2018-04-27
3205,인천,중구,2,0,0,2,1,0,2018-05-27
3206,인천,중구,4,0,0,4,2,0,2018-06-27
3207,인천,중구,0,0,0,0,0,0,2018-07-27
3208,인천,중구,0,0,1,1,1,0,2018-08-27
3209,인천,중구,2,1,5,8,2,0,2018-09-27
3210,인천,중구,1,0,1,2,1,0,2018-10-27
3211,인천,중구,0,0,1,1,1,1,2018-11-27
3212,인천,중구,0,1,0,1,1,0,2018-12-27
3213,인천,강화군,0,0,0,0,1,1,2018-01-28
3214,인천,강화군,0,0,0,0,0,0,2018-02-28
3215,인천,강화군,0,0,0,0,0,0,2018-03-28
3216,인천,강화군,0,0,0,0,1,1,2018-04-28
3217,인천,강화군,0,0,0,0,0,0,2018-05-28
3218,인천,강화군,0,0,0,0,0,0,2018-06-28
3219,인천,강화군,0,0,1,1,1,0,2018-07-28
3220,인천,강화군,3,0,0,3,1,0,2018-08-28
3221,인천,강화군,0,0,0,0,0,0,2018-09-28
3222,인천,강화군,2,0,1,3,1,0,2018-10-28
3223,인천,강화군,0,0,0,0,0,0,2018-11-28
3224,인천,강화군,0,0,0,0,0,0,2018-12-28
3225,인천,계양구,5,1,2,8,3,0,2018-01-28
3226,인천,계양구,10,0,2,12,6,0,2018-02-28
3227,인천,계양구,0,0,2,2,2,0,2018-03-28
3228,인천,계양구,4,1,3,8,3,0,2018-04-28
3229,인천,계양구,1,0,1,2,2,0,2018-05-28
3230,인천,계양구,1,0,2,3,3,0,2018-06-28
3231,인천,계양구,0,0,0,0,0,0,2018-07-28
3232,인천,계양구,4,0,0,4,3,0,2018-08-28
3233,인천,계양구,3,0,0,3,2,0,2018-09-28
3234,인천,계양구,6,0,0,6,3,0,2018-10-28
3235,인천,계양구,1,0,1,2,2,0,2018-11-28
3236,인천,계양구,1,1,4,6,5,0,2018-12-28
3237,인천,남동구,5,0,1,6,4,0,2018-01-28
3238,인천,남동구,3,0,1,4,4,0,2018-02-28
3239,인천,남동구,2,0,1,3,3,0,2018-03-28
3240,인천,남동구,12,0,3,15,9,0,2018-04-28
3241,인천,남동구,6,0,0,6,3,0,2018-05-28
3242,인천,남동구,6,0,1,7,7,0,2018-06-28
3243,인천,남동구,3,0,2,5,4,1,2018-07-28
3244,인천,남동구,9,0,1,10,6,0,2018-08-28
3245,인천,남동구,4,1,1,6,5,0,2018-09-28
3246,인천,남동구,3,0,1,4,3,0,2018-10-28
3247,인천,남동구,3,1,1,5,5,0,2018-11-28
3248,인천,남동구,7,0,0,7,5,0,2018-12-28
3249,인천,동구,0,0,0,0,0,0,2018-01-28
3250,인천,동구,2,0,0,2,1,0,2018-02-28
3251,인천,동구,0,0,0,0,0,0,2018-03-28
3252,인천,동구,0,0,0,0,0,0,2018-04-28
3253,인천,동구,0,0,1,1,1,0,2018-05-28
3254,인천,동구,1,0,0,1,1,0,2018-06-28
3255,인천,동구,0,0,1,1,1,0,2018-07-28
3256,인천,동구,0,0,0,0,0,0,2018-08-28
3257,인천,동구,0,0,0,0,0,0,2018-09-28
3258,인천,동구,1,0,1,2,1,0,2018-10-28
3259,인천,동구,0,0,0,0,0,0,2018-11-28
3260,인천,동구,1,0,0,1,1,0,2018-12-28
3261,인천,미추홀구,10,0,2,12,4,0,2018-01-28
3262,인천,미추홀구,2,0,0,2,2,0,2018-02-28
3263,인천,미추홀구,1,0,0,1,1,0,2018-03-28
3264,인천,미추홀구,2,1,3,6,4,0,2018-04-28
3265,인천,미추홀구,6,0,0,6,3,0,2018-05-28
3266,인천,미추홀구,2,0,1,3,3,0,2018-06-28
3267,인천,미추홀구,4,1,0,5,3,0,2018-07-28
3268,인천,미추홀구,3,1,2,6,5,0,2018-08-28
3269,인천,미추홀구,0,1,0,1,1,0,2018-09-28
3270,인천,미추홀구,11,0,0,11,6,0,2018-10-28
3271,인천,미추홀구,2,0,0,2,2,0,2018-11-28
3272,인천,미추홀구,1,2,1,4,4,0,2018-12-28
3273,인천,부평구,3,0,5,8,4,0,2018-01-28
3274,인천,부평구,6,1,2,9,6,0,2018-02-28
3275,인천,부평구,3,1,2,6,3,0,2018-03-28
3276,인천,부평구,5,0,1,6,3,0,2018-04-28
3277,인천,부평구,3,0,1,4,3,0,2018-05-28
3278,인천,부평구,4,0,0,4,3,0,2018-06-28
3279,인천,부평구,1,2,1,4,4,0,2018-07-28
3280,인천,부평구,4,0,0,4,2,0,2018-08-28
3281,인천,부평구,3,0,1,4,3,0,2018-09-28
3282,인천,부평구,1,0,1,2,2,0,2018-10-28
3283,인천,부평구,3,0,2,5,4,0,2018-11-28
3284,인천,부평구,0,0,1,1,1,0,2018-12-28
3285,인천,서구,2,0,2,4,3,0,2018-01-28
3286,인천,서구,3,0,1,4,4,0,2018-02-28
3287,인천,서구,9,0,0,9,4,0,2018-03-28
3288,인천,서구,3,0,2,5,4,0,2018-04-28
3289,인천,서구,7,0,3,10,6,0,2018-05-28
3290,인천,서구,8,0,1,9,7,0,2018-06-28
3291,인천,서구,1,0,0,1,1,0,2018-07-28
3292,인천,서구,3,0,1,4,4,0,2018-08-28
3293,인천,서구,0,0,0,0,0,0,2018-09-28
3294,인천,서구,0,0,0,0,0,0,2018-10-28
3295,인천,서구,7,0,1,8,4,0,2018-11-28
3296,인천,서구,2,0,4,6,5,0,2018-12-28
3297,인천,연수구,2,0,0,2,2,0,2018-01-28
3298,인천,연수구,0,0,1,1,1,0,2018-02-28
3299,인천,연수구,3,0,1,4,3,0,2018-03-28
3300,인천,연수구,3,0,2,5,3,0,2018-04-28
3301,인천,연수구,1,0,1,2,1,0,2018-05-28
3302,인천,연수구,0,0,1,1,1,0,2018-06-28
3303,인천,연수구,2,0,1,3,2,0,2018-07-28
3304,인천,연수구,3,0,1,4,3,0,2018-08-28
3305,인천,연수구,0,0,0,0,0,0,2018-09-28
3306,인천,연수구,4,0,0,4,1,0,2018-10-28
3307,인천,연수구,0,0,1,1,1,0,2018-11-28
3308,인천,연수구,1,0,2,3,3,0,2018-12-28
3309,인천,옹진군,0,0,0,0,0,0,2018-01-28
3310,인천,옹진군,0,0,0,0,0,0,2018-03-28
3311,인천,옹진군,0,0,0,0,0,0,2018-04-28
3312,인천,옹진군,0,0,0,0,0,0,2018-05-28
3313,인천,옹진군,0,0,0,0,0,0,2018-06-28
3314,인천,옹진군,0,0,0,0,0,0,2018-07-28
3315,인천,옹진군,0,0,0,0,0,0,2018-08-28
3316,인천,옹진군,0,0,0,0,0,0,2018-09-28
3317,인천,옹진군,0,0,0,0,0,0,2018-10-28
3318,인천,옹진군,0,0,0,0,0,0,2018-11-28
3319,인천,옹진군,0,0,0,0,0,0,2018-12-28
3320,인천,중구,0,0,0,0,0,0,2018-01-28
3321,인천,중구,1,0,1,2,2,0,2018-02-28
3322,인천,중구,4,0,0,4,2,0,2018-03-28
3323,인천,중구,4,0,0,4,2,0,2018-04-28
3324,인천,중구,2,0,0,2,2,1,2018-05-28
3325,인천,중구,1,0,1,2,1,0,2018-06-28
3326,인천,중구,0,0,0,0,0,0,2018-07-28
3327,인천,중구,3,0,0,3,2,0,2018-08-28
3328,인천,중구,0,0,0,0,0,0,2018-09-28
3329,인천,중구,0,0,1,1,1,0,2018-10-28
3330,인천,중구,0,0,0,0,0,0,2018-11-28
3331,인천,중구,4,0,1,5,2,0,2018-12-28
3332,인천,강화군,4,0,1,5,1,0,2018-01-29
3334,인천,강화군,0,0,0,0,0,0,2018-03-29
3335,인천,강화군,2,0,1,3,2,0,2018-04-29
3336,인천,강화군,0,0,1,1,1,0,2018-05-29
3337,인천,강화군,0,0,0,0,0,0,2018-06-29
3338,인천,강화군,0,0,0,0,0,0,2018-07-29
3339,인천,강화군,1,0,2,3,2,0,2018-08-29
3340,인천,강화군,3,3,3,9,2,0,2018-09-29
3341,인천,강화군,0,0,0,0,0,0,2018-10-29
3342,인천,강화군,0,0,1,1,1,0,2018-11-29
3343,인천,강화군,1,0,1,2,1,0,2018-12-29
3344,인천,계양구,2,0,0,2,2,0,2018-01-29
3346,인천,계양구,2,0,2,4,3,0,2018-03-29
3347,인천,계양구,3,1,1,5,5,0,2018-04-29
3348,인천,계양구,2,1,0,3,3,0,2018-05-29
3349,인천,계양구,2,0,0,2,1,0,2018-06-29
3350,인천,계양구,0,0,0,0,0,0,2018-07-29
3351,인천,계양구,2,0,0,2,2,1,2018-08-29
3352,인천,계양구,4,1,0,5,2,0,2018-09-29
3353,인천,계양구,9,2,1,12,5,0,2018-10-29
3354,인천,계양구,3,0,1,4,3,0,2018-11-29
3355,인천,계양구,1,0,0,1,1,0,2018-12-29
3356,인천,남동구,0,0,0,0,0,0,2018-01-29
3358,인천,남동구,5,1,0,6,4,0,2018-03-29
3359,인천,남동구,6,1,3,10,5,0,2018-04-29
3360,인천,남동구,4,1,0,5,5,0,2018-05-29
3361,인천,남동구,5,0,2,7,6,0,2018-06-29
3362,인천,남동구,7,0,1,8,3,0,2018-07-29
3363,인천,남동구,7,0,0,7,4,0,2018-08-29
3364,인천,남동구,3,0,2,5,5,0,2018-09-29
3365,인천,남동구,6,0,2,8,6,0,2018-10-29
3366,인천,남동구,5,0,0,5,3,0,2018-11-29
3367,인천,남동구,3,0,2,5,3,0,2018-12-29
3368,인천,동구,0,0,0,0,0,0,2018-01-29
3370,인천,동구,0,0,0,0,0,0,2018-03-29
3371,인천,동구,0,0,0,0,0,0,2018-04-29
3372,인천,동구,1,0,0,1,1,0,2018-05-29
3373,인천,동구,0,0,0,0,0,0,2018-06-29
3374,인천,동구,0,0,0,0,0,0,2018-07-29
3375,인천,동구,0,0,0,0,0,0,2018-08-29
3376,인천,동구,0,0,0,0,0,0,2018-09-29
3377,인천,동구,0,0,1,1,1,0,2018-10-29
3378,인천,동구,0,0,0,0,0,0,2018-11-29
3379,인천,동구,0,0,0,0,0,0,2018-12-29
3380,인천,미추홀구,2,1,0,3,3,0,2018-01-29
3382,인천,미추홀구,2,0,4,6,6,0,2018-03-29
3383,인천,미추홀구,2,1,0,3,3,0,2018-04-29
3384,인천,미추홀구,6,2,1,9,6,0,2018-05-29
3385,인천,미추홀구,3,0,0,3,2,0,2018-06-29
3386,인천,미추홀구,1,0,0,1,2,1,2018-07-29
3387,인천,미추홀구,1,0,0,1,1,0,2018-08-29
3388,인천,미추홀구,1,0,1,2,2,0,2018-09-29
3389,인천,미추홀구,2,1,0,3,3,0,2018-10-29
3390,인천,미추홀구,2,0,0,2,2,0,2018-11-29
3391,인천,미추홀구,2,1,0,3,3,0,2018-12-29
3392,인천,부평구,6,1,2,9,6,0,2018-01-29
3394,인천,부평구,4,0,2,6,5,0,2018-03-29
3395,인천,부평구,0,0,1,1,1,0,2018-04-29
3396,인천,부평구,1,0,0,1,1,0,2018-05-29
3397,인천,부평구,7,0,0,7,3,0,2018-06-29
3398,인천,부평구,3,0,1,4,2,0,2018-07-29
3399,인천,부평구,3,0,1,4,2,0,2018-08-29
3400,인천,부평구,2,0,0,2,2,0,2018-09-29
3401,인천,부평구,6,0,0,6,4,0,2018-10-29
3402,인천,부평구,0,0,0,0,0,0,2018-11-29
3403,인천,부평구,1,0,2,3,2,0,2018-12-29
3404,인천,서구,2,0,1,3,3,0,2018-01-29
3406,인천,서구,2,1,1,4,3,0,2018-03-29
3407,인천,서구,4,0,0,4,3,0,2018-04-29
3408,인천,서구,0,0,1,1,1,0,2018-05-29
3409,인천,서구,3,0,0,3,3,0,2018-06-29
3410,인천,서구,6,0,1,7,5,0,2018-07-29
3411,인천,서구,4,0,0,4,4,0,2018-08-29
3412,인천,서구,2,0,2,4,3,0,2018-09-29
3413,인천,서구,0,0,1,1,1,0,2018-10-29
3414,인천,서구,2,0,2,4,3,0,2018-11-29
3415,인천,서구,1,0,2,3,3,0,2018-12-29
3416,인천,연수구,1,0,1,2,2,0,2018-01-29
3418,인천,연수구,3,0,0,3,3,0,2018-03-29
3419,인천,연수구,5,0,1,6,2,0,2018-04-29
3420,인천,연수구,3,0,0,3,2,0,2018-05-29
3421,인천,연수구,1,0,1,2,1,0,2018-06-29
3422,인천,연수구,1,0,1,2,2,0,2018-07-29
3423,인천,연수구,5,0,0,5,3,0,2018-08-29
3424,인천,연수구,1,0,0,1,1,0,2018-09-29
3425,인천,연수구,4,0,0,4,4,1,2018-10-29
3426,인천,연수구,2,0,0,2,2,0,2018-11-29
3427,인천,연수구,4,0,0,4,3,0,2018-12-29
3428,인천,옹진군,0,0,0,0,0,0,2018-01-29
3429,인천,옹진군,0,0,0,0,0,0,2018-03-29
3430,인천,옹진군,0,0,0,0,0,0,2018-04-29
3431,인천,옹진군,0,0,0,0,0,0,2018-05-29
3432,인천,옹진군,0,0,0,0,0,0,2018-06-29
3433,인천,옹진군,1,0,1,2,2,0,2018-07-29
3434,인천,옹진군,0,0,0,0,0,0,2018-08-29
3435,인천,옹진군,0,0,0,0,0,0,2018-09-29
3436,인천,옹진군,0,0,0,0,0,0,2018-10-29
3437,인천,옹진군,0,0,0,0,0,0,2018-11-29
3438,인천,옹진군,0,0,0,0,0,0,2018-12-29
3439,인천,중구,3,0,0,3,1,0,2018-01-29
3441,인천,중구,1,0,0,1,1,0,2018-03-29
3442,인천,중구,0,0,0,0,0,0,2018-04-29
3443,인천,중구,1,0,0,1,1,0,2018-05-29
3444,인천,중구,2,5,3,10,2,0,2018-06-29
3445,인천,중구,0,0,0,0,0,0,2018-07-29
3446,인천,중구,1,0,0,1,1,0,2018-08-29
3447,인천,중구,3,0,2,5,3,0,2018-09-29
3448,인천,중구,0,0,0,0,0,0,2018-10-29
3449,인천,중구,1,1,0,2,2,0,2018-11-29
3450,인천,중구,2,0,2,4,1,0,2018-12-29
3451,인천,강화군,1,0,0,1,1,0,2018-01-30
3453,인천,강화군,1,0,0,1,1,0,2018-03-30
3454,인천,강화군,0,0,1,1,1,0,2018-04-30
3455,인천,강화군,2,0,0,2,2,0,2018-05-30
3456,인천,강화군,0,1,1,2,2,0,2018-06-30
3457,인천,강화군,0,0,1,1,1,0,2018-07-30
3458,인천,강화군,0,0,0,0,0,0,2018-08-30
3459,인천,강화군,0,0,0,0,0,0,2018-09-30
3460,인천,강화군,1,0,0,1,1,0,2018-10-30
3461,인천,강화군,0,0,0,0,0,0,2018-11-30
3462,인천,강화군,0,0,0,0,0,0,2018-12-30
3463,인천,계양구,1,0,1,2,2,0,2018-01-30
3465,인천,계양구,1,0,0,1,1,0,2018-03-30
3466,인천,계양구,4,0,2,6,3,1,2018-04-30
3467,인천,계양구,2,1,1,4,2,0,2018-05-30
3468,인천,계양구,0,1,0,1,1,0,2018-06-30
3469,인천,계양구,3,0,6,9,7,0,2018-07-30
3470,인천,계양구,2,0,0,2,1,0,2018-08-30
3471,인천,계양구,0,1,1,2,2,0,2018-09-30
3472,인천,계양구,0,0,1,1,1,0,2018-10-30
3473,인천,계양구,0,0,1,1,1,0,2018-11-30
3474,인천,계양구,0,1,0,1,1,0,2018-12-30
3475,인천,남동구,9,0,2,11,5,0,2018-01-30
3477,인천,남동구,5,0,1,6,3,0,2018-03-30
3478,인천,남동구,5,0,0,5,5,0,2018-04-30
3479,인천,남동구,14,4,1,19,10,0,2018-05-30
3480,인천,남동구,3,0,0,3,3,0,2018-06-30
3481,인천,남동구,3,0,0,3,2,0,2018-07-30
3482,인천,남동구,3,0,1,4,4,0,2018-08-30
3483,인천,남동구,12,0,3,15,7,0,2018-09-30
3484,인천,남동구,5,0,2,7,4,0,2018-10-30
3485,인천,남동구,6,0,1,7,6,0,2018-11-30
3486,인천,남동구,6,0,0,6,5,0,2018-12-30
3487,인천,동구,0,0,0,0,0,0,2018-01-30
3489,인천,동구,1,0,0,1,1,0,2018-03-30
3490,인천,동구,0,0,1,1,1,0,2018-04-30
3491,인천,동구,0,0,0,0,0,0,2018-05-30
3492,인천,동구,0,0,0,0,0,0,2018-06-30
3493,인천,동구,0,0,0,0,0,0,2018-07-30
3494,인천,동구,0,0,0,0,0,0,2018-08-30
3495,인천,동구,1,1,1,3,2,0,2018-09-30
3496,인천,동구,0,0,0,0,0,0,2018-10-30
3497,인천,동구,0,0,1,1,1,0,2018-11-30
3498,인천,동구,0,0,0,0,0,0,2018-12-30
3499,인천,미추홀구,5,0,2,7,4,0,2018-01-30
3501,인천,미추홀구,3,0,0,3,1,0,2018-03-30
3502,인천,미추홀구,9,1,2,12,8,0,2018-04-30
3503,인천,미추홀구,4,1,1,6,4,0,2018-05-30
3504,인천,미추홀구,3,0,0,3,2,0,2018-06-30
3505,인천,미추홀구,3,0,1,4,4,1,2018-07-30
3506,인천,미추홀구,7,2,0,9,5,0,2018-08-30
3507,인천,미추홀구,2,0,4,6,4,0,2018-09-30
3508,인천,미추홀구,9,2,1,12,6,0,2018-10-30
3509,인천,미추홀구,6,0,1,7,6,0,2018-11-30
3510,인천,미추홀구,0,0,0,0,0,0,2018-12-30
3511,인천,부평구,3,1,1,5,3,0,2018-01-30
3513,인천,부평구,1,0,1,2,2,0,2018-03-30
3514,인천,부평구,4,0,3,7,7,0,2018-04-30
3515,인천,부평구,3,0,1,4,3,0,2018-05-30
3516,인천,부평구,0,0,1,1,1,0,2018-06-30
3517,인천,부평구,2,0,2,4,4,0,2018-07-30
3518,인천,부평구,2,0,1,3,3,0,2018-08-30
3519,인천,부평구,8,0,2,10,7,0,2018-09-30
3520,인천,부평구,3,0,0,3,3,0,2018-10-30
3521,인천,부평구,2,0,0,2,2,0,2018-11-30
3522,인천,부평구,7,0,2,9,4,0,2018-12-30
3523,인천,서구,3,0,1,4,4,0,2018-01-30
3525,인천,서구,2,0,2,4,3,0,2018-03-30
3526,인천,서구,2,0,1,3,3,0,2018-04-30
3527,인천,서구,2,0,2,4,4,0,2018-05-30
3528,인천,서구,1,0,3,4,1,0,2018-06-30
3529,인천,서구,5,0,0,5,4,0,2018-07-30
3530,인천,서구,1,0,2,3,3,0,2018-08-30
3531,인천,서구,0,0,1,1,1,0,2018-09-30
3532,인천,서구,1,0,3,4,3,0,2018-10-30
3533,인천,서구,1,0,0,1,1,0,2018-11-30
3534,인천,서구,4,0,0,4,2,0,2018-12-30
3535,인천,연수구,0,0,0,0,0,0,2018-01-30
3537,인천,연수구,2,1,0,3,2,0,2018-03-30
3538,인천,연수구,0,0,0,0,1,1,2018-04-30
3539,인천,연수구,5,0,0,5,2,0,2018-05-30
3540,인천,연수구,0,0,0,0,0,0,2018-06-30
3541,인천,연수구,0,0,1,1,1,0,2018-07-30
3542,인천,연수구,4,0,0,4,2,0,2018-08-30
3543,인천,연수구,0,0,0,0,0,0,2018-09-30
3544,인천,연수구,1,0,1,2,2,0,2018-10-30
3545,인천,연수구,1,0,0,1,1,0,2018-11-30
3546,인천,연수구,1,0,0,1,1,0,2018-12-30
3547,인천,옹진군,0,0,0,0,0,0,2018-01-30
3548,인천,옹진군,0,0,2,2,1,0,2018-03-30
3549,인천,옹진군,0,0,0,0,0,0,2018-04-30
3550,인천,옹진군,0,0,0,0,0,0,2018-05-30
3551,인천,옹진군,0,0,0,0,0,0,2018-06-30
3552,인천,옹진군,0,0,0,0,0,0,2018-07-30
3553,인천,옹진군,0,0,0,0,0,0,2018-08-30
3554,인천,옹진군,0,0,0,0,0,0,2018-09-30
3555,인천,옹진군,0,0,0,0,0,0,2018-10-30
3556,인천,옹진군,3,0,0,3,1,0,2018-11-30
3557,인천,옹진군,0,0,0,0,0,0,2018-12-30
3558,인천,중구,1,0,0,1,1,0,2018-01-30
3560,인천,중구,4,0,0,4,2,0,2018-03-30
3561,인천,중구,2,0,0,2,1,0,2018-04-30
3562,인천,중구,2,0,0,2,2,0,2018-05-30
3563,인천,중구,2,0,0,2,1,0,2018-06-30
3564,인천,중구,1,0,0,1,1,0,2018-07-30
3565,인천,중구,3,0,2,5,4,0,2018-08-30
3566,인천,중구,1,0,0,1,1,0,2018-09-30
3567,인천,중구,1,0,1,2,2,0,2018-10-30
3568,인천,중구,1,0,0,1,1,0,2018-11-30
3569,인천,중구,0,0,1,1,1,0,2018-12-30
3570,인천,강화군,1,0,0,1,1,0,2018-01-31
3572,인천,강화군,1,0,0,1,1,0,2018-03-31
3574,인천,강화군,0,1,1,2,2,0,2018-05-31
3576,인천,강화군,0,0,1,1,1,0,2018-07-31
3577,인천,강화군,0,0,0,0,0,0,2018-08-31
3579,인천,강화군,2,0,0,2,1,0,2018-10-31
3581,인천,강화군,0,0,0,0,0,0,2018-12-31
3582,인천,계양구,4,0,2,6,4,0,2018-01-31
3584,인천,계양구,4,0,2,6,4,0,2018-03-31
3586,인천,계양구,1,0,0,1,1,0,2018-05-31
3588,인천,계양구,2,0,0,2,2,0,2018-07-31
3589,인천,계양구,2,0,0,2,2,0,2018-08-31
3591,인천,계양구,4,1,3,8,6,0,2018-10-31
3593,인천,계양구,3,0,1,4,3,0,2018-12-31
3594,인천,남동구,8,0,1,9,5,0,2018-01-31
3596,인천,남동구,10,0,4,14,6,0,2018-03-31
3598,인천,남동구,11,0,0,11,7,0,2018-05-31
3600,인천,남동구,5,0,2,7,5,0,2018-07-31
3601,인천,남동구,9,0,1,10,8,0,2018-08-31
3603,인천,남동구,2,1,0,3,3,0,2018-10-31
3605,인천,남동구,2,0,1,3,2,0,2018-12-31
3606,인천,동구,0,0,0,0,0,0,2018-01-31
3608,인천,동구,0,0,0,0,0,0,2018-03-31
3610,인천,동구,0,0,1,1,1,0,2018-05-31
3612,인천,동구,1,0,0,1,1,0,2018-07-31
3613,인천,동구,0,0,0,0,0,0,2018-08-31
3615,인천,동구,1,0,1,2,2,0,2018-10-31
3617,인천,동구,1,0,0,1,1,0,2018-12-31
3618,인천,미추홀구,0,0,1,1,1,0,2018-01-31
3620,인천,미추홀구,9,0,0,9,3,0,2018-03-31
3622,인천,미추홀구,4,0,0,4,3,0,2018-05-31
3624,인천,미추홀구,1,0,0,1,1,0,2018-07-31
3625,인천,미추홀구,1,0,0,1,1,0,2018-08-31
3627,인천,미추홀구,2,0,2,4,3,0,2018-10-31
3629,인천,미추홀구,1,0,1,2,2,0,2018-12-31
3630,인천,부평구,3,0,1,4,4,0,2018-01-31
3632,인천,부평구,7,0,2,9,6,0,2018-03-31
3634,인천,부평구,4,0,3,7,4,0,2018-05-31
3636,인천,부평구,0,0,0,0,0,0,2018-07-31
3637,인천,부평구,1,1,0,2,2,0,2018-08-31
3639,인천,부평구,4,0,1,5,4,0,2018-10-31
3641,인천,부평구,4,0,2,6,4,0,2018-12-31
3642,인천,서구,6,0,2,8,5,0,2018-01-31
3644,인천,서구,4,1,0,5,3,0,2018-03-31
3646,인천,서구,3,0,0,3,3,0,2018-05-31
3648,인천,서구,2,0,0,2,2,0,2018-07-31
3649,인천,서구,12,0,2,14,9,0,2018-08-31
3651,인천,서구,7,0,2,9,8,0,2018-10-31
3653,인천,서구,7,0,3,10,7,0,2018-12-31
3654,인천,연수구,0,0,0,0,0,0,2018-01-31
3656,인천,연수구,1,0,0,1,1,0,2018-03-31
3658,인천,연수구,1,0,0,1,1,0,2018-05-31
3660,인천,연수구,1,1,2,4,3,0,2018-07-31
3661,인천,연수구,0,0,1,1,1,0,2018-08-31
3663,인천,연수구,2,0,0,2,2,0,2018-10-31
3665,인천,연수구,1,0,0,1,1,0,2018-12-31
3666,인천,옹진군,0,0,0,0,0,0,2018-01-31
3667,인천,옹진군,0,0,0,0,0,0,2018-03-31
3669,인천,옹진군,0,0,0,0,0,0,2018-05-31
3671,인천,옹진군,0,0,0,0,0,0,2018-07-31
3672,인천,옹진군,0,0,0,0,0,0,2018-08-31
3674,인천,옹진군,0,0,0,0,0,0,2018-10-31
3676,인천,옹진군,0,0,0,0,0,0,2018-12-31
3677,인천,중구,2,0,0,2,2,0,2018-01-31
3679,인천,중구,0,0,0,0,0,0,2018-03-31
3681,인천,중구,0,0,0,0,0,0,2018-05-31
3683,인천,중구,3,1,1,5,3,0,2018-07-31
3684,인천,중구,0,0,0,0,0,0,2018-08-31
3686,인천,중구,0,0,0,0,0,0,2018-10-31
3688,인천,중구,0,0,0,0,0,0,2018-12-31
0,인천,강화군,0,0,0,0,0,0,2019-01-01
1,인천,강화군,0,0,0,0,0,0,2019-02-01
2,인천,강화군,1,0,0,1,1,0,2019-03-01
3,인천,강화군,0,0,0,0,0,0,2019-04-01
4,인천,강화군,0,0,0,0,0,0,2019-05-01
5,인천,강화군,0,0,3,3,1,1,2019-06-01
6,인천,강화군,0,0,0,0,0,0,2019-07-01
7,인천,강화군,0,0,0,0,0,0,2019-08-01
8,인천,강화군,0,0,0,0,0,0,2019-09-01
9,인천,강화군,0,0,0,0,0,0,2019-10-01
10,인천,강화군,0,0,0,0,0,0,2019-11-01
11,인천,강화군,3,0,0,3,1,0,2019-12-01
12,인천,계양구,0,0,0,0,0,0,2019-01-01
13,인천,계양구,4,0,0,4,2,0,2019-02-01
14,인천,계양구,1,0,0,1,1,0,2019-03-01
15,인천,계양구,3,0,1,4,4,0,2019-04-01
16,인천,계양구,4,0,2,6,4,1,2019-05-01
17,인천,계양구,1,0,0,1,1,0,2019-06-01
18,인천,계양구,2,1,0,3,2,0,2019-07-01
19,인천,계양구,5,0,0,5,2,0,2019-08-01
20,인천,계양구,0,0,0,0,0,0,2019-09-01
21,인천,계양구,9,0,2,11,4,0,2019-10-01
22,인천,계양구,2,1,3,6,6,0,2019-11-01
23,인천,계양구,4,0,2,6,5,0,2019-12-01
24,인천,남동구,1,0,2,3,1,0,2019-01-01
25,인천,남동구,6,0,0,6,5,0,2019-02-01
26,인천,남동구,5,0,0,5,4,0,2019-03-01
27,인천,남동구,7,0,2,9,8,0,2019-04-01
28,인천,남동구,8,0,2,10,7,0,2019-05-01
29,인천,남동구,1,0,0,1,1,0,2019-06-01
30,인천,남동구,5,0,0,5,3,0,2019-07-01
31,인천,남동구,6,0,1,7,4,0,2019-08-01
32,인천,남동구,2,0,1,3,3,0,2019-09-01
33,인천,남동구,4,0,2,6,6,0,2019-10-01
34,인천,남동구,4,0,1,5,4,0,2019-11-01
35,인천,남동구,1,0,1,2,2,0,2019-12-01
36,인천,동구,0,0,0,0,0,0,2019-01-01
37,인천,동구,0,0,0,0,0,0,2019-02-01
38,인천,동구,0,0,0,0,0,0,2019-03-01
39,인천,동구,1,0,0,1,1,1,2019-04-01
40,인천,동구,0,0,0,0,0,0,2019-05-01
41,인천,동구,1,0,0,1,1,0,2019-06-01
42,인천,동구,0,0,0,0,0,0,2019-07-01
43,인천,동구,1,0,0,1,1,0,2019-08-01
44,인천,동구,1,0,0,1,1,0,2019-09-01
45,인천,동구,0,0,0,0,0,0,2019-10-01
46,인천,동구,1,1,0,2,2,0,2019-11-01
47,인천,동구,1,0,0,1,1,0,2019-12-01
48,인천,미추홀구,5,0,0,5,2,0,2019-01-01
49,인천,미추홀구,6,1,3,10,7,0,2019-02-01
50,인천,미추홀구,4,1,1,6,5,0,2019-03-01
51,인천,미추홀구,2,0,3,5,3,0,2019-04-01
52,인천,미추홀구,4,0,1,5,4,0,2019-05-01
53,인천,미추홀구,1,0,0,1,1,0,2019-06-01
54,인천,미추홀구,5,0,2,7,4,0,2019-07-01
55,인천,미추홀구,3,0,1,4,2,0,2019-08-01
56,인천,미추홀구,1,2,0,3,3,0,2019-09-01
57,인천,미추홀구,1,0,0,1,1,0,2019-10-01
58,인천,미추홀구,6,1,1,8,4,0,2019-11-01
59,인천,미추홀구,3,1,0,4,3,0,2019-12-01
60,인천,부평구,5,1,0,6,3,0,2019-01-01
61,인천,부평구,3,0,1,4,4,0,2019-02-01
62,인천,부평구,3,0,0,3,1,0,2019-03-01
63,인천,부평구,1,0,0,1,1,0,2019-04-01
64,인천,부평구,2,0,1,3,4,1,2019-05-01
65,인천,부평구,3,0,1,4,4,0,2019-06-01
66,인천,부평구,0,1,3,4,4,0,2019-07-01
67,인천,부평구,5,0,1,6,5,0,2019-08-01
68,인천,부평구,5,1,3,9,6,0,2019-09-01
69,인천,부평구,6,0,0,6,5,0,2019-10-01
70,인천,부평구,2,0,0,2,2,0,2019-11-01
71,인천,부평구,0,0,1,1,1,0,2019-12-01
72,인천,서구,4,0,4,8,6,0,2019-01-01
73,인천,서구,11,0,1,12,6,0,2019-02-01
74,인천,서구,3,0,0,3,1,0,2019-03-01
75,인천,서구,5,0,2,7,5,0,2019-04-01
76,인천,서구,7,0,0,7,4,0,2019-05-01
77,인천,서구,5,0,0,5,2,0,2019-06-01
78,인천,서구,3,0,1,4,4,0,2019-07-01
79,인천,서구,0,0,2,2,2,0,2019-08-01
80,인천,서구,2,0,0,2,2,0,2019-09-01
81,인천,서구,6,0,1,7,6,0,2019-10-01
82,인천,서구,7,1,0,8,6,0,2019-11-01
83,인천,서구,3,0,0,3,1,0,2019-12-01
84,인천,연수구,0,0,0,0,0,0,2019-01-01
85,인천,연수구,3,0,0,3,2,0,2019-02-01
86,인천,연수구,3,0,0,3,1,0,2019-03-01
87,인천,연수구,1,0,0,1,2,1,2019-04-01
88,인천,연수구,0,0,0,0,0,0,2019-05-01
89,인천,연수구,0,0,1,1,1,0,2019-06-01
90,인천,연수구,3,0,0,3,2,0,2019-07-01
91,인천,연수구,1,0,1,2,2,0,2019-08-01
92,인천,연수구,2,0,1,3,2,0,2019-09-01
93,인천,연수구,6,0,0,6,3,0,2019-10-01
94,인천,연수구,3,0,3,6,5,0,2019-11-01
95,인천,연수구,2,0,1,3,2,0,2019-12-01
96,인천,옹진군,0,0,0,0,0,0,2019-01-01
97,인천,옹진군,0,0,0,0,0,0,2019-02-01
98,인천,옹진군,0,0,0,0,0,0,2019-03-01
99,인천,옹진군,0,0,0,0,0,0,2019-04-01
100,인천,옹진군,0,0,0,0,0,0,2019-05-01
101,인천,옹진군,2,0,0,2,1,0,2019-07-01
102,인천,옹진군,0,0,0,0,0,0,2019-08-01
103,인천,옹진군,0,0,0,0,0,0,2019-09-01
104,인천,옹진군,1,0,0,1,1,0,2019-10-01
105,인천,옹진군,0,0,0,0,0,0,2019-12-01
106,인천,중구,2,2,0,4,1,0,2019-01-01
107,인천,중구,0,0,0,0,0,0,2019-02-01
108,인천,중구,8,0,1,9,3,0,2019-03-01
109,인천,중구,1,0,0,1,1,0,2019-04-01
110,인천,중구,3,0,0,3,2,0,2019-05-01
111,인천,중구,4,0,0,4,2,0,2019-06-01
112,인천,중구,5,1,0,6,5,0,2019-07-01
113,인천,중구,4,0,0,4,1,0,2019-08-01
114,인천,중구,2,0,0,2,2,0,2019-09-01
115,인천,중구,5,0,1,6,3,0,2019-10-01
116,인천,중구,13,1,4,18,5,0,2019-11-01
117,인천,중구,0,0,0,0,0,0,2019-12-01
118,인천,강화군,0,0,0,0,0,0,2019-01-02
119,인천,강화군,0,0,0,0,0,0,2019-02-02
120,인천,강화군,0,0,0,0,0,0,2019-03-02
121,인천,강화군,0,0,0,0,0,0,2019-04-02
122,인천,강화군,0,0,0,0,0,0,2019-05-02
123,인천,강화군,0,0,1,1,1,0,2019-06-02
124,인천,강화군,0,0,0,0,0,0,2019-07-02
125,인천,강화군,0,0,0,0,0,0,2019-08-02
126,인천,강화군,0,0,0,0,0,0,2019-09-02
127,인천,강화군,0,0,0,0,0,0,2019-10-02
128,인천,강화군,0,0,0,0,0,0,2019-11-02
129,인천,강화군,0,0,0,0,0,0,2019-12-02
130,인천,계양구,6,0,1,7,7,1,2019-01-02
131,인천,계양구,2,0,0,2,2,0,2019-02-02
132,인천,계양구,1,0,1,2,2,0,2019-03-02
133,인천,계양구,0,0,0,0,0,0,2019-04-02
134,인천,계양구,6,0,0,6,4,0,2019-05-02
135,인천,계양구,2,2,1,5,3,0,2019-06-02
136,인천,계양구,3,0,1,4,3,0,2019-07-02
137,인천,계양구,1,0,0,1,1,0,2019-08-02
138,인천,계양구,3,0,4,7,8,1,2019-09-02
139,인천,계양구,4,0,2,6,5,0,2019-10-02
140,인천,계양구,8,0,0,8,6,0,2019-11-02
141,인천,계양구,5,0,2,7,5,0,2019-12-02
142,인천,남동구,5,0,0,5,4,0,2019-01-02
143,인천,남동구,11,0,2,13,6,0,2019-02-02
144,인천,남동구,4,0,0,4,3,0,2019-03-02
145,인천,남동구,5,0,2,7,6,0,2019-04-02
146,인천,남동구,6,0,2,8,8,0,2019-05-02
147,인천,남동구,5,0,0,5,5,0,2019-06-02
148,인천,남동구,3,0,0,3,2,0,2019-07-02
149,인천,남동구,10,0,3,13,4,0,2019-08-02
150,인천,남동구,2,2,1,5,5,0,2019-09-02
151,인천,남동구,6,0,0,6,4,0,2019-10-02
152,인천,남동구,7,0,0,7,3,0,2019-11-02
153,인천,남동구,5,1,2,8,5,0,2019-12-02
154,인천,동구,0,0,0,0,0,0,2019-01-02
155,인천,동구,1,0,1,2,2,0,2019-02-02
156,인천,동구,0,0,0,0,0,0,2019-03-02
157,인천,동구,1,0,0,1,1,0,2019-04-02
158,인천,동구,1,0,0,1,1,0,2019-05-02
159,인천,동구,5,0,0,5,1,0,2019-06-02
160,인천,동구,0,0,0,0,0,0,2019-07-02
161,인천,동구,2,0,0,2,2,0,2019-08-02
162,인천,동구,2,0,1,3,1,0,2019-09-02
163,인천,동구,0,0,0,0,0,0,2019-10-02
164,인천,동구,2,0,0,2,1,0,2019-11-02
165,인천,동구,0,0,0,0,0,0,2019-12-02
166,인천,미추홀구,5,0,0,5,3,0,2019-01-02
167,인천,미추홀구,4,0,2,6,6,0,2019-02-02
168,인천,미추홀구,4,0,0,4,3,0,2019-03-02
169,인천,미추홀구,1,0,0,1,1,0,2019-04-02
170,인천,미추홀구,7,0,2,9,7,0,2019-05-02
171,인천,미추홀구,1,0,0,1,1,0,2019-06-02
172,인천,미추홀구,0,1,1,2,2,0,2019-07-02
173,인천,미추홀구,3,2,0,5,5,0,2019-08-02
174,인천,미추홀구,4,1,0,5,5,0,2019-09-02
175,인천,미추홀구,4,2,1,7,7,0,2019-10-02
176,인천,미추홀구,7,0,0,7,6,0,2019-11-02
177,인천,미추홀구,1,0,2,3,2,0,2019-12-02
178,인천,부평구,3,0,3,6,4,0,2019-01-02
179,인천,부평구,9,0,0,9,3,0,2019-02-02
180,인천,부평구,6,0,3,9,7,0,2019-03-02
181,인천,부평구,6,0,2,8,6,0,2019-04-02
182,인천,부평구,5,0,0,5,3,0,2019-05-02
183,인천,부평구,8,0,3,11,7,0,2019-06-02
184,인천,부평구,4,1,1,6,6,0,2019-07-02
185,인천,부평구,2,1,1,4,3,0,2019-08-02
186,인천,부평구,11,1,1,13,10,0,2019-09-02
187,인천,부평구,10,0,0,10,6,0,2019-10-02
188,인천,부평구,5,0,1,6,7,1,2019-11-02
189,인천,부평구,0,0,0,0,0,0,2019-12-02
190,인천,서구,0,0,2,2,2,0,2019-01-02
191,인천,서구,1,0,1,2,2,0,2019-02-02
192,인천,서구,2,0,1,3,3,0,2019-03-02
193,인천,서구,7,1,2,10,8,0,2019-04-02
194,인천,서구,4,0,0,4,4,0,2019-05-02
195,인천,서구,3,0,0,3,2,0,2019-06-02
196,인천,서구,3,0,1,4,3,0,2019-07-02
197,인천,서구,4,0,1,5,4,0,2019-08-02
198,인천,서구,0,0,0,0,0,0,2019-09-02
199,인천,서구,11,0,3,14,7,0,2019-10-02
200,인천,서구,1,0,1,2,2,0,2019-11-02
201,인천,서구,4,0,2,6,5,0,2019-12-02
202,인천,연수구,5,0,1,6,2,0,2019-01-02
203,인천,연수구,2,0,2,4,2,0,2019-02-02
204,인천,연수구,1,0,1,2,2,0,2019-03-02
205,인천,연수구,1,0,0,1,1,0,2019-04-02
206,인천,연수구,5,0,2,7,4,0,2019-05-02
207,인천,연수구,0,0,0,0,0,0,2019-06-02
208,인천,연수구,3,0,0,3,3,0,2019-07-02
209,인천,연수구,0,0,0,0,0,0,2019-08-02
210,인천,연수구,2,0,0,2,1,0,2019-09-02
211,인천,연수구,1,0,0,1,1,0,2019-10-02
212,인천,연수구,1,0,0,1,1,0,2019-11-02
213,인천,연수구,1,0,0,1,1,0,2019-12-02
214,인천,옹진군,0,0,0,0,0,0,2019-01-02
215,인천,옹진군,0,0,0,0,0,0,2019-02-02
216,인천,옹진군,0,0,0,0,0,0,2019-03-02
217,인천,옹진군,0,0,0,0,0,0,2019-04-02
218,인천,옹진군,0,0,0,0,0,0,2019-05-02
219,인천,옹진군,0,0,0,0,0,0,2019-07-02
220,인천,옹진군,0,0,0,0,0,0,2019-08-02
221,인천,옹진군,0,0,0,0,0,0,2019-09-02
222,인천,옹진군,0,0,0,0,0,0,2019-10-02
223,인천,옹진군,0,0,0,0,0,0,2019-12-02
224,인천,중구,1,0,0,1,1,0,2019-01-02
225,인천,중구,1,0,0,1,1,0,2019-02-02
226,인천,중구,1,0,4,5,1,0,2019-03-02
227,인천,중구,2,0,0,2,1,0,2019-04-02
228,인천,중구,2,0,1,3,2,0,2019-05-02
229,인천,중구,0,0,1,1,1,0,2019-06-02
230,인천,중구,6,0,2,8,2,0,2019-07-02
231,인천,중구,0,0,0,0,0,0,2019-08-02
232,인천,중구,1,0,0,1,1,0,2019-09-02
233,인천,중구,4,0,0,4,4,0,2019-10-02
234,인천,중구,6,0,1,7,2,0,2019-11-02
235,인천,중구,2,0,1,3,2,0,2019-12-02
236,인천,강화군,0,0,1,1,1,0,2019-01-03
237,인천,강화군,0,0,0,0,0,0,2019-02-03
238,인천,강화군,0,0,0,0,0,0,2019-03-03
239,인천,강화군,0,0,0,0,0,0,2019-04-03
240,인천,강화군,0,0,0,0,0,0,2019-05-03
241,인천,강화군,1,0,0,1,1,0,2019-06-03
242,인천,강화군,0,0,0,0,0,0,2019-07-03
243,인천,강화군,0,0,0,0,0,0,2019-08-03
244,인천,강화군,0,0,1,1,1,0,2019-09-03
245,인천,강화군,0,0,2,2,1,0,2019-10-03
246,인천,강화군,0,0,0,0,0,0,2019-11-03
247,인천,강화군,0,0,0,0,0,0,2019-12-03
248,인천,계양구,4,0,2,6,5,0,2019-01-03
249,인천,계양구,1,0,0,1,1,0,2019-02-03
250,인천,계양구,2,0,0,2,2,0,2019-03-03
251,인천,계양구,2,0,0,2,2,0,2019-04-03
252,인천,계양구,5,1,2,8,6,0,2019-05-03
253,인천,계양구,0,0,0,0,0,0,2019-06-03
254,인천,계양구,1,1,0,2,2,0,2019-07-03
255,인천,계양구,1,0,0,1,1,0,2019-08-03
256,인천,계양구,6,0,2,8,4,0,2019-09-03
257,인천,계양구,2,0,0,2,2,0,2019-10-03
258,인천,계양구,5,0,1,6,4,0,2019-11-03
259,인천,계양구,2,1,1,4,3,0,2019-12-03
260,인천,남동구,2,0,0,2,2,0,2019-01-03
261,인천,남동구,8,0,5,13,7,0,2019-02-03
262,인천,남동구,3,0,1,4,2,0,2019-03-03
263,인천,남동구,3,1,4,8,6,0,2019-04-03
264,인천,남동구,3,0,1,4,4,0,2019-05-03
265,인천,남동구,5,0,2,7,6,0,2019-06-03
266,인천,남동구,6,0,2,8,8,0,2019-07-03
267,인천,남동구,4,0,2,6,2,0,2019-08-03
268,인천,남동구,4,0,1,5,5,0,2019-09-03
269,인천,남동구,15,0,2,17,10,2,2019-10-03
270,인천,남동구,6,1,0,7,4,0,2019-11-03
271,인천,남동구,4,1,2,7,5,0,2019-12-03
272,인천,동구,2,0,1,3,1,0,2019-01-03
273,인천,동구,0,0,0,0,0,0,2019-02-03
274,인천,동구,0,0,0,0,0,0,2019-03-03
275,인천,동구,0,0,0,0,0,0,2019-04-03
276,인천,동구,0,0,0,0,0,0,2019-05-03
277,인천,동구,2,0,0,2,1,0,2019-06-03
278,인천,동구,0,0,0,0,0,0,2019-07-03
279,인천,동구,0,0,0,0,0,0,2019-08-03
280,인천,동구,1,0,0,1,1,0,2019-09-03
281,인천,동구,2,0,2,4,3,0,2019-10-03
282,인천,동구,0,0,0,0,0,0,2019-11-03
283,인천,동구,0,0,0,0,0,0,2019-12-03
284,인천,미추홀구,2,0,1,3,2,0,2019-01-03
285,인천,미추홀구,2,0,3,5,4,0,2019-02-03
286,인천,미추홀구,0,0,1,1,1,0,2019-03-03
287,인천,미추홀구,1,0,1,2,2,0,2019-04-03
288,인천,미추홀구,1,1,2,4,3,0,2019-05-03
289,인천,미추홀구,4,0,1,5,3,0,2019-06-03
290,인천,미추홀구,5,0,0,5,5,0,2019-07-03
291,인천,미추홀구,1,0,0,1,1,0,2019-08-03
292,인천,미추홀구,4,2,0,6,5,0,2019-09-03
293,인천,미추홀구,1,0,0,1,1,0,2019-10-03
294,인천,미추홀구,2,1,2,5,5,0,2019-11-03
295,인천,미추홀구,3,1,1,5,5,0,2019-12-03
296,인천,부평구,1,0,0,1,1,0,2019-01-03
297,인천,부평구,2,0,1,3,2,0,2019-02-03
298,인천,부평구,2,0,1,3,2,0,2019-03-03
299,인천,부평구,1,0,2,3,3,0,2019-04-03
300,인천,부평구,2,0,0,2,2,0,2019-05-03
301,인천,부평구,3,0,1,4,4,0,2019-06-03
302,인천,부평구,6,0,0,6,5,0,2019-07-03
303,인천,부평구,7,0,5,12,6,0,2019-08-03
304,인천,부평구,7,0,0,7,6,0,2019-09-03
305,인천,부평구,4,0,1,5,4,0,2019-10-03
306,인천,부평구,6,0,1,7,5,0,2019-11-03
307,인천,부평구,3,0,7,10,7,0,2019-12-03
308,인천,서구,0,0,0,0,0,0,2019-01-03
309,인천,서구,3,0,2,5,2,0,2019-02-03
310,인천,서구,0,0,0,0,0,0,2019-03-03
311,인천,서구,4,0,1,5,4,0,2019-04-03
312,인천,서구,13,1,2,16,7,0,2019-05-03
313,인천,서구,5,0,1,6,5,0,2019-06-03
314,인천,서구,3,0,0,3,3,0,2019-07-03
315,인천,서구,6,1,1,8,5,0,2019-08-03
316,인천,서구,8,2,2,12,11,0,2019-09-03
317,인천,서구,9,0,2,11,4,0,2019-10-03
318,인천,서구,6,1,1,8,4,0,2019-11-03
319,인천,서구,3,0,2,5,2,0,2019-12-03
320,인천,연수구,0,0,0,0,0,0,2019-01-03
321,인천,연수구,0,0,0,0,0,0,2019-02-03
322,인천,연수구,0,0,0,0,0,0,2019-03-03
323,인천,연수구,1,0,1,2,2,0,2019-04-03
324,인천,연수구,3,0,1,4,4,0,2019-05-03
325,인천,연수구,1,0,0,1,1,0,2019-06-03
326,인천,연수구,3,0,0,3,2,0,2019-07-03
327,인천,연수구,0,0,1,1,1,0,2019-08-03
328,인천,연수구,1,0,2,3,3,0,2019-09-03
329,인천,연수구,1,0,1,2,2,0,2019-10-03
330,인천,연수구,1,0,0,1,1,0,2019-11-03
331,인천,연수구,1,0,1,2,2,0,2019-12-03
332,인천,옹진군,0,0,0,0,0,0,2019-01-03
333,인천,옹진군,0,0,0,0,0,0,2019-02-03
334,인천,옹진군,0,0,0,0,0,0,2019-03-03
335,인천,옹진군,0,0,0,0,0,0,2019-04-03
336,인천,옹진군,0,0,0,0,0,0,2019-05-03
337,인천,옹진군,0,0,0,0,0,0,2019-07-03
338,인천,옹진군,0,0,0,0,0,0,2019-08-03
339,인천,옹진군,0,0,0,0,0,0,2019-09-03
340,인천,옹진군,0,0,0,0,0,0,2019-10-03
341,인천,옹진군,0,0,0,0,0,0,2019-12-03
342,인천,중구,1,0,0,1,1,0,2019-01-03
343,인천,중구,1,0,0,1,1,0,2019-02-03
344,인천,중구,0,0,0,0,0,0,2019-03-03
345,인천,중구,0,0,0,0,0,0,2019-04-03
346,인천,중구,2,0,1,3,3,0,2019-05-03
347,인천,중구,2,1,0,3,3,0,2019-06-03
348,인천,중구,1,0,0,1,1,0,2019-07-03
349,인천,중구,4,0,2,6,4,0,2019-08-03
350,인천,중구,1,0,0,1,1,0,2019-09-03
351,인천,중구,2,0,3,5,2,0,2019-10-03
352,인천,중구,1,0,0,1,1,0,2019-11-03
353,인천,중구,2,1,1,4,3,0,2019-12-03
354,인천,강화군,0,0,0,0,0,0,2019-01-04
355,인천,강화군,0,0,0,0,0,0,2019-02-04
356,인천,강화군,0,0,0,0,0,0,2019-03-04
357,인천,강화군,0,0,1,1,1,0,2019-04-04
358,인천,강화군,8,0,0,8,1,0,2019-05-04
359,인천,강화군,0,0,0,0,0,0,2019-06-04
360,인천,강화군,0,0,0,0,0,0,2019-07-04
361,인천,강화군,0,0,0,0,0,0,2019-08-04
362,인천,강화군,0,0,0,0,0,0,2019-09-04
363,인천,강화군,2,0,0,2,1,0,2019-10-04
364,인천,강화군,2,0,0,2,2,0,2019-11-04
365,인천,강화군,1,0,0,1,1,0,2019-12-04
366,인천,계양구,2,0,1,3,2,0,2019-01-04
367,인천,계양구,3,0,0,3,3,0,2019-02-04
368,인천,계양구,0,0,1,1,1,0,2019-03-04
369,인천,계양구,3,0,4,7,4,0,2019-04-04
370,인천,계양구,1,0,1,2,2,0,2019-05-04
371,인천,계양구,4,1,1,6,5,0,2019-06-04
372,인천,계양구,1,0,0,1,1,0,2019-07-04
373,인천,계양구,0,0,0,0,0,0,2019-08-04
374,인천,계양구,2,0,0,2,2,0,2019-09-04
375,인천,계양구,0,0,0,0,0,0,2019-10-04
376,인천,계양구,0,0,1,1,1,0,2019-11-04
377,인천,계양구,3,0,0,3,2,0,2019-12-04
378,인천,남동구,7,1,2,10,9,0,2019-01-04
379,인천,남동구,3,0,1,4,4,0,2019-02-04
380,인천,남동구,2,0,2,4,4,0,2019-03-04
381,인천,남동구,2,0,2,4,3,0,2019-04-04
382,인천,남동구,7,0,3,10,6,0,2019-05-04
383,인천,남동구,1,0,3,4,4,0,2019-06-04
384,인천,남동구,7,0,2,9,8,0,2019-07-04
385,인천,남동구,10,0,1,11,3,0,2019-08-04
386,인천,남동구,5,2,1,8,6,0,2019-09-04
387,인천,남동구,5,0,2,7,5,0,2019-10-04
388,인천,남동구,6,0,4,10,8,0,2019-11-04
389,인천,남동구,3,1,1,5,4,0,2019-12-04
390,인천,동구,0,0,1,1,1,0,2019-01-04
391,인천,동구,0,0,0,0,0,0,2019-02-04
392,인천,동구,0,0,0,0,0,0,2019-03-04
393,인천,동구,0,0,0,0,0,0,2019-04-04
394,인천,동구,0,0,0,0,0,0,2019-05-04
395,인천,동구,4,0,0,4,1,0,2019-06-04
396,인천,동구,0,0,0,0,0,0,2019-07-04
397,인천,동구,0,0,0,0,0,0,2019-08-04
398,인천,동구,2,0,0,2,1,0,2019-09-04
399,인천,동구,0,0,1,1,1,0,2019-10-04
400,인천,동구,0,0,0,0,0,0,2019-11-04
401,인천,동구,0,0,0,0,0,0,2019-12-04
402,인천,미추홀구,2,0,0,2,2,0,2019-01-04
403,인천,미추홀구,0,0,1,1,1,0,2019-02-04
404,인천,미추홀구,1,0,0,1,1,0,2019-03-04
405,인천,미추홀구,2,1,3,6,5,0,2019-04-04
406,인천,미추홀구,5,2,1,8,7,0,2019-05-04
407,인천,미추홀구,2,1,1,4,3,0,2019-06-04
408,인천,미추홀구,2,0,1,3,3,0,2019-07-04
409,인천,미추홀구,4,1,0,5,4,1,2019-08-04
410,인천,미추홀구,5,0,6,11,4,0,2019-09-04
411,인천,미추홀구,4,0,3,7,6,0,2019-10-04
412,인천,미추홀구,3,0,1,4,4,0,2019-11-04
413,인천,미추홀구,2,1,2,5,5,0,2019-12-04
414,인천,부평구,3,0,2,5,4,0,2019-01-04
415,인천,부평구,0,0,0,0,0,0,2019-02-04
416,인천,부평구,5,0,0,5,4,0,2019-03-04
417,인천,부평구,4,1,0,5,3,1,2019-04-04
418,인천,부평구,4,0,1,5,5,0,2019-05-04
419,인천,부평구,2,0,0,2,2,0,2019-06-04
420,인천,부평구,5,0,1,6,3,0,2019-07-04
421,인천,부평구,2,0,2,4,1,0,2019-08-04
422,인천,부평구,2,0,0,2,1,0,2019-09-04
423,인천,부평구,2,0,1,3,3,0,2019-10-04
424,인천,부평구,5,0,0,5,4,0,2019-11-04
425,인천,부평구,11,0,1,12,7,0,2019-12-04
426,인천,서구,3,0,0,3,3,0,2019-01-04
427,인천,서구,0,0,0,0,0,0,2019-02-04
428,인천,서구,4,0,2,6,5,0,2019-03-04
429,인천,서구,7,0,2,9,5,0,2019-04-04
430,인천,서구,3,0,3,6,4,1,2019-05-04
431,인천,서구,4,0,3,7,7,0,2019-06-04
432,인천,서구,6,0,5,11,10,0,2019-07-04
433,인천,서구,1,0,1,2,2,0,2019-08-04
434,인천,서구,6,0,0,6,6,0,2019-09-04
435,인천,서구,6,0,3,9,8,0,2019-10-04
436,인천,서구,6,0,2,8,5,0,2019-11-04
437,인천,서구,11,0,1,12,9,0,2019-12-04
438,인천,연수구,3,0,0,3,2,0,2019-01-04
439,인천,연수구,1,0,0,1,1,0,2019-02-04
440,인천,연수구,3,0,0,3,1,0,2019-03-04
441,인천,연수구,0,0,1,1,1,0,2019-04-04
442,인천,연수구,1,0,0,1,1,0,2019-05-04
443,인천,연수구,2,0,1,3,2,0,2019-06-04
444,인천,연수구,2,0,0,2,2,0,2019-07-04
445,인천,연수구,5,0,0,5,4,0,2019-08-04
446,인천,연수구,3,0,1,4,4,0,2019-09-04
447,인천,연수구,0,0,1,1,1,0,2019-10-04
448,인천,연수구,7,0,0,7,3,0,2019-11-04
449,인천,연수구,0,0,0,0,0,0,2019-12-04
450,인천,옹진군,0,0,0,0,0,0,2019-01-04
451,인천,옹진군,0,0,0,0,0,0,2019-02-04
452,인천,옹진군,0,1,0,1,1,0,2019-03-04
453,인천,옹진군,0,0,0,0,0,0,2019-04-04
454,인천,옹진군,0,0,0,0,0,0,2019-05-04
455,인천,옹진군,0,0,0,0,0,0,2019-07-04
456,인천,옹진군,0,0,0,0,0,0,2019-08-04
457,인천,옹진군,0,0,0,0,0,0,2019-09-04
458,인천,옹진군,0,0,0,0,0,0,2019-10-04
459,인천,옹진군,0,0,0,0,0,0,2019-12-04
460,인천,중구,1,0,1,2,2,0,2019-01-04
461,인천,중구,5,0,1,6,3,0,2019-02-04
462,인천,중구,4,1,0,5,2,0,2019-03-04
463,인천,중구,0,0,0,0,0,0,2019-04-04
464,인천,중구,1,0,0,1,1,0,2019-05-04
465,인천,중구,0,0,0,0,0,0,2019-06-04
466,인천,중구,1,0,1,2,2,0,2019-07-04
467,인천,중구,2,7,0,9,2,0,2019-08-04
468,인천,중구,0,0,0,0,0,0,2019-09-04
469,인천,중구,0,0,1,1,1,0,2019-10-04
470,인천,중구,5,0,1,6,3,0,2019-11-04
471,인천,중구,2,0,0,2,1,0,2019-12-04
472,인천,강화군,0,0,0,0,0,0,2019-01-05
473,인천,강화군,0,0,0,0,0,0,2019-02-05
474,인천,강화군,0,0,0,0,0,0,2019-03-05
475,인천,강화군,1,0,0,1,1,0,2019-04-05
476,인천,강화군,3,0,0,3,2,0,2019-05-05
477,인천,강화군,0,0,0,0,0,0,2019-06-05
478,인천,강화군,0,0,0,0,0,0,2019-07-05
479,인천,강화군,2,0,0,2,2,0,2019-08-05
480,인천,강화군,1,0,0,1,1,0,2019-09-05
481,인천,강화군,0,0,0,0,0,0,2019-10-05
482,인천,강화군,0,0,0,0,0,0,2019-11-05
483,인천,강화군,0,0,0,0,0,0,2019-12-05
484,인천,계양구,1,0,2,3,3,0,2019-01-05
485,인천,계양구,0,0,0,0,0,0,2019-02-05
486,인천,계양구,0,0,0,0,0,0,2019-03-05
487,인천,계양구,2,1,0,3,3,0,2019-04-05
488,인천,계양구,2,0,2,4,4,0,2019-05-05
489,인천,계양구,1,0,0,1,1,0,2019-06-05
490,인천,계양구,5,0,0,5,3,0,2019-07-05
491,인천,계양구,2,0,2,4,3,0,2019-08-05
492,인천,계양구,0,0,0,0,0,0,2019-09-05
493,인천,계양구,7,0,2,9,5,0,2019-10-05
494,인천,계양구,1,0,0,1,1,0,2019-11-05
495,인천,계양구,3,0,1,4,4,0,2019-12-05
496,인천,남동구,2,0,4,6,4,0,2019-01-05
497,인천,남동구,11,1,0,12,5,0,2019-02-05
498,인천,남동구,5,0,0,5,4,0,2019-03-05
499,인천,남동구,3,0,4,7,6,0,2019-04-05
500,인천,남동구,2,0,4,6,5,0,2019-05-05
501,인천,남동구,3,0,1,4,4,0,2019-06-05
502,인천,남동구,3,0,0,3,3,0,2019-07-05
503,인천,남동구,3,0,0,3,3,0,2019-08-05
504,인천,남동구,9,0,1,10,9,0,2019-09-05
505,인천,남동구,3,1,0,4,3,0,2019-10-05
506,인천,남동구,10,0,3,13,8,0,2019-11-05
507,인천,남동구,6,0,2,8,6,0,2019-12-05
508,인천,동구,1,0,0,1,1,0,2019-01-05
509,인천,동구,0,0,0,0,0,0,2019-02-05
510,인천,동구,0,0,0,0,0,0,2019-03-05
511,인천,동구,0,0,0,0,0,0,2019-04-05
512,인천,동구,0,0,0,0,0,0,2019-05-05
513,인천,동구,0,0,0,0,0,0,2019-06-05
514,인천,동구,0,0,0,0,0,0,2019-07-05
515,인천,동구,0,0,0,0,0,0,2019-08-05
516,인천,동구,0,0,0,0,0,0,2019-09-05
517,인천,동구,0,0,0,0,0,0,2019-10-05
518,인천,동구,0,0,0,0,0,0,2019-11-05
519,인천,동구,0,0,0,0,0,0,2019-12-05
520,인천,미추홀구,5,0,1,6,5,0,2019-01-05
521,인천,미추홀구,1,0,0,1,1,0,2019-02-05
522,인천,미추홀구,5,0,0,5,4,0,2019-03-05
523,인천,미추홀구,4,0,1,5,4,0,2019-04-05
524,인천,미추홀구,0,0,1,1,1,0,2019-05-05
525,인천,미추홀구,6,0,0,6,3,0,2019-06-05
526,인천,미추홀구,7,0,0,7,3,0,2019-07-05
527,인천,미추홀구,1,0,2,3,4,1,2019-08-05
528,인천,미추홀구,12,2,0,14,12,1,2019-09-05
529,인천,미추홀구,0,0,0,0,0,0,2019-10-05
530,인천,미추홀구,6,0,1,7,3,0,2019-11-05
531,인천,미추홀구,3,1,1,5,4,0,2019-12-05
532,인천,부평구,3,0,1,4,3,0,2019-01-05
533,인천,부평구,2,0,0,2,2,0,2019-02-05
534,인천,부평구,2,0,1,3,3,0,2019-03-05
535,인천,부평구,2,0,2,4,2,0,2019-04-05
536,인천,부평구,1,0,0,1,1,0,2019-05-05
537,인천,부평구,3,0,0,3,3,0,2019-06-05
538,인천,부평구,4,0,0,4,3,0,2019-07-05
539,인천,부평구,3,0,0,3,3,0,2019-08-05
540,인천,부평구,3,0,0,3,3,0,2019-09-05
541,인천,부평구,4,0,0,4,3,0,2019-10-05
542,인천,부평구,5,0,0,5,4,0,2019-11-05
543,인천,부평구,6,0,2,8,7,1,2019-12-05
544,인천,서구,0,0,0,0,0,0,2019-01-05
545,인천,서구,0,0,1,1,1,0,2019-02-05
546,인천,서구,0,0,0,0,0,0,2019-03-05
547,인천,서구,5,1,4,10,7,0,2019-04-05
548,인천,서구,0,0,1,1,1,0,2019-05-05
549,인천,서구,3,0,3,6,4,0,2019-06-05
550,인천,서구,4,0,0,4,3,0,2019-07-05
551,인천,서구,4,0,0,4,2,0,2019-08-05
552,인천,서구,9,0,4,13,7,0,2019-09-05
553,인천,서구,12,2,1,15,8,0,2019-10-05
554,인천,서구,10,0,2,12,8,1,2019-11-05
555,인천,서구,3,0,4,7,6,0,2019-12-05
556,인천,연수구,3,0,0,3,2,0,2019-01-05
557,인천,연수구,0,0,0,0,0,0,2019-02-05
558,인천,연수구,0,0,0,0,0,0,2019-03-05
559,인천,연수구,0,0,1,1,1,0,2019-04-05
560,인천,연수구,4,1,0,5,3,0,2019-05-05
561,인천,연수구,3,0,0,3,2,0,2019-06-05
562,인천,연수구,5,0,0,5,4,0,2019-07-05
563,인천,연수구,2,0,0,2,2,0,2019-08-05
564,인천,연수구,6,0,1,7,3,0,2019-09-05
565,인천,연수구,3,0,0,3,2,0,2019-10-05
566,인천,연수구,0,0,0,0,0,0,2019-11-05
567,인천,연수구,2,1,1,4,3,1,2019-12-05
568,인천,옹진군,0,0,0,0,0,0,2019-01-05
569,인천,옹진군,0,0,0,0,0,0,2019-02-05
570,인천,옹진군,0,0,0,0,0,0,2019-03-05
571,인천,옹진군,0,0,0,0,0,0,2019-04-05
572,인천,옹진군,0,0,0,0,0,0,2019-05-05
573,인천,옹진군,0,0,0,0,0,0,2019-07-05
574,인천,옹진군,0,0,0,0,0,0,2019-08-05
575,인천,옹진군,0,0,0,0,0,0,2019-09-05
576,인천,옹진군,0,0,0,0,0,0,2019-10-05
577,인천,옹진군,0,0,0,0,0,0,2019-12-05
578,인천,중구,2,0,1,3,3,0,2019-01-05
579,인천,중구,2,0,0,2,1,0,2019-02-05
580,인천,중구,2,0,0,2,2,0,2019-03-05
581,인천,중구,0,0,0,0,0,0,2019-04-05
582,인천,중구,2,0,0,2,2,0,2019-05-05
583,인천,중구,6,0,0,6,1,0,2019-06-05
584,인천,중구,5,0,1,6,3,0,2019-07-05
585,인천,중구,1,0,0,1,1,0,2019-08-05
586,인천,중구,3,0,1,4,2,0,2019-09-05
587,인천,중구,3,0,0,3,3,0,2019-10-05
588,인천,중구,3,1,5,9,4,0,2019-11-05
589,인천,중구,1,0,0,1,1,0,2019-12-05
590,인천,강화군,3,0,2,5,1,0,2019-01-06
591,인천,강화군,0,0,0,0,0,0,2019-02-06
592,인천,강화군,0,0,0,0,0,0,2019-03-06
593,인천,강화군,0,0,0,0,0,0,2019-04-06
594,인천,강화군,1,0,0,1,1,0,2019-05-06
595,인천,강화군,2,0,0,2,1,0,2019-06-06
596,인천,강화군,1,0,0,1,1,0,2019-07-06
597,인천,강화군,0,0,1,1,1,0,2019-08-06
598,인천,강화군,1,0,1,2,2,0,2019-09-06
599,인천,강화군,2,0,0,2,2,0,2019-10-06
600,인천,강화군,0,0,0,0,0,0,2019-11-06
601,인천,강화군,0,0,1,1,1,0,2019-12-06
602,인천,계양구,0,0,0,0,0,0,2019-01-06
603,인천,계양구,8,0,0,8,3,0,2019-02-06
604,인천,계양구,1,0,0,1,1,0,2019-03-06
605,인천,계양구,0,0,0,0,0,0,2019-04-06
606,인천,계양구,3,0,3,6,4,0,2019-05-06
607,인천,계양구,4,1,0,5,4,0,2019-06-06
608,인천,계양구,3,1,0,4,2,0,2019-07-06
609,인천,계양구,1,0,0,1,1,0,2019-08-06
610,인천,계양구,3,0,1,4,3,0,2019-09-06
611,인천,계양구,0,0,0,0,0,0,2019-10-06
612,인천,계양구,6,0,3,9,6,0,2019-11-06
613,인천,계양구,1,0,1,2,2,0,2019-12-06
614,인천,남동구,3,0,1,4,3,1,2019-01-06
615,인천,남동구,0,0,1,1,1,0,2019-02-06
616,인천,남동구,8,0,3,11,7,0,2019-03-06
617,인천,남동구,9,0,1,10,8,0,2019-04-06
618,인천,남동구,10,0,1,11,6,0,2019-05-06
619,인천,남동구,4,0,0,4,3,0,2019-06-06
620,인천,남동구,11,0,5,16,8,0,2019-07-06
621,인천,남동구,3,1,1,5,5,0,2019-08-06
622,인천,남동구,4,1,3,8,6,0,2019-09-06
623,인천,남동구,7,0,2,9,7,0,2019-10-06
624,인천,남동구,5,0,1,6,4,0,2019-11-06
625,인천,남동구,11,0,0,11,8,0,2019-12-06
626,인천,동구,0,0,0,0,0,0,2019-01-06
627,인천,동구,0,0,0,0,0,0,2019-02-06
628,인천,동구,0,0,0,0,0,0,2019-03-06
629,인천,동구,0,0,0,0,0,0,2019-04-06
630,인천,동구,0,0,0,0,0,0,2019-05-06
631,인천,동구,0,0,0,0,0,0,2019-06-06
632,인천,동구,0,0,0,0,0,0,2019-07-06
633,인천,동구,1,0,1,2,1,0,2019-08-06
634,인천,동구,0,0,0,0,0,0,2019-09-06
635,인천,동구,4,0,0,4,2,0,2019-10-06
636,인천,동구,1,0,1,2,1,0,2019-11-06
637,인천,동구,0,0,0,0,0,0,2019-12-06
638,인천,미추홀구,3,0,0,3,2,0,2019-01-06
639,인천,미추홀구,1,0,1,2,2,0,2019-02-06
640,인천,미추홀구,4,1,1,6,5,0,2019-03-06
641,인천,미추홀구,3,0,1,4,3,0,2019-04-06
642,인천,미추홀구,6,0,0,6,2,0,2019-05-06
643,인천,미추홀구,4,0,0,4,2,0,2019-06-06
644,인천,미추홀구,3,1,1,5,4,0,2019-07-06
645,인천,미추홀구,8,0,3,11,9,0,2019-08-06
646,인천,미추홀구,2,0,4,6,5,0,2019-09-06
647,인천,미추홀구,3,0,2,5,4,0,2019-10-06
648,인천,미추홀구,5,1,2,8,5,0,2019-11-06
649,인천,미추홀구,4,2,1,7,6,0,2019-12-06
650,인천,부평구,5,0,0,5,3,0,2019-01-06
651,인천,부평구,0,0,0,0,0,0,2019-02-06
652,인천,부평구,0,0,1,1,1,0,2019-03-06
653,인천,부평구,6,0,0,6,4,0,2019-04-06
654,인천,부평구,1,0,0,1,1,0,2019-05-06
655,인천,부평구,4,0,3,7,6,0,2019-06-06
656,인천,부평구,1,0,3,4,3,0,2019-07-06
657,인천,부평구,1,1,0,2,2,0,2019-08-06
658,인천,부평구,7,0,0,7,4,0,2019-09-06
659,인천,부평구,7,2,1,10,3,0,2019-10-06
660,인천,부평구,7,0,1,8,6,0,2019-11-06
661,인천,부평구,3,0,1,4,4,0,2019-12-06
662,인천,서구,1,0,2,3,2,0,2019-01-06
663,인천,서구,1,0,0,1,1,0,2019-02-06
664,인천,서구,4,0,1,5,6,1,2019-03-06
665,인천,서구,5,0,2,7,5,0,2019-04-06
666,인천,서구,2,0,1,3,3,0,2019-05-06
667,인천,서구,1,0,1,2,2,0,2019-06-06
668,인천,서구,14,0,5,19,6,0,2019-07-06
669,인천,서구,4,0,3,7,5,0,2019-08-06
670,인천,서구,9,0,0,9,6,1,2019-09-06
671,인천,서구,7,0,1,8,5,0,2019-10-06
672,인천,서구,5,0,0,5,3,0,2019-11-06
673,인천,서구,6,0,1,7,6,0,2019-12-06
674,인천,연수구,0,0,0,0,1,1,2019-01-06
675,인천,연수구,2,0,0,2,1,0,2019-02-06
676,인천,연수구,0,0,1,1,1,0,2019-03-06
677,인천,연수구,8,0,1,9,5,0,2019-04-06
678,인천,연수구,1,0,1,2,2,0,2019-05-06
679,인천,연수구,1,0,1,2,2,0,2019-06-06
680,인천,연수구,2,0,0,2,2,0,2019-07-06
681,인천,연수구,6,0,2,8,4,0,2019-08-06
682,인천,연수구,3,0,1,4,3,0,2019-09-06
683,인천,연수구,3,0,2,5,2,0,2019-10-06
684,인천,연수구,1,0,1,2,2,0,2019-11-06
685,인천,연수구,2,0,0,2,2,0,2019-12-06
686,인천,옹진군,0,0,0,0,0,0,2019-01-06
687,인천,옹진군,0,0,0,0,0,0,2019-02-06
688,인천,옹진군,0,0,0,0,1,1,2019-03-06
689,인천,옹진군,0,0,0,0,0,0,2019-04-06
690,인천,옹진군,0,0,0,0,0,0,2019-05-06
691,인천,옹진군,0,0,0,0,0,0,2019-07-06
692,인천,옹진군,1,2,1,4,1,0,2019-08-06
693,인천,옹진군,0,0,0,0,0,0,2019-09-06
694,인천,옹진군,0,0,0,0,0,0,2019-10-06
695,인천,옹진군,0,0,0,0,0,0,2019-12-06
696,인천,중구,0,0,0,0,0,0,2019-01-06
697,인천,중구,2,0,2,4,3,0,2019-02-06
698,인천,중구,0,0,0,0,0,0,2019-03-06
699,인천,중구,1,0,0,1,1,0,2019-04-06
700,인천,중구,1,0,0,1,1,0,2019-05-06
701,인천,중구,9,3,0,12,4,0,2019-06-06
702,인천,중구,5,0,0,5,2,0,2019-07-06
703,인천,중구,0,0,0,0,0,0,2019-08-06
704,인천,중구,0,0,0,0,0,0,2019-09-06
705,인천,중구,0,0,0,0,0,0,2019-10-06
706,인천,중구,0,0,1,1,1,0,2019-11-06
707,인천,중구,4,0,0,4,1,0,2019-12-06
708,인천,강화군,0,0,1,1,1,0,2019-01-07
709,인천,강화군,0,0,0,0,0,0,2019-02-07
710,인천,강화군,0,0,0,0,0,0,2019-03-07
711,인천,강화군,0,0,0,0,0,0,2019-04-07
712,인천,강화군,0,0,0,0,1,1,2019-05-07
713,인천,강화군,0,0,1,1,1,0,2019-06-07
714,인천,강화군,0,0,0,0,0,0,2019-07-07
715,인천,강화군,0,0,0,0,0,0,2019-08-07
716,인천,강화군,0,0,0,0,0,0,2019-09-07
717,인천,강화군,2,0,0,2,1,0,2019-10-07
718,인천,강화군,2,0,0,2,2,0,2019-11-07
719,인천,강화군,0,0,0,0,0,0,2019-12-07
720,인천,계양구,1,0,0,1,1,0,2019-01-07
721,인천,계양구,1,0,1,2,2,0,2019-02-07
722,인천,계양구,1,0,2,3,3,0,2019-03-07
723,인천,계양구,2,0,1,3,1,0,2019-04-07
724,인천,계양구,3,0,1,4,3,1,2019-05-07
725,인천,계양구,7,1,0,8,4,0,2019-06-07
726,인천,계양구,2,0,0,2,2,0,2019-07-07
727,인천,계양구,4,0,0,4,4,0,2019-08-07
728,인천,계양구,1,0,1,2,2,0,2019-09-07
729,인천,계양구,4,0,0,4,3,0,2019-10-07
730,인천,계양구,5,0,2,7,6,0,2019-11-07
731,인천,계양구,0,0,1,1,1,0,2019-12-07
732,인천,남동구,2,2,1,5,5,0,2019-01-07
733,인천,남동구,14,0,4,18,10,0,2019-02-07
734,인천,남동구,11,0,2,13,6,0,2019-03-07
735,인천,남동구,2,0,1,3,3,0,2019-04-07
736,인천,남동구,5,1,0,6,4,0,2019-05-07
737,인천,남동구,7,0,2,9,7,0,2019-06-07
738,인천,남동구,13,0,1,14,4,0,2019-07-07
739,인천,남동구,6,0,1,7,5,1,2019-08-07
740,인천,남동구,1,1,0,2,2,0,2019-09-07
741,인천,남동구,5,0,0,5,5,0,2019-10-07
742,인천,남동구,8,0,3,11,9,0,2019-11-07
743,인천,남동구,6,1,0,7,5,0,2019-12-07
744,인천,동구,0,0,0,0,0,0,2019-01-07
745,인천,동구,1,0,0,1,1,0,2019-02-07
746,인천,동구,2,0,1,3,2,0,2019-03-07
747,인천,동구,0,0,0,0,0,0,2019-04-07
748,인천,동구,0,0,0,0,0,0,2019-05-07
749,인천,동구,0,0,1,1,1,0,2019-06-07
750,인천,동구,0,0,0,0,0,0,2019-07-07
751,인천,동구,0,0,0,0,0,0,2019-08-07
752,인천,동구,0,0,0,0,0,0,2019-09-07
753,인천,동구,1,0,0,1,1,0,2019-10-07
754,인천,동구,0,0,0,0,0,0,2019-11-07
755,인천,동구,1,0,0,1,1,0,2019-12-07
756,인천,미추홀구,3,0,0,3,3,0,2019-01-07
757,인천,미추홀구,3,0,1,4,3,0,2019-02-07
758,인천,미추홀구,1,0,0,1,1,0,2019-03-07
759,인천,미추홀구,10,1,5,16,9,0,2019-04-07
760,인천,미추홀구,2,1,0,3,3,0,2019-05-07
761,인천,미추홀구,2,1,1,4,3,0,2019-06-07
762,인천,미추홀구,10,0,0,10,4,0,2019-07-07
763,인천,미추홀구,1,2,1,4,3,0,2019-08-07
764,인천,미추홀구,2,0,0,2,2,0,2019-09-07
765,인천,미추홀구,9,0,2,11,6,0,2019-10-07
766,인천,미추홀구,2,0,1,3,3,0,2019-11-07
767,인천,미추홀구,1,0,0,1,1,0,2019-12-07
768,인천,부평구,2,0,0,2,1,0,2019-01-07
769,인천,부평구,0,0,1,1,1,0,2019-02-07
770,인천,부평구,0,0,2,2,1,0,2019-03-07
771,인천,부평구,9,0,4,13,7,0,2019-04-07
772,인천,부평구,4,0,3,7,4,0,2019-05-07
773,인천,부평구,1,0,0,1,1,0,2019-06-07
774,인천,부평구,1,0,0,1,1,0,2019-07-07
775,인천,부평구,3,0,0,3,3,0,2019-08-07
776,인천,부평구,5,0,1,6,5,0,2019-09-07
777,인천,부평구,7,0,3,10,7,0,2019-10-07
778,인천,부평구,8,0,2,10,8,0,2019-11-07
779,인천,부평구,7,0,0,7,7,0,2019-12-07
780,인천,서구,3,0,1,4,4,0,2019-01-07
781,인천,서구,5,0,2,7,5,0,2019-02-07
782,인천,서구,6,0,0,6,5,0,2019-03-07
783,인천,서구,1,0,5,6,4,0,2019-04-07
784,인천,서구,6,0,2,8,5,0,2019-05-07
785,인천,서구,1,0,2,3,3,0,2019-06-07
786,인천,서구,0,0,1,1,1,0,2019-07-07
787,인천,서구,10,0,1,11,5,0,2019-08-07
788,인천,서구,6,0,0,6,4,0,2019-09-07
789,인천,서구,7,0,3,10,9,0,2019-10-07
790,인천,서구,9,0,2,11,9,0,2019-11-07
791,인천,서구,16,0,0,16,9,0,2019-12-07
792,인천,연수구,0,0,0,0,0,0,2019-01-07
793,인천,연수구,0,0,0,0,0,0,2019-02-07
794,인천,연수구,1,0,0,1,1,0,2019-03-07
795,인천,연수구,4,0,0,4,2,0,2019-04-07
796,인천,연수구,1,0,0,1,1,0,2019-05-07
797,인천,연수구,3,0,1,4,2,0,2019-06-07
798,인천,연수구,0,0,0,0,0,0,2019-07-07
799,인천,연수구,2,0,2,4,3,0,2019-08-07
800,인천,연수구,4,0,0,4,2,0,2019-09-07
801,인천,연수구,0,0,0,0,0,0,2019-10-07
802,인천,연수구,3,0,0,3,3,0,2019-11-07
803,인천,연수구,3,0,1,4,3,0,2019-12-07
804,인천,옹진군,0,0,0,0,0,0,2019-01-07
805,인천,옹진군,0,0,0,0,0,0,2019-02-07
806,인천,옹진군,0,0,0,0,0,0,2019-03-07
807,인천,옹진군,0,0,0,0,0,0,2019-04-07
808,인천,옹진군,0,0,0,0,0,0,2019-05-07
809,인천,옹진군,0,0,0,0,0,0,2019-07-07
810,인천,옹진군,0,0,0,0,0,0,2019-08-07
811,인천,옹진군,0,0,0,0,0,0,2019-09-07
812,인천,옹진군,0,0,0,0,0,0,2019-10-07
813,인천,옹진군,0,0,0,0,0,0,2019-12-07
814,인천,중구,7,0,0,7,4,0,2019-01-07
815,인천,중구,0,0,0,0,0,0,2019-02-07
816,인천,중구,1,0,0,1,1,0,2019-03-07
817,인천,중구,2,0,1,3,1,0,2019-04-07
818,인천,중구,7,0,1,8,5,0,2019-05-07
819,인천,중구,0,0,0,0,0,0,2019-06-07
820,인천,중구,2,0,0,2,2,0,2019-07-07
821,인천,중구,0,0,0,0,0,0,2019-08-07
822,인천,중구,1,0,1,2,1,0,2019-09-07
823,인천,중구,4,0,0,4,2,0,2019-10-07
824,인천,중구,5,0,2,7,4,0,2019-11-07
825,인천,중구,4,0,0,4,3,0,2019-12-07
826,인천,강화군,0,0,0,0,0,0,2019-01-08
827,인천,강화군,0,0,1,1,1,0,2019-02-08
828,인천,강화군,3,0,1,4,2,0,2019-03-08
829,인천,강화군,0,0,0,0,0,0,2019-04-08
830,인천,강화군,2,0,0,2,1,0,2019-05-08
831,인천,강화군,0,0,0,0,0,0,2019-06-08
832,인천,강화군,0,0,0,0,0,0,2019-07-08
833,인천,강화군,0,0,0,0,0,0,2019-08-08
834,인천,강화군,0,0,0,0,0,0,2019-09-08
835,인천,강화군,1,0,0,1,1,0,2019-10-08
836,인천,강화군,0,0,0,0,0,0,2019-11-08
837,인천,강화군,0,0,0,0,0,0,2019-12-08
838,인천,계양구,7,0,0,7,6,0,2019-01-08
839,인천,계양구,3,0,0,3,3,0,2019-02-08
840,인천,계양구,0,0,0,0,0,0,2019-03-08
841,인천,계양구,2,0,2,4,4,0,2019-04-08
842,인천,계양구,4,0,2,6,3,0,2019-05-08
843,인천,계양구,5,0,0,5,4,0,2019-06-08
844,인천,계양구,0,1,0,1,1,0,2019-07-08
845,인천,계양구,2,0,0,2,1,0,2019-08-08
846,인천,계양구,2,0,1,3,2,0,2019-09-08
847,인천,계양구,2,0,1,3,2,0,2019-10-08
848,인천,계양구,4,1,4,9,8,0,2019-11-08
849,인천,계양구,0,0,0,0,0,0,2019-12-08
850,인천,남동구,3,0,0,3,3,0,2019-01-08
851,인천,남동구,2,0,0,2,2,0,2019-02-08
852,인천,남동구,8,2,2,12,10,0,2019-03-08
853,인천,남동구,4,0,1,5,3,0,2019-04-08
854,인천,남동구,1,0,5,6,4,0,2019-05-08
855,인천,남동구,4,0,2,6,6,0,2019-06-08
856,인천,남동구,1,1,0,2,2,0,2019-07-08
857,인천,남동구,3,0,0,3,3,0,2019-08-08
858,인천,남동구,9,0,2,11,8,0,2019-09-08
859,인천,남동구,1,0,2,3,3,0,2019-10-08
860,인천,남동구,6,0,0,6,5,0,2019-11-08
861,인천,남동구,3,0,0,3,2,0,2019-12-08
862,인천,동구,1,0,0,1,1,0,2019-01-08
863,인천,동구,0,0,1,1,1,0,2019-02-08
864,인천,동구,0,0,0,0,0,0,2019-03-08
865,인천,동구,1,0,0,1,1,0,2019-04-08
866,인천,동구,0,0,0,0,0,0,2019-05-08
867,인천,동구,0,0,0,0,0,0,2019-06-08
868,인천,동구,0,0,0,0,0,0,2019-07-08
869,인천,동구,0,0,0,0,0,0,2019-08-08
870,인천,동구,0,0,0,0,0,0,2019-09-08
871,인천,동구,1,0,1,2,2,0,2019-10-08
872,인천,동구,0,0,1,1,1,0,2019-11-08
873,인천,동구,0,0,0,0,0,0,2019-12-08
874,인천,미추홀구,4,0,0,4,2,0,2019-01-08
875,인천,미추홀구,0,0,0,0,1,1,2019-02-08
876,인천,미추홀구,3,1,1,5,3,0,2019-03-08
877,인천,미추홀구,2,0,0,2,1,0,2019-04-08
878,인천,미추홀구,3,0,0,3,3,0,2019-05-08
879,인천,미추홀구,1,0,0,1,1,0,2019-06-08
880,인천,미추홀구,1,0,0,1,1,0,2019-07-08
881,인천,미추홀구,2,0,0,2,2,0,2019-08-08
882,인천,미추홀구,0,0,0,0,0,0,2019-09-08
883,인천,미추홀구,2,3,2,7,7,0,2019-10-08
884,인천,미추홀구,8,0,0,8,6,0,2019-11-08
885,인천,미추홀구,3,2,1,6,6,0,2019-12-08
886,인천,부평구,5,0,2,7,6,1,2019-01-08
887,인천,부평구,3,0,0,3,3,0,2019-02-08
888,인천,부평구,4,0,0,4,4,0,2019-03-08
889,인천,부평구,10,0,1,11,7,1,2019-04-08
890,인천,부평구,1,0,2,3,2,0,2019-05-08
891,인천,부평구,3,0,1,4,3,0,2019-06-08
892,인천,부평구,1,0,1,2,2,0,2019-07-08
893,인천,부평구,6,0,0,6,4,0,2019-08-08
894,인천,부평구,1,0,0,1,1,0,2019-09-08
895,인천,부평구,5,0,1,6,5,0,2019-10-08
896,인천,부평구,4,0,0,4,2,0,2019-11-08
897,인천,부평구,7,0,1,8,5,0,2019-12-08
898,인천,서구,0,0,0,0,0,0,2019-01-08
899,인천,서구,3,0,1,4,4,0,2019-02-08
900,인천,서구,4,0,4,8,7,0,2019-03-08
901,인천,서구,5,1,1,7,6,0,2019-04-08
902,인천,서구,6,0,2,8,6,0,2019-05-08
903,인천,서구,6,0,1,7,6,1,2019-06-08
904,인천,서구,13,0,3,16,9,1,2019-07-08
905,인천,서구,10,0,3,13,8,0,2019-08-08
906,인천,서구,4,0,2,6,4,0,2019-09-08
907,인천,서구,13,0,2,15,11,0,2019-10-08
908,인천,서구,8,0,2,10,8,0,2019-11-08
909,인천,서구,9,0,0,9,5,0,2019-12-08
910,인천,연수구,1,0,0,1,1,0,2019-01-08
911,인천,연수구,3,0,2,5,3,0,2019-02-08
912,인천,연수구,5,0,0,5,3,0,2019-03-08
913,인천,연수구,1,0,0,1,1,0,2019-04-08
914,인천,연수구,2,0,0,2,2,0,2019-05-08
915,인천,연수구,2,0,0,2,2,0,2019-06-08
916,인천,연수구,3,0,1,4,3,0,2019-07-08
917,인천,연수구,4,0,1,5,3,0,2019-08-08
918,인천,연수구,0,0,1,1,1,0,2019-09-08
919,인천,연수구,0,0,0,0,0,0,2019-10-08
920,인천,연수구,7,0,0,7,5,0,2019-11-08
921,인천,연수구,1,0,0,1,1,0,2019-12-08
922,인천,옹진군,0,0,0,0,0,0,2019-01-08
923,인천,옹진군,0,1,0,1,1,0,2019-02-08
924,인천,옹진군,0,0,0,0,0,0,2019-03-08
925,인천,옹진군,0,0,1,1,1,0,2019-04-08
926,인천,옹진군,0,0,0,0,0,0,2019-05-08
927,인천,옹진군,0,0,0,0,0,0,2019-07-08
928,인천,옹진군,0,0,0,0,0,0,2019-08-08
929,인천,옹진군,0,0,0,0,0,0,2019-09-08
930,인천,옹진군,0,0,0,0,0,0,2019-10-08
931,인천,옹진군,0,0,0,0,0,0,2019-12-08
932,인천,중구,0,0,0,0,0,0,2019-01-08
933,인천,중구,0,0,0,0,0,0,2019-02-08
934,인천,중구,2,0,0,2,2,0,2019-03-08
935,인천,중구,4,0,2,6,3,0,2019-04-08
936,인천,중구,2,0,0,2,2,0,2019-05-08
937,인천,중구,4,0,1,5,3,0,2019-06-08
938,인천,중구,2,0,0,2,1,0,2019-07-08
939,인천,중구,3,0,0,3,1,0,2019-08-08
940,인천,중구,0,0,4,4,1,0,2019-09-08
941,인천,중구,2,0,0,2,1,0,2019-10-08
942,인천,중구,2,0,1,3,3,0,2019-11-08
943,인천,중구,2,0,1,3,2,0,2019-12-08
944,인천,강화군,1,0,0,1,1,0,2019-01-09
945,인천,강화군,0,0,0,0,0,0,2019-02-09
946,인천,강화군,2,0,1,3,2,0,2019-03-09
947,인천,강화군,1,0,0,1,1,0,2019-04-09
948,인천,강화군,0,0,2,2,1,0,2019-05-09
949,인천,강화군,0,0,0,0,0,0,2019-06-09
950,인천,강화군,0,0,0,0,0,0,2019-07-09
951,인천,강화군,0,0,0,0,0,0,2019-08-09
952,인천,강화군,1,0,2,3,1,0,2019-09-09
953,인천,강화군,0,0,1,1,1,0,2019-10-09
954,인천,강화군,1,0,0,1,1,0,2019-11-09
955,인천,강화군,1,0,0,1,1,0,2019-12-09
956,인천,계양구,2,0,0,2,1,0,2019-01-09
957,인천,계양구,0,0,0,0,0,0,2019-02-09
958,인천,계양구,3,2,4,9,4,0,2019-03-09
959,인천,계양구,2,1,1,4,4,0,2019-04-09
960,인천,계양구,2,1,1,4,4,0,2019-05-09
961,인천,계양구,0,0,0,0,0,0,2019-06-09
962,인천,계양구,4,0,3,7,7,0,2019-07-09
963,인천,계양구,3,0,0,3,2,0,2019-08-09
964,인천,계양구,1,0,1,2,2,0,2019-09-09
965,인천,계양구,4,0,1,5,4,0,2019-10-09
966,인천,계양구,7,0,2,9,4,0,2019-11-09
967,인천,계양구,2,0,0,2,2,0,2019-12-09
968,인천,남동구,2,0,3,5,5,0,2019-01-09
969,인천,남동구,5,1,2,8,6,1,2019-02-09
970,인천,남동구,8,0,1,9,8,0,2019-03-09
971,인천,남동구,9,0,3,12,6,0,2019-04-09
972,인천,남동구,10,0,0,10,9,0,2019-05-09
973,인천,남동구,6,0,0,6,3,0,2019-06-09
974,인천,남동구,4,1,2,7,7,0,2019-07-09
975,인천,남동구,8,0,4,12,7,1,2019-08-09
976,인천,남동구,6,0,0,6,6,0,2019-09-09
977,인천,남동구,6,0,1,7,4,0,2019-10-09
978,인천,남동구,9,0,1,10,8,0,2019-11-09
979,인천,남동구,5,0,1,6,6,0,2019-12-09
980,인천,동구,0,0,0,0,0,0,2019-01-09
981,인천,동구,0,0,0,0,0,0,2019-02-09
982,인천,동구,0,0,0,0,0,0,2019-03-09
983,인천,동구,0,0,0,0,0,0,2019-04-09
984,인천,동구,0,0,0,0,0,0,2019-05-09
985,인천,동구,0,0,0,0,0,0,2019-06-09
986,인천,동구,1,0,0,1,1,1,2019-07-09
987,인천,동구,1,0,0,1,1,0,2019-08-09
988,인천,동구,0,0,0,0,0,0,2019-09-09
989,인천,동구,0,0,0,0,0,0,2019-10-09
990,인천,동구,0,0,0,0,0,0,2019-11-09
991,인천,동구,0,0,0,0,0,0,2019-12-09
992,인천,미추홀구,3,0,0,3,3,0,2019-01-09
993,인천,미추홀구,1,0,1,2,2,0,2019-02-09
994,인천,미추홀구,7,1,0,8,4,0,2019-03-09
995,인천,미추홀구,2,0,0,2,3,1,2019-04-09
996,인천,미추홀구,4,0,0,4,4,0,2019-05-09
997,인천,미추홀구,7,0,1,8,4,0,2019-06-09
998,인천,미추홀구,5,0,0,5,3,0,2019-07-09
999,인천,미추홀구,10,0,4,14,6,0,2019-08-09
1000,인천,미추홀구,2,0,1,3,3,0,2019-09-09
1001,인천,미추홀구,1,1,0,2,2,0,2019-10-09
1002,인천,미추홀구,6,0,1,7,4,0,2019-11-09
1003,인천,미추홀구,2,0,4,6,5,0,2019-12-09
1004,인천,부평구,1,0,0,1,1,0,2019-01-09
1005,인천,부평구,3,0,2,5,4,0,2019-02-09
1006,인천,부평구,6,0,2,8,5,0,2019-03-09
1007,인천,부평구,7,0,0,7,4,0,2019-04-09
1008,인천,부평구,6,0,2,8,5,0,2019-05-09
1009,인천,부평구,5,0,1,6,2,0,2019-06-09
1010,인천,부평구,1,0,0,1,1,0,2019-07-09
1011,인천,부평구,1,1,2,4,5,1,2019-08-09
1012,인천,부평구,4,0,1,5,4,0,2019-09-09
1013,인천,부평구,10,0,0,10,3,0,2019-10-09
1014,인천,부평구,4,1,1,6,4,0,2019-11-09
1015,인천,부평구,3,0,1,4,2,0,2019-12-09
1016,인천,서구,6,0,0,6,6,0,2019-01-09
1017,인천,서구,4,0,0,4,3,0,2019-02-09
1018,인천,서구,1,0,0,1,1,0,2019-03-09
1019,인천,서구,8,0,2,10,7,0,2019-04-09
1020,인천,서구,9,1,3,13,10,0,2019-05-09
1021,인천,서구,5,0,0,5,3,0,2019-06-09
1022,인천,서구,3,0,0,3,3,0,2019-07-09
1023,인천,서구,5,0,0,5,3,0,2019-08-09
1024,인천,서구,3,1,1,5,4,0,2019-09-09
1025,인천,서구,12,0,5,17,12,0,2019-10-09
1026,인천,서구,7,0,3,10,7,0,2019-11-09
1027,인천,서구,9,0,1,10,9,0,2019-12-09
1028,인천,연수구,0,0,0,0,0,0,2019-01-09
1029,인천,연수구,2,0,0,2,2,0,2019-02-09
1030,인천,연수구,4,0,0,4,1,0,2019-03-09
1031,인천,연수구,2,0,0,2,2,0,2019-04-09
1032,인천,연수구,5,0,0,5,3,0,2019-05-09
1033,인천,연수구,0,0,0,0,0,0,2019-06-09
1034,인천,연수구,1,0,0,1,1,0,2019-07-09
1035,인천,연수구,0,0,2,2,2,0,2019-08-09
1036,인천,연수구,3,0,0,3,3,0,2019-09-09
1037,인천,연수구,5,0,0,5,4,0,2019-10-09
1038,인천,연수구,4,0,0,4,3,0,2019-11-09
1039,인천,연수구,2,0,0,2,2,0,2019-12-09
1040,인천,옹진군,0,0,0,0,0,0,2019-01-09
1041,인천,옹진군,0,0,0,0,0,0,2019-02-09
1042,인천,옹진군,0,0,0,0,0,0,2019-03-09
1043,인천,옹진군,0,0,0,0,0,0,2019-04-09
1044,인천,옹진군,0,0,0,0,0,0,2019-05-09
1045,인천,옹진군,0,0,0,0,0,0,2019-07-09
1046,인천,옹진군,2,0,1,3,1,0,2019-08-09
1047,인천,옹진군,0,0,0,0,0,0,2019-09-09
1048,인천,옹진군,0,0,0,0,0,0,2019-10-09
1049,인천,옹진군,0,0,0,0,0,0,2019-12-09
1050,인천,중구,1,0,0,1,1,0,2019-01-09
1051,인천,중구,2,0,0,2,1,0,2019-02-09
1052,인천,중구,1,0,0,1,1,0,2019-03-09
1053,인천,중구,0,0,0,0,0,0,2019-04-09
1054,인천,중구,0,0,1,1,1,0,2019-05-09
1055,인천,중구,0,0,0,0,0,0,2019-06-09
1056,인천,중구,0,0,0,0,0,0,2019-07-09
1057,인천,중구,2,0,0,2,2,0,2019-08-09
1058,인천,중구,2,0,1,3,3,0,2019-09-09
1059,인천,중구,0,0,0,0,0,0,2019-10-09
1060,인천,중구,2,0,1,3,3,0,2019-11-09
1061,인천,중구,4,0,2,6,3,0,2019-12-09
1062,인천,강화군,0,0,0,0,0,0,2019-01-10
1063,인천,강화군,0,0,0,0,0,0,2019-02-10
1064,인천,강화군,2,0,0,2,1,0,2019-03-10
1065,인천,강화군,0,0,0,0,0,0,2019-04-10
1066,인천,강화군,0,0,0,0,0,0,2019-05-10
1067,인천,강화군,0,0,0,0,0,0,2019-06-10
1068,인천,강화군,0,0,1,1,1,0,2019-07-10
1069,인천,강화군,0,0,0,0,0,0,2019-08-10
1070,인천,강화군,0,0,1,1,1,0,2019-09-10
1071,인천,강화군,0,0,0,0,0,0,2019-10-10
1072,인천,강화군,2,0,0,2,1,0,2019-11-10
1073,인천,강화군,1,0,0,1,1,0,2019-12-10
1074,인천,계양구,2,1,0,3,3,0,2019-01-10
1075,인천,계양구,0,0,0,0,0,0,2019-02-10
1076,인천,계양구,5,1,0,6,4,0,2019-03-10
1077,인천,계양구,0,0,0,0,0,0,2019-04-10
1078,인천,계양구,2,0,0,2,2,0,2019-05-10
1079,인천,계양구,5,1,0,6,2,0,2019-06-10
1080,인천,계양구,6,0,1,7,5,0,2019-07-10
1081,인천,계양구,0,0,0,0,0,0,2019-08-10
1082,인천,계양구,2,0,0,2,2,0,2019-09-10
1083,인천,계양구,0,0,0,0,0,0,2019-10-10
1084,인천,계양구,6,0,0,6,4,0,2019-11-10
1085,인천,계양구,7,0,1,8,6,0,2019-12-10
1086,인천,남동구,4,1,0,5,4,0,2019-01-10
1087,인천,남동구,4,0,1,5,4,0,2019-02-10
1088,인천,남동구,3,0,2,5,3,0,2019-03-10
1089,인천,남동구,5,1,4,10,9,0,2019-04-10
1090,인천,남동구,4,0,2,6,6,0,2019-05-10
1091,인천,남동구,2,0,0,2,3,1,2019-06-10
1092,인천,남동구,4,3,2,9,6,0,2019-07-10
1093,인천,남동구,3,0,0,3,2,0,2019-08-10
1094,인천,남동구,1,0,0,1,2,1,2019-09-10
1095,인천,남동구,3,0,1,4,4,0,2019-10-10
1096,인천,남동구,4,0,2,6,3,0,2019-11-10
1097,인천,남동구,8,0,0,8,8,0,2019-12-10
1098,인천,동구,0,0,1,1,1,0,2019-01-10
1099,인천,동구,1,1,0,2,2,0,2019-02-10
1100,인천,동구,0,0,0,0,0,0,2019-03-10
1101,인천,동구,0,0,0,0,0,0,2019-04-10
1102,인천,동구,0,0,0,0,0,0,2019-05-10
1103,인천,동구,0,0,0,0,0,0,2019-06-10
1104,인천,동구,0,0,0,0,0,0,2019-07-10
1105,인천,동구,0,0,1,1,1,0,2019-08-10
1106,인천,동구,0,0,0,0,0,0,2019-09-10
1107,인천,동구,2,0,0,2,1,0,2019-10-10
1108,인천,동구,0,0,0,0,0,0,2019-11-10
1109,인천,동구,0,0,0,0,0,0,2019-12-10
1110,인천,미추홀구,2,0,0,2,2,0,2019-01-10
1111,인천,미추홀구,6,0,1,7,3,0,2019-02-10
1112,인천,미추홀구,0,1,1,2,2,0,2019-03-10
1113,인천,미추홀구,1,0,0,1,1,0,2019-04-10
1114,인천,미추홀구,3,0,2,5,4,0,2019-05-10
1115,인천,미추홀구,1,1,2,4,4,0,2019-06-10
1116,인천,미추홀구,5,0,2,7,4,0,2019-07-10
1117,인천,미추홀구,2,0,0,2,2,0,2019-08-10
1118,인천,미추홀구,2,0,0,2,2,0,2019-09-10
1119,인천,미추홀구,2,1,1,4,4,0,2019-10-10
1120,인천,미추홀구,5,0,2,7,6,0,2019-11-10
1121,인천,미추홀구,3,1,0,4,2,0,2019-12-10
1122,인천,부평구,2,0,0,2,2,0,2019-01-10
1123,인천,부평구,1,0,0,1,1,0,2019-02-10
1124,인천,부평구,4,1,1,6,2,0,2019-03-10
1125,인천,부평구,2,0,2,4,3,0,2019-04-10
1126,인천,부평구,2,2,0,4,3,0,2019-05-10
1127,인천,부평구,5,0,0,5,3,0,2019-06-10
1128,인천,부평구,3,0,0,3,2,1,2019-07-10
1129,인천,부평구,2,0,0,2,2,0,2019-08-10
1130,인천,부평구,8,0,0,8,6,0,2019-09-10
1131,인천,부평구,3,1,0,4,4,0,2019-10-10
1132,인천,부평구,1,0,1,2,2,0,2019-11-10
1133,인천,부평구,1,2,2,5,5,0,2019-12-10
1134,인천,서구,1,0,2,3,3,0,2019-01-10
1135,인천,서구,0,0,0,0,0,0,2019-02-10
1136,인천,서구,1,0,2,3,3,0,2019-03-10
1137,인천,서구,2,0,3,5,4,0,2019-04-10
1138,인천,서구,8,0,2,10,6,0,2019-05-10
1139,인천,서구,5,0,0,5,4,0,2019-06-10
1140,인천,서구,6,1,3,10,7,0,2019-07-10
1141,인천,서구,5,2,2,9,6,0,2019-08-10
1142,인천,서구,4,0,0,4,3,0,2019-09-10
1143,인천,서구,2,0,0,2,3,1,2019-10-10
1144,인천,서구,11,0,2,13,9,0,2019-11-10
1145,인천,서구,6,1,4,11,9,0,2019-12-10
1146,인천,연수구,1,0,0,1,1,0,2019-01-10
1147,인천,연수구,2,0,0,2,1,0,2019-02-10
1148,인천,연수구,2,0,0,2,1,0,2019-03-10
1149,인천,연수구,3,0,0,3,3,0,2019-04-10
1150,인천,연수구,2,0,0,2,2,0,2019-05-10
1151,인천,연수구,1,1,0,2,2,0,2019-06-10
1152,인천,연수구,2,0,1,3,3,0,2019-07-10
1153,인천,연수구,1,1,0,2,2,0,2019-08-10
1154,인천,연수구,5,3,1,9,5,0,2019-09-10
1155,인천,연수구,4,0,3,7,4,0,2019-10-10
1156,인천,연수구,3,0,0,3,2,0,2019-11-10
1157,인천,연수구,12,0,3,15,8,0,2019-12-10
1158,인천,옹진군,0,0,0,0,0,0,2019-01-10
1159,인천,옹진군,0,0,0,0,0,0,2019-02-10
1160,인천,옹진군,0,0,0,0,0,0,2019-03-10
1161,인천,옹진군,0,0,0,0,0,0,2019-04-10
1162,인천,옹진군,0,0,0,0,0,0,2019-05-10
1163,인천,옹진군,0,0,0,0,0,0,2019-07-10
1164,인천,옹진군,0,0,0,0,0,0,2019-08-10
1165,인천,옹진군,0,0,0,0,0,0,2019-09-10
1166,인천,옹진군,0,0,0,0,0,0,2019-10-10
1167,인천,옹진군,0,0,0,0,0,0,2019-12-10
1168,인천,중구,2,0,1,3,2,0,2019-01-10
1169,인천,중구,0,0,0,0,0,0,2019-02-10
1170,인천,중구,0,1,0,1,1,0,2019-03-10
1171,인천,중구,1,0,0,1,1,0,2019-04-10
1172,인천,중구,4,0,0,4,1,0,2019-05-10
1173,인천,중구,2,0,0,2,2,0,2019-06-10
1174,인천,중구,3,0,0,3,3,0,2019-07-10
1175,인천,중구,3,0,2,5,3,0,2019-08-10
1176,인천,중구,4,0,1,5,4,0,2019-09-10
1177,인천,중구,1,0,0,1,1,0,2019-10-10
1178,인천,중구,6,0,0,6,3,0,2019-11-10
1179,인천,중구,0,0,1,1,1,0,2019-12-10
1180,인천,강화군,5,0,0,5,1,0,2019-01-11
1181,인천,강화군,0,0,0,0,0,0,2019-02-11
1182,인천,강화군,2,0,0,2,1,0,2019-03-11
1183,인천,강화군,0,0,0,0,0,0,2019-04-11
1184,인천,강화군,4,0,0,4,2,0,2019-05-11
1185,인천,강화군,0,0,0,0,0,0,2019-06-11
1186,인천,강화군,0,0,0,0,0,0,2019-07-11
1187,인천,강화군,0,0,0,0,0,0,2019-08-11
1188,인천,강화군,2,0,0,2,1,0,2019-09-11
1189,인천,강화군,0,0,0,0,0,0,2019-10-11
1190,인천,강화군,1,0,0,1,1,0,2019-11-11
1191,인천,강화군,0,0,0,0,0,0,2019-12-11
1192,인천,계양구,0,0,0,0,0,0,2019-01-11
1193,인천,계양구,8,0,1,9,4,0,2019-02-11
1194,인천,계양구,0,0,0,0,0,0,2019-03-11
1195,인천,계양구,2,0,0,2,2,0,2019-04-11
1196,인천,계양구,3,1,1,5,5,0,2019-05-11
1197,인천,계양구,5,0,2,7,6,0,2019-06-11
1198,인천,계양구,1,0,2,3,3,0,2019-07-11
1199,인천,계양구,1,0,1,2,2,0,2019-08-11
1200,인천,계양구,2,0,0,2,2,0,2019-09-11
1201,인천,계양구,2,1,0,3,2,0,2019-10-11
1202,인천,계양구,0,0,3,3,4,1,2019-11-11
1203,인천,계양구,7,0,3,10,4,0,2019-12-11
1204,인천,남동구,6,0,3,9,7,0,2019-01-11
1205,인천,남동구,10,1,1,12,8,0,2019-02-11
1206,인천,남동구,1,0,0,1,1,0,2019-03-11
1207,인천,남동구,3,0,0,3,3,0,2019-04-11
1208,인천,남동구,4,0,1,5,3,0,2019-05-11
1209,인천,남동구,2,0,1,3,3,0,2019-06-11
1210,인천,남동구,5,0,3,8,6,0,2019-07-11
1211,인천,남동구,10,1,1,12,9,0,2019-08-11
1212,인천,남동구,10,0,2,12,10,0,2019-09-11
1213,인천,남동구,6,0,1,7,5,0,2019-10-11
1214,인천,남동구,11,0,3,14,10,0,2019-11-11
1215,인천,남동구,11,0,2,13,12,0,2019-12-11
1216,인천,동구,0,0,0,0,0,0,2019-01-11
1217,인천,동구,0,0,0,0,0,0,2019-02-11
1218,인천,동구,1,0,0,1,1,0,2019-03-11
1219,인천,동구,0,1,0,1,1,0,2019-04-11
1220,인천,동구,0,0,0,0,0,0,2019-05-11
1221,인천,동구,0,0,0,0,0,0,2019-06-11
1222,인천,동구,2,0,0,2,2,0,2019-07-11
1223,인천,동구,0,0,0,0,0,0,2019-08-11
1224,인천,동구,0,0,0,0,0,0,2019-09-11
1225,인천,동구,0,0,0,0,0,0,2019-10-11
1226,인천,동구,0,0,0,0,0,0,2019-11-11
1227,인천,동구,2,0,0,2,1,0,2019-12-11
1228,인천,미추홀구,10,0,2,12,8,0,2019-01-11
1229,인천,미추홀구,1,1,1,3,3,0,2019-02-11
1230,인천,미추홀구,3,0,1,4,4,0,2019-03-11
1231,인천,미추홀구,4,0,0,4,4,0,2019-04-11
1232,인천,미추홀구,1,1,0,2,2,0,2019-05-11
1233,인천,미추홀구,0,0,0,0,0,0,2019-06-11
1234,인천,미추홀구,1,0,0,1,1,0,2019-07-11
1235,인천,미추홀구,3,1,1,5,4,0,2019-08-11
1236,인천,미추홀구,3,0,2,5,3,0,2019-09-11
1237,인천,미추홀구,1,0,2,3,3,0,2019-10-11
1238,인천,미추홀구,3,1,2,6,5,0,2019-11-11
1239,인천,미추홀구,2,0,0,2,1,0,2019-12-11
1240,인천,부평구,3,0,1,4,4,0,2019-01-11
1241,인천,부평구,5,0,0,5,4,0,2019-02-11
1242,인천,부평구,5,0,3,8,6,0,2019-03-11
1243,인천,부평구,8,0,0,8,6,0,2019-04-11
1244,인천,부평구,5,0,2,7,5,0,2019-05-11
1245,인천,부평구,7,0,2,9,5,0,2019-06-11
1246,인천,부평구,3,0,0,3,3,0,2019-07-11
1247,인천,부평구,11,0,1,12,7,0,2019-08-11
1248,인천,부평구,2,0,1,3,2,0,2019-09-11
1249,인천,부평구,7,0,0,7,5,0,2019-10-11
1250,인천,부평구,5,0,1,6,4,0,2019-11-11
1251,인천,부평구,6,0,1,7,5,0,2019-12-11
1252,인천,서구,6,1,0,7,4,0,2019-01-11
1253,인천,서구,11,0,0,11,6,0,2019-02-11
1254,인천,서구,3,0,0,3,2,0,2019-03-11
1255,인천,서구,4,0,3,7,6,0,2019-04-11
1256,인천,서구,4,0,0,4,4,1,2019-05-11
1257,인천,서구,10,0,5,15,11,0,2019-06-11
1258,인천,서구,4,0,1,5,3,0,2019-07-11
1259,인천,서구,3,0,0,3,2,0,2019-08-11
1260,인천,서구,1,0,2,3,2,0,2019-09-11
1261,인천,서구,5,0,0,5,4,0,2019-10-11
1262,인천,서구,7,1,1,9,5,1,2019-11-11
1263,인천,서구,17,0,1,18,9,0,2019-12-11
1264,인천,연수구,1,0,0,1,1,0,2019-01-11
1265,인천,연수구,0,0,0,0,0,0,2019-02-11
1266,인천,연수구,2,0,0,2,2,0,2019-03-11
1267,인천,연수구,0,0,1,1,1,0,2019-04-11
1268,인천,연수구,4,0,0,4,2,0,2019-05-11
1269,인천,연수구,0,0,0,0,0,0,2019-06-11
1270,인천,연수구,1,0,0,1,1,0,2019-07-11
1271,인천,연수구,1,0,0,1,1,0,2019-08-11
1272,인천,연수구,3,0,3,6,4,0,2019-09-11
1273,인천,연수구,2,0,1,3,3,0,2019-10-11
1274,인천,연수구,0,0,0,0,0,0,2019-11-11
1275,인천,연수구,7,0,1,8,4,0,2019-12-11
1276,인천,옹진군,0,0,1,1,1,0,2019-01-11
1277,인천,옹진군,0,0,0,0,0,0,2019-02-11
1278,인천,옹진군,0,0,0,0,0,0,2019-03-11
1279,인천,옹진군,0,0,0,0,0,0,2019-04-11
1280,인천,옹진군,0,0,0,0,0,0,2019-05-11
1281,인천,옹진군,1,0,2,3,2,0,2019-07-11
1282,인천,옹진군,0,0,0,0,0,0,2019-08-11
1283,인천,옹진군,0,0,0,0,0,0,2019-09-11
1284,인천,옹진군,0,0,1,1,1,1,2019-10-11
1285,인천,옹진군,0,0,0,0,0,0,2019-12-11
1286,인천,중구,0,0,0,0,0,0,2019-01-11
1287,인천,중구,0,0,0,0,0,0,2019-02-11
1288,인천,중구,5,0,1,6,5,0,2019-03-11
1289,인천,중구,6,0,0,6,2,0,2019-04-11
1290,인천,중구,3,0,0,3,3,0,2019-05-11
1291,인천,중구,2,0,0,2,1,0,2019-06-11
1292,인천,중구,4,1,1,6,4,0,2019-07-11
1293,인천,중구,5,0,0,5,2,0,2019-08-11
1294,인천,중구,0,0,3,3,3,0,2019-09-11
1295,인천,중구,1,1,0,2,2,0,2019-10-11
1296,인천,중구,1,0,0,1,1,0,2019-11-11
1297,인천,중구,0,0,0,0,0,0,2019-12-11
1298,인천,강화군,0,0,0,0,0,0,2019-01-12
1299,인천,강화군,0,0,0,0,0,0,2019-02-12
1300,인천,강화군,0,0,0,0,0,0,2019-03-12
1301,인천,강화군,0,0,0,0,0,0,2019-04-12
1302,인천,강화군,0,0,0,0,0,0,2019-05-12
1303,인천,강화군,0,0,1,1,1,0,2019-06-12
1304,인천,강화군,0,0,0,0,0,0,2019-07-12
1305,인천,강화군,0,0,0,0,0,0,2019-08-12
1306,인천,강화군,0,0,0,0,0,0,2019-09-12
1307,인천,강화군,2,0,0,2,1,0,2019-10-12
1308,인천,강화군,0,0,0,0,0,0,2019-11-12
1309,인천,강화군,0,0,0,0,0,0,2019-12-12
1310,인천,계양구,0,0,0,0,0,0,2019-01-12
1311,인천,계양구,1,0,0,1,1,0,2019-02-12
1312,인천,계양구,0,0,0,0,0,0,2019-03-12
1313,인천,계양구,1,0,2,3,2,0,2019-04-12
1314,인천,계양구,2,0,1,3,3,0,2019-05-12
1315,인천,계양구,5,0,1,6,4,0,2019-06-12
1316,인천,계양구,0,0,1,1,1,0,2019-07-12
1317,인천,계양구,0,0,1,1,1,0,2019-08-12
1318,인천,계양구,1,0,1,2,2,0,2019-09-12
1319,인천,계양구,2,0,0,2,2,0,2019-10-12
1320,인천,계양구,1,0,1,2,2,0,2019-11-12
1321,인천,계양구,3,0,0,3,3,0,2019-12-12
1322,인천,남동구,5,1,0,6,7,1,2019-01-12
1323,인천,남동구,11,1,0,12,4,0,2019-02-12
1324,인천,남동구,5,0,0,5,4,0,2019-03-12
1325,인천,남동구,5,0,4,9,9,0,2019-04-12
1326,인천,남동구,6,1,1,8,4,0,2019-05-12
1327,인천,남동구,8,0,2,10,7,0,2019-06-12
1328,인천,남동구,7,0,1,8,6,0,2019-07-12
1329,인천,남동구,8,0,1,9,8,0,2019-08-12
1330,인천,남동구,2,0,0,2,1,0,2019-09-12
1331,인천,남동구,7,0,7,14,9,1,2019-10-12
1332,인천,남동구,2,0,2,4,4,0,2019-11-12
1333,인천,남동구,0,0,0,0,0,0,2019-12-12
1334,인천,동구,0,0,0,0,0,0,2019-01-12
1335,인천,동구,0,0,0,0,0,0,2019-02-12
1336,인천,동구,0,0,0,0,0,0,2019-03-12
1337,인천,동구,0,0,0,0,0,0,2019-04-12
1338,인천,동구,1,0,1,2,1,0,2019-05-12
1339,인천,동구,1,0,0,1,1,0,2019-06-12
1340,인천,동구,2,0,0,2,2,0,2019-07-12
1341,인천,동구,0,0,0,0,0,0,2019-08-12
1342,인천,동구,0,0,0,0,0,0,2019-09-12
1343,인천,동구,0,0,0,0,0,0,2019-10-12
1344,인천,동구,0,0,0,0,0,0,2019-11-12
1345,인천,동구,1,0,0,1,1,0,2019-12-12
1346,인천,미추홀구,1,2,0,3,3,0,2019-01-12
1347,인천,미추홀구,8,0,1,9,1,0,2019-02-12
1348,인천,미추홀구,1,0,0,1,1,0,2019-03-12
1349,인천,미추홀구,1,0,0,1,1,0,2019-04-12
1350,인천,미추홀구,3,1,2,6,5,0,2019-05-12
1351,인천,미추홀구,1,0,0,1,1,0,2019-06-12
1352,인천,미추홀구,1,3,1,5,5,0,2019-07-12
1353,인천,미추홀구,7,2,0,9,6,0,2019-08-12
1354,인천,미추홀구,5,0,0,5,2,0,2019-09-12
1355,인천,미추홀구,1,1,0,2,2,0,2019-10-12
1356,인천,미추홀구,2,0,1,3,3,0,2019-11-12
1357,인천,미추홀구,0,3,0,3,1,0,2019-12-12
1358,인천,부평구,0,0,0,0,0,0,2019-01-12
1359,인천,부평구,3,0,1,4,3,0,2019-02-12
1360,인천,부평구,1,0,0,1,1,0,2019-03-12
1361,인천,부평구,0,0,3,3,3,0,2019-04-12
1362,인천,부평구,6,0,0,6,4,0,2019-05-12
1363,인천,부평구,2,0,0,2,2,0,2019-06-12
1364,인천,부평구,5,0,0,5,4,0,2019-07-12
1365,인천,부평구,2,0,0,2,2,0,2019-08-12
1366,인천,부평구,5,1,1,7,6,0,2019-09-12
1367,인천,부평구,12,0,5,17,6,0,2019-10-12
1368,인천,부평구,4,0,0,4,4,0,2019-11-12
1369,인천,부평구,5,1,1,7,6,0,2019-12-12
1370,인천,서구,3,0,1,4,2,0,2019-01-12
1371,인천,서구,3,0,1,4,3,0,2019-02-12
1372,인천,서구,0,0,0,0,0,0,2019-03-12
1373,인천,서구,5,0,1,6,5,0,2019-04-12
1374,인천,서구,8,0,2,10,8,0,2019-05-12
1375,인천,서구,8,0,5,13,7,0,2019-06-12
1376,인천,서구,13,0,2,15,7,0,2019-07-12
1377,인천,서구,6,0,3,9,4,0,2019-08-12
1378,인천,서구,5,0,2,7,4,0,2019-09-12
1379,인천,서구,4,0,1,5,4,0,2019-10-12
1380,인천,서구,6,0,0,6,3,0,2019-11-12
1381,인천,서구,8,0,3,11,8,0,2019-12-12
1382,인천,연수구,0,0,0,0,0,0,2019-01-12
1383,인천,연수구,1,0,0,1,1,0,2019-02-12
1384,인천,연수구,3,0,0,3,1,0,2019-03-12
1385,인천,연수구,0,0,0,0,0,0,2019-04-12
1386,인천,연수구,7,0,1,8,3,0,2019-05-12
1387,인천,연수구,1,0,0,1,1,0,2019-06-12
1388,인천,연수구,3,0,1,4,4,0,2019-07-12
1389,인천,연수구,0,1,0,1,1,0,2019-08-12
1390,인천,연수구,2,0,0,2,3,1,2019-09-12
1391,인천,연수구,4,0,3,7,4,0,2019-10-12
1392,인천,연수구,0,0,0,0,0,0,2019-11-12
1393,인천,연수구,0,0,0,0,0,0,2019-12-12
1394,인천,옹진군,0,0,0,0,0,0,2019-01-12
1395,인천,옹진군,0,0,0,0,0,0,2019-02-12
1396,인천,옹진군,0,0,0,0,0,0,2019-03-12
1397,인천,옹진군,2,0,2,4,2,0,2019-04-12
1398,인천,옹진군,0,0,1,1,1,0,2019-05-12
1399,인천,옹진군,0,0,0,0,0,0,2019-07-12
1400,인천,옹진군,0,0,0,0,0,0,2019-08-12
1401,인천,옹진군,0,0,0,0,0,0,2019-09-12
1402,인천,옹진군,0,0,0,0,0,0,2019-10-12
1403,인천,옹진군,1,0,0,1,1,0,2019-12-12
1404,인천,중구,0,0,0,0,0,0,2019-01-12
1405,인천,중구,0,0,0,0,0,0,2019-02-12
1406,인천,중구,1,0,1,2,2,0,2019-03-12
1407,인천,중구,2,0,1,3,3,0,2019-04-12
1408,인천,중구,3,0,1,4,2,0,2019-05-12
1409,인천,중구,0,0,0,0,0,0,2019-06-12
1410,인천,중구,0,0,0,0,0,0,2019-07-12
1411,인천,중구,3,0,0,3,1,0,2019-08-12
1412,인천,중구,1,0,1,2,2,0,2019-09-12
1413,인천,중구,0,1,0,1,1,0,2019-10-12
1414,인천,중구,0,0,0,0,0,0,2019-11-12
1415,인천,중구,1,0,2,3,2,0,2019-12-12
1416,인천,강화군,0,0,0,0,0,0,2019-01-13
1417,인천,강화군,0,0,3,3,1,0,2019-02-13
1418,인천,강화군,0,0,0,0,0,0,2019-03-13
1419,인천,강화군,0,0,2,2,1,0,2019-04-13
1420,인천,강화군,5,0,0,5,2,0,2019-05-13
1421,인천,강화군,0,0,0,0,0,0,2019-06-13
1422,인천,강화군,0,0,0,0,0,0,2019-07-13
1423,인천,강화군,0,0,0,0,0,0,2019-08-13
1424,인천,강화군,5,0,0,5,1,0,2019-09-13
1425,인천,강화군,2,0,1,3,2,0,2019-10-13
1426,인천,강화군,1,0,0,1,1,0,2019-11-13
1427,인천,강화군,0,0,1,1,1,0,2019-12-13
1428,인천,계양구,1,0,0,1,1,0,2019-01-13
1429,인천,계양구,1,0,1,2,1,0,2019-02-13
1430,인천,계양구,3,0,0,3,2,0,2019-03-13
1431,인천,계양구,2,0,0,2,1,0,2019-04-13
1432,인천,계양구,2,0,1,3,1,0,2019-05-13
1433,인천,계양구,3,0,0,3,3,0,2019-06-13
1434,인천,계양구,0,0,1,1,1,1,2019-07-13
1435,인천,계양구,3,0,0,3,2,0,2019-08-13
1436,인천,계양구,2,0,0,2,1,0,2019-09-13
1437,인천,계양구,2,0,0,2,2,0,2019-10-13
1438,인천,계양구,1,0,0,1,1,0,2019-11-13
1439,인천,계양구,2,0,1,3,3,0,2019-12-13
1440,인천,남동구,2,0,1,3,3,0,2019-01-13
1441,인천,남동구,1,0,0,1,1,0,2019-02-13
1442,인천,남동구,7,0,3,10,6,0,2019-03-13
1443,인천,남동구,12,1,3,16,10,0,2019-04-13
1444,인천,남동구,4,0,1,5,5,0,2019-05-13
1445,인천,남동구,9,1,1,11,7,0,2019-06-13
1446,인천,남동구,4,0,2,6,4,0,2019-07-13
1447,인천,남동구,11,0,1,12,7,0,2019-08-13
1448,인천,남동구,1,3,0,4,1,0,2019-09-13
1449,인천,남동구,5,0,1,6,3,0,2019-10-13
1450,인천,남동구,7,0,2,9,6,0,2019-11-13
1451,인천,남동구,4,1,2,7,6,0,2019-12-13
1452,인천,동구,0,0,0,0,0,0,2019-01-13
1453,인천,동구,2,0,0,2,1,0,2019-02-13
1454,인천,동구,0,0,0,0,0,0,2019-03-13
1455,인천,동구,0,0,0,0,0,0,2019-04-13
1456,인천,동구,1,0,0,1,1,0,2019-05-13
1457,인천,동구,1,0,0,1,1,0,2019-06-13
1458,인천,동구,0,0,0,0,0,0,2019-07-13
1459,인천,동구,0,0,0,0,0,0,2019-08-13
1460,인천,동구,0,0,0,0,0,0,2019-09-13
1461,인천,동구,0,0,0,0,0,0,2019-10-13
1462,인천,동구,0,0,0,0,0,0,2019-11-13
1463,인천,동구,0,0,0,0,0,0,2019-12-13
1464,인천,미추홀구,2,1,1,4,3,0,2019-01-13
1465,인천,미추홀구,1,0,0,1,1,0,2019-02-13
1466,인천,미추홀구,2,2,1,5,4,0,2019-03-13
1467,인천,미추홀구,1,0,0,1,1,0,2019-04-13
1468,인천,미추홀구,1,0,0,1,1,0,2019-05-13
1469,인천,미추홀구,7,0,1,8,5,0,2019-06-13
1470,인천,미추홀구,5,0,0,5,3,0,2019-07-13
1471,인천,미추홀구,1,4,0,5,4,0,2019-08-13
1472,인천,미추홀구,0,0,1,1,1,0,2019-09-13
1473,인천,미추홀구,5,0,0,5,2,0,2019-10-13
1474,인천,미추홀구,1,0,0,1,1,0,2019-11-13
1475,인천,미추홀구,5,0,1,6,4,0,2019-12-13
1476,인천,부평구,5,0,3,8,5,1,2019-01-13
1477,인천,부평구,2,0,0,2,2,0,2019-02-13
1478,인천,부평구,3,0,2,5,5,1,2019-03-13
1479,인천,부평구,6,0,1,7,6,0,2019-04-13
1480,인천,부평구,1,0,2,3,3,0,2019-05-13
1481,인천,부평구,2,0,0,2,2,0,2019-06-13
1482,인천,부평구,11,0,0,11,7,0,2019-07-13
1483,인천,부평구,4,0,1,5,5,0,2019-08-13
1484,인천,부평구,0,0,0,0,0,0,2019-09-13
1485,인천,부평구,2,0,0,2,1,0,2019-10-13
1486,인천,부평구,4,0,2,6,5,0,2019-11-13
1487,인천,부평구,9,0,3,12,6,0,2019-12-13
1488,인천,서구,2,0,0,2,2,0,2019-01-13
1489,인천,서구,5,0,2,7,5,0,2019-02-13
1490,인천,서구,2,0,0,2,2,0,2019-03-13
1491,인천,서구,4,0,0,4,3,0,2019-04-13
1492,인천,서구,3,0,1,4,4,0,2019-05-13
1493,인천,서구,5,0,2,7,6,0,2019-06-13
1494,인천,서구,8,1,0,9,3,0,2019-07-13
1495,인천,서구,7,0,2,9,6,0,2019-08-13
1496,인천,서구,2,2,1,5,2,0,2019-09-13
1497,인천,서구,1,0,1,2,2,0,2019-10-13
1498,인천,서구,5,0,4,9,8,0,2019-11-13
1499,인천,서구,6,0,1,7,4,0,2019-12-13
1500,인천,연수구,1,0,0,1,1,0,2019-01-13
1501,인천,연수구,2,0,0,2,1,0,2019-02-13
1502,인천,연수구,4,0,0,4,1,0,2019-03-13
1503,인천,연수구,4,0,0,4,3,0,2019-04-13
1504,인천,연수구,0,0,0,0,0,0,2019-05-13
1505,인천,연수구,7,0,0,7,5,0,2019-06-13
1506,인천,연수구,4,0,0,4,3,0,2019-07-13
1507,인천,연수구,1,1,0,2,2,0,2019-08-13
1508,인천,연수구,1,0,0,1,1,0,2019-09-13
1509,인천,연수구,1,0,2,3,2,0,2019-10-13
1510,인천,연수구,5,1,0,6,4,0,2019-11-13
1511,인천,연수구,1,0,0,1,1,0,2019-12-13
1512,인천,옹진군,0,0,0,0,0,0,2019-01-13
1513,인천,옹진군,0,0,0,0,0,0,2019-02-13
1514,인천,옹진군,0,0,0,0,0,0,2019-03-13
1515,인천,옹진군,0,0,0,0,0,0,2019-04-13
1516,인천,옹진군,0,0,0,0,0,0,2019-05-13
1517,인천,옹진군,0,0,0,0,0,0,2019-07-13
1518,인천,옹진군,0,0,0,0,0,0,2019-08-13
1519,인천,옹진군,0,0,0,0,0,0,2019-09-13
1520,인천,옹진군,10,0,0,10,1,0,2019-10-13
1521,인천,옹진군,0,0,0,0,0,0,2019-12-13
1522,인천,중구,1,0,0,1,2,1,2019-01-13
1523,인천,중구,0,0,0,0,0,0,2019-02-13
1524,인천,중구,1,0,0,1,1,0,2019-03-13
1525,인천,중구,6,2,1,9,4,0,2019-04-13
1526,인천,중구,0,0,0,0,0,0,2019-05-13
1527,인천,중구,1,0,0,1,1,0,2019-06-13
1528,인천,중구,1,0,0,1,1,0,2019-07-13
1529,인천,중구,4,0,0,4,4,0,2019-08-13
1530,인천,중구,2,0,0,2,2,0,2019-09-13
1531,인천,중구,4,0,1,5,2,0,2019-10-13
1532,인천,중구,2,0,1,3,3,0,2019-11-13
1533,인천,중구,3,0,4,7,2,0,2019-12-13
1534,인천,강화군,1,0,0,1,1,0,2019-01-14
1535,인천,강화군,0,0,0,0,0,0,2019-02-14
1536,인천,강화군,2,0,2,4,4,0,2019-03-14
1537,인천,강화군,1,0,0,1,1,0,2019-04-14
1538,인천,강화군,0,0,0,0,0,0,2019-05-14
1539,인천,강화군,0,0,0,0,0,0,2019-06-14
1540,인천,강화군,0,0,0,0,0,0,2019-07-14
1541,인천,강화군,3,0,0,3,1,0,2019-08-14
1542,인천,강화군,1,0,0,1,1,0,2019-09-14
1543,인천,강화군,1,0,0,1,1,0,2019-10-14
1544,인천,강화군,1,0,1,2,2,0,2019-11-14
1545,인천,강화군,0,0,0,0,1,1,2019-12-14
1546,인천,계양구,3,0,1,4,3,0,2019-01-14
1547,인천,계양구,1,0,3,4,4,0,2019-02-14
1548,인천,계양구,2,0,1,3,3,0,2019-03-14
1549,인천,계양구,2,0,0,2,1,0,2019-04-14
1550,인천,계양구,4,0,1,5,5,0,2019-05-14
1551,인천,계양구,2,1,1,4,3,0,2019-06-14
1552,인천,계양구,1,1,1,3,3,0,2019-07-14
1553,인천,계양구,1,0,0,1,1,0,2019-08-14
1554,인천,계양구,0,0,0,0,0,0,2019-09-14
1555,인천,계양구,6,0,0,6,3,0,2019-10-14
1556,인천,계양구,2,0,0,2,2,0,2019-11-14
1557,인천,계양구,3,0,0,3,3,0,2019-12-14
1558,인천,남동구,4,0,1,5,2,0,2019-01-14
1559,인천,남동구,4,0,0,4,3,0,2019-02-14
1560,인천,남동구,7,0,2,9,7,1,2019-03-14
1561,인천,남동구,16,1,4,21,10,1,2019-04-14
1562,인천,남동구,7,0,0,7,4,0,2019-05-14
1563,인천,남동구,3,2,1,6,3,0,2019-06-14
1564,인천,남동구,5,0,1,6,6,0,2019-07-14
1565,인천,남동구,10,0,3,13,10,0,2019-08-14
1566,인천,남동구,3,0,0,3,3,0,2019-09-14
1567,인천,남동구,5,0,0,5,5,0,2019-10-14
1568,인천,남동구,3,0,2,5,4,0,2019-11-14
1569,인천,남동구,8,0,1,9,5,0,2019-12-14
1570,인천,동구,0,0,0,0,0,0,2019-01-14
1571,인천,동구,0,0,0,0,0,0,2019-02-14
1572,인천,동구,0,0,0,0,0,0,2019-03-14
1573,인천,동구,0,0,0,0,0,0,2019-04-14
1574,인천,동구,0,0,0,0,0,0,2019-05-14
1575,인천,동구,0,0,0,0,0,0,2019-06-14
1576,인천,동구,0,0,0,0,0,0,2019-07-14
1577,인천,동구,0,0,0,0,0,0,2019-08-14
1578,인천,동구,0,0,0,0,0,0,2019-09-14
1579,인천,동구,0,0,0,0,0,0,2019-10-14
1580,인천,동구,0,0,0,0,0,0,2019-11-14
1581,인천,동구,0,0,0,0,0,0,2019-12-14
1582,인천,미추홀구,1,0,1,2,2,0,2019-01-14
1583,인천,미추홀구,5,0,1,6,3,0,2019-02-14
1584,인천,미추홀구,0,1,0,1,1,0,2019-03-14
1585,인천,미추홀구,6,0,0,6,4,0,2019-04-14
1586,인천,미추홀구,1,0,1,2,2,0,2019-05-14
1587,인천,미추홀구,3,0,2,5,4,1,2019-06-14
1588,인천,미추홀구,0,0,0,0,0,0,2019-07-14
1589,인천,미추홀구,4,1,3,8,7,0,2019-08-14
1590,인천,미추홀구,4,0,0,4,2,0,2019-09-14
1591,인천,미추홀구,3,1,1,5,5,0,2019-10-14
1592,인천,미추홀구,3,0,2,5,3,0,2019-11-14
1593,인천,미추홀구,9,1,0,10,7,0,2019-12-14
1594,인천,부평구,7,0,2,9,5,0,2019-01-14
1595,인천,부평구,3,0,1,4,4,0,2019-02-14
1596,인천,부평구,14,0,4,18,7,1,2019-03-14
1597,인천,부평구,7,0,0,7,5,0,2019-04-14
1598,인천,부평구,1,0,0,1,1,0,2019-05-14
1599,인천,부평구,1,1,0,2,2,0,2019-06-14
1600,인천,부평구,5,0,0,5,4,1,2019-07-14
1601,인천,부평구,4,0,0,4,4,0,2019-08-14
1602,인천,부평구,4,1,0,5,3,0,2019-09-14
1603,인천,부평구,8,0,1,9,5,0,2019-10-14
1604,인천,부평구,2,0,2,4,4,0,2019-11-14
1605,인천,부평구,4,1,0,5,4,0,2019-12-14
1606,인천,서구,1,0,0,1,1,0,2019-01-14
1607,인천,서구,1,0,0,1,1,0,2019-02-14
1608,인천,서구,5,0,2,7,6,0,2019-03-14
1609,인천,서구,1,0,2,3,2,0,2019-04-14
1610,인천,서구,2,0,1,3,3,0,2019-05-14
1611,인천,서구,5,0,1,6,4,0,2019-06-14
1612,인천,서구,2,0,0,2,1,0,2019-07-14
1613,인천,서구,4,0,1,5,5,0,2019-08-14
1614,인천,서구,5,1,0,6,3,0,2019-09-14
1615,인천,서구,4,0,1,5,4,0,2019-10-14
1616,인천,서구,7,1,2,10,8,0,2019-11-14
1617,인천,서구,5,1,4,10,9,0,2019-12-14
1618,인천,연수구,1,0,1,2,2,0,2019-01-14
1619,인천,연수구,0,0,0,0,0,0,2019-02-14
1620,인천,연수구,3,0,0,3,2,0,2019-03-14
1621,인천,연수구,3,0,3,6,4,0,2019-04-14
1622,인천,연수구,0,0,0,0,0,0,2019-05-14
1623,인천,연수구,6,0,1,7,5,0,2019-06-14
1624,인천,연수구,5,2,0,7,2,0,2019-07-14
1625,인천,연수구,0,0,0,0,0,0,2019-08-14
1626,인천,연수구,1,0,0,1,1,0,2019-09-14
1627,인천,연수구,0,0,1,1,1,0,2019-10-14
1628,인천,연수구,1,0,1,2,2,0,2019-11-14
1629,인천,연수구,2,0,0,2,2,0,2019-12-14
1630,인천,옹진군,0,0,0,0,0,0,2019-01-14
1631,인천,옹진군,0,0,0,0,0,0,2019-02-14
1632,인천,옹진군,0,0,0,0,0,0,2019-03-14
1633,인천,옹진군,0,0,0,0,0,0,2019-04-14
1634,인천,옹진군,0,0,0,0,0,0,2019-05-14
1635,인천,옹진군,0,0,0,0,0,0,2019-07-14
1636,인천,옹진군,0,0,0,0,0,0,2019-08-14
1637,인천,옹진군,0,0,1,1,1,0,2019-09-14
1638,인천,옹진군,0,0,0,0,0,0,2019-10-14
1639,인천,옹진군,0,0,0,0,0,0,2019-12-14
1640,인천,중구,4,0,1,5,2,0,2019-01-14
1641,인천,중구,0,0,0,0,0,0,2019-02-14
1642,인천,중구,1,0,0,1,1,0,2019-03-14
1643,인천,중구,1,0,0,1,1,0,2019-04-14
1644,인천,중구,2,1,0,3,3,0,2019-05-14
1645,인천,중구,0,0,0,0,0,0,2019-06-14
1646,인천,중구,12,0,1,13,4,0,2019-07-14
1647,인천,중구,4,0,0,4,2,0,2019-08-14
1648,인천,중구,3,0,0,3,3,0,2019-09-14
1649,인천,중구,2,0,0,2,2,0,2019-10-14
1650,인천,중구,2,0,1,3,2,0,2019-11-14
1651,인천,중구,11,1,0,12,4,0,2019-12-14
1652,인천,강화군,0,0,0,0,0,0,2019-01-15
1653,인천,강화군,0,0,1,1,1,0,2019-02-15
1654,인천,강화군,0,0,0,0,0,0,2019-03-15
1655,인천,강화군,0,0,0,0,0,0,2019-04-15
1656,인천,강화군,0,0,0,0,0,0,2019-05-15
1657,인천,강화군,0,0,1,1,1,0,2019-06-15
1658,인천,강화군,0,0,0,0,0,0,2019-07-15
1659,인천,강화군,1,0,0,1,1,0,2019-08-15
1660,인천,강화군,1,0,0,1,1,0,2019-09-15
1661,인천,강화군,0,0,0,0,0,0,2019-10-15
1662,인천,강화군,0,0,0,0,0,0,2019-11-15
1663,인천,강화군,1,0,0,1,2,1,2019-12-15
1664,인천,계양구,2,0,1,3,3,0,2019-01-15
1665,인천,계양구,11,0,0,11,7,0,2019-02-15
1666,인천,계양구,0,0,0,0,0,0,2019-03-15
1667,인천,계양구,3,0,2,5,4,0,2019-04-15
1668,인천,계양구,0,0,0,0,0,0,2019-05-15
1669,인천,계양구,3,0,1,4,3,0,2019-06-15
1670,인천,계양구,1,0,1,2,2,0,2019-07-15
1671,인천,계양구,5,0,0,5,3,0,2019-08-15
1672,인천,계양구,5,0,3,8,3,0,2019-09-15
1673,인천,계양구,8,1,1,10,4,0,2019-10-15
1674,인천,계양구,2,0,1,3,3,0,2019-11-15
1675,인천,계양구,1,0,0,1,1,0,2019-12-15
1676,인천,남동구,5,0,0,5,3,0,2019-01-15
1677,인천,남동구,5,0,3,8,6,0,2019-02-15
1678,인천,남동구,6,2,2,10,8,0,2019-03-15
1679,인천,남동구,13,0,1,14,11,0,2019-04-15
1680,인천,남동구,4,0,0,4,3,0,2019-05-15
1681,인천,남동구,11,1,0,12,8,0,2019-06-15
1682,인천,남동구,5,0,3,8,6,0,2019-07-15
1683,인천,남동구,3,0,0,3,3,0,2019-08-15
1684,인천,남동구,6,2,1,9,9,0,2019-09-15
1685,인천,남동구,14,0,1,15,11,0,2019-10-15
1686,인천,남동구,16,0,1,17,12,0,2019-11-15
1687,인천,남동구,1,0,0,1,1,0,2019-12-15
1688,인천,동구,1,0,0,1,1,0,2019-01-15
1689,인천,동구,0,0,1,1,1,0,2019-02-15
1690,인천,동구,0,0,0,0,0,0,2019-03-15
1691,인천,동구,0,0,0,0,0,0,2019-04-15
1692,인천,동구,0,0,0,0,0,0,2019-05-15
1693,인천,동구,0,0,0,0,0,0,2019-06-15
1694,인천,동구,0,0,0,0,0,0,2019-07-15
1695,인천,동구,0,0,0,0,0,0,2019-08-15
1696,인천,동구,0,0,0,0,0,0,2019-09-15
1697,인천,동구,1,0,0,1,1,0,2019-10-15
1698,인천,동구,0,0,0,0,0,0,2019-11-15
1699,인천,동구,0,0,0,0,0,0,2019-12-15
1700,인천,미추홀구,5,0,0,5,4,0,2019-01-15
1701,인천,미추홀구,2,1,1,4,4,0,2019-02-15
1702,인천,미추홀구,0,0,0,0,0,0,2019-03-15
1703,인천,미추홀구,2,0,0,2,2,0,2019-04-15
1704,인천,미추홀구,5,0,2,7,6,0,2019-05-15
1705,인천,미추홀구,4,1,0,5,4,0,2019-06-15
1706,인천,미추홀구,2,1,1,4,4,0,2019-07-15
1707,인천,미추홀구,4,0,1,5,1,0,2019-08-15
1708,인천,미추홀구,2,0,2,4,3,0,2019-09-15
1709,인천,미추홀구,6,1,1,8,6,0,2019-10-15
1710,인천,미추홀구,6,0,1,7,6,0,2019-11-15
1711,인천,미추홀구,4,1,1,6,3,0,2019-12-15
1712,인천,부평구,1,0,2,3,3,0,2019-01-15
1713,인천,부평구,7,0,2,9,6,0,2019-02-15
1714,인천,부평구,6,0,0,6,6,0,2019-03-15
1715,인천,부평구,6,0,2,8,7,0,2019-04-15
1716,인천,부평구,1,0,0,1,1,0,2019-05-15
1717,인천,부평구,6,0,1,7,5,0,2019-06-15
1718,인천,부평구,3,0,0,3,3,0,2019-07-15
1719,인천,부평구,3,0,1,4,3,0,2019-08-15
1720,인천,부평구,0,0,0,0,0,0,2019-09-15
1721,인천,부평구,4,0,0,4,3,0,2019-10-15
1722,인천,부평구,5,0,2,7,6,0,2019-11-15
1723,인천,부평구,3,0,2,5,3,0,2019-12-15
1724,인천,서구,3,0,1,4,3,0,2019-01-15
1725,인천,서구,5,0,1,6,5,0,2019-02-15
1726,인천,서구,2,1,2,5,5,0,2019-03-15
1727,인천,서구,2,0,1,3,4,1,2019-04-15
1728,인천,서구,10,0,5,15,11,0,2019-05-15
1729,인천,서구,3,2,3,8,6,0,2019-06-15
1730,인천,서구,5,0,4,9,6,0,2019-07-15
1731,인천,서구,7,0,0,7,4,0,2019-08-15
1732,인천,서구,7,0,3,10,6,0,2019-09-15
1733,인천,서구,7,1,0,8,6,0,2019-10-15
1734,인천,서구,4,0,1,5,5,0,2019-11-15
1735,인천,서구,14,0,2,16,6,0,2019-12-15
1736,인천,연수구,1,0,1,2,1,0,2019-01-15
1737,인천,연수구,3,0,1,4,4,0,2019-02-15
1738,인천,연수구,3,0,2,5,5,0,2019-03-15
1739,인천,연수구,0,0,0,0,0,0,2019-04-15
1740,인천,연수구,5,0,3,8,4,2,2019-05-15
1741,인천,연수구,0,0,1,1,1,0,2019-06-15
1742,인천,연수구,0,0,0,0,0,0,2019-07-15
1743,인천,연수구,4,0,0,4,1,0,2019-08-15
1744,인천,연수구,1,0,0,1,1,0,2019-09-15
1745,인천,연수구,1,0,2,3,3,1,2019-10-15
1746,인천,연수구,9,1,1,11,9,0,2019-11-15
1747,인천,연수구,4,0,1,5,4,0,2019-12-15
1748,인천,옹진군,0,0,0,0,0,0,2019-01-15
1749,인천,옹진군,0,0,0,0,0,0,2019-02-15
1750,인천,옹진군,0,0,0,0,0,0,2019-03-15
1751,인천,옹진군,0,0,0,0,0,0,2019-04-15
1752,인천,옹진군,0,0,0,0,0,0,2019-05-15
1753,인천,옹진군,0,0,0,0,0,0,2019-07-15
1754,인천,옹진군,0,0,0,0,0,0,2019-08-15
1755,인천,옹진군,0,0,0,0,0,0,2019-09-15
1756,인천,옹진군,0,0,0,0,0,0,2019-10-15
1757,인천,옹진군,0,0,0,0,0,0,2019-12-15
1758,인천,중구,0,1,0,1,1,0,2019-01-15
1759,인천,중구,2,0,2,4,3,0,2019-02-15
1760,인천,중구,3,0,0,3,2,0,2019-03-15
1761,인천,중구,0,0,0,0,0,0,2019-04-15
1762,인천,중구,2,0,0,2,2,0,2019-05-15
1763,인천,중구,1,0,0,1,1,0,2019-06-15
1764,인천,중구,3,0,0,3,3,0,2019-07-15
1765,인천,중구,0,0,0,0,0,0,2019-08-15
1766,인천,중구,2,0,0,2,1,0,2019-09-15
1767,인천,중구,3,0,2,5,3,0,2019-10-15
1768,인천,중구,2,0,1,3,2,0,2019-11-15
1769,인천,중구,3,0,0,3,2,0,2019-12-15
1770,인천,강화군,0,0,0,0,0,0,2019-01-16
1771,인천,강화군,0,0,0,0,0,0,2019-02-16
1772,인천,강화군,0,0,0,0,0,0,2019-03-16
1773,인천,강화군,1,0,0,1,1,0,2019-04-16
1774,인천,강화군,0,0,0,0,0,0,2019-05-16
1775,인천,강화군,0,0,0,0,0,0,2019-06-16
1776,인천,강화군,0,0,0,0,0,0,2019-07-16
1777,인천,강화군,0,0,0,0,0,0,2019-08-16
1778,인천,강화군,0,0,2,2,2,0,2019-09-16
1779,인천,강화군,0,0,0,0,0,0,2019-10-16
1780,인천,강화군,0,0,0,0,0,0,2019-11-16
1781,인천,강화군,0,0,0,0,0,0,2019-12-16
1782,인천,계양구,6,1,0,7,2,0,2019-01-16
1783,인천,계양구,4,0,1,5,3,0,2019-02-16
1784,인천,계양구,0,0,1,1,1,0,2019-03-16
1785,인천,계양구,1,0,0,1,1,0,2019-04-16
1786,인천,계양구,2,0,0,2,2,0,2019-05-16
1787,인천,계양구,2,0,0,2,1,0,2019-06-16
1788,인천,계양구,5,0,0,5,3,1,2019-07-16
1789,인천,계양구,0,0,1,1,1,0,2019-08-16
1790,인천,계양구,2,0,0,2,1,0,2019-09-16
1791,인천,계양구,6,0,2,8,5,0,2019-10-16
1792,인천,계양구,1,0,0,1,1,0,2019-11-16
1793,인천,계양구,0,0,0,0,0,0,2019-12-16
1794,인천,남동구,1,0,1,2,1,0,2019-01-16
1795,인천,남동구,6,1,2,9,6,0,2019-02-16
1796,인천,남동구,4,0,0,4,3,0,2019-03-16
1797,인천,남동구,2,0,0,2,1,0,2019-04-16
1798,인천,남동구,3,0,0,3,2,0,2019-05-16
1799,인천,남동구,6,0,1,7,5,0,2019-06-16
1800,인천,남동구,10,0,1,11,6,0,2019-07-16
1801,인천,남동구,2,0,1,3,3,0,2019-08-16
1802,인천,남동구,12,1,0,13,8,0,2019-09-16
1803,인천,남동구,4,1,2,7,7,0,2019-10-16
1804,인천,남동구,12,2,2,16,6,0,2019-11-16
1805,인천,남동구,4,0,2,6,5,0,2019-12-16
1806,인천,동구,1,0,0,1,1,0,2019-01-16
1807,인천,동구,0,0,0,0,0,0,2019-02-16
1808,인천,동구,5,0,0,5,1,0,2019-03-16
1809,인천,동구,0,0,0,0,0,0,2019-04-16
1810,인천,동구,1,0,2,3,1,0,2019-05-16
1811,인천,동구,0,0,0,0,0,0,2019-06-16
1812,인천,동구,1,0,0,1,1,0,2019-07-16
1813,인천,동구,0,0,0,0,0,0,2019-08-16
1814,인천,동구,1,0,0,1,1,0,2019-09-16
1815,인천,동구,0,0,0,0,0,0,2019-10-16
1816,인천,동구,0,0,0,0,0,0,2019-11-16
1817,인천,동구,0,0,1,1,1,0,2019-12-16
1818,인천,미추홀구,0,0,1,1,1,0,2019-01-16
1819,인천,미추홀구,5,2,2,9,7,0,2019-02-16
1820,인천,미추홀구,1,0,0,1,1,0,2019-03-16
1821,인천,미추홀구,1,0,1,2,1,0,2019-04-16
1822,인천,미추홀구,6,1,0,7,4,0,2019-05-16
1823,인천,미추홀구,1,1,0,2,2,0,2019-06-16
1824,인천,미추홀구,2,0,2,4,4,0,2019-07-16
1825,인천,미추홀구,2,0,1,3,3,0,2019-08-16
1826,인천,미추홀구,1,0,1,2,2,0,2019-09-16
1827,인천,미추홀구,1,0,0,1,2,1,2019-10-16
1828,인천,미추홀구,0,1,0,1,1,0,2019-11-16
1829,인천,미추홀구,5,1,0,6,6,0,2019-12-16
1830,인천,부평구,0,0,1,1,1,0,2019-01-16
1831,인천,부평구,3,0,0,3,2,0,2019-02-16
1832,인천,부평구,4,0,1,5,4,0,2019-03-16
1833,인천,부평구,3,0,1,4,3,0,2019-04-16
1834,인천,부평구,2,0,1,3,2,0,2019-05-16
1835,인천,부평구,1,0,0,1,1,0,2019-06-16
1836,인천,부평구,4,1,2,7,6,0,2019-07-16
1837,인천,부평구,4,0,2,6,6,0,2019-08-16
1838,인천,부평구,8,0,0,8,5,0,2019-09-16
1839,인천,부평구,4,0,1,5,5,0,2019-10-16
1840,인천,부평구,3,0,1,4,4,0,2019-11-16
1841,인천,부평구,2,0,1,3,3,0,2019-12-16
1842,인천,서구,2,0,1,3,3,0,2019-01-16
1843,인천,서구,5,2,0,7,5,0,2019-02-16
1844,인천,서구,5,2,0,7,5,0,2019-03-16
1845,인천,서구,6,0,1,7,5,0,2019-04-16
1846,인천,서구,2,0,1,3,3,0,2019-05-16
1847,인천,서구,3,0,0,3,2,0,2019-06-16
1848,인천,서구,16,0,2,18,10,0,2019-07-16
1849,인천,서구,11,0,4,15,8,1,2019-08-16
1850,인천,서구,5,0,1,6,5,0,2019-09-16
1851,인천,서구,8,0,1,9,5,0,2019-10-16
1852,인천,서구,7,0,0,7,5,0,2019-11-16
1853,인천,서구,3,0,1,4,4,0,2019-12-16
1854,인천,연수구,3,1,1,5,3,0,2019-01-16
1855,인천,연수구,3,0,1,4,3,0,2019-02-16
1856,인천,연수구,0,0,0,0,0,0,2019-03-16
1857,인천,연수구,2,0,0,2,2,0,2019-04-16
1858,인천,연수구,5,2,1,8,3,0,2019-05-16
1859,인천,연수구,1,0,0,1,1,0,2019-06-16
1860,인천,연수구,0,0,0,0,0,0,2019-07-16
1861,인천,연수구,1,0,0,1,1,0,2019-08-16
1862,인천,연수구,5,0,0,5,3,0,2019-09-16
1863,인천,연수구,2,0,0,2,2,0,2019-10-16
1864,인천,연수구,0,0,0,0,0,0,2019-11-16
1865,인천,연수구,3,0,0,3,2,0,2019-12-16
1866,인천,옹진군,0,0,0,0,0,0,2019-01-16
1867,인천,옹진군,0,0,0,0,0,0,2019-02-16
1868,인천,옹진군,0,0,0,0,0,0,2019-03-16
1869,인천,옹진군,0,0,1,1,1,0,2019-04-16
1870,인천,옹진군,0,0,0,0,0,0,2019-05-16
1871,인천,옹진군,0,0,1,1,1,0,2019-07-16
1872,인천,옹진군,0,0,0,0,0,0,2019-08-16
1873,인천,옹진군,0,0,0,0,0,0,2019-09-16
1874,인천,옹진군,0,0,0,0,0,0,2019-10-16
1875,인천,옹진군,0,0,0,0,0,0,2019-12-16
1876,인천,중구,1,0,0,1,2,1,2019-01-16
1877,인천,중구,17,0,3,20,6,0,2019-02-16
1878,인천,중구,2,0,0,2,1,0,2019-03-16
1879,인천,중구,1,0,1,2,2,0,2019-04-16
1880,인천,중구,0,0,0,0,0,0,2019-05-16
1881,인천,중구,0,0,0,0,0,0,2019-06-16
1882,인천,중구,2,0,0,2,2,0,2019-07-16
1883,인천,중구,2,0,1,3,3,0,2019-08-16
1884,인천,중구,1,0,0,1,1,0,2019-09-16
1885,인천,중구,4,0,0,4,4,0,2019-10-16
1886,인천,중구,0,0,0,0,0,0,2019-11-16
1887,인천,중구,4,0,2,6,4,0,2019-12-16
1888,인천,강화군,0,0,1,1,2,1,2019-01-17
1889,인천,강화군,1,0,0,1,1,0,2019-02-17
1890,인천,강화군,2,0,1,3,2,0,2019-03-17
1891,인천,강화군,0,0,0,0,0,0,2019-04-17
1892,인천,강화군,0,0,0,0,0,0,2019-05-17
1893,인천,강화군,0,0,0,0,0,0,2019-06-17
1894,인천,강화군,1,0,0,1,2,1,2019-07-17
1895,인천,강화군,1,0,0,1,1,0,2019-08-17
1896,인천,강화군,0,0,0,0,0,0,2019-09-17
1897,인천,강화군,0,0,0,0,0,0,2019-10-17
1898,인천,강화군,0,0,0,0,0,0,2019-11-17
1899,인천,강화군,0,0,0,0,0,0,2019-12-17
1900,인천,계양구,3,1,0,4,2,0,2019-01-17
1901,인천,계양구,3,0,0,3,1,0,2019-02-17
1902,인천,계양구,1,0,0,1,1,0,2019-03-17
1903,인천,계양구,1,0,0,1,1,0,2019-04-17
1904,인천,계양구,1,0,1,2,2,0,2019-05-17
1905,인천,계양구,2,0,0,2,3,1,2019-06-17
1906,인천,계양구,1,0,1,2,2,0,2019-07-17
1907,인천,계양구,0,0,0,0,0,0,2019-08-17
1908,인천,계양구,1,0,0,1,1,0,2019-09-17
1909,인천,계양구,5,0,1,6,4,0,2019-10-17
1910,인천,계양구,2,0,1,3,3,0,2019-11-17
1911,인천,계양구,5,1,0,6,1,0,2019-12-17
1912,인천,남동구,8,0,0,8,7,1,2019-01-17
1913,인천,남동구,1,0,2,3,2,0,2019-02-17
1914,인천,남동구,16,0,1,17,11,0,2019-03-17
1915,인천,남동구,10,0,0,10,8,0,2019-04-17
1916,인천,남동구,2,1,1,4,4,0,2019-05-17
1917,인천,남동구,3,0,4,7,6,0,2019-06-17
1918,인천,남동구,7,1,3,11,7,0,2019-07-17
1919,인천,남동구,10,0,1,11,7,0,2019-08-17
1920,인천,남동구,8,1,2,11,7,0,2019-09-17
1921,인천,남동구,3,0,1,4,4,0,2019-10-17
1922,인천,남동구,10,0,0,10,6,0,2019-11-17
1923,인천,남동구,6,1,1,8,8,0,2019-12-17
1924,인천,동구,0,0,1,1,1,0,2019-01-17
1925,인천,동구,0,0,0,0,0,0,2019-02-17
1926,인천,동구,0,0,0,0,0,0,2019-03-17
1927,인천,동구,0,0,0,0,0,0,2019-04-17
1928,인천,동구,0,0,0,0,0,0,2019-05-17
1929,인천,동구,0,0,0,0,0,0,2019-06-17
1930,인천,동구,0,0,1,1,1,0,2019-07-17
1931,인천,동구,1,0,0,1,1,0,2019-08-17
1932,인천,동구,1,0,0,1,1,0,2019-09-17
1933,인천,동구,0,0,0,0,0,0,2019-10-17
1934,인천,동구,0,0,0,0,0,0,2019-11-17
1935,인천,동구,0,0,0,0,0,0,2019-12-17
1936,인천,미추홀구,1,0,0,1,1,0,2019-01-17
1937,인천,미추홀구,2,0,0,2,2,0,2019-02-17
1938,인천,미추홀구,6,2,0,8,2,0,2019-03-17
1939,인천,미추홀구,3,0,0,3,2,0,2019-04-17
1940,인천,미추홀구,6,0,1,7,3,0,2019-05-17
1941,인천,미추홀구,4,0,0,4,2,0,2019-06-17
1942,인천,미추홀구,1,0,0,1,1,0,2019-07-17
1943,인천,미추홀구,3,0,1,4,4,0,2019-08-17
1944,인천,미추홀구,0,0,0,0,0,0,2019-09-17
1945,인천,미추홀구,1,0,1,2,2,0,2019-10-17
1946,인천,미추홀구,2,0,0,2,2,0,2019-11-17
1947,인천,미추홀구,6,0,1,7,6,0,2019-12-17
1948,인천,부평구,1,0,0,1,1,0,2019-01-17
1949,인천,부평구,5,0,1,6,6,0,2019-02-17
1950,인천,부평구,10,0,0,10,7,0,2019-03-17
1951,인천,부평구,3,0,0,3,2,0,2019-04-17
1952,인천,부평구,1,1,0,2,2,0,2019-05-17
1953,인천,부평구,3,0,0,3,3,0,2019-06-17
1954,인천,부평구,1,0,1,2,2,0,2019-07-17
1955,인천,부평구,4,0,2,6,4,0,2019-08-17
1956,인천,부평구,1,0,1,2,2,0,2019-09-17
1957,인천,부평구,4,0,1,5,5,0,2019-10-17
1958,인천,부평구,0,0,0,0,0,0,2019-11-17
1959,인천,부평구,2,1,1,4,4,0,2019-12-17
1960,인천,서구,3,0,1,4,4,0,2019-01-17
1961,인천,서구,5,0,0,5,3,0,2019-02-17
1962,인천,서구,3,0,0,3,2,0,2019-03-17
1963,인천,서구,4,0,0,4,4,0,2019-04-17
1964,인천,서구,2,0,1,3,3,0,2019-05-17
1965,인천,서구,4,0,1,5,6,1,2019-06-17
1966,인천,서구,4,0,0,4,4,0,2019-07-17
1967,인천,서구,6,0,2,8,5,0,2019-08-17
1968,인천,서구,8,0,0,8,5,0,2019-09-17
1969,인천,서구,10,0,3,13,8,0,2019-10-17
1970,인천,서구,1,0,3,4,4,0,2019-11-17
1971,인천,서구,7,0,2,9,7,0,2019-12-17
1972,인천,연수구,1,0,0,1,1,0,2019-01-17
1973,인천,연수구,1,0,0,1,1,0,2019-02-17
1974,인천,연수구,7,0,0,7,2,0,2019-03-17
1975,인천,연수구,2,0,0,2,2,0,2019-04-17
1976,인천,연수구,1,0,0,1,1,0,2019-05-17
1977,인천,연수구,5,0,1,6,3,0,2019-06-17
1978,인천,연수구,1,0,0,1,1,0,2019-07-17
1979,인천,연수구,1,0,0,1,1,0,2019-08-17
1980,인천,연수구,2,0,1,3,3,0,2019-09-17
1981,인천,연수구,3,1,0,4,3,0,2019-10-17
1982,인천,연수구,7,0,0,7,4,0,2019-11-17
1983,인천,연수구,4,0,0,4,3,0,2019-12-17
1984,인천,옹진군,0,0,0,0,0,0,2019-01-17
1985,인천,옹진군,0,0,0,0,0,0,2019-02-17
1986,인천,옹진군,0,0,0,0,0,0,2019-03-17
1987,인천,옹진군,0,0,0,0,0,0,2019-04-17
1988,인천,옹진군,0,0,0,0,0,0,2019-05-17
1989,인천,옹진군,0,0,0,0,0,0,2019-07-17
1990,인천,옹진군,0,0,0,0,0,0,2019-08-17
1991,인천,옹진군,0,0,0,0,0,0,2019-09-17
1992,인천,옹진군,0,0,0,0,0,0,2019-10-17
1993,인천,옹진군,0,0,0,0,0,0,2019-12-17
1994,인천,중구,0,0,0,0,0,0,2019-01-17
1995,인천,중구,1,0,0,1,1,0,2019-02-17
1996,인천,중구,0,0,2,2,2,0,2019-03-17
1997,인천,중구,3,0,0,3,3,0,2019-04-17
1998,인천,중구,1,0,0,1,1,0,2019-05-17
1999,인천,중구,3,0,1,4,3,0,2019-06-17
2000,인천,중구,3,0,0,3,2,0,2019-07-17
2001,인천,중구,0,0,0,0,0,0,2019-08-17
2002,인천,중구,1,0,0,1,1,0,2019-09-17
2003,인천,중구,7,0,0,7,4,0,2019-10-17
2004,인천,중구,1,0,0,1,1,0,2019-11-17
2005,인천,중구,3,0,0,3,2,0,2019-12-17
2006,인천,강화군,0,0,0,0,0,0,2019-01-18
2007,인천,강화군,0,0,0,0,0,0,2019-02-18
2008,인천,강화군,0,0,1,1,1,0,2019-03-18
2009,인천,강화군,0,0,0,0,0,0,2019-04-18
2010,인천,강화군,1,0,0,1,1,0,2019-05-18
2011,인천,강화군,0,0,1,1,1,0,2019-06-18
2012,인천,강화군,0,0,0,0,0,0,2019-07-18
2013,인천,강화군,0,0,0,0,0,0,2019-08-18
2014,인천,강화군,0,0,0,0,0,0,2019-09-18
2015,인천,강화군,3,0,0,3,2,0,2019-10-18
2016,인천,강화군,0,0,0,0,0,0,2019-11-18
2017,인천,강화군,0,0,1,1,1,0,2019-12-18
2018,인천,계양구,1,0,0,1,1,0,2019-01-18
2019,인천,계양구,4,0,1,5,4,0,2019-02-18
2020,인천,계양구,4,1,0,5,3,0,2019-03-18
2021,인천,계양구,0,0,0,0,0,0,2019-04-18
2022,인천,계양구,0,0,0,0,0,0,2019-05-18
2023,인천,계양구,3,0,0,3,1,0,2019-06-18
2024,인천,계양구,4,0,2,6,4,0,2019-07-18
2025,인천,계양구,1,0,0,1,1,0,2019-08-18
2026,인천,계양구,3,0,0,3,3,0,2019-09-18
2027,인천,계양구,5,0,0,5,4,0,2019-10-18
2028,인천,계양구,3,0,1,4,3,0,2019-11-18
2029,인천,계양구,4,0,2,6,4,0,2019-12-18
2030,인천,남동구,4,0,3,7,5,0,2019-01-18
2031,인천,남동구,3,0,2,5,3,0,2019-02-18
2032,인천,남동구,1,0,0,1,1,0,2019-03-18
2033,인천,남동구,11,0,0,11,8,0,2019-04-18
2034,인천,남동구,15,1,3,19,9,0,2019-05-18
2035,인천,남동구,7,4,1,12,5,0,2019-06-18
2036,인천,남동구,6,0,0,6,3,0,2019-07-18
2037,인천,남동구,5,1,1,7,5,0,2019-08-18
2038,인천,남동구,3,0,1,4,4,0,2019-09-18
2039,인천,남동구,6,0,3,9,6,0,2019-10-18
2040,인천,남동구,6,0,1,7,6,0,2019-11-18
2041,인천,남동구,3,0,0,3,2,0,2019-12-18
2042,인천,동구,1,0,0,1,1,0,2019-01-18
2043,인천,동구,0,0,0,0,0,0,2019-02-18
2044,인천,동구,0,0,0,0,0,0,2019-03-18
2045,인천,동구,0,0,0,0,0,0,2019-04-18
2046,인천,동구,0,0,0,0,0,0,2019-05-18
2047,인천,동구,0,0,0,0,0,0,2019-06-18
2048,인천,동구,0,0,1,1,1,0,2019-07-18
2049,인천,동구,0,0,0,0,0,0,2019-08-18
2050,인천,동구,2,0,0,2,2,0,2019-09-18
2051,인천,동구,3,0,0,3,2,0,2019-10-18
2052,인천,동구,0,0,0,0,0,0,2019-11-18
2053,인천,동구,0,0,0,0,0,0,2019-12-18
2054,인천,미추홀구,4,3,2,9,6,0,2019-01-18
2055,인천,미추홀구,8,0,0,8,4,0,2019-02-18
2056,인천,미추홀구,6,0,1,7,4,0,2019-03-18
2057,인천,미추홀구,2,0,0,2,2,0,2019-04-18
2058,인천,미추홀구,0,0,2,2,2,0,2019-05-18
2059,인천,미추홀구,1,2,1,4,4,0,2019-06-18
2060,인천,미추홀구,3,0,6,9,5,0,2019-07-18
2061,인천,미추홀구,4,0,1,5,2,0,2019-08-18
2062,인천,미추홀구,5,0,1,6,4,0,2019-09-18
2063,인천,미추홀구,1,0,1,2,2,0,2019-10-18
2064,인천,미추홀구,1,0,1,2,2,0,2019-11-18
2065,인천,미추홀구,2,2,1,5,4,1,2019-12-18
2066,인천,부평구,1,0,0,1,1,0,2019-01-18
2067,인천,부평구,4,0,0,4,2,0,2019-02-18
2068,인천,부평구,7,0,0,7,2,0,2019-03-18
2069,인천,부평구,2,0,1,3,3,0,2019-04-18
2070,인천,부평구,9,2,2,13,5,0,2019-05-18
2071,인천,부평구,4,0,1,5,5,0,2019-06-18
2072,인천,부평구,7,0,0,7,5,0,2019-07-18
2073,인천,부평구,0,1,0,1,1,0,2019-08-18
2074,인천,부평구,4,0,0,4,3,0,2019-09-18
2075,인천,부평구,1,0,1,2,2,0,2019-10-18
2076,인천,부평구,5,0,2,7,6,0,2019-11-18
2077,인천,부평구,0,0,1,1,1,0,2019-12-18
2078,인천,서구,7,1,2,10,7,1,2019-01-18
2079,인천,서구,3,0,2,5,4,0,2019-02-18
2080,인천,서구,3,0,1,4,3,0,2019-03-18
2081,인천,서구,4,2,0,6,4,0,2019-04-18
2082,인천,서구,3,0,5,8,6,0,2019-05-18
2083,인천,서구,7,0,2,9,8,0,2019-06-18
2084,인천,서구,2,0,3,5,5,0,2019-07-18
2085,인천,서구,1,0,1,2,2,0,2019-08-18
2086,인천,서구,10,1,2,13,6,0,2019-09-18
2087,인천,서구,13,1,1,15,11,0,2019-10-18
2088,인천,서구,11,0,1,12,5,0,2019-11-18
2089,인천,서구,8,1,0,9,7,0,2019-12-18
2090,인천,연수구,0,1,0,1,1,0,2019-01-18
2091,인천,연수구,2,0,0,2,1,0,2019-02-18
2092,인천,연수구,1,0,0,1,1,0,2019-03-18
2093,인천,연수구,3,0,2,5,2,0,2019-04-18
2094,인천,연수구,1,0,0,1,1,0,2019-05-18
2095,인천,연수구,0,0,2,2,2,0,2019-06-18
2096,인천,연수구,0,0,0,0,0,0,2019-07-18
2097,인천,연수구,3,0,0,3,1,0,2019-08-18
2098,인천,연수구,2,0,1,3,2,0,2019-09-18
2099,인천,연수구,1,0,1,2,2,0,2019-10-18
2100,인천,연수구,4,0,0,4,1,0,2019-11-18
2101,인천,연수구,1,0,0,1,1,0,2019-12-18
2102,인천,옹진군,0,0,0,0,0,0,2019-01-18
2103,인천,옹진군,0,0,0,0,0,0,2019-02-18
2104,인천,옹진군,0,0,0,0,0,0,2019-03-18
2105,인천,옹진군,0,0,0,0,0,0,2019-04-18
2106,인천,옹진군,0,0,0,0,0,0,2019-05-18
2107,인천,옹진군,0,0,0,0,0,0,2019-07-18
2108,인천,옹진군,0,0,0,0,0,0,2019-08-18
2109,인천,옹진군,0,0,0,0,0,0,2019-09-18
2110,인천,옹진군,0,0,0,0,0,0,2019-10-18
2111,인천,옹진군,0,0,0,0,0,0,2019-12-18
2112,인천,중구,1,0,0,1,1,0,2019-01-18
2113,인천,중구,2,0,0,2,2,0,2019-02-18
2114,인천,중구,1,0,0,1,1,0,2019-03-18
2115,인천,중구,0,0,0,0,0,0,2019-04-18
2116,인천,중구,2,0,0,2,2,0,2019-05-18
2117,인천,중구,6,0,1,7,4,0,2019-06-18
2118,인천,중구,2,0,0,2,2,0,2019-07-18
2119,인천,중구,0,0,0,0,0,0,2019-08-18
2120,인천,중구,1,0,0,1,1,0,2019-09-18
2121,인천,중구,2,0,1,3,3,0,2019-10-18
2122,인천,중구,1,0,0,1,1,0,2019-11-18
2123,인천,중구,1,0,0,1,1,0,2019-12-18
2124,인천,강화군,0,0,0,0,0,0,2019-01-19
2125,인천,강화군,0,0,0,0,0,0,2019-02-19
2126,인천,강화군,0,0,1,1,1,0,2019-03-19
2127,인천,강화군,0,0,1,1,1,0,2019-04-19
2128,인천,강화군,0,0,0,0,0,0,2019-05-19
2129,인천,강화군,0,0,1,1,1,0,2019-06-19
2130,인천,강화군,0,0,0,0,0,0,2019-07-19
2131,인천,강화군,2,0,0,2,1,0,2019-08-19
2132,인천,강화군,1,0,1,2,2,0,2019-09-19
2133,인천,강화군,0,0,1,1,1,0,2019-10-19
2134,인천,강화군,0,0,0,0,0,0,2019-11-19
2135,인천,강화군,0,0,0,0,0,0,2019-12-19
2136,인천,계양구,3,0,0,3,1,0,2019-01-19
2137,인천,계양구,2,0,0,2,2,0,2019-02-19
2138,인천,계양구,2,0,1,3,2,0,2019-03-19
2139,인천,계양구,0,0,0,0,0,0,2019-04-19
2140,인천,계양구,2,0,0,2,2,0,2019-05-19
2141,인천,계양구,0,0,1,1,2,1,2019-06-19
2142,인천,계양구,3,0,3,6,3,0,2019-07-19
2143,인천,계양구,3,0,0,3,1,0,2019-08-19
2144,인천,계양구,3,0,0,3,3,0,2019-09-19
2145,인천,계양구,0,0,0,0,0,0,2019-10-19
2146,인천,계양구,0,0,0,0,0,0,2019-11-19
2147,인천,계양구,3,1,0,4,4,0,2019-12-19
2148,인천,남동구,4,0,0,4,3,0,2019-01-19
2149,인천,남동구,4,0,2,6,5,0,2019-02-19
2150,인천,남동구,1,0,1,2,2,0,2019-03-19
2151,인천,남동구,11,0,4,15,8,0,2019-04-19
2152,인천,남동구,10,0,2,12,8,0,2019-05-19
2153,인천,남동구,8,1,1,10,8,1,2019-06-19
2154,인천,남동구,10,0,7,17,12,0,2019-07-19
2155,인천,남동구,14,0,2,16,12,0,2019-08-19
2156,인천,남동구,6,0,1,7,6,0,2019-09-19
2157,인천,남동구,2,1,1,4,3,0,2019-10-19
2158,인천,남동구,18,0,2,20,11,0,2019-11-19
2159,인천,남동구,3,0,0,3,3,0,2019-12-19
2160,인천,동구,0,0,0,0,0,0,2019-01-19
2161,인천,동구,0,0,0,0,0,0,2019-02-19
2162,인천,동구,0,0,0,0,0,0,2019-03-19
2163,인천,동구,5,0,0,5,1,0,2019-04-19
2164,인천,동구,1,0,0,1,1,0,2019-05-19
2165,인천,동구,0,0,0,0,0,0,2019-06-19
2166,인천,동구,2,0,0,2,1,0,2019-07-19
2167,인천,동구,0,0,0,0,0,0,2019-08-19
2168,인천,동구,0,0,0,0,0,0,2019-09-19
2169,인천,동구,1,0,0,1,1,0,2019-10-19
2170,인천,동구,0,0,0,0,0,0,2019-11-19
2171,인천,동구,0,0,0,0,0,0,2019-12-19
2172,인천,미추홀구,0,0,1,1,1,0,2019-01-19
2173,인천,미추홀구,2,1,0,3,3,0,2019-02-19
2174,인천,미추홀구,1,0,1,2,2,0,2019-03-19
2175,인천,미추홀구,3,1,0,4,4,0,2019-04-19
2176,인천,미추홀구,3,0,2,5,3,0,2019-05-19
2177,인천,미추홀구,1,0,0,1,1,0,2019-06-19
2178,인천,미추홀구,1,1,3,5,3,0,2019-07-19
2179,인천,미추홀구,2,0,0,2,1,0,2019-08-19
2180,인천,미추홀구,2,0,1,3,2,0,2019-09-19
2181,인천,미추홀구,9,1,0,10,5,0,2019-10-19
2182,인천,미추홀구,1,0,1,2,2,0,2019-11-19
2183,인천,미추홀구,3,1,0,4,4,0,2019-12-19
2184,인천,부평구,1,0,1,2,2,0,2019-01-19
2185,인천,부평구,2,0,0,2,2,0,2019-02-19
2186,인천,부평구,6,0,1,7,4,0,2019-03-19
2187,인천,부평구,2,0,2,4,4,0,2019-04-19
2188,인천,부평구,7,0,0,7,4,0,2019-05-19
2189,인천,부평구,2,1,1,4,3,0,2019-06-19
2190,인천,부평구,2,0,0,2,2,0,2019-07-19
2191,인천,부평구,1,0,0,1,1,0,2019-08-19
2192,인천,부평구,2,0,0,2,1,0,2019-09-19
2193,인천,부평구,4,1,1,6,4,0,2019-10-19
2194,인천,부평구,4,0,0,4,4,0,2019-11-19
2195,인천,부평구,5,0,0,5,3,0,2019-12-19
2196,인천,서구,0,0,0,0,0,0,2019-01-19
2197,인천,서구,7,0,2,9,5,0,2019-02-19
2198,인천,서구,4,0,1,5,4,0,2019-03-19
2199,인천,서구,3,0,0,3,3,0,2019-04-19
2200,인천,서구,7,0,3,10,9,1,2019-05-19
2201,인천,서구,4,0,1,5,4,0,2019-06-19
2202,인천,서구,5,0,0,5,5,0,2019-07-19
2203,인천,서구,3,0,1,4,3,0,2019-08-19
2204,인천,서구,6,0,2,8,5,0,2019-09-19
2205,인천,서구,6,0,1,7,5,0,2019-10-19
2206,인천,서구,8,0,5,13,8,0,2019-11-19
2207,인천,서구,13,0,1,14,11,0,2019-12-19
2208,인천,연수구,0,0,0,0,0,0,2019-01-19
2209,인천,연수구,0,0,0,0,0,0,2019-02-19
2210,인천,연수구,2,0,1,3,3,0,2019-03-19
2211,인천,연수구,5,0,1,6,3,0,2019-04-19
2212,인천,연수구,3,0,0,3,2,0,2019-05-19
2213,인천,연수구,1,0,0,1,1,0,2019-06-19
2214,인천,연수구,1,0,0,1,1,0,2019-07-19
2215,인천,연수구,1,0,0,1,1,0,2019-08-19
2216,인천,연수구,2,0,2,4,3,0,2019-09-19
2217,인천,연수구,8,0,1,9,3,0,2019-10-19
2218,인천,연수구,3,0,2,5,3,0,2019-11-19
2219,인천,연수구,1,0,5,6,4,0,2019-12-19
2220,인천,옹진군,0,0,0,0,0,0,2019-01-19
2221,인천,옹진군,0,0,0,0,0,0,2019-02-19
2222,인천,옹진군,0,0,0,0,0,0,2019-03-19
2223,인천,옹진군,0,0,0,0,0,0,2019-04-19
2224,인천,옹진군,2,0,4,6,2,0,2019-05-19
2225,인천,옹진군,0,0,0,0,0,0,2019-07-19
2226,인천,옹진군,0,0,0,0,0,0,2019-08-19
2227,인천,옹진군,0,0,0,0,0,0,2019-09-19
2228,인천,옹진군,0,0,0,0,0,0,2019-10-19
2229,인천,옹진군,0,0,0,0,0,0,2019-12-19
2230,인천,중구,0,0,0,0,0,0,2019-01-19
2231,인천,중구,4,0,1,5,3,0,2019-02-19
2232,인천,중구,4,1,1,6,2,0,2019-03-19
2233,인천,중구,6,1,1,8,4,0,2019-04-19
2234,인천,중구,2,0,0,2,2,0,2019-05-19
2235,인천,중구,0,0,0,0,0,0,2019-06-19
2236,인천,중구,2,0,0,2,2,0,2019-07-19
2237,인천,중구,5,1,0,6,4,0,2019-08-19
2238,인천,중구,7,0,0,7,3,0,2019-09-19
2239,인천,중구,6,0,0,6,3,0,2019-10-19
2240,인천,중구,0,0,0,0,0,0,2019-11-19
2241,인천,중구,0,0,0,0,0,0,2019-12-19
2242,인천,강화군,0,0,0,0,0,0,2019-01-20
2243,인천,강화군,1,0,0,1,1,0,2019-02-20
2244,인천,강화군,0,0,0,0,0,0,2019-03-20
2245,인천,강화군,3,0,1,4,1,0,2019-04-20
2246,인천,강화군,0,0,0,0,0,0,2019-05-20
2247,인천,강화군,1,0,0,1,1,0,2019-06-20
2248,인천,강화군,2,0,1,3,1,0,2019-07-20
2249,인천,강화군,0,0,0,0,0,0,2019-08-20
2250,인천,강화군,0,0,0,0,0,0,2019-09-20
2251,인천,강화군,2,0,0,2,1,0,2019-10-20
2252,인천,강화군,0,0,0,0,0,0,2019-11-20
2253,인천,강화군,0,0,0,0,0,0,2019-12-20
2254,인천,계양구,0,0,2,2,2,0,2019-01-20
2255,인천,계양구,0,0,0,0,0,0,2019-02-20
2256,인천,계양구,4,1,1,6,2,0,2019-03-20
2257,인천,계양구,4,0,0,4,3,0,2019-04-20
2258,인천,계양구,4,0,2,6,4,0,2019-05-20
2259,인천,계양구,0,0,1,1,1,0,2019-06-20
2260,인천,계양구,0,0,2,2,2,0,2019-07-20
2261,인천,계양구,6,0,0,6,4,0,2019-08-20
2262,인천,계양구,7,0,0,7,4,0,2019-09-20
2263,인천,계양구,2,0,1,3,2,0,2019-10-20
2264,인천,계양구,6,0,1,7,4,0,2019-11-20
2265,인천,계양구,2,0,0,2,1,0,2019-12-20
2266,인천,남동구,2,1,3,6,3,0,2019-01-20
2267,인천,남동구,6,0,3,9,7,0,2019-02-20
2268,인천,남동구,2,0,0,2,2,0,2019-03-20
2269,인천,남동구,4,1,0,5,3,0,2019-04-20
2270,인천,남동구,9,1,1,11,8,0,2019-05-20
2271,인천,남동구,5,0,1,6,5,0,2019-06-20
2272,인천,남동구,18,0,1,19,11,0,2019-07-20
2273,인천,남동구,3,0,2,5,4,0,2019-08-20
2274,인천,남동구,4,2,1,7,3,0,2019-09-20
2275,인천,남동구,6,0,2,8,5,0,2019-10-20
2276,인천,남동구,5,1,4,10,10,0,2019-11-20
2277,인천,남동구,6,0,3,9,8,0,2019-12-20
2278,인천,동구,2,0,1,3,2,0,2019-01-20
2279,인천,동구,1,0,0,1,1,0,2019-02-20
2280,인천,동구,2,0,0,2,1,0,2019-03-20
2281,인천,동구,0,0,0,0,0,0,2019-04-20
2282,인천,동구,0,0,0,0,0,0,2019-05-20
2283,인천,동구,0,0,0,0,0,0,2019-06-20
2284,인천,동구,2,0,0,2,1,0,2019-07-20
2285,인천,동구,1,0,0,1,1,0,2019-08-20
2286,인천,동구,3,0,0,3,2,0,2019-09-20
2287,인천,동구,0,0,0,0,0,0,2019-10-20
2288,인천,동구,0,0,0,0,0,0,2019-11-20
2289,인천,동구,4,0,0,4,1,0,2019-12-20
2290,인천,미추홀구,1,0,2,3,3,0,2019-01-20
2291,인천,미추홀구,5,0,1,6,3,0,2019-02-20
2292,인천,미추홀구,4,1,0,5,5,0,2019-03-20
2293,인천,미추홀구,4,0,0,4,4,0,2019-04-20
2294,인천,미추홀구,0,0,2,2,2,0,2019-05-20
2295,인천,미추홀구,4,1,0,5,4,0,2019-06-20
2296,인천,미추홀구,9,0,0,9,4,0,2019-07-20
2297,인천,미추홀구,3,0,0,3,3,0,2019-08-20
2298,인천,미추홀구,3,1,1,5,5,0,2019-09-20
2299,인천,미추홀구,1,0,0,1,2,1,2019-10-20
2300,인천,미추홀구,6,1,0,7,5,0,2019-11-20
2301,인천,미추홀구,2,0,1,3,3,0,2019-12-20
2302,인천,부평구,0,1,0,1,1,0,2019-01-20
2303,인천,부평구,1,0,0,1,1,0,2019-02-20
2304,인천,부평구,2,0,1,3,2,0,2019-03-20
2305,인천,부평구,4,0,1,5,3,0,2019-04-20
2306,인천,부평구,0,0,0,0,1,1,2019-05-20
2307,인천,부평구,4,0,0,4,4,0,2019-06-20
2308,인천,부평구,5,0,0,5,4,0,2019-07-20
2309,인천,부평구,3,0,3,6,6,0,2019-08-20
2310,인천,부평구,7,0,1,8,4,0,2019-09-20
2311,인천,부평구,3,0,0,3,2,0,2019-10-20
2312,인천,부평구,2,0,3,5,5,0,2019-11-20
2313,인천,부평구,2,2,1,5,5,0,2019-12-20
2314,인천,서구,2,0,1,3,3,0,2019-01-20
2315,인천,서구,4,0,2,6,4,0,2019-02-20
2316,인천,서구,7,3,0,10,9,0,2019-03-20
2317,인천,서구,6,0,0,6,5,0,2019-04-20
2318,인천,서구,5,0,1,6,5,0,2019-05-20
2319,인천,서구,3,0,1,4,4,0,2019-06-20
2320,인천,서구,4,0,0,4,3,0,2019-07-20
2321,인천,서구,5,0,4,9,5,0,2019-08-20
2322,인천,서구,1,0,0,1,1,0,2019-09-20
2323,인천,서구,0,0,0,0,0,0,2019-10-20
2324,인천,서구,3,0,3,6,5,0,2019-11-20
2325,인천,서구,13,0,1,14,8,0,2019-12-20
2326,인천,연수구,5,0,0,5,2,0,2019-01-20
2327,인천,연수구,1,0,0,1,1,0,2019-02-20
2328,인천,연수구,3,0,3,6,2,0,2019-03-20
2329,인천,연수구,3,0,0,3,3,0,2019-04-20
2330,인천,연수구,2,0,0,2,2,0,2019-05-20
2331,인천,연수구,4,0,0,4,4,0,2019-06-20
2332,인천,연수구,2,0,1,3,1,0,2019-07-20
2333,인천,연수구,1,0,0,1,1,0,2019-08-20
2334,인천,연수구,1,0,0,1,1,0,2019-09-20
2335,인천,연수구,1,0,0,1,1,0,2019-10-20
2336,인천,연수구,4,0,1,5,3,0,2019-11-20
2337,인천,연수구,0,0,1,1,1,0,2019-12-20
2338,인천,옹진군,0,0,0,0,0,0,2019-01-20
2339,인천,옹진군,0,0,0,0,0,0,2019-02-20
2340,인천,옹진군,0,0,0,0,0,0,2019-03-20
2341,인천,옹진군,0,0,0,0,0,0,2019-04-20
2342,인천,옹진군,0,0,0,0,0,0,2019-05-20
2343,인천,옹진군,0,0,0,0,0,0,2019-07-20
2344,인천,옹진군,0,0,0,0,0,0,2019-08-20
2345,인천,옹진군,0,0,0,0,0,0,2019-09-20
2346,인천,옹진군,0,0,0,0,0,0,2019-10-20
2347,인천,옹진군,0,0,0,0,0,0,2019-12-20
2348,인천,중구,4,0,1,5,1,1,2019-01-20
2349,인천,중구,2,0,0,2,1,0,2019-02-20
2350,인천,중구,0,0,0,0,0,0,2019-03-20
2351,인천,중구,0,0,0,0,0,0,2019-04-20
2352,인천,중구,3,0,1,4,3,0,2019-05-20
2353,인천,중구,3,0,6,9,2,0,2019-06-20
2354,인천,중구,2,0,0,2,2,0,2019-07-20
2355,인천,중구,1,0,0,1,1,0,2019-08-20
2356,인천,중구,1,0,1,2,1,0,2019-09-20
2357,인천,중구,5,0,1,6,2,0,2019-10-20
2358,인천,중구,0,0,0,0,0,0,2019-11-20
2359,인천,중구,2,1,1,4,3,0,2019-12-20
2360,인천,강화군,1,0,0,1,1,0,2019-01-21
2361,인천,강화군,0,0,0,0,0,0,2019-02-21
2362,인천,강화군,3,0,3,6,1,0,2019-03-21
2363,인천,강화군,5,0,0,5,1,0,2019-04-21
2364,인천,강화군,1,0,0,1,1,0,2019-05-21
2365,인천,강화군,1,0,0,1,1,0,2019-06-21
2366,인천,강화군,0,0,0,0,0,0,2019-07-21
2367,인천,강화군,0,0,1,1,1,0,2019-08-21
2368,인천,강화군,1,0,0,1,1,0,2019-09-21
2369,인천,강화군,0,0,1,1,1,0,2019-10-21
2370,인천,강화군,0,0,1,1,1,0,2019-11-21
2371,인천,강화군,0,0,0,0,0,0,2019-12-21
2372,인천,계양구,1,0,1,2,2,0,2019-01-21
2373,인천,계양구,3,0,0,3,2,0,2019-02-21
2374,인천,계양구,1,1,3,5,2,0,2019-03-21
2375,인천,계양구,3,0,0,3,1,0,2019-04-21
2376,인천,계양구,1,0,0,1,1,0,2019-05-21
2377,인천,계양구,0,0,1,1,1,0,2019-06-21
2378,인천,계양구,6,0,0,6,3,0,2019-07-21
2379,인천,계양구,0,0,0,0,0,0,2019-08-21
2380,인천,계양구,4,0,0,4,3,0,2019-09-21
2381,인천,계양구,3,1,0,4,3,0,2019-10-21
2382,인천,계양구,5,0,2,7,6,0,2019-11-21
2383,인천,계양구,4,0,2,6,4,0,2019-12-21
2384,인천,남동구,2,0,1,3,3,0,2019-01-21
2385,인천,남동구,13,1,2,16,7,0,2019-02-21
2386,인천,남동구,11,0,3,14,8,0,2019-03-21
2387,인천,남동구,0,0,0,0,0,0,2019-04-21
2388,인천,남동구,8,0,1,9,5,0,2019-05-21
2389,인천,남동구,12,0,0,12,7,0,2019-06-21
2390,인천,남동구,9,0,0,9,5,0,2019-07-21
2391,인천,남동구,2,0,0,2,2,0,2019-08-21
2392,인천,남동구,3,0,1,4,4,0,2019-09-21
2393,인천,남동구,7,1,0,8,7,0,2019-10-21
2394,인천,남동구,3,0,2,5,5,0,2019-11-21
2395,인천,남동구,8,1,2,11,7,1,2019-12-21
2396,인천,동구,1,0,0,1,1,0,2019-01-21
2397,인천,동구,0,0,0,0,0,0,2019-02-21
2398,인천,동구,2,0,0,2,1,0,2019-03-21
2399,인천,동구,0,0,0,0,0,0,2019-04-21
2400,인천,동구,0,0,0,0,0,0,2019-05-21
2401,인천,동구,1,0,0,1,1,0,2019-06-21
2402,인천,동구,1,0,0,1,1,0,2019-07-21
2403,인천,동구,0,0,1,1,1,0,2019-08-21
2404,인천,동구,0,0,0,0,0,0,2019-09-21
2405,인천,동구,1,0,0,1,1,0,2019-10-21
2406,인천,동구,0,0,0,0,0,0,2019-11-21
2407,인천,동구,0,0,0,0,0,0,2019-12-21
2408,인천,미추홀구,2,1,1,4,4,0,2019-01-21
2409,인천,미추홀구,2,2,0,4,4,0,2019-02-21
2410,인천,미추홀구,4,1,0,5,3,0,2019-03-21
2411,인천,미추홀구,1,0,0,1,1,0,2019-04-21
2412,인천,미추홀구,1,1,2,4,3,0,2019-05-21
2413,인천,미추홀구,2,0,1,3,2,0,2019-06-21
2414,인천,미추홀구,5,0,0,5,3,0,2019-07-21
2415,인천,미추홀구,4,1,1,6,5,0,2019-08-21
2416,인천,미추홀구,1,0,1,2,2,0,2019-09-21
2417,인천,미추홀구,7,0,0,7,5,0,2019-10-21
2418,인천,미추홀구,1,1,0,2,2,0,2019-11-21
2419,인천,미추홀구,6,0,2,8,5,0,2019-12-21
2420,인천,부평구,1,0,2,3,3,0,2019-01-21
2421,인천,부평구,3,0,0,3,2,0,2019-02-21
2422,인천,부평구,2,0,0,2,1,0,2019-03-21
2423,인천,부평구,6,0,1,7,4,0,2019-04-21
2424,인천,부평구,2,0,1,3,3,0,2019-05-21
2425,인천,부평구,6,0,1,7,6,0,2019-06-21
2426,인천,부평구,5,0,2,7,5,1,2019-07-21
2427,인천,부평구,5,0,1,6,6,0,2019-08-21
2428,인천,부평구,2,0,2,4,3,0,2019-09-21
2429,인천,부평구,2,0,0,2,2,0,2019-10-21
2430,인천,부평구,9,0,0,9,5,0,2019-11-21
2431,인천,부평구,1,0,2,3,2,0,2019-12-21
2432,인천,서구,4,0,2,6,6,0,2019-01-21
2433,인천,서구,6,0,2,8,5,0,2019-02-21
2434,인천,서구,3,0,0,3,2,0,2019-03-21
2435,인천,서구,0,0,0,0,0,0,2019-04-21
2436,인천,서구,4,0,0,4,3,0,2019-05-21
2437,인천,서구,5,1,3,9,5,0,2019-06-21
2438,인천,서구,8,0,0,8,3,0,2019-07-21
2439,인천,서구,5,1,2,8,6,0,2019-08-21
2440,인천,서구,5,0,0,5,4,0,2019-09-21
2441,인천,서구,13,0,1,14,10,0,2019-10-21
2442,인천,서구,9,0,1,10,8,0,2019-11-21
2443,인천,서구,4,0,2,6,5,0,2019-12-21
2444,인천,연수구,1,0,0,1,1,0,2019-01-21
2445,인천,연수구,1,0,0,1,1,0,2019-02-21
2446,인천,연수구,0,0,0,0,0,0,2019-03-21
2447,인천,연수구,4,0,1,5,3,0,2019-04-21
2448,인천,연수구,0,0,1,1,1,0,2019-05-21
2449,인천,연수구,1,0,0,1,1,0,2019-06-21
2450,인천,연수구,1,0,0,1,1,0,2019-07-21
2451,인천,연수구,0,0,0,0,0,0,2019-08-21
2452,인천,연수구,4,0,1,5,4,0,2019-09-21
2453,인천,연수구,0,0,0,0,0,0,2019-10-21
2454,인천,연수구,2,0,2,4,3,0,2019-11-21
2455,인천,연수구,2,0,0,2,2,0,2019-12-21
2456,인천,옹진군,0,0,0,0,0,0,2019-01-21
2457,인천,옹진군,0,0,0,0,0,0,2019-02-21
2458,인천,옹진군,0,0,0,0,0,0,2019-03-21
2459,인천,옹진군,0,0,0,0,0,0,2019-04-21
2460,인천,옹진군,0,0,0,0,0,0,2019-05-21
2461,인천,옹진군,0,0,0,0,0,0,2019-07-21
2462,인천,옹진군,0,0,0,0,0,0,2019-08-21
2463,인천,옹진군,0,0,0,0,0,0,2019-09-21
2464,인천,옹진군,0,0,0,0,0,0,2019-10-21
2465,인천,옹진군,0,0,0,0,0,0,2019-12-21
2466,인천,중구,4,0,0,4,2,0,2019-01-21
2467,인천,중구,1,0,0,1,1,0,2019-02-21
2468,인천,중구,4,0,0,4,1,0,2019-03-21
2469,인천,중구,0,0,2,2,2,0,2019-04-21
2470,인천,중구,3,1,0,4,2,0,2019-05-21
2471,인천,중구,3,0,0,3,2,0,2019-06-21
2472,인천,중구,4,0,0,4,2,0,2019-07-21
2473,인천,중구,2,0,1,3,2,0,2019-08-21
2474,인천,중구,2,0,0,2,1,0,2019-09-21
2475,인천,중구,3,0,1,4,4,0,2019-10-21
2476,인천,중구,1,0,0,1,1,0,2019-11-21
2477,인천,중구,1,0,0,1,1,0,2019-12-21
2478,인천,강화군,1,0,0,1,1,0,2019-01-22
2479,인천,강화군,0,0,0,0,0,0,2019-02-22
2480,인천,강화군,3,0,1,4,2,0,2019-03-22
2481,인천,강화군,1,0,0,1,1,0,2019-04-22
2482,인천,강화군,0,0,0,0,0,0,2019-05-22
2483,인천,강화군,0,0,0,0,0,0,2019-06-22
2484,인천,강화군,1,0,1,2,2,0,2019-07-22
2485,인천,강화군,0,0,1,1,1,0,2019-08-22
2486,인천,강화군,2,0,0,2,1,0,2019-09-22
2487,인천,강화군,1,0,0,1,1,0,2019-10-22
2488,인천,강화군,1,0,2,3,3,0,2019-11-22
2489,인천,강화군,0,0,2,2,1,0,2019-12-22
2490,인천,계양구,1,0,1,2,2,0,2019-01-22
2491,인천,계양구,2,0,0,2,1,0,2019-02-22
2492,인천,계양구,2,0,1,3,2,0,2019-03-22
2493,인천,계양구,3,0,2,5,4,0,2019-04-22
2494,인천,계양구,1,0,0,1,1,0,2019-05-22
2495,인천,계양구,3,0,1,4,3,0,2019-06-22
2496,인천,계양구,3,1,0,4,3,0,2019-07-22
2497,인천,계양구,2,0,1,3,3,0,2019-08-22
2498,인천,계양구,1,0,0,1,1,0,2019-09-22
2499,인천,계양구,1,0,0,1,1,0,2019-10-22
2500,인천,계양구,11,0,1,12,8,0,2019-11-22
2501,인천,계양구,5,0,1,6,5,0,2019-12-22
2502,인천,남동구,4,0,1,5,4,0,2019-01-22
2503,인천,남동구,4,0,1,5,3,0,2019-02-22
2504,인천,남동구,10,0,5,15,7,0,2019-03-22
2505,인천,남동구,5,0,2,7,4,0,2019-04-22
2506,인천,남동구,7,0,0,7,5,0,2019-05-22
2507,인천,남동구,12,0,2,14,8,0,2019-06-22
2508,인천,남동구,5,0,3,8,7,0,2019-07-22
2509,인천,남동구,11,0,0,11,7,0,2019-08-22
2510,인천,남동구,4,0,1,5,3,0,2019-09-22
2511,인천,남동구,6,1,3,10,9,0,2019-10-22
2512,인천,남동구,12,0,2,14,7,0,2019-11-22
2513,인천,남동구,7,0,1,8,5,0,2019-12-22
2514,인천,동구,3,0,1,4,2,0,2019-01-22
2515,인천,동구,2,0,1,3,2,0,2019-02-22
2516,인천,동구,1,0,0,1,1,0,2019-03-22
2517,인천,동구,0,0,0,0,0,0,2019-04-22
2518,인천,동구,0,0,0,0,0,0,2019-05-22
2519,인천,동구,0,0,0,0,0,0,2019-06-22
2520,인천,동구,0,0,0,0,0,0,2019-07-22
2521,인천,동구,0,0,0,0,0,0,2019-08-22
2522,인천,동구,0,0,0,0,0,0,2019-09-22
2523,인천,동구,0,0,1,1,1,0,2019-10-22
2524,인천,동구,0,0,0,0,0,0,2019-11-22
2525,인천,동구,0,0,0,0,0,0,2019-12-22
2526,인천,미추홀구,3,0,0,3,3,0,2019-01-22
2527,인천,미추홀구,3,0,1,4,4,0,2019-02-22
2528,인천,미추홀구,2,0,1,3,4,1,2019-03-22
2529,인천,미추홀구,5,0,2,7,5,0,2019-04-22
2530,인천,미추홀구,4,0,1,5,4,0,2019-05-22
2531,인천,미추홀구,8,3,1,12,6,0,2019-06-22
2532,인천,미추홀구,5,2,0,7,5,0,2019-07-22
2533,인천,미추홀구,4,0,0,4,1,0,2019-08-22
2534,인천,미추홀구,4,0,2,6,5,0,2019-09-22
2535,인천,미추홀구,1,0,0,1,1,0,2019-10-22
2536,인천,미추홀구,4,1,2,7,6,0,2019-11-22
2537,인천,미추홀구,3,3,3,9,7,0,2019-12-22
2538,인천,부평구,1,0,1,2,2,0,2019-01-22
2539,인천,부평구,2,0,0,2,2,0,2019-02-22
2540,인천,부평구,1,0,0,1,1,0,2019-03-22
2541,인천,부평구,4,0,3,7,7,0,2019-04-22
2542,인천,부평구,2,0,1,3,3,0,2019-05-22
2543,인천,부평구,0,0,0,0,0,0,2019-06-22
2544,인천,부평구,2,0,1,3,3,0,2019-07-22
2545,인천,부평구,8,0,1,9,7,0,2019-08-22
2546,인천,부평구,6,0,0,6,3,0,2019-09-22
2547,인천,부평구,0,0,0,0,0,0,2019-10-22
2548,인천,부평구,4,0,2,6,5,0,2019-11-22
2549,인천,부평구,3,0,0,3,2,0,2019-12-22
2550,인천,서구,5,0,1,6,5,0,2019-01-22
2551,인천,서구,14,0,0,14,7,0,2019-02-22
2552,인천,서구,7,0,1,8,5,0,2019-03-22
2553,인천,서구,6,0,0,6,4,0,2019-04-22
2554,인천,서구,4,0,0,4,2,0,2019-05-22
2555,인천,서구,1,0,0,1,1,0,2019-06-22
2556,인천,서구,4,0,0,4,5,1,2019-07-22
2557,인천,서구,5,0,2,7,4,0,2019-08-22
2558,인천,서구,4,0,2,6,6,0,2019-09-22
2559,인천,서구,2,0,0,2,2,0,2019-10-22
2560,인천,서구,9,0,1,10,8,0,2019-11-22
2561,인천,서구,2,0,2,4,3,0,2019-12-22
2562,인천,연수구,5,1,2,8,3,0,2019-01-22
2563,인천,연수구,2,0,0,2,2,0,2019-02-22
2564,인천,연수구,2,1,0,3,1,0,2019-03-22
2565,인천,연수구,5,0,0,5,1,0,2019-04-22
2566,인천,연수구,3,0,2,5,3,0,2019-05-22
2567,인천,연수구,5,1,1,7,4,0,2019-06-22
2568,인천,연수구,0,0,0,0,0,0,2019-07-22
2569,인천,연수구,0,0,0,0,0,0,2019-08-22
2570,인천,연수구,2,0,0,2,1,0,2019-09-22
2571,인천,연수구,5,0,1,6,5,0,2019-10-22
2572,인천,연수구,1,0,1,2,2,0,2019-11-22
2573,인천,연수구,2,0,1,3,3,0,2019-12-22
2574,인천,옹진군,0,0,0,0,0,0,2019-01-22
2575,인천,옹진군,0,0,0,0,0,0,2019-02-22
2576,인천,옹진군,0,0,0,0,0,0,2019-03-22
2577,인천,옹진군,0,0,1,1,1,0,2019-04-22
2578,인천,옹진군,0,0,0,0,0,0,2019-05-22
2579,인천,옹진군,0,0,0,0,0,0,2019-07-22
2580,인천,옹진군,0,0,0,0,0,0,2019-08-22
2581,인천,옹진군,0,0,0,0,0,0,2019-09-22
2582,인천,옹진군,0,0,0,0,0,0,2019-10-22
2583,인천,옹진군,0,0,0,0,0,0,2019-12-22
2584,인천,중구,1,0,0,1,1,0,2019-01-22
2585,인천,중구,0,0,0,0,0,0,2019-02-22
2586,인천,중구,0,0,0,0,0,0,2019-03-22
2587,인천,중구,0,0,1,1,1,0,2019-04-22
2588,인천,중구,0,0,2,2,2,0,2019-05-22
2589,인천,중구,1,1,0,2,2,0,2019-06-22
2590,인천,중구,4,0,0,4,2,0,2019-07-22
2591,인천,중구,2,0,0,2,1,0,2019-08-22
2592,인천,중구,1,0,0,1,1,0,2019-09-22
2593,인천,중구,5,2,0,7,3,0,2019-10-22
2594,인천,중구,1,0,0,1,1,0,2019-11-22
2595,인천,중구,2,0,2,4,4,0,2019-12-22
2596,인천,강화군,0,0,1,1,1,0,2019-01-23
2597,인천,강화군,0,0,0,0,0,0,2019-02-23
2598,인천,강화군,1,0,0,1,1,0,2019-03-23
2599,인천,강화군,0,0,1,1,1,0,2019-04-23
2600,인천,강화군,1,0,0,1,1,0,2019-05-23
2601,인천,강화군,0,0,0,0,0,0,2019-06-23
2602,인천,강화군,0,0,0,0,0,0,2019-07-23
2603,인천,강화군,0,0,0,0,0,0,2019-08-23
2604,인천,강화군,1,0,0,1,1,0,2019-09-23
2605,인천,강화군,0,0,0,0,0,0,2019-10-23
2606,인천,강화군,3,0,0,3,2,0,2019-11-23
2607,인천,강화군,0,0,0,0,0,0,2019-12-23
2608,인천,계양구,2,0,0,2,1,0,2019-01-23
2609,인천,계양구,1,0,1,2,2,0,2019-02-23
2610,인천,계양구,8,1,1,10,6,0,2019-03-23
2611,인천,계양구,4,0,0,4,2,0,2019-04-23
2612,인천,계양구,6,0,1,7,3,0,2019-05-23
2613,인천,계양구,2,0,0,2,2,0,2019-06-23
2614,인천,계양구,1,0,0,1,1,0,2019-07-23
2615,인천,계양구,5,0,1,6,4,0,2019-08-23
2616,인천,계양구,4,0,1,5,4,0,2019-09-23
2617,인천,계양구,1,0,2,3,3,0,2019-10-23
2618,인천,계양구,6,0,1,7,5,0,2019-11-23
2619,인천,계양구,0,0,1,1,1,0,2019-12-23
2620,인천,남동구,7,0,1,8,5,0,2019-01-23
2621,인천,남동구,10,0,3,13,6,0,2019-02-23
2622,인천,남동구,5,0,1,6,2,0,2019-03-23
2623,인천,남동구,6,1,1,8,7,0,2019-04-23
2624,인천,남동구,4,0,2,6,5,0,2019-05-23
2625,인천,남동구,2,0,1,3,3,0,2019-06-23
2626,인천,남동구,6,0,2,8,6,0,2019-07-23
2627,인천,남동구,8,0,1,9,7,0,2019-08-23
2628,인천,남동구,8,0,0,8,5,0,2019-09-23
2629,인천,남동구,4,2,2,8,5,0,2019-10-23
2630,인천,남동구,12,0,0,12,7,0,2019-11-23
2631,인천,남동구,10,0,0,10,6,0,2019-12-23
2632,인천,동구,1,0,1,2,2,0,2019-01-23
2633,인천,동구,0,0,0,0,0,0,2019-02-23
2634,인천,동구,1,0,0,1,1,0,2019-03-23
2635,인천,동구,0,0,1,1,1,0,2019-04-23
2636,인천,동구,3,1,0,4,2,0,2019-05-23
2637,인천,동구,0,0,0,0,0,0,2019-06-23
2638,인천,동구,0,0,0,0,0,0,2019-07-23
2639,인천,동구,0,0,0,0,0,0,2019-08-23
2640,인천,동구,1,0,0,1,1,0,2019-09-23
2641,인천,동구,0,0,0,0,0,0,2019-10-23
2642,인천,동구,0,0,0,0,0,0,2019-11-23
2643,인천,동구,0,0,0,0,0,0,2019-12-23
2644,인천,미추홀구,2,1,1,4,4,0,2019-01-23
2645,인천,미추홀구,2,0,0,2,2,0,2019-02-23
2646,인천,미추홀구,1,1,0,2,2,0,2019-03-23
2647,인천,미추홀구,4,0,2,6,4,0,2019-04-23
2648,인천,미추홀구,3,0,2,5,3,0,2019-05-23
2649,인천,미추홀구,2,0,0,2,2,0,2019-06-23
2650,인천,미추홀구,7,0,2,9,7,0,2019-07-23
2651,인천,미추홀구,2,2,3,7,7,0,2019-08-23
2652,인천,미추홀구,2,1,1,4,4,0,2019-09-23
2653,인천,미추홀구,4,0,1,5,5,0,2019-10-23
2654,인천,미추홀구,3,1,0,4,4,0,2019-11-23
2655,인천,미추홀구,5,0,0,5,4,0,2019-12-23
2656,인천,부평구,3,0,1,4,4,0,2019-01-23
2657,인천,부평구,6,0,1,7,5,0,2019-02-23
2658,인천,부평구,12,0,1,13,8,0,2019-03-23
2659,인천,부평구,2,0,0,2,2,0,2019-04-23
2660,인천,부평구,3,0,0,3,3,0,2019-05-23
2661,인천,부평구,0,0,0,0,0,0,2019-06-23
2662,인천,부평구,4,0,0,4,4,0,2019-07-23
2663,인천,부평구,6,0,0,6,4,0,2019-08-23
2664,인천,부평구,3,0,0,3,3,0,2019-09-23
2665,인천,부평구,3,0,0,3,2,0,2019-10-23
2666,인천,부평구,1,0,1,2,2,0,2019-11-23
2667,인천,부평구,6,0,2,8,6,0,2019-12-23
2668,인천,서구,3,0,1,4,3,0,2019-01-23
2669,인천,서구,0,0,0,0,0,0,2019-02-23
2670,인천,서구,6,0,1,7,4,0,2019-03-23
2671,인천,서구,6,0,1,7,5,0,2019-04-23
2672,인천,서구,3,1,1,5,5,0,2019-05-23
2673,인천,서구,1,0,1,2,2,0,2019-06-23
2674,인천,서구,9,0,3,12,6,0,2019-07-23
2675,인천,서구,7,0,3,10,6,0,2019-08-23
2676,인천,서구,2,0,0,2,2,0,2019-09-23
2677,인천,서구,7,0,3,10,8,0,2019-10-23
2678,인천,서구,2,0,0,2,1,0,2019-11-23
2679,인천,서구,5,0,0,5,4,0,2019-12-23
2680,인천,연수구,1,0,0,1,1,0,2019-01-23
2681,인천,연수구,1,0,0,1,1,0,2019-02-23
2682,인천,연수구,3,0,0,3,2,0,2019-03-23
2683,인천,연수구,1,0,0,1,1,0,2019-04-23
2684,인천,연수구,4,0,0,4,2,0,2019-05-23
2685,인천,연수구,1,0,0,1,1,0,2019-06-23
2686,인천,연수구,0,0,0,0,0,0,2019-07-23
2687,인천,연수구,6,0,3,9,7,0,2019-08-23
2688,인천,연수구,4,0,0,4,3,0,2019-09-23
2689,인천,연수구,1,0,0,1,1,0,2019-10-23
2690,인천,연수구,2,0,0,2,2,0,2019-11-23
2691,인천,연수구,0,0,0,0,0,0,2019-12-23
2692,인천,옹진군,0,0,0,0,0,0,2019-01-23
2693,인천,옹진군,0,0,0,0,0,0,2019-02-23
2694,인천,옹진군,0,0,0,0,0,0,2019-03-23
2695,인천,옹진군,0,0,0,0,0,0,2019-04-23
2696,인천,옹진군,0,0,0,0,0,0,2019-05-23
2697,인천,옹진군,0,0,0,0,0,0,2019-07-23
2698,인천,옹진군,0,0,0,0,0,0,2019-08-23
2699,인천,옹진군,0,0,0,0,0,0,2019-09-23
2700,인천,옹진군,0,0,0,0,0,0,2019-10-23
2701,인천,옹진군,0,0,0,0,0,0,2019-12-23
2702,인천,중구,3,0,3,6,1,0,2019-01-23
2703,인천,중구,1,0,0,1,1,0,2019-02-23
2704,인천,중구,0,0,0,0,0,0,2019-03-23
2705,인천,중구,11,1,4,16,6,0,2019-04-23
2706,인천,중구,7,0,1,8,4,0,2019-05-23
2707,인천,중구,1,0,1,2,2,0,2019-06-23
2708,인천,중구,2,0,0,2,1,0,2019-07-23
2709,인천,중구,5,0,1,6,3,0,2019-08-23
2710,인천,중구,0,0,0,0,0,0,2019-09-23
2711,인천,중구,0,3,1,4,1,0,2019-10-23
2712,인천,중구,4,0,1,5,2,0,2019-11-23
2713,인천,중구,1,0,0,1,1,0,2019-12-23
2714,인천,강화군,0,0,0,0,0,0,2019-01-24
2715,인천,강화군,0,0,0,0,0,0,2019-02-24
2716,인천,강화군,0,0,0,0,0,0,2019-03-24
2717,인천,강화군,0,0,0,0,0,0,2019-04-24
2718,인천,강화군,0,0,0,0,0,0,2019-05-24
2719,인천,강화군,0,0,1,1,1,0,2019-06-24
2720,인천,강화군,0,0,0,0,0,0,2019-07-24
2721,인천,강화군,1,0,1,2,1,0,2019-08-24
2722,인천,강화군,1,0,0,1,1,0,2019-09-24
2723,인천,강화군,0,0,1,1,1,0,2019-10-24
2724,인천,강화군,2,0,0,2,1,0,2019-11-24
2725,인천,강화군,0,0,1,1,1,0,2019-12-24
2726,인천,계양구,3,0,1,4,4,0,2019-01-24
2727,인천,계양구,0,0,1,1,1,0,2019-02-24
2728,인천,계양구,2,0,0,2,2,0,2019-03-24
2729,인천,계양구,4,0,1,5,3,0,2019-04-24
2730,인천,계양구,0,0,3,3,3,0,2019-05-24
2731,인천,계양구,2,2,1,5,5,0,2019-06-24
2732,인천,계양구,13,0,2,15,7,0,2019-07-24
2733,인천,계양구,0,0,0,0,0,0,2019-08-24
2734,인천,계양구,1,0,1,2,2,0,2019-09-24
2735,인천,계양구,5,1,0,6,3,0,2019-10-24
2736,인천,계양구,1,0,0,1,1,0,2019-11-24
2737,인천,계양구,2,0,2,4,3,0,2019-12-24
2738,인천,남동구,0,0,1,1,1,0,2019-01-24
2739,인천,남동구,9,0,2,11,5,0,2019-02-24
2740,인천,남동구,8,0,1,9,5,0,2019-03-24
2741,인천,남동구,8,2,1,11,9,0,2019-04-24
2742,인천,남동구,4,0,1,5,5,0,2019-05-24
2743,인천,남동구,10,0,2,12,8,0,2019-06-24
2744,인천,남동구,7,1,2,10,8,0,2019-07-24
2745,인천,남동구,6,1,3,10,5,0,2019-08-24
2746,인천,남동구,4,1,2,7,6,0,2019-09-24
2747,인천,남동구,4,1,0,5,5,0,2019-10-24
2748,인천,남동구,5,1,3,9,5,0,2019-11-24
2749,인천,남동구,3,0,1,4,3,0,2019-12-24
2750,인천,동구,0,0,0,0,0,0,2019-01-24
2751,인천,동구,0,0,0,0,0,0,2019-02-24
2752,인천,동구,0,0,0,0,0,0,2019-03-24
2753,인천,동구,0,0,0,0,0,0,2019-04-24
2754,인천,동구,0,0,3,3,2,0,2019-05-24
2755,인천,동구,1,0,0,1,1,0,2019-06-24
2756,인천,동구,0,0,0,0,0,0,2019-07-24
2757,인천,동구,0,0,0,0,0,0,2019-08-24
2758,인천,동구,1,0,1,2,2,0,2019-09-24
2759,인천,동구,3,0,0,3,1,0,2019-10-24
2760,인천,동구,0,0,1,1,1,0,2019-11-24
2761,인천,동구,0,0,0,0,0,0,2019-12-24
2762,인천,미추홀구,1,0,1,2,3,1,2019-01-24
2763,인천,미추홀구,4,0,1,5,4,0,2019-02-24
2764,인천,미추홀구,10,1,1,12,7,0,2019-03-24
2765,인천,미추홀구,5,2,1,8,3,0,2019-04-24
2766,인천,미추홀구,4,0,1,5,5,0,2019-05-24
2767,인천,미추홀구,2,0,0,2,2,0,2019-06-24
2768,인천,미추홀구,3,1,0,4,3,0,2019-07-24
2769,인천,미추홀구,5,2,0,7,5,2,2019-08-24
2770,인천,미추홀구,8,0,1,9,7,0,2019-09-24
2771,인천,미추홀구,10,0,1,11,6,0,2019-10-24
2772,인천,미추홀구,3,0,0,3,2,0,2019-11-24
2773,인천,미추홀구,0,0,0,0,0,0,2019-12-24
2774,인천,부평구,1,0,1,2,2,0,2019-01-24
2775,인천,부평구,1,0,5,6,3,0,2019-02-24
2776,인천,부평구,1,0,0,1,1,0,2019-03-24
2777,인천,부평구,4,0,0,4,4,1,2019-04-24
2778,인천,부평구,7,0,0,7,7,0,2019-05-24
2779,인천,부평구,1,0,1,2,2,0,2019-06-24
2780,인천,부평구,2,0,0,2,2,0,2019-07-24
2781,인천,부평구,4,0,4,8,4,0,2019-08-24
2782,인천,부평구,5,0,1,6,2,0,2019-09-24
2783,인천,부평구,1,0,1,2,2,0,2019-10-24
2784,인천,부평구,1,0,1,2,2,0,2019-11-24
2785,인천,부평구,5,0,2,7,4,0,2019-12-24
2786,인천,서구,3,0,1,4,3,0,2019-01-24
2787,인천,서구,6,0,0,6,2,0,2019-02-24
2788,인천,서구,1,0,0,1,1,0,2019-03-24
2789,인천,서구,8,0,1,9,5,2,2019-04-24
2790,인천,서구,7,1,6,14,8,0,2019-05-24
2791,인천,서구,10,0,1,11,8,0,2019-06-24
2792,인천,서구,6,0,1,7,6,0,2019-07-24
2793,인천,서구,10,0,1,11,5,0,2019-08-24
2794,인천,서구,3,0,0,3,2,0,2019-09-24
2795,인천,서구,9,1,2,12,7,0,2019-10-24
2796,인천,서구,10,0,2,12,4,0,2019-11-24
2797,인천,서구,8,0,1,9,5,0,2019-12-24
2798,인천,연수구,0,0,0,0,0,0,2019-01-24
2799,인천,연수구,0,0,0,0,0,0,2019-02-24
2800,인천,연수구,0,0,0,0,0,0,2019-03-24
2801,인천,연수구,1,0,1,2,1,0,2019-04-24
2802,인천,연수구,0,0,0,0,0,0,2019-05-24
2803,인천,연수구,2,1,1,4,1,0,2019-06-24
2804,인천,연수구,3,0,4,7,3,0,2019-07-24
2805,인천,연수구,2,2,0,4,3,0,2019-08-24
2806,인천,연수구,0,1,0,1,1,0,2019-09-24
2807,인천,연수구,2,0,0,2,1,0,2019-10-24
2808,인천,연수구,1,0,0,1,1,0,2019-11-24
2809,인천,연수구,3,0,0,3,2,0,2019-12-24
2810,인천,옹진군,0,0,0,0,0,0,2019-01-24
2811,인천,옹진군,1,0,0,1,1,0,2019-02-24
2812,인천,옹진군,0,0,0,0,0,0,2019-03-24
2813,인천,옹진군,0,0,0,0,0,0,2019-04-24
2814,인천,옹진군,0,0,0,0,0,0,2019-05-24
2815,인천,옹진군,0,0,0,0,0,0,2019-07-24
2816,인천,옹진군,0,0,0,0,0,0,2019-08-24
2817,인천,옹진군,0,0,0,0,0,0,2019-09-24
2818,인천,옹진군,0,0,0,0,0,0,2019-10-24
2819,인천,옹진군,0,0,0,0,0,0,2019-12-24
2820,인천,중구,1,0,1,2,2,0,2019-01-24
2821,인천,중구,5,0,0,5,2,0,2019-02-24
2822,인천,중구,0,0,0,0,0,0,2019-03-24
2823,인천,중구,3,0,1,4,4,0,2019-04-24
2824,인천,중구,0,0,0,0,0,0,2019-05-24
2825,인천,중구,0,0,0,0,0,0,2019-06-24
2826,인천,중구,0,1,0,1,1,0,2019-07-24
2827,인천,중구,0,0,1,1,1,0,2019-08-24
2828,인천,중구,0,0,0,0,0,0,2019-09-24
2829,인천,중구,4,0,0,4,2,0,2019-10-24
2830,인천,중구,3,0,0,3,1,0,2019-11-24
2831,인천,중구,5,0,1,6,3,0,2019-12-24
2832,인천,강화군,0,0,0,0,0,0,2019-01-25
2833,인천,강화군,0,0,0,0,0,0,2019-02-25
2834,인천,강화군,0,0,0,0,0,0,2019-03-25
2835,인천,강화군,0,0,0,0,0,0,2019-04-25
2836,인천,강화군,1,0,0,1,1,0,2019-05-25
2837,인천,강화군,0,0,0,0,1,1,2019-06-25
2838,인천,강화군,0,0,0,0,0,0,2019-07-25
2839,인천,강화군,3,0,0,3,2,0,2019-08-25
2840,인천,강화군,0,0,0,0,0,0,2019-09-25
2841,인천,강화군,1,0,0,1,1,0,2019-10-25
2842,인천,강화군,1,0,0,1,1,0,2019-11-25
2843,인천,강화군,1,0,0,1,2,1,2019-12-25
2844,인천,계양구,7,0,0,7,4,0,2019-01-25
2845,인천,계양구,1,0,0,1,1,0,2019-02-25
2846,인천,계양구,3,0,0,3,3,0,2019-03-25
2847,인천,계양구,4,0,1,5,3,0,2019-04-25
2848,인천,계양구,3,1,0,4,4,0,2019-05-25
2849,인천,계양구,2,0,4,6,5,0,2019-06-25
2850,인천,계양구,1,0,0,1,1,0,2019-07-25
2851,인천,계양구,0,0,0,0,0,0,2019-08-25
2852,인천,계양구,4,0,1,5,5,0,2019-09-25
2853,인천,계양구,1,0,1,2,2,0,2019-10-25
2854,인천,계양구,3,0,1,4,3,0,2019-11-25
2855,인천,계양구,7,0,0,7,3,0,2019-12-25
2856,인천,남동구,3,0,0,3,4,1,2019-01-25
2857,인천,남동구,8,1,0,9,6,0,2019-02-25
2858,인천,남동구,1,0,2,3,2,0,2019-03-25
2859,인천,남동구,5,1,0,6,6,0,2019-04-25
2860,인천,남동구,12,0,1,13,9,0,2019-05-25
2861,인천,남동구,6,0,2,8,5,0,2019-06-25
2862,인천,남동구,3,1,0,4,3,0,2019-07-25
2863,인천,남동구,1,0,2,3,2,0,2019-08-25
2864,인천,남동구,11,0,0,11,9,1,2019-09-25
2865,인천,남동구,3,1,2,6,5,1,2019-10-25
2866,인천,남동구,3,1,0,4,4,0,2019-11-25
2867,인천,남동구,6,0,0,6,4,0,2019-12-25
2868,인천,동구,0,0,0,0,0,0,2019-01-25
2869,인천,동구,0,0,0,0,0,0,2019-02-25
2870,인천,동구,0,0,0,0,0,0,2019-03-25
2871,인천,동구,0,1,0,1,1,0,2019-04-25
2872,인천,동구,0,0,0,0,0,0,2019-05-25
2873,인천,동구,5,1,0,6,3,0,2019-06-25
2874,인천,동구,0,0,0,0,0,0,2019-07-25
2875,인천,동구,0,0,0,0,0,0,2019-08-25
2876,인천,동구,0,0,0,0,0,0,2019-09-25
2877,인천,동구,0,0,0,0,0,0,2019-10-25
2878,인천,동구,0,0,0,0,0,0,2019-11-25
2879,인천,동구,0,0,0,0,0,0,2019-12-25
2880,인천,미추홀구,3,1,0,4,3,0,2019-01-25
2881,인천,미추홀구,2,1,0,3,3,0,2019-02-25
2882,인천,미추홀구,1,0,0,1,1,0,2019-03-25
2883,인천,미추홀구,1,0,1,2,2,0,2019-04-25
2884,인천,미추홀구,6,0,2,8,5,1,2019-05-25
2885,인천,미추홀구,1,1,0,2,2,0,2019-06-25
2886,인천,미추홀구,2,0,1,3,3,0,2019-07-25
2887,인천,미추홀구,2,0,0,2,1,0,2019-08-25
2888,인천,미추홀구,4,0,2,6,5,0,2019-09-25
2889,인천,미추홀구,1,0,2,3,3,0,2019-10-25
2890,인천,미추홀구,2,1,1,4,4,0,2019-11-25
2891,인천,미추홀구,0,0,0,0,0,0,2019-12-25
2892,인천,부평구,5,0,0,5,4,0,2019-01-25
2893,인천,부평구,0,0,0,0,0,0,2019-02-25
2894,인천,부평구,4,0,1,5,5,0,2019-03-25
2895,인천,부평구,2,0,1,3,3,0,2019-04-25
2896,인천,부평구,1,0,0,1,1,0,2019-05-25
2897,인천,부평구,2,0,0,2,2,0,2019-06-25
2898,인천,부평구,7,0,2,9,6,0,2019-07-25
2899,인천,부평구,3,0,1,4,4,0,2019-08-25
2900,인천,부평구,6,0,0,6,4,0,2019-09-25
2901,인천,부평구,2,0,1,3,3,0,2019-10-25
2902,인천,부평구,2,0,4,6,5,0,2019-11-25
2903,인천,부평구,4,0,0,4,3,0,2019-12-25
2904,인천,서구,2,0,0,2,2,0,2019-01-25
2905,인천,서구,1,0,0,1,1,0,2019-02-25
2906,인천,서구,1,0,3,4,4,0,2019-03-25
2907,인천,서구,4,0,0,4,4,0,2019-04-25
2908,인천,서구,8,0,1,9,4,0,2019-05-25
2909,인천,서구,4,0,3,7,6,0,2019-06-25
2910,인천,서구,2,0,1,3,3,0,2019-07-25
2911,인천,서구,7,0,1,8,5,0,2019-08-25
2912,인천,서구,1,1,0,2,2,0,2019-09-25
2913,인천,서구,7,0,2,9,7,0,2019-10-25
2914,인천,서구,11,0,1,12,7,0,2019-11-25
2915,인천,서구,9,0,0,9,2,0,2019-12-25
2916,인천,연수구,3,0,1,4,3,0,2019-01-25
2917,인천,연수구,3,0,0,3,2,0,2019-02-25
2918,인천,연수구,3,0,3,6,5,0,2019-03-25
2919,인천,연수구,0,0,3,3,3,0,2019-04-25
2920,인천,연수구,1,0,0,1,1,0,2019-05-25
2921,인천,연수구,5,0,0,5,4,0,2019-06-25
2922,인천,연수구,1,0,0,1,1,0,2019-07-25
2923,인천,연수구,3,0,1,4,2,0,2019-08-25
2924,인천,연수구,6,0,0,6,3,0,2019-09-25
2925,인천,연수구,0,0,1,1,1,0,2019-10-25
2926,인천,연수구,0,0,1,1,1,0,2019-11-25
2927,인천,연수구,2,0,1,3,3,0,2019-12-25
2928,인천,옹진군,0,0,0,0,0,0,2019-01-25
2929,인천,옹진군,0,0,0,0,0,0,2019-02-25
2930,인천,옹진군,0,0,0,0,0,0,2019-03-25
2931,인천,옹진군,0,0,0,0,0,0,2019-04-25
2932,인천,옹진군,0,0,0,0,0,0,2019-05-25
2933,인천,옹진군,1,1,0,2,1,0,2019-07-25
2934,인천,옹진군,0,0,0,0,0,0,2019-08-25
2935,인천,옹진군,0,0,0,0,0,0,2019-09-25
2936,인천,옹진군,0,0,0,0,0,0,2019-10-25
2937,인천,옹진군,0,0,0,0,0,0,2019-12-25
2938,인천,중구,1,0,0,1,1,0,2019-01-25
2939,인천,중구,2,0,1,3,2,0,2019-02-25
2940,인천,중구,1,0,0,1,1,0,2019-03-25
2941,인천,중구,1,0,2,3,2,1,2019-04-25
2942,인천,중구,2,1,2,5,3,0,2019-05-25
2943,인천,중구,0,0,0,0,0,0,2019-06-25
2944,인천,중구,0,0,0,0,0,0,2019-07-25
2945,인천,중구,1,0,0,1,1,0,2019-08-25
2946,인천,중구,0,0,0,0,0,0,2019-09-25
2947,인천,중구,2,0,1,3,2,0,2019-10-25
2948,인천,중구,11,0,1,12,4,0,2019-11-25
2949,인천,중구,0,0,2,2,1,0,2019-12-25
2950,인천,강화군,4,0,0,4,1,0,2019-01-26
2951,인천,강화군,0,0,1,1,1,0,2019-02-26
2952,인천,강화군,0,0,0,0,0,0,2019-03-26
2953,인천,강화군,0,0,0,0,0,0,2019-04-26
2954,인천,강화군,0,0,0,0,0,0,2019-05-26
2955,인천,강화군,0,0,0,0,0,0,2019-06-26
2956,인천,강화군,0,0,0,0,0,0,2019-07-26
2957,인천,강화군,2,0,1,3,2,0,2019-08-26
2958,인천,강화군,0,0,0,0,0,0,2019-09-26
2959,인천,강화군,1,0,1,2,2,0,2019-10-26
2960,인천,강화군,0,0,0,0,0,0,2019-11-26
2961,인천,강화군,0,0,0,0,0,0,2019-12-26
2962,인천,계양구,1,0,0,1,1,0,2019-01-26
2963,인천,계양구,2,0,0,2,2,0,2019-02-26
2964,인천,계양구,5,0,2,7,4,0,2019-03-26
2965,인천,계양구,0,0,0,0,0,0,2019-04-26
2966,인천,계양구,0,2,0,2,1,0,2019-05-26
2967,인천,계양구,1,0,0,1,1,0,2019-06-26
2968,인천,계양구,1,0,1,2,2,0,2019-07-26
2969,인천,계양구,3,0,0,3,2,0,2019-08-26
2970,인천,계양구,0,0,0,0,0,0,2019-09-26
2971,인천,계양구,0,0,0,0,1,1,2019-10-26
2972,인천,계양구,2,0,0,2,2,0,2019-11-26
2973,인천,계양구,2,0,3,5,4,0,2019-12-26
2974,인천,남동구,6,2,3,11,5,0,2019-01-26
2975,인천,남동구,1,0,2,3,1,0,2019-02-26
2976,인천,남동구,7,0,0,7,5,0,2019-03-26
2977,인천,남동구,16,0,2,18,12,0,2019-04-26
2978,인천,남동구,4,0,3,7,5,0,2019-05-26
2979,인천,남동구,9,2,2,13,9,0,2019-06-26
2980,인천,남동구,4,1,1,6,6,0,2019-07-26
2981,인천,남동구,6,1,2,9,9,0,2019-08-26
2982,인천,남동구,5,0,2,7,6,0,2019-09-26
2983,인천,남동구,5,1,0,6,4,0,2019-10-26
2984,인천,남동구,3,0,0,3,3,0,2019-11-26
2985,인천,남동구,9,2,0,11,5,0,2019-12-26
2986,인천,동구,0,0,0,0,0,0,2019-01-26
2987,인천,동구,0,0,0,0,0,0,2019-02-26
2988,인천,동구,0,0,0,0,0,0,2019-03-26
2989,인천,동구,0,0,0,0,0,0,2019-04-26
2990,인천,동구,2,0,0,2,1,0,2019-05-26
2991,인천,동구,1,0,0,1,1,0,2019-06-26
2992,인천,동구,1,0,0,1,1,0,2019-07-26
2993,인천,동구,0,0,0,0,0,0,2019-08-26
2994,인천,동구,0,0,0,0,0,0,2019-09-26
2995,인천,동구,0,0,0,0,0,0,2019-10-26
2996,인천,동구,0,0,0,0,0,0,2019-11-26
2997,인천,동구,1,0,0,1,1,0,2019-12-26
2998,인천,미추홀구,2,0,0,2,2,0,2019-01-26
2999,인천,미추홀구,4,1,0,5,4,0,2019-02-26
3000,인천,미추홀구,8,0,2,10,5,0,2019-03-26
3001,인천,미추홀구,5,0,0,5,5,0,2019-04-26
3002,인천,미추홀구,4,1,2,7,5,0,2019-05-26
3003,인천,미추홀구,4,0,0,4,4,0,2019-06-26
3004,인천,미추홀구,3,1,0,4,3,0,2019-07-26
3005,인천,미추홀구,2,0,2,4,4,0,2019-08-26
3006,인천,미추홀구,4,1,0,5,4,0,2019-09-26
3007,인천,미추홀구,4,0,0,4,4,0,2019-10-26
3008,인천,미추홀구,2,0,1,3,3,0,2019-11-26
3009,인천,미추홀구,4,0,2,6,4,0,2019-12-26
3010,인천,부평구,7,0,1,8,4,0,2019-01-26
3011,인천,부평구,3,0,1,4,4,0,2019-02-26
3012,인천,부평구,3,0,0,3,1,0,2019-03-26
3013,인천,부평구,2,1,1,4,4,0,2019-04-26
3014,인천,부평구,3,0,0,3,3,0,2019-05-26
3015,인천,부평구,3,0,0,3,3,0,2019-06-26
3016,인천,부평구,7,0,2,9,5,0,2019-07-26
3017,인천,부평구,3,0,0,3,3,0,2019-08-26
3018,인천,부평구,3,0,2,5,5,0,2019-09-26
3019,인천,부평구,1,0,1,2,2,0,2019-10-26
3020,인천,부평구,1,0,0,1,1,0,2019-11-26
3021,인천,부평구,1,1,0,2,2,0,2019-12-26
3022,인천,서구,4,0,2,6,3,0,2019-01-26
3023,인천,서구,1,0,0,1,1,0,2019-02-26
3024,인천,서구,4,0,1,5,4,0,2019-03-26
3025,인천,서구,1,0,1,2,2,0,2019-04-26
3026,인천,서구,4,0,0,4,3,0,2019-05-26
3027,인천,서구,4,0,0,4,4,0,2019-06-26
3028,인천,서구,2,1,1,4,4,0,2019-07-26
3029,인천,서구,6,0,3,9,6,0,2019-08-26
3030,인천,서구,4,1,0,5,6,1,2019-09-26
3031,인천,서구,7,0,2,9,4,0,2019-10-26
3032,인천,서구,6,0,0,6,3,0,2019-11-26
3033,인천,서구,6,0,2,8,6,0,2019-12-26
3034,인천,연수구,3,0,1,4,4,0,2019-01-26
3035,인천,연수구,2,0,0,2,3,1,2019-02-26
3036,인천,연수구,3,0,0,3,2,0,2019-03-26
3037,인천,연수구,0,0,0,0,0,0,2019-04-26
3038,인천,연수구,2,0,0,2,2,0,2019-05-26
3039,인천,연수구,0,0,0,0,0,0,2019-06-26
3040,인천,연수구,3,0,1,4,4,0,2019-07-26
3041,인천,연수구,0,0,1,1,1,0,2019-08-26
3042,인천,연수구,2,0,3,5,4,0,2019-09-26
3043,인천,연수구,7,0,0,7,3,0,2019-10-26
3044,인천,연수구,5,0,3,8,4,0,2019-11-26
3045,인천,연수구,0,0,0,0,0,0,2019-12-26
3046,인천,옹진군,0,0,0,0,0,0,2019-01-26
3047,인천,옹진군,0,0,0,0,0,0,2019-02-26
3048,인천,옹진군,0,0,0,0,0,0,2019-03-26
3049,인천,옹진군,0,0,0,0,1,1,2019-04-26
3050,인천,옹진군,0,0,0,0,0,0,2019-05-26
3051,인천,옹진군,0,0,0,0,0,0,2019-07-26
3052,인천,옹진군,0,0,0,0,0,0,2019-08-26
3053,인천,옹진군,0,0,0,0,0,0,2019-09-26
3054,인천,옹진군,0,0,0,0,0,0,2019-10-26
3055,인천,옹진군,0,0,0,0,0,0,2019-12-26
3056,인천,중구,4,0,0,4,4,0,2019-01-26
3057,인천,중구,5,1,2,8,5,0,2019-02-26
3058,인천,중구,0,0,0,0,0,0,2019-03-26
3059,인천,중구,5,0,2,7,5,0,2019-04-26
3060,인천,중구,2,0,4,6,2,0,2019-05-26
3061,인천,중구,3,1,1,5,3,0,2019-06-26
3062,인천,중구,4,0,1,5,2,0,2019-07-26
3063,인천,중구,0,0,0,0,0,0,2019-08-26
3064,인천,중구,4,1,1,6,3,0,2019-09-26
3065,인천,중구,7,0,0,7,3,0,2019-10-26
3066,인천,중구,1,0,2,3,2,0,2019-11-26
3067,인천,중구,1,0,1,2,2,0,2019-12-26
3068,인천,강화군,0,0,0,0,0,0,2019-01-27
3069,인천,강화군,1,0,0,1,1,0,2019-02-27
3070,인천,강화군,0,0,0,0,0,0,2019-03-27
3071,인천,강화군,0,0,0,0,0,0,2019-04-27
3072,인천,강화군,0,0,0,0,0,0,2019-05-27
3073,인천,강화군,1,0,0,1,1,0,2019-06-27
3074,인천,강화군,1,0,0,1,1,0,2019-07-27
3075,인천,강화군,0,0,0,0,0,0,2019-08-27
3076,인천,강화군,0,0,0,0,0,0,2019-09-27
3077,인천,강화군,3,1,0,4,4,0,2019-10-27
3078,인천,강화군,1,0,1,2,2,0,2019-11-27
3079,인천,강화군,0,0,0,0,0,0,2019-12-27
3080,인천,계양구,0,0,0,0,0,0,2019-01-27
3081,인천,계양구,0,0,0,0,0,0,2019-02-27
3082,인천,계양구,3,0,0,3,1,0,2019-03-27
3083,인천,계양구,1,0,2,3,3,0,2019-04-27
3084,인천,계양구,3,0,0,3,2,0,2019-05-27
3085,인천,계양구,3,0,0,3,3,0,2019-06-27
3086,인천,계양구,0,0,0,0,0,0,2019-07-27
3087,인천,계양구,5,0,0,5,4,0,2019-08-27
3088,인천,계양구,5,0,0,5,4,0,2019-09-27
3089,인천,계양구,2,1,0,3,3,0,2019-10-27
3090,인천,계양구,5,0,0,5,3,0,2019-11-27
3091,인천,계양구,1,0,0,1,1,0,2019-12-27
3092,인천,남동구,3,0,0,3,3,0,2019-01-27
3093,인천,남동구,1,0,4,5,5,0,2019-02-27
3094,인천,남동구,6,1,2,9,5,0,2019-03-27
3095,인천,남동구,5,0,1,6,5,0,2019-04-27
3096,인천,남동구,8,1,0,9,7,0,2019-05-27
3097,인천,남동구,8,1,4,13,11,0,2019-06-27
3098,인천,남동구,2,0,1,3,3,1,2019-07-27
3099,인천,남동구,6,0,4,10,5,0,2019-08-27
3100,인천,남동구,17,0,4,21,8,3,2019-09-27
3101,인천,남동구,4,2,1,7,5,0,2019-10-27
3102,인천,남동구,1,0,0,1,1,0,2019-11-27
3103,인천,남동구,3,0,0,3,3,0,2019-12-27
3104,인천,동구,0,0,0,0,0,0,2019-01-27
3105,인천,동구,0,0,0,0,0,0,2019-02-27
3106,인천,동구,0,0,0,0,0,0,2019-03-27
3107,인천,동구,0,0,0,0,0,0,2019-04-27
3108,인천,동구,0,0,0,0,0,0,2019-05-27
3109,인천,동구,3,0,1,4,3,0,2019-06-27
3110,인천,동구,0,0,0,0,0,0,2019-07-27
3111,인천,동구,0,0,0,0,0,0,2019-08-27
3112,인천,동구,0,0,0,0,0,0,2019-09-27
3113,인천,동구,0,0,0,0,0,0,2019-10-27
3114,인천,동구,0,0,0,0,0,0,2019-11-27
3115,인천,동구,0,0,1,1,1,0,2019-12-27
3116,인천,미추홀구,6,0,3,9,5,0,2019-01-27
3117,인천,미추홀구,12,1,1,14,7,0,2019-02-27
3118,인천,미추홀구,2,0,1,3,3,0,2019-03-27
3119,인천,미추홀구,7,0,5,12,6,0,2019-04-27
3120,인천,미추홀구,1,0,0,1,1,0,2019-05-27
3121,인천,미추홀구,5,0,3,8,7,0,2019-06-27
3122,인천,미추홀구,3,0,0,3,3,0,2019-07-27
3123,인천,미추홀구,1,0,0,1,1,0,2019-08-27
3124,인천,미추홀구,1,1,0,2,2,0,2019-09-27
3125,인천,미추홀구,10,0,2,12,6,0,2019-10-27
3126,인천,미추홀구,1,0,1,2,2,0,2019-11-27
3127,인천,미추홀구,9,0,2,11,8,0,2019-12-27
3128,인천,부평구,15,1,0,16,6,0,2019-01-27
3129,인천,부평구,7,0,0,7,4,0,2019-02-27
3130,인천,부평구,4,0,2,6,4,0,2019-03-27
3131,인천,부평구,4,0,0,4,3,0,2019-04-27
3132,인천,부평구,1,0,0,1,1,0,2019-05-27
3133,인천,부평구,4,0,1,5,5,0,2019-06-27
3134,인천,부평구,10,1,0,11,7,0,2019-07-27
3135,인천,부평구,1,0,1,2,2,0,2019-08-27
3136,인천,부평구,1,0,1,2,2,0,2019-09-27
3137,인천,부평구,6,1,2,9,5,0,2019-10-27
3138,인천,부평구,3,0,1,4,3,0,2019-11-27
3139,인천,부평구,1,0,1,2,2,0,2019-12-27
3140,인천,서구,3,0,0,3,3,0,2019-01-27
3141,인천,서구,0,0,0,0,0,0,2019-02-27
3142,인천,서구,4,0,2,6,4,0,2019-03-27
3143,인천,서구,7,0,2,9,5,0,2019-04-27
3144,인천,서구,5,0,1,6,5,0,2019-05-27
3145,인천,서구,5,0,2,7,4,0,2019-06-27
3146,인천,서구,3,0,0,3,1,0,2019-07-27
3147,인천,서구,3,1,1,5,4,0,2019-08-27
3148,인천,서구,2,0,2,4,4,0,2019-09-27
3149,인천,서구,1,0,0,1,1,0,2019-10-27
3150,인천,서구,4,0,1,5,5,0,2019-11-27
3151,인천,서구,3,2,2,7,7,0,2019-12-27
3152,인천,연수구,0,0,0,0,0,0,2019-01-27
3153,인천,연수구,0,0,0,0,0,0,2019-02-27
3154,인천,연수구,1,0,1,2,2,0,2019-03-27
3155,인천,연수구,5,0,2,7,7,0,2019-04-27
3156,인천,연수구,2,0,0,2,2,0,2019-05-27
3157,인천,연수구,1,1,0,2,2,0,2019-06-27
3158,인천,연수구,1,0,0,1,1,0,2019-07-27
3159,인천,연수구,0,0,1,1,1,0,2019-08-27
3160,인천,연수구,0,0,2,2,2,0,2019-09-27
3161,인천,연수구,1,0,0,1,1,0,2019-10-27
3162,인천,연수구,3,0,1,4,4,0,2019-11-27
3163,인천,연수구,0,0,0,0,0,0,2019-12-27
3164,인천,옹진군,0,0,0,0,0,0,2019-01-27
3165,인천,옹진군,0,0,0,0,0,0,2019-02-27
3166,인천,옹진군,3,0,0,3,1,0,2019-03-27
3167,인천,옹진군,0,0,0,0,0,0,2019-04-27
3168,인천,옹진군,0,0,0,0,0,0,2019-05-27
3169,인천,옹진군,0,0,0,0,0,0,2019-07-27
3170,인천,옹진군,0,0,1,1,1,0,2019-08-27
3171,인천,옹진군,0,1,0,1,1,0,2019-09-27
3172,인천,옹진군,0,0,1,1,1,0,2019-10-27
3173,인천,옹진군,0,0,0,0,0,0,2019-12-27
3174,인천,중구,1,0,0,1,1,0,2019-01-27
3175,인천,중구,3,0,2,5,2,0,2019-02-27
3176,인천,중구,1,0,0,1,1,0,2019-03-27
3177,인천,중구,4,0,0,4,3,0,2019-04-27
3178,인천,중구,5,0,2,7,3,0,2019-05-27
3179,인천,중구,0,0,0,0,0,0,2019-06-27
3180,인천,중구,3,0,0,3,1,0,2019-07-27
3181,인천,중구,0,2,0,2,2,0,2019-08-27
3182,인천,중구,2,1,1,4,4,0,2019-09-27
3183,인천,중구,2,0,2,4,2,0,2019-10-27
3184,인천,중구,5,0,0,5,4,0,2019-11-27
3185,인천,중구,0,0,0,0,0,0,2019-12-27
3186,인천,강화군,1,0,0,1,1,0,2019-01-28
3187,인천,강화군,0,0,0,0,0,0,2019-02-28
3188,인천,강화군,2,0,1,3,2,0,2019-03-28
3189,인천,강화군,0,0,0,0,0,0,2019-04-28
3190,인천,강화군,0,0,0,0,0,0,2019-05-28
3191,인천,강화군,0,0,0,0,0,0,2019-06-28
3192,인천,강화군,0,0,0,0,0,0,2019-07-28
3193,인천,강화군,1,0,0,1,1,0,2019-08-28
3194,인천,강화군,2,0,2,4,3,0,2019-09-28
3195,인천,강화군,0,0,0,0,0,0,2019-10-28
3196,인천,강화군,0,0,0,0,0,0,2019-11-28
3197,인천,강화군,0,1,0,1,1,0,2019-12-28
3198,인천,계양구,2,0,0,2,1,0,2019-01-28
3199,인천,계양구,2,0,1,3,3,0,2019-02-28
3200,인천,계양구,1,0,1,2,2,0,2019-03-28
3201,인천,계양구,3,0,1,4,3,0,2019-04-28
3202,인천,계양구,0,0,0,0,0,0,2019-05-28
3203,인천,계양구,9,0,2,11,6,0,2019-06-28
3204,인천,계양구,0,0,0,0,0,0,2019-07-28
3205,인천,계양구,6,0,0,6,6,0,2019-08-28
3206,인천,계양구,1,0,0,1,1,0,2019-09-28
3207,인천,계양구,1,0,0,1,1,0,2019-10-28
3208,인천,계양구,2,0,0,2,2,0,2019-11-28
3209,인천,계양구,1,0,1,2,2,0,2019-12-28
3210,인천,남동구,6,0,2,8,6,0,2019-01-28
3211,인천,남동구,4,3,1,8,5,0,2019-02-28
3212,인천,남동구,13,0,1,14,8,0,2019-03-28
3213,인천,남동구,8,0,3,11,8,0,2019-04-28
3214,인천,남동구,10,0,4,14,8,0,2019-05-28
3215,인천,남동구,6,0,0,6,6,0,2019-06-28
3216,인천,남동구,2,0,0,2,1,0,2019-07-28
3217,인천,남동구,7,0,2,9,7,0,2019-08-28
3218,인천,남동구,10,1,5,16,12,0,2019-09-28
3219,인천,남동구,6,0,1,7,5,0,2019-10-28
3220,인천,남동구,2,0,3,5,4,0,2019-11-28
3221,인천,남동구,10,1,1,12,5,0,2019-12-28
3222,인천,동구,0,0,0,0,0,0,2019-01-28
3223,인천,동구,0,0,1,1,1,0,2019-02-28
3224,인천,동구,0,0,0,0,0,0,2019-03-28
3225,인천,동구,1,0,0,1,1,0,2019-04-28
3226,인천,동구,0,0,0,0,0,0,2019-05-28
3227,인천,동구,0,0,0,0,0,0,2019-06-28
3228,인천,동구,0,0,0,0,0,0,2019-07-28
3229,인천,동구,0,0,0,0,0,0,2019-08-28
3230,인천,동구,1,0,0,1,1,0,2019-09-28
3231,인천,동구,0,0,0,0,0,0,2019-10-28
3232,인천,동구,0,0,0,0,0,0,2019-11-28
3233,인천,동구,0,0,0,0,0,0,2019-12-28
3234,인천,미추홀구,0,1,0,1,2,1,2019-01-28
3235,인천,미추홀구,3,1,2,6,5,0,2019-02-28
3236,인천,미추홀구,4,2,2,8,6,0,2019-03-28
3237,인천,미추홀구,6,0,3,9,6,0,2019-04-28
3238,인천,미추홀구,2,0,2,4,4,0,2019-05-28
3239,인천,미추홀구,2,0,4,6,3,0,2019-06-28
3240,인천,미추홀구,2,0,2,4,3,0,2019-07-28
3241,인천,미추홀구,2,1,1,4,4,0,2019-08-28
3242,인천,미추홀구,2,2,1,5,5,1,2019-09-28
3243,인천,미추홀구,1,0,0,1,2,1,2019-10-28
3244,인천,미추홀구,7,1,0,8,4,0,2019-11-28
3245,인천,미추홀구,2,1,0,3,3,0,2019-12-28
3246,인천,부평구,2,0,1,3,3,0,2019-01-28
3247,인천,부평구,2,0,0,2,2,0,2019-02-28
3248,인천,부평구,3,0,1,4,2,0,2019-03-28
3249,인천,부평구,3,0,1,4,2,0,2019-04-28
3250,인천,부평구,10,0,0,10,7,0,2019-05-28
3251,인천,부평구,2,0,1,3,3,0,2019-06-28
3252,인천,부평구,4,0,1,5,5,0,2019-07-28
3253,인천,부평구,2,1,2,5,5,1,2019-08-28
3254,인천,부평구,9,0,5,14,8,0,2019-09-28
3255,인천,부평구,1,0,2,3,3,0,2019-10-28
3256,인천,부평구,7,0,0,7,7,0,2019-11-28
3257,인천,부평구,4,0,1,5,5,0,2019-12-28
3258,인천,서구,2,0,1,3,3,0,2019-01-28
3259,인천,서구,2,0,0,2,2,0,2019-02-28
3260,인천,서구,9,1,3,13,11,0,2019-03-28
3261,인천,서구,4,0,4,8,6,0,2019-04-28
3262,인천,서구,4,0,3,7,6,0,2019-05-28
3263,인천,서구,1,0,1,2,2,0,2019-06-28
3264,인천,서구,6,0,0,6,5,0,2019-07-28
3265,인천,서구,1,0,1,2,2,0,2019-08-28
3266,인천,서구,12,0,2,14,7,0,2019-09-28
3267,인천,서구,9,0,0,9,8,0,2019-10-28
3268,인천,서구,3,0,0,3,3,0,2019-11-28
3269,인천,서구,4,0,0,4,4,0,2019-12-28
3270,인천,연수구,2,0,1,3,3,0,2019-01-28
3271,인천,연수구,0,0,0,0,0,0,2019-02-28
3272,인천,연수구,3,0,0,3,1,0,2019-03-28
3273,인천,연수구,0,0,0,0,0,0,2019-04-28
3274,인천,연수구,0,0,2,2,1,1,2019-05-28
3275,인천,연수구,0,0,1,1,1,0,2019-06-28
3276,인천,연수구,1,0,1,2,1,0,2019-07-28
3277,인천,연수구,0,0,1,1,1,0,2019-08-28
3278,인천,연수구,7,0,0,7,4,0,2019-09-28
3279,인천,연수구,0,0,0,0,0,0,2019-10-28
3280,인천,연수구,2,0,1,3,2,0,2019-11-28
3281,인천,연수구,0,0,2,2,2,0,2019-12-28
3282,인천,옹진군,0,0,0,0,0,0,2019-01-28
3283,인천,옹진군,0,0,0,0,0,0,2019-02-28
3284,인천,옹진군,0,0,0,0,0,0,2019-03-28
3285,인천,옹진군,0,0,0,0,0,0,2019-04-28
3286,인천,옹진군,0,0,0,0,0,0,2019-05-28
3287,인천,옹진군,0,0,0,0,0,0,2019-07-28
3288,인천,옹진군,0,0,0,0,0,0,2019-08-28
3289,인천,옹진군,0,0,0,0,0,0,2019-09-28
3290,인천,옹진군,0,0,0,0,0,0,2019-10-28
3291,인천,옹진군,0,0,0,0,0,0,2019-12-28
3292,인천,중구,2,0,3,5,3,0,2019-01-28
3293,인천,중구,0,0,0,0,0,0,2019-02-28
3294,인천,중구,1,0,0,1,1,0,2019-03-28
3295,인천,중구,1,0,0,1,1,0,2019-04-28
3296,인천,중구,3,0,1,4,3,0,2019-05-28
3297,인천,중구,1,0,0,1,1,0,2019-06-28
3298,인천,중구,0,0,0,0,0,0,2019-07-28
3299,인천,중구,4,0,3,7,3,0,2019-08-28
3300,인천,중구,0,0,0,0,0,0,2019-09-28
3301,인천,중구,1,0,1,2,2,0,2019-10-28
3302,인천,중구,2,0,3,5,5,0,2019-11-28
3303,인천,중구,4,1,1,6,2,0,2019-12-28
3304,인천,강화군,0,0,0,0,0,0,2019-01-29
3306,인천,강화군,0,0,0,0,0,0,2019-03-29
3307,인천,강화군,0,0,0,0,1,1,2019-04-29
3308,인천,강화군,1,0,0,1,1,0,2019-05-29
3309,인천,강화군,0,0,0,0,0,0,2019-06-29
3310,인천,강화군,1,0,0,1,1,0,2019-07-29
3311,인천,강화군,0,0,0,0,0,0,2019-08-29
3312,인천,강화군,0,0,0,0,0,0,2019-09-29
3313,인천,강화군,0,0,0,0,0,0,2019-10-29
3314,인천,강화군,0,0,0,0,0,0,2019-11-29
3315,인천,강화군,0,0,0,0,0,0,2019-12-29
3316,인천,계양구,1,0,0,1,1,0,2019-01-29
3318,인천,계양구,3,0,0,3,3,0,2019-03-29
3319,인천,계양구,3,0,0,3,3,0,2019-04-29
3320,인천,계양구,4,0,1,5,4,0,2019-05-29
3321,인천,계양구,1,1,0,2,1,0,2019-06-29
3322,인천,계양구,4,0,1,5,3,0,2019-07-29
3323,인천,계양구,4,1,3,8,5,0,2019-08-29
3324,인천,계양구,4,0,0,4,3,0,2019-09-29
3325,인천,계양구,6,0,4,10,9,0,2019-10-29
3326,인천,계양구,3,0,0,3,3,0,2019-11-29
3327,인천,계양구,0,0,0,0,0,0,2019-12-29
3328,인천,남동구,1,4,1,6,3,0,2019-01-29
3330,인천,남동구,4,0,0,4,3,0,2019-03-29
3331,인천,남동구,1,0,0,1,1,0,2019-04-29
3332,인천,남동구,5,0,0,5,5,0,2019-05-29
3333,인천,남동구,8,0,2,10,6,0,2019-06-29
3334,인천,남동구,3,0,0,3,2,0,2019-07-29
3335,인천,남동구,4,0,1,5,3,0,2019-08-29
3336,인천,남동구,5,0,2,7,5,0,2019-09-29
3337,인천,남동구,2,0,1,3,3,0,2019-10-29
3338,인천,남동구,11,1,1,13,9,0,2019-11-29
3339,인천,남동구,4,0,2,6,4,0,2019-12-29
3340,인천,동구,0,0,0,0,0,0,2019-01-29
3342,인천,동구,0,0,0,0,0,0,2019-03-29
3343,인천,동구,0,0,0,0,0,0,2019-04-29
3344,인천,동구,0,0,0,0,1,1,2019-05-29
3345,인천,동구,0,0,0,0,0,0,2019-06-29
3346,인천,동구,0,0,0,0,0,0,2019-07-29
3347,인천,동구,0,0,0,0,0,0,2019-08-29
3348,인천,동구,0,0,0,0,0,0,2019-09-29
3349,인천,동구,0,0,0,0,0,0,2019-10-29
3350,인천,동구,1,0,1,2,2,0,2019-11-29
3351,인천,동구,0,0,2,2,2,0,2019-12-29
3352,인천,미추홀구,5,0,1,6,4,0,2019-01-29
3354,인천,미추홀구,6,0,0,6,5,0,2019-03-29
3355,인천,미추홀구,3,0,1,4,4,0,2019-04-29
3356,인천,미추홀구,6,0,0,6,4,0,2019-05-29
3357,인천,미추홀구,3,0,0,3,2,0,2019-06-29
3358,인천,미추홀구,0,1,1,2,2,0,2019-07-29
3359,인천,미추홀구,4,0,0,4,3,0,2019-08-29
3360,인천,미추홀구,2,1,0,3,3,0,2019-09-29
3361,인천,미추홀구,6,0,0,6,6,0,2019-10-29
3362,인천,미추홀구,4,0,2,6,4,0,2019-11-29
3363,인천,미추홀구,1,0,0,1,1,0,2019-12-29
3364,인천,부평구,1,1,0,2,2,0,2019-01-29
3366,인천,부평구,2,1,1,4,3,0,2019-03-29
3367,인천,부평구,0,0,1,1,1,0,2019-04-29
3368,인천,부평구,6,0,1,7,5,0,2019-05-29
3369,인천,부평구,3,0,1,4,4,0,2019-06-29
3370,인천,부평구,1,0,0,1,1,0,2019-07-29
3371,인천,부평구,8,0,0,8,5,0,2019-08-29
3372,인천,부평구,2,0,0,2,2,0,2019-09-29
3373,인천,부평구,4,0,0,4,2,0,2019-10-29
3374,인천,부평구,3,1,2,6,5,0,2019-11-29
3375,인천,부평구,3,1,0,4,4,0,2019-12-29
3376,인천,서구,5,0,1,6,5,0,2019-01-29
3378,인천,서구,9,0,3,12,8,0,2019-03-29
3379,인천,서구,3,1,2,6,5,0,2019-04-29
3380,인천,서구,4,0,3,7,4,0,2019-05-29
3381,인천,서구,2,0,3,5,4,0,2019-06-29
3382,인천,서구,8,0,2,10,8,0,2019-07-29
3383,인천,서구,5,1,2,8,6,0,2019-08-29
3384,인천,서구,0,0,2,2,2,0,2019-09-29
3385,인천,서구,6,0,3,9,8,0,2019-10-29
3386,인천,서구,11,0,0,11,7,1,2019-11-29
3387,인천,서구,5,0,0,5,4,0,2019-12-29
3388,인천,연수구,0,0,1,1,1,0,2019-01-29
3390,인천,연수구,1,0,0,1,1,0,2019-03-29
3391,인천,연수구,3,0,2,5,3,0,2019-04-29
3392,인천,연수구,2,0,0,2,2,0,2019-05-29
3393,인천,연수구,0,1,2,3,1,0,2019-06-29
3394,인천,연수구,1,0,0,1,1,0,2019-07-29
3395,인천,연수구,2,0,0,2,2,0,2019-08-29
3396,인천,연수구,0,0,1,1,1,0,2019-09-29
3397,인천,연수구,1,0,1,2,2,0,2019-10-29
3398,인천,연수구,1,0,0,1,1,0,2019-11-29
3399,인천,연수구,0,0,0,0,0,0,2019-12-29
3400,인천,옹진군,0,0,0,0,0,0,2019-01-29
3402,인천,옹진군,0,0,0,0,0,0,2019-03-29
3403,인천,옹진군,0,0,0,0,0,0,2019-04-29
3404,인천,옹진군,0,0,0,0,0,0,2019-05-29
3405,인천,옹진군,0,0,0,0,0,0,2019-07-29
3406,인천,옹진군,0,0,0,0,0,0,2019-08-29
3407,인천,옹진군,0,0,0,0,0,0,2019-09-29
3408,인천,옹진군,0,0,0,0,0,0,2019-10-29
3409,인천,옹진군,0,0,0,0,0,0,2019-12-29
3410,인천,중구,3,0,0,3,2,0,2019-01-29
3412,인천,중구,2,0,0,2,1,0,2019-03-29
3413,인천,중구,1,0,1,2,2,0,2019-04-29
3414,인천,중구,1,0,0,1,1,0,2019-05-29
3415,인천,중구,3,0,1,4,3,0,2019-06-29
3416,인천,중구,2,0,3,5,4,0,2019-07-29
3417,인천,중구,1,0,1,2,2,0,2019-08-29
3418,인천,중구,1,0,0,1,1,0,2019-09-29
3419,인천,중구,3,0,0,3,3,0,2019-10-29
3420,인천,중구,1,0,1,2,2,0,2019-11-29
3421,인천,중구,0,0,0,0,0,0,2019-12-29
3422,인천,강화군,2,0,0,2,1,0,2019-01-30
3424,인천,강화군,2,0,0,2,2,0,2019-03-30
3425,인천,강화군,0,0,0,0,0,0,2019-04-30
3426,인천,강화군,0,0,0,0,0,0,2019-05-30
3427,인천,강화군,4,0,0,4,2,0,2019-06-30
3428,인천,강화군,0,0,0,0,1,1,2019-07-30
3429,인천,강화군,2,0,2,4,3,0,2019-08-30
3430,인천,강화군,0,0,0,0,0,0,2019-09-30
3431,인천,강화군,0,0,0,0,0,0,2019-10-30
3432,인천,강화군,1,0,0,1,1,0,2019-11-30
3433,인천,강화군,1,0,0,1,1,0,2019-12-30
3434,인천,계양구,0,0,1,1,1,0,2019-01-30
3436,인천,계양구,3,0,1,4,4,0,2019-03-30
3437,인천,계양구,6,0,0,6,5,0,2019-04-30
3438,인천,계양구,2,0,0,2,2,0,2019-05-30
3439,인천,계양구,2,0,0,2,1,0,2019-06-30
3440,인천,계양구,1,0,0,1,1,0,2019-07-30
3441,인천,계양구,4,0,1,5,5,0,2019-08-30
3442,인천,계양구,2,0,0,2,2,0,2019-09-30
3443,인천,계양구,0,0,0,0,0,0,2019-10-30
3444,인천,계양구,2,0,1,3,2,0,2019-11-30
3445,인천,계양구,5,0,1,6,5,0,2019-12-30
3446,인천,남동구,10,0,5,15,9,0,2019-01-30
3448,인천,남동구,7,0,1,8,5,0,2019-03-30
3449,인천,남동구,3,0,1,4,4,0,2019-04-30
3450,인천,남동구,3,0,1,4,4,0,2019-05-30
3451,인천,남동구,1,0,0,1,1,0,2019-06-30
3452,인천,남동구,4,0,0,4,2,0,2019-07-30
3453,인천,남동구,7,1,2,10,9,0,2019-08-30
3454,인천,남동구,3,1,0,4,5,1,2019-09-30
3455,인천,남동구,6,0,0,6,4,0,2019-10-30
3456,인천,남동구,5,1,2,8,6,0,2019-11-30
3457,인천,남동구,3,0,2,5,4,0,2019-12-30
3458,인천,동구,2,0,1,3,3,0,2019-01-30
3460,인천,동구,0,0,0,0,0,0,2019-03-30
3461,인천,동구,1,0,0,1,1,0,2019-04-30
3462,인천,동구,1,0,0,1,1,0,2019-05-30
3463,인천,동구,0,0,0,0,0,0,2019-06-30
3464,인천,동구,0,0,0,0,0,0,2019-07-30
3465,인천,동구,0,0,0,0,0,0,2019-08-30
3466,인천,동구,0,0,0,0,0,0,2019-09-30
3467,인천,동구,5,0,0,5,3,0,2019-10-30
3468,인천,동구,0,0,0,0,0,0,2019-11-30
3469,인천,동구,2,0,0,2,1,0,2019-12-30
3470,인천,미추홀구,2,0,2,4,3,0,2019-01-30
3472,인천,미추홀구,3,0,1,4,3,0,2019-03-30
3473,인천,미추홀구,3,0,0,3,2,0,2019-04-30
3474,인천,미추홀구,2,2,2,6,4,0,2019-05-30
3475,인천,미추홀구,6,0,0,6,2,0,2019-06-30
3476,인천,미추홀구,2,0,3,5,5,0,2019-07-30
3477,인천,미추홀구,7,0,1,8,7,0,2019-08-30
3478,인천,미추홀구,1,0,0,1,1,0,2019-09-30
3479,인천,미추홀구,0,2,1,3,2,0,2019-10-30
3480,인천,미추홀구,8,0,1,9,5,0,2019-11-30
3481,인천,미추홀구,0,1,0,1,1,0,2019-12-30
3482,인천,부평구,2,0,2,4,4,0,2019-01-30
3484,인천,부평구,1,0,0,1,1,0,2019-03-30
3485,인천,부평구,1,1,4,6,4,0,2019-04-30
3486,인천,부평구,3,0,0,3,3,0,2019-05-30
3487,인천,부평구,3,0,0,3,1,0,2019-06-30
3488,인천,부평구,3,0,2,5,4,0,2019-07-30
3489,인천,부평구,3,1,2,6,5,0,2019-08-30
3490,인천,부평구,3,0,2,5,4,0,2019-09-30
3491,인천,부평구,2,0,1,3,2,0,2019-10-30
3492,인천,부평구,4,0,0,4,4,0,2019-11-30
3493,인천,부평구,0,0,0,0,0,0,2019-12-30
3494,인천,서구,4,0,2,6,3,0,2019-01-30
3496,인천,서구,4,0,3,7,6,0,2019-03-30
3497,인천,서구,9,1,5,15,5,0,2019-04-30
3498,인천,서구,5,1,1,7,3,0,2019-05-30
3499,인천,서구,1,0,0,1,1,0,2019-06-30
3500,인천,서구,14,0,2,16,9,0,2019-07-30
3501,인천,서구,12,0,1,13,8,0,2019-08-30
3502,인천,서구,10,0,2,12,7,0,2019-09-30
3503,인천,서구,3,0,2,5,4,0,2019-10-30
3504,인천,서구,4,0,0,4,3,0,2019-11-30
3505,인천,서구,5,1,1,7,6,0,2019-12-30
3506,인천,연수구,1,0,0,1,1,0,2019-01-30
3508,인천,연수구,0,0,0,0,0,0,2019-03-30
3509,인천,연수구,1,1,1,3,2,0,2019-04-30
3510,인천,연수구,7,0,0,7,5,0,2019-05-30
3511,인천,연수구,11,0,0,11,3,0,2019-06-30
3512,인천,연수구,0,0,1,1,1,0,2019-07-30
3513,인천,연수구,1,0,0,1,1,0,2019-08-30
3514,인천,연수구,3,1,0,4,4,0,2019-09-30
3515,인천,연수구,1,0,0,1,1,0,2019-10-30
3516,인천,연수구,3,0,0,3,2,0,2019-11-30
3517,인천,연수구,1,0,0,1,1,0,2019-12-30
3518,인천,옹진군,0,0,0,0,0,0,2019-01-30
3520,인천,옹진군,0,0,0,0,0,0,2019-03-30
3521,인천,옹진군,0,0,0,0,0,0,2019-04-30
3522,인천,옹진군,0,0,0,0,0,0,2019-05-30
3523,인천,옹진군,0,0,0,0,0,0,2019-07-30
3524,인천,옹진군,0,0,0,0,0,0,2019-08-30
3525,인천,옹진군,0,0,0,0,0,0,2019-09-30
3526,인천,옹진군,0,0,0,0,0,0,2019-10-30
3527,인천,옹진군,0,0,0,0,0,0,2019-12-30
3528,인천,중구,25,0,18,43,5,0,2019-01-30
3530,인천,중구,0,0,1,1,2,1,2019-03-30
3531,인천,중구,0,0,0,0,0,0,2019-04-30
3532,인천,중구,1,0,2,3,2,0,2019-05-30
3533,인천,중구,0,0,1,1,1,0,2019-06-30
3534,인천,중구,2,0,2,4,3,1,2019-07-30
3535,인천,중구,2,0,1,3,3,0,2019-08-30
3536,인천,중구,3,0,1,4,4,0,2019-09-30
3537,인천,중구,4,1,0,5,3,0,2019-10-30
3538,인천,중구,1,0,1,2,2,0,2019-11-30
3539,인천,중구,0,0,1,1,1,0,2019-12-30
3540,인천,강화군,0,0,0,0,0,0,2019-01-31
3542,인천,강화군,0,0,0,0,0,0,2019-03-31
3544,인천,강화군,0,0,0,0,0,0,2019-05-31
3546,인천,강화군,1,0,0,1,1,0,2019-07-31
3547,인천,강화군,0,0,0,0,0,0,2019-08-31
3549,인천,강화군,0,0,0,0,0,0,2019-10-31
3551,인천,강화군,0,0,0,0,0,0,2019-12-31
3552,인천,계양구,0,0,1,1,1,0,2019-01-31
3554,인천,계양구,5,0,0,5,3,0,2019-03-31
3556,인천,계양구,4,0,0,4,3,0,2019-05-31
3558,인천,계양구,0,0,0,0,0,0,2019-07-31
3559,인천,계양구,2,0,0,2,2,0,2019-08-31
3561,인천,계양구,0,0,1,1,1,0,2019-10-31
3563,인천,계양구,0,0,1,1,1,0,2019-12-31
3564,인천,남동구,3,0,2,5,4,0,2019-01-31
3566,인천,남동구,3,0,2,5,5,0,2019-03-31
3568,인천,남동구,6,0,2,8,6,0,2019-05-31
3570,인천,남동구,8,0,0,8,6,0,2019-07-31
3571,인천,남동구,8,1,3,12,7,0,2019-08-31
3573,인천,남동구,5,1,2,8,6,0,2019-10-31
3575,인천,남동구,5,0,3,8,5,0,2019-12-31
3576,인천,동구,2,0,0,2,1,0,2019-01-31
3578,인천,동구,2,0,0,2,1,0,2019-03-31
3580,인천,동구,0,0,0,0,0,0,2019-05-31
3582,인천,동구,1,0,1,2,2,0,2019-07-31
3583,인천,동구,0,0,0,0,0,0,2019-08-31
3585,인천,동구,0,0,0,0,0,0,2019-10-31
3587,인천,동구,0,0,0,0,0,0,2019-12-31
3588,인천,미추홀구,7,0,0,7,3,0,2019-01-31
3590,인천,미추홀구,3,2,0,5,2,0,2019-03-31
3592,인천,미추홀구,3,1,2,6,5,0,2019-05-31
3594,인천,미추홀구,4,0,0,4,4,0,2019-07-31
3595,인천,미추홀구,2,0,0,2,2,0,2019-08-31
3597,인천,미추홀구,0,0,1,1,1,0,2019-10-31
3599,인천,미추홀구,3,0,2,5,4,0,2019-12-31
3600,인천,부평구,3,0,0,3,2,0,2019-01-31
3602,인천,부평구,3,0,0,3,3,0,2019-03-31
3604,인천,부평구,6,0,1,7,5,0,2019-05-31
3606,인천,부평구,6,0,4,10,10,0,2019-07-31
3607,인천,부평구,4,1,2,7,6,0,2019-08-31
3609,인천,부평구,4,0,0,4,2,0,2019-10-31
3611,인천,부평구,3,0,2,5,5,0,2019-12-31
3612,인천,서구,6,0,2,8,7,0,2019-01-31
3614,인천,서구,0,0,2,2,2,0,2019-03-31
3616,인천,서구,7,0,4,11,8,0,2019-05-31
3618,인천,서구,11,0,3,14,7,0,2019-07-31
3619,인천,서구,6,0,0,6,2,0,2019-08-31
3621,인천,서구,7,0,4,11,9,1,2019-10-31
3623,인천,서구,2,0,1,3,3,0,2019-12-31
3624,인천,연수구,1,0,1,2,2,0,2019-01-31
3626,인천,연수구,3,0,0,3,2,0,2019-03-31
3628,인천,연수구,2,0,1,3,4,1,2019-05-31
3630,인천,연수구,1,0,1,2,2,0,2019-07-31
3631,인천,연수구,3,0,0,3,1,0,2019-08-31
3633,인천,연수구,1,0,0,1,1,0,2019-10-31
3635,인천,연수구,2,1,0,3,3,0,2019-12-31
3636,인천,옹진군,0,0,0,0,0,0,2019-01-31
3638,인천,옹진군,1,0,0,1,1,0,2019-03-31
3640,인천,옹진군,0,0,0,0,0,0,2019-05-31
3641,인천,옹진군,1,0,0,1,1,0,2019-07-31
3642,인천,옹진군,0,0,0,0,0,0,2019-08-31
3644,인천,옹진군,0,0,0,0,0,0,2019-10-31
3645,인천,옹진군,0,0,0,0,0,0,2019-12-31
3646,인천,중구,1,0,1,2,2,0,2019-01-31
3648,인천,중구,4,0,0,4,3,0,2019-03-31
3650,인천,중구,3,0,1,4,4,0,2019-05-31
3652,인천,중구,0,0,0,0,0,0,2019-07-31
3653,인천,중구,3,0,1,4,4,0,2019-08-31
3655,인천,중구,0,0,0,0,0,0,2019-10-31
3657,인천,중구,3,0,0,3,3,0,2019-12-31
